municipality,group,variable,month,Repetidas en personas de 5 a 14 años -Hombre,Repetidas en personas de 5 a 14 años -Mujer,TOTAL-H,TOTAL-M,TOTAL
ACACIO,consulta externa,repetidas en personas de 5 a 14 anos,2005-01-01,0,3,0,3,3
ACHACACHI,consulta externa,repetidas en personas de 5 a 14 anos,2005-01-01,7,6,7,6,13
ACHOCALLA,consulta externa,repetidas en personas de 5 a 14 anos,2005-01-01,2,2,2,2,4
AIQUILE,consulta externa,repetidas en personas de 5 a 14 anos,2005-01-01,14,16,14,16,30
ANCORAIMES,consulta externa,repetidas en personas de 5 a 14 anos,2005-01-01,10,2,10,2,12
ARQUE,consulta externa,repetidas en personas de 5 a 14 anos,2005-01-01,1,0,1,0,1
ATOCHA,consulta externa,repetidas en personas de 5 a 14 anos,2005-01-01,13,29,13,29,42
AYO AYO,consulta externa,repetidas en personas de 5 a 14 anos,2005-01-01,0,1,0,1,1
BATALLAS,consulta externa,repetidas en personas de 5 a 14 anos,2005-01-01,0,4,0,4,4
BAURES,consulta externa,repetidas en personas de 5 a 14 anos,2005-01-01,3,3,3,3,6
BELEN DE URMIRI,consulta externa,repetidas en personas de 5 a 14 anos,2005-01-01,0,1,0,1,1
BERMEJO,consulta externa,repetidas en personas de 5 a 14 anos,2005-01-01,18,25,18,25,43
BETANZOS,consulta externa,repetidas en personas de 5 a 14 anos,2005-01-01,3,1,3,1,4
BOYUIBE,consulta externa,repetidas en personas de 5 a 14 anos,2005-01-01,9,3,9,3,12
BUENA VISTA,consulta externa,repetidas en personas de 5 a 14 anos,2005-01-01,11,12,11,12,23
CABEZAS,consulta externa,repetidas en personas de 5 a 14 anos,2005-01-01,3,2,3,2,5
"CAIZA ""D""",consulta externa,repetidas en personas de 5 a 14 anos,2005-01-01,0,4,0,4,4
CAJUATA,consulta externa,repetidas en personas de 5 a 14 anos,2005-01-01,0,1,0,1,1
CALACOTO,consulta externa,repetidas en personas de 5 a 14 anos,2005-01-01,2,0,2,0,2
CALAMARCA,consulta externa,repetidas en personas de 5 a 14 anos,2005-01-01,0,1,0,1,1
CAMARGO,consulta externa,repetidas en personas de 5 a 14 anos,2005-01-01,3,6,3,6,9
CAMATAQUI (C. VILLA ABECIA),consulta externa,repetidas en personas de 5 a 14 anos,2005-01-01,0,1,0,1,1
CAMIRI,consulta externa,repetidas en personas de 5 a 14 anos,2005-01-01,28,68,28,68,96
CAPINOTA,consulta externa,repetidas en personas de 5 a 14 anos,2005-01-01,89,5,89,5,94
CAQUIAVIRI,consulta externa,repetidas en personas de 5 a 14 anos,2005-01-01,2,0,2,0,2
CARACOLLO,consulta externa,repetidas en personas de 5 a 14 anos,2005-01-01,3,5,3,5,8
CARANAVI,consulta externa,repetidas en personas de 5 a 14 anos,2005-01-01,10,7,10,7,17
CARAPARI,consulta externa,repetidas en personas de 5 a 14 anos,2005-01-01,3,0,3,0,3
CARMEN RIVERO TORREZ,consulta externa,repetidas en personas de 5 a 14 anos,2005-01-01,0,1,0,1,1
CATACORA,consulta externa,repetidas en personas de 5 a 14 anos,2005-01-01,1,0,1,0,1
CHALLAPATA,consulta externa,repetidas en personas de 5 a 14 anos,2005-01-01,1,2,1,2,3
CHAQUI,consulta externa,repetidas en personas de 5 a 14 anos,2005-01-01,1,4,1,4,5
CHARAGUA,consulta externa,repetidas en personas de 5 a 14 anos,2005-01-01,11,3,11,3,14
CHARAÑA,consulta externa,repetidas en personas de 5 a 14 anos,2005-01-01,1,0,1,0,1
CHAYANTA,consulta externa,repetidas en personas de 5 a 14 anos,2005-01-01,1,2,1,2,3
CHIMORE,consulta externa,repetidas en personas de 5 a 14 anos,2005-01-01,6,2,6,2,8
CHULUMANI (V. DE LA LIBERTAD),consulta externa,repetidas en personas de 5 a 14 anos,2005-01-01,6,2,6,2,8
CHUMA,consulta externa,repetidas en personas de 5 a 14 anos,2005-01-01,1,4,1,4,5
CLIZA,consulta externa,repetidas en personas de 5 a 14 anos,2005-01-01,1,1,1,1,2
COBIJA,consulta externa,repetidas en personas de 5 a 14 anos,2005-01-01,31,28,31,28,59
COCHABAMBA,consulta externa,repetidas en personas de 5 a 14 anos,2005-01-01,2049,1986,2049,1986,4035
COLCAPIRHUA,consulta externa,repetidas en personas de 5 a 14 anos,2005-01-01,62,43,62,43,105
"COLCHA ""K""",consulta externa,repetidas en personas de 5 a 14 anos,2005-01-01,3,1,3,1,4
COLOMI,consulta externa,repetidas en personas de 5 a 14 anos,2005-01-01,4,1,4,1,5
COLPA BELGICA,consulta externa,repetidas en personas de 5 a 14 anos,2005-01-01,34,8,34,8,42
COLQUECHACA,consulta externa,repetidas en personas de 5 a 14 anos,2005-01-01,1,1,1,1,2
COLQUIRI,consulta externa,repetidas en personas de 5 a 14 anos,2005-01-01,9,3,9,3,12
COMANCHE,consulta externa,repetidas en personas de 5 a 14 anos,2005-01-01,1,1,1,1,2
COMARAPA,consulta externa,repetidas en personas de 5 a 14 anos,2005-01-01,8,5,8,5,13
COMBAYA,consulta externa,repetidas en personas de 5 a 14 anos,2005-01-01,1,0,1,0,1
CONCEPCION,consulta externa,repetidas en personas de 5 a 14 anos,2005-01-01,6,2,6,2,8
COPACABANA,consulta externa,repetidas en personas de 5 a 14 anos,2005-01-01,6,5,6,5,11
CORIPATA,consulta externa,repetidas en personas de 5 a 14 anos,2005-01-01,1,0,1,0,1
COROICO,consulta externa,repetidas en personas de 5 a 14 anos,2005-01-01,13,4,13,4,17
CORQUE,consulta externa,repetidas en personas de 5 a 14 anos,2005-01-01,1,2,1,2,3
COTAGAITA,consulta externa,repetidas en personas de 5 a 14 anos,2005-01-01,4,8,4,8,12
COTOCA,consulta externa,repetidas en personas de 5 a 14 anos,2005-01-01,4,33,4,33,37
CUATRO CAÑADAS,consulta externa,repetidas en personas de 5 a 14 anos,2005-01-01,4,4,4,4,8
CUEVO,consulta externa,repetidas en personas de 5 a 14 anos,2005-01-01,2,4,2,4,6
EL ALTO,consulta externa,repetidas en personas de 5 a 14 anos,2005-01-01,2075,2816,2075,2816,4891
EL PUENTE(STC),consulta externa,repetidas en personas de 5 a 14 anos,2005-01-01,3,0,3,0,3
EL TORNO,consulta externa,repetidas en personas de 5 a 14 anos,2005-01-01,41,45,41,45,86
EL VILLAR,consulta externa,repetidas en personas de 5 a 14 anos,2005-01-01,1,2,1,2,3
ENTRE RIOS,consulta externa,repetidas en personas de 5 a 14 anos,2005-01-01,3,4,3,4,7
ENTRE RIOS,consulta externa,repetidas en personas de 5 a 14 anos,2005-01-01,4,4,4,4,8
EUCALIPTUS,consulta externa,repetidas en personas de 5 a 14 anos,2005-01-01,1,0,1,0,1
FERNANDEZ ALONSO,consulta externa,repetidas en personas de 5 a 14 anos,2005-01-01,6,5,6,5,11
GENERAL SAAVEDRA,consulta externa,repetidas en personas de 5 a 14 anos,2005-01-01,3,0,3,0,3
GUANAY,consulta externa,repetidas en personas de 5 a 14 anos,2005-01-01,15,7,15,7,22
GUAQUI,consulta externa,repetidas en personas de 5 a 14 anos,2005-01-01,0,5,0,5,5
GUAYARAMERIN,consulta externa,repetidas en personas de 5 a 14 anos,2005-01-01,58,68,58,68,126
GUTIERREZ,consulta externa,repetidas en personas de 5 a 14 anos,2005-01-01,8,9,8,9,17
HUACARETA,consulta externa,repetidas en personas de 5 a 14 anos,2005-01-01,7,0,7,0,7
HUANUNI,consulta externa,repetidas en personas de 5 a 14 anos,2005-01-01,79,73,79,73,152
HUARACAJE,consulta externa,repetidas en personas de 5 a 14 anos,2005-01-01,3,5,3,5,8
ICLA,consulta externa,repetidas en personas de 5 a 14 anos,2005-01-01,1,6,1,6,7
INGAVI (HUMAITA),consulta externa,repetidas en personas de 5 a 14 anos,2005-01-01,0,1,0,1,1
IRUPANA (VILLA DE LANZA),consulta externa,repetidas en personas de 5 a 14 anos,2005-01-01,3,0,3,0,3
IXIAMAS,consulta externa,repetidas en personas de 5 a 14 anos,2005-01-01,3,0,3,0,3
JESUS DE MACHACA,consulta externa,repetidas en personas de 5 a 14 anos,2005-01-01,2,0,2,0,2
LA ASUNTA,consulta externa,repetidas en personas de 5 a 14 anos,2005-01-01,1,0,1,0,1
LA GUARDIA,consulta externa,repetidas en personas de 5 a 14 anos,2005-01-01,10,3,10,3,13
LA PAZ,consulta externa,repetidas en personas de 5 a 14 anos,2005-01-01,2332,2567,2332,2567,4899
LAJA,consulta externa,repetidas en personas de 5 a 14 anos,2005-01-01,1,0,1,0,1
LAS CARRERAS,consulta externa,repetidas en personas de 5 a 14 anos,2005-01-01,1,0,1,0,1
LLALLAGUA,consulta externa,repetidas en personas de 5 a 14 anos,2005-01-01,7,15,7,15,22
LORETO,consulta externa,repetidas en personas de 5 a 14 anos,2005-01-01,2,0,2,0,2
LURIBAY,consulta externa,repetidas en personas de 5 a 14 anos,2005-01-01,1,0,1,0,1
MACHACAMARCA,consulta externa,repetidas en personas de 5 a 14 anos,2005-01-01,2,2,2,2,4
MACHARETI,consulta externa,repetidas en personas de 5 a 14 anos,2005-01-01,1,1,1,1,2
MAGDALENA,consulta externa,repetidas en personas de 5 a 14 anos,2005-01-01,14,17,14,17,31
MAIRANA,consulta externa,repetidas en personas de 5 a 14 anos,2005-01-01,1,3,1,3,4
MAPIRI,consulta externa,repetidas en personas de 5 a 14 anos,2005-01-01,2,1,2,1,3
MECAPACA,consulta externa,repetidas en personas de 5 a 14 anos,2005-01-01,15,10,15,10,25
MINEROS,consulta externa,repetidas en personas de 5 a 14 anos,2005-01-01,0,1,0,1,1
MOCOMOCO,consulta externa,repetidas en personas de 5 a 14 anos,2005-01-01,1,0,1,0,1
MOJINETE,consulta externa,repetidas en personas de 5 a 14 anos,2005-01-01,1,0,1,0,1
MOJOCOYA,consulta externa,repetidas en personas de 5 a 14 anos,2005-01-01,2,1,2,1,3
MONTEAGUDO,consulta externa,repetidas en personas de 5 a 14 anos,2005-01-01,15,17,15,17,32
MONTERO,consulta externa,repetidas en personas de 5 a 14 anos,2005-01-01,127,130,127,130,257
MOROCHATA,consulta externa,repetidas en personas de 5 a 14 anos,2005-01-01,0,1,0,1,1
NUEVO MANOA (NUEVA ESPERANZA),consulta externa,repetidas en personas de 5 a 14 anos,2005-01-01,1,0,1,0,1
OKINAWA,consulta externa,repetidas en personas de 5 a 14 anos,2005-01-01,9,8,9,8,17
ORURO,consulta externa,repetidas en personas de 5 a 14 anos,2005-01-01,388,456,388,456,844
PADCAYA,consulta externa,repetidas en personas de 5 a 14 anos,2005-01-01,2,1,2,1,3
PADILLA,consulta externa,repetidas en personas de 5 a 14 anos,2005-01-01,4,5,4,5,9
PAILON,consulta externa,repetidas en personas de 5 a 14 anos,2005-01-01,1,0,1,0,1
PALCA,consulta externa,repetidas en personas de 5 a 14 anos,2005-01-01,1,1,1,1,2
PALOS BLANCOS,consulta externa,repetidas en personas de 5 a 14 anos,2005-01-01,32,20,32,20,52
PAMPA GRANDE,consulta externa,repetidas en personas de 5 a 14 anos,2005-01-01,2,7,2,7,9
PAPEL PAMPA,consulta externa,repetidas en personas de 5 a 14 anos,2005-01-01,1,0,1,0,1
PATACAMAYA,consulta externa,repetidas en personas de 5 a 14 anos,2005-01-01,1,0,1,0,1
PELECHUCO,consulta externa,repetidas en personas de 5 a 14 anos,2005-01-01,3,1,3,1,4
POCOATA,consulta externa,repetidas en personas de 5 a 14 anos,2005-01-01,0,2,0,2,2
POOPO,consulta externa,repetidas en personas de 5 a 14 anos,2005-01-01,1,0,1,0,1
POROMA,consulta externa,repetidas en personas de 5 a 14 anos,2005-01-01,2,0,2,0,2
PORONGO,consulta externa,repetidas en personas de 5 a 14 anos,2005-01-01,1,2,1,2,3
PORTACHUELO,consulta externa,repetidas en personas de 5 a 14 anos,2005-01-01,21,33,21,33,54
PORVENIR,consulta externa,repetidas en personas de 5 a 14 anos,2005-01-01,1,0,1,0,1
POSTRER VALLE,consulta externa,repetidas en personas de 5 a 14 anos,2005-01-01,1,1,1,1,2
POTOSI,consulta externa,repetidas en personas de 5 a 14 anos,2005-01-01,359,448,359,448,807
PRESTO,consulta externa,repetidas en personas de 5 a 14 anos,2005-01-01,0,1,0,1,1
PUCARANI,consulta externa,repetidas en personas de 5 a 14 anos,2005-01-01,0,1,0,1,1
PUERTO ACOSTA,consulta externa,repetidas en personas de 5 a 14 anos,2005-01-01,3,0,3,0,3
PUERTO CARABUCO,consulta externa,repetidas en personas de 5 a 14 anos,2005-01-01,7,0,7,0,7
PUERTO GONZALO MORENO,consulta externa,repetidas en personas de 5 a 14 anos,2005-01-01,4,0,4,0,4
PUERTO QUIJARRO,consulta externa,repetidas en personas de 5 a 14 anos,2005-01-01,18,18,18,18,36
PUERTO RICO,consulta externa,repetidas en personas de 5 a 14 anos,2005-01-01,2,1,2,1,3
PUERTO SILES,consulta externa,repetidas en personas de 5 a 14 anos,2005-01-01,1,0,1,0,1
PUERTO SUAREZ,consulta externa,repetidas en personas de 5 a 14 anos,2005-01-01,7,13,7,13,20
PUERTO VILLARROEL,consulta externa,repetidas en personas de 5 a 14 anos,2005-01-01,8,11,8,11,19
PUNA,consulta externa,repetidas en personas de 5 a 14 anos,2005-01-01,7,2,7,2,9
PUNATA,consulta externa,repetidas en personas de 5 a 14 anos,2005-01-01,18,15,18,15,33
QUIABAYA,consulta externa,repetidas en personas de 5 a 14 anos,2005-01-01,0,1,0,1,1
QUILLACOLLO,consulta externa,repetidas en personas de 5 a 14 anos,2005-01-01,77,83,77,83,160
QUIME,consulta externa,repetidas en personas de 5 a 14 anos,2005-01-01,2,0,2,0,2
RAVELO,consulta externa,repetidas en personas de 5 a 14 anos,2005-01-01,0,1,0,1,1
REYES,consulta externa,repetidas en personas de 5 a 14 anos,2005-01-01,11,8,11,8,19
RIBERALTA,consulta externa,repetidas en personas de 5 a 14 anos,2005-01-01,140,165,140,165,305
ROBORE,consulta externa,repetidas en personas de 5 a 14 anos,2005-01-01,5,177,5,177,182
RURRENABAQUE,consulta externa,repetidas en personas de 5 a 14 anos,2005-01-01,6,4,6,4,10
SABAYA,consulta externa,repetidas en personas de 5 a 14 anos,2005-01-01,0,4,0,4,4
SACABA,consulta externa,repetidas en personas de 5 a 14 anos,2005-01-01,60,68,60,68,128
SACACA,consulta externa,repetidas en personas de 5 a 14 anos,2005-01-01,10,0,10,0,10
SAIPINA,consulta externa,repetidas en personas de 5 a 14 anos,2005-01-01,6,5,6,5,11
SALINAS DE GARCI MENDOZA,consulta externa,repetidas en personas de 5 a 14 anos,2005-01-01,0,1,0,1,1
SAMAIPATA,consulta externa,repetidas en personas de 5 a 14 anos,2005-01-01,1,1,1,1,2
SAN ANDRES,consulta externa,repetidas en personas de 5 a 14 anos,2005-01-01,7,6,7,6,13
SAN BENITO,consulta externa,repetidas en personas de 5 a 14 anos,2005-01-01,7,6,7,6,13
SAN BORJA,consulta externa,repetidas en personas de 5 a 14 anos,2005-01-01,21,20,21,20,41
SAN BUENA VENTURA,consulta externa,repetidas en personas de 5 a 14 anos,2005-01-01,5,0,5,0,5
SAN CARLOS,consulta externa,repetidas en personas de 5 a 14 anos,2005-01-01,0,4,0,4,4
SAN IGNACIO,consulta externa,repetidas en personas de 5 a 14 anos,2005-01-01,9,10,9,10,19
SAN IGNACIO DE VELASCO,consulta externa,repetidas en personas de 5 a 14 anos,2005-01-01,21,24,21,24,45
SAN JAVIER(BNI),consulta externa,repetidas en personas de 5 a 14 anos,2005-01-01,1,0,1,0,1
SAN JAVIER(STC),consulta externa,repetidas en personas de 5 a 14 anos,2005-01-01,1,2,1,2,3
SAN JOAQUIN,consulta externa,repetidas en personas de 5 a 14 anos,2005-01-01,3,7,3,7,10
SAN JOSE DE CHIQUITOS,consulta externa,repetidas en personas de 5 a 14 anos,2005-01-01,2,0,2,0,2
SAN JUAN DE YAPACANI,consulta externa,repetidas en personas de 5 a 14 anos,2005-01-01,2,7,2,7,9
SAN JULIAN,consulta externa,repetidas en personas de 5 a 14 anos,2005-01-01,3,6,3,6,9
SAN LORENZO(TJA),consulta externa,repetidas en personas de 5 a 14 anos,2005-01-01,6,11,6,11,17
SAN LUCAS,consulta externa,repetidas en personas de 5 a 14 anos,2005-01-01,0,2,0,2,2
SAN MATIAS,consulta externa,repetidas en personas de 5 a 14 anos,2005-01-01,1,3,1,3,4
SAN MIGUEL DE VELASCO,consulta externa,repetidas en personas de 5 a 14 anos,2005-01-01,10,12,10,12,22
SAN PABLO DE LIPEZ,consulta externa,repetidas en personas de 5 a 14 anos,2005-01-01,0,1,0,1,1
SAN PEDRO,consulta externa,repetidas en personas de 5 a 14 anos,2005-01-01,12,19,12,19,31
SAN PEDRO DE CURAHUARA,consulta externa,repetidas en personas de 5 a 14 anos,2005-01-01,2,1,2,1,3
SAN PEDRO DE TIQUINA,consulta externa,repetidas en personas de 5 a 14 anos,2005-01-01,1,0,1,0,1
SAN RAFAEL,consulta externa,repetidas en personas de 5 a 14 anos,2005-01-01,1,1,1,1,2
SAN RAMON,consulta externa,repetidas en personas de 5 a 14 anos,2005-01-01,2,5,2,5,7
SAN RAMON,consulta externa,repetidas en personas de 5 a 14 anos,2005-01-01,4,1,4,1,5
SANTA ANA,consulta externa,repetidas en personas de 5 a 14 anos,2005-01-01,36,21,36,21,57
SANTA CRUZ DE LA SIERRA,consulta externa,repetidas en personas de 5 a 14 anos,2005-01-01,1535,1983,1535,1983,3518
SANTA ROSA DEL SARA,consulta externa,repetidas en personas de 5 a 14 anos,2005-01-01,8,5,8,5,13
SANTIVAÑES,consulta externa,repetidas en personas de 5 a 14 anos,2005-01-01,1,0,1,0,1
SAPAHAQUI,consulta externa,repetidas en personas de 5 a 14 anos,2005-01-01,0,1,0,1,1
SENA,consulta externa,repetidas en personas de 5 a 14 anos,2005-01-01,1,2,1,2,3
SICA SICA (VILLA AROMA),consulta externa,repetidas en personas de 5 a 14 anos,2005-01-01,1,2,1,2,3
SIPE SIPE,consulta externa,repetidas en personas de 5 a 14 anos,2005-01-01,10,10,10,10,20
SOPACHUY,consulta externa,repetidas en personas de 5 a 14 anos,2005-01-01,1,1,1,1,2
SORATA,consulta externa,repetidas en personas de 5 a 14 anos,2005-01-01,1,3,1,3,4
SUCRE,consulta externa,repetidas en personas de 5 a 14 anos,2005-01-01,690,784,690,784,1474
TACACHI,consulta externa,repetidas en personas de 5 a 14 anos,2005-01-01,8,6,8,6,14
TACOBAMBA,consulta externa,repetidas en personas de 5 a 14 anos,2005-01-01,1,0,1,0,1
TAPACARI,consulta externa,repetidas en personas de 5 a 14 anos,2005-01-01,1,0,1,0,1
TARABUCO,consulta externa,repetidas en personas de 5 a 14 anos,2005-01-01,5,2,5,2,7
TARATA,consulta externa,repetidas en personas de 5 a 14 anos,2005-01-01,9,2,9,2,11
TARIJA,consulta externa,repetidas en personas de 5 a 14 anos,2005-01-01,497,601,497,601,1098
TARVITA,consulta externa,repetidas en personas de 5 a 14 anos,2005-01-01,2,5,2,5,7
TIAWANACU,consulta externa,repetidas en personas de 5 a 14 anos,2005-01-01,1,0,1,0,1
TIQUIPAYA,consulta externa,repetidas en personas de 5 a 14 anos,2005-01-01,15,24,15,24,39
TIRAQUE (CBBA),consulta externa,repetidas en personas de 5 a 14 anos,2005-01-01,7,12,7,12,19
TITO YUPANQUI (PARQUIPUJIO),consulta externa,repetidas en personas de 5 a 14 anos,2005-01-01,2,0,2,0,2
TODOS SANTOS,consulta externa,repetidas en personas de 5 a 14 anos,2005-01-01,2,0,2,0,2
TOLATA,consulta externa,repetidas en personas de 5 a 14 anos,2005-01-01,1,0,1,0,1
TOLEDO,consulta externa,repetidas en personas de 5 a 14 anos,2005-01-01,2,4,2,4,6
TOMAVE,consulta externa,repetidas en personas de 5 a 14 anos,2005-01-01,0,1,0,1,1
TOMINA,consulta externa,repetidas en personas de 5 a 14 anos,2005-01-01,4,4,4,4,8
TORO TORO,consulta externa,repetidas en personas de 5 a 14 anos,2005-01-01,1,1,1,1,2
TOTORA(CBBA),consulta externa,repetidas en personas de 5 a 14 anos,2005-01-01,0,2,0,2,2
TRIGAL,consulta externa,repetidas en personas de 5 a 14 anos,2005-01-01,1,0,1,0,1
TRINIDAD,consulta externa,repetidas en personas de 5 a 14 anos,2005-01-01,228,321,228,321,549
TUPIZA,consulta externa,repetidas en personas de 5 a 14 anos,2005-01-01,33,63,33,63,96
TURCO,consulta externa,repetidas en personas de 5 a 14 anos,2005-01-01,0,2,0,2,2
UNCIA,consulta externa,repetidas en personas de 5 a 14 anos,2005-01-01,7,16,7,16,23
URIONDO (A. CONCEPCION),consulta externa,repetidas en personas de 5 a 14 anos,2005-01-01,0,1,0,1,1
UYUNI,consulta externa,repetidas en personas de 5 a 14 anos,2005-01-01,9,9,9,9,18
VACAS,consulta externa,repetidas en personas de 5 a 14 anos,2005-01-01,8,4,8,4,12
VALLEGRANDE,consulta externa,repetidas en personas de 5 a 14 anos,2005-01-01,15,24,15,24,39
VIACHA,consulta externa,repetidas en personas de 5 a 14 anos,2005-01-01,18,32,18,32,50
VILLA MONTES,consulta externa,repetidas en personas de 5 a 14 anos,2005-01-01,8,14,8,14,22
VILLA RIVERO,consulta externa,repetidas en personas de 5 a 14 anos,2005-01-01,4,0,4,0,4
VILLA TUNARI,consulta externa,repetidas en personas de 5 a 14 anos,2005-01-01,15,5,15,5,20
VILLA VACA GUZMAN (MUYUPAMPA),consulta externa,repetidas en personas de 5 a 14 anos,2005-01-01,6,1,6,1,7
VILLAZON,consulta externa,repetidas en personas de 5 a 14 anos,2005-01-01,6,27,6,27,33
VINTO,consulta externa,repetidas en personas de 5 a 14 anos,2005-01-01,2,2,2,2,4
VITICHI,consulta externa,repetidas en personas de 5 a 14 anos,2005-01-01,3,3,3,3,6
WARNES,consulta externa,repetidas en personas de 5 a 14 anos,2005-01-01,3,2,3,2,5
YACO,consulta externa,repetidas en personas de 5 a 14 anos,2005-01-01,2,0,2,0,2
YACUIBA,consulta externa,repetidas en personas de 5 a 14 anos,2005-01-01,84,80,84,80,164
YAMPARAEZ,consulta externa,repetidas en personas de 5 a 14 anos,2005-01-01,3,0,3,0,3
YAPACANI,consulta externa,repetidas en personas de 5 a 14 anos,2005-01-01,24,11,24,11,35
YOCALLA,consulta externa,repetidas en personas de 5 a 14 anos,2005-01-01,0,1,0,1,1
YOTALA,consulta externa,repetidas en personas de 5 a 14 anos,2005-01-01,7,10,7,10,17
ZUDAÑEZ,consulta externa,repetidas en personas de 5 a 14 anos,2005-01-01,0,1,0,1,1
ACACIO,consulta externa,repetidas en personas de 5 a 14 anos,2005-02-01,1,0,1,0,1
ACHACACHI,consulta externa,repetidas en personas de 5 a 14 anos,2005-02-01,5,7,5,7,12
ACHOCALLA,consulta externa,repetidas en personas de 5 a 14 anos,2005-02-01,1,1,1,1,2
AIQUILE,consulta externa,repetidas en personas de 5 a 14 anos,2005-02-01,12,11,12,11,23
ANCORAIMES,consulta externa,repetidas en personas de 5 a 14 anos,2005-02-01,2,4,2,4,6
ANZALDO,consulta externa,repetidas en personas de 5 a 14 anos,2005-02-01,1,0,1,0,1
APOLO,consulta externa,repetidas en personas de 5 a 14 anos,2005-02-01,0,1,0,1,1
ARANI,consulta externa,repetidas en personas de 5 a 14 anos,2005-02-01,2,3,2,3,5
ARBIETO,consulta externa,repetidas en personas de 5 a 14 anos,2005-02-01,3,1,3,1,4
ASCENCION DE GUARAYOS,consulta externa,repetidas en personas de 5 a 14 anos,2005-02-01,1,1,1,1,2
ATOCHA,consulta externa,repetidas en personas de 5 a 14 anos,2005-02-01,18,28,18,28,46
AUCAPATA,consulta externa,repetidas en personas de 5 a 14 anos,2005-02-01,1,0,1,0,1
AYATA,consulta externa,repetidas en personas de 5 a 14 anos,2005-02-01,3,0,3,0,3
AYOPAYA (V. DE INDEPENDENCIA),consulta externa,repetidas en personas de 5 a 14 anos,2005-02-01,2,3,2,3,5
BAURES,consulta externa,repetidas en personas de 5 a 14 anos,2005-02-01,1,1,1,1,2
BELEN DE URMIRI,consulta externa,repetidas en personas de 5 a 14 anos,2005-02-01,2,2,2,2,4
BERMEJO,consulta externa,repetidas en personas de 5 a 14 anos,2005-02-01,105,81,105,81,186
BETANZOS,consulta externa,repetidas en personas de 5 a 14 anos,2005-02-01,0,7,0,7,7
BOLIVAR,consulta externa,repetidas en personas de 5 a 14 anos,2005-02-01,1,1,1,1,2
BOLPEBRA,consulta externa,repetidas en personas de 5 a 14 anos,2005-02-01,3,0,3,0,3
BOYUIBE,consulta externa,repetidas en personas de 5 a 14 anos,2005-02-01,0,1,0,1,1
BUENA VISTA,consulta externa,repetidas en personas de 5 a 14 anos,2005-02-01,4,7,4,7,11
"CAIZA ""D""",consulta externa,repetidas en personas de 5 a 14 anos,2005-02-01,1,0,1,0,1
CALAMARCA,consulta externa,repetidas en personas de 5 a 14 anos,2005-02-01,1,3,1,3,4
CAMARGO,consulta externa,repetidas en personas de 5 a 14 anos,2005-02-01,0,1,0,1,1
CAMIRI,consulta externa,repetidas en personas de 5 a 14 anos,2005-02-01,30,53,30,53,83
CAPINOTA,consulta externa,repetidas en personas de 5 a 14 anos,2005-02-01,5,0,5,0,5
CARACOLLO,consulta externa,repetidas en personas de 5 a 14 anos,2005-02-01,1,2,1,2,3
CARANAVI,consulta externa,repetidas en personas de 5 a 14 anos,2005-02-01,13,1,13,1,14
CARAPARI,consulta externa,repetidas en personas de 5 a 14 anos,2005-02-01,2,1,2,1,3
CHACARILLA,consulta externa,repetidas en personas de 5 a 14 anos,2005-02-01,1,0,1,0,1
CHALLAPATA,consulta externa,repetidas en personas de 5 a 14 anos,2005-02-01,13,8,13,8,21
CHAQUI,consulta externa,repetidas en personas de 5 a 14 anos,2005-02-01,1,0,1,0,1
CHARAGUA,consulta externa,repetidas en personas de 5 a 14 anos,2005-02-01,4,7,4,7,11
CHAYANTA,consulta externa,repetidas en personas de 5 a 14 anos,2005-02-01,1,0,1,0,1
CHIMORE,consulta externa,repetidas en personas de 5 a 14 anos,2005-02-01,2,7,2,7,9
CHOQUE COTA,consulta externa,repetidas en personas de 5 a 14 anos,2005-02-01,1,0,1,0,1
CHULUMANI (V. DE LA LIBERTAD),consulta externa,repetidas en personas de 5 a 14 anos,2005-02-01,15,14,15,14,29
CHUMA,consulta externa,repetidas en personas de 5 a 14 anos,2005-02-01,6,1,6,1,7
CLIZA,consulta externa,repetidas en personas de 5 a 14 anos,2005-02-01,1,0,1,0,1
COBIJA,consulta externa,repetidas en personas de 5 a 14 anos,2005-02-01,32,103,32,103,135
COCHABAMBA,consulta externa,repetidas en personas de 5 a 14 anos,2005-02-01,1596,1571,1596,1571,3167
COLCAPIRHUA,consulta externa,repetidas en personas de 5 a 14 anos,2005-02-01,36,34,36,34,70
"COLCHA ""K""",consulta externa,repetidas en personas de 5 a 14 anos,2005-02-01,3,1,3,1,4
COLOMI,consulta externa,repetidas en personas de 5 a 14 anos,2005-02-01,1,3,1,3,4
COLPA BELGICA,consulta externa,repetidas en personas de 5 a 14 anos,2005-02-01,19,9,19,9,28
COLQUECHACA,consulta externa,repetidas en personas de 5 a 14 anos,2005-02-01,0,2,0,2,2
COLQUENCHA,consulta externa,repetidas en personas de 5 a 14 anos,2005-02-01,1,0,1,0,1
COLQUIRI,consulta externa,repetidas en personas de 5 a 14 anos,2005-02-01,5,4,5,4,9
COMANCHE,consulta externa,repetidas en personas de 5 a 14 anos,2005-02-01,0,1,0,1,1
COMARAPA,consulta externa,repetidas en personas de 5 a 14 anos,2005-02-01,5,5,5,5,10
COMBAYA,consulta externa,repetidas en personas de 5 a 14 anos,2005-02-01,1,2,1,2,3
CORO CORO,consulta externa,repetidas en personas de 5 a 14 anos,2005-02-01,6,0,6,0,6
COROICO,consulta externa,repetidas en personas de 5 a 14 anos,2005-02-01,8,11,8,11,19
CORQUE,consulta externa,repetidas en personas de 5 a 14 anos,2005-02-01,4,0,4,0,4
COTAGAITA,consulta externa,repetidas en personas de 5 a 14 anos,2005-02-01,12,27,12,27,39
COTOCA,consulta externa,repetidas en personas de 5 a 14 anos,2005-02-01,0,1,0,1,1
CUATRO CAÑADAS,consulta externa,repetidas en personas de 5 a 14 anos,2005-02-01,10,7,10,7,17
CUCHUMUELA (V. G. VILLARROEL),consulta externa,repetidas en personas de 5 a 14 anos,2005-02-01,1,2,1,2,3
CUEVO,consulta externa,repetidas en personas de 5 a 14 anos,2005-02-01,0,1,0,1,1
CULPINA,consulta externa,repetidas en personas de 5 a 14 anos,2005-02-01,2,0,2,0,2
EL ALTO,consulta externa,repetidas en personas de 5 a 14 anos,2005-02-01,1563,1792,1563,1792,3355
EL CHORO,consulta externa,repetidas en personas de 5 a 14 anos,2005-02-01,0,1,0,1,1
EL TORNO,consulta externa,repetidas en personas de 5 a 14 anos,2005-02-01,18,32,18,32,50
EL VILLAR,consulta externa,repetidas en personas de 5 a 14 anos,2005-02-01,3,1,3,1,4
ENTRE RIOS,consulta externa,repetidas en personas de 5 a 14 anos,2005-02-01,2,0,2,0,2
ENTRE RIOS,consulta externa,repetidas en personas de 5 a 14 anos,2005-02-01,4,12,4,12,16
EXALTACION,consulta externa,repetidas en personas de 5 a 14 anos,2005-02-01,1,1,1,1,2
FERNANDEZ ALONSO,consulta externa,repetidas en personas de 5 a 14 anos,2005-02-01,1,7,1,7,8
FILADELFIA,consulta externa,repetidas en personas de 5 a 14 anos,2005-02-01,13,9,13,9,22
GENERAL SAAVEDRA,consulta externa,repetidas en personas de 5 a 14 anos,2005-02-01,5,1,5,1,6
GUANAY,consulta externa,repetidas en personas de 5 a 14 anos,2005-02-01,6,2,6,2,8
GUAYARAMERIN,consulta externa,repetidas en personas de 5 a 14 anos,2005-02-01,57,55,57,55,112
GUTIERREZ,consulta externa,repetidas en personas de 5 a 14 anos,2005-02-01,4,6,4,6,10
HUACARETA,consulta externa,repetidas en personas de 5 a 14 anos,2005-02-01,2,7,2,7,9
HUACHACALLA,consulta externa,repetidas en personas de 5 a 14 anos,2005-02-01,2,0,2,0,2
HUANUNI,consulta externa,repetidas en personas de 5 a 14 anos,2005-02-01,84,88,84,88,172
HUARACAJE,consulta externa,repetidas en personas de 5 a 14 anos,2005-02-01,2,0,2,0,2
HUAYLLAMARCA,consulta externa,repetidas en personas de 5 a 14 anos,2005-02-01,1,0,1,0,1
ICHOCA,consulta externa,repetidas en personas de 5 a 14 anos,2005-02-01,1,0,1,0,1
INCAHUASI,consulta externa,repetidas en personas de 5 a 14 anos,2005-02-01,0,2,0,2,2
INGAVI (HUMAITA),consulta externa,repetidas en personas de 5 a 14 anos,2005-02-01,2,1,2,1,3
INQUISIVI,consulta externa,repetidas en personas de 5 a 14 anos,2005-02-01,3,0,3,0,3
IXIAMAS,consulta externa,repetidas en personas de 5 a 14 anos,2005-02-01,6,2,6,2,8
JESUS DE MACHACA,consulta externa,repetidas en personas de 5 a 14 anos,2005-02-01,14,0,14,0,14
LA ASUNTA,consulta externa,repetidas en personas de 5 a 14 anos,2005-02-01,1,0,1,0,1
LA GUARDIA,consulta externa,repetidas en personas de 5 a 14 anos,2005-02-01,11,8,11,8,19
LA PAZ,consulta externa,repetidas en personas de 5 a 14 anos,2005-02-01,2217,2191,2217,2191,4408
LAGUNILLAS,consulta externa,repetidas en personas de 5 a 14 anos,2005-02-01,1,0,1,0,1
LAJA,consulta externa,repetidas en personas de 5 a 14 anos,2005-02-01,4,1,4,1,5
LAS CARRERAS,consulta externa,repetidas en personas de 5 a 14 anos,2005-02-01,1,2,1,2,3
LLALLAGUA,consulta externa,repetidas en personas de 5 a 14 anos,2005-02-01,10,5,10,5,15
LORETO,consulta externa,repetidas en personas de 5 a 14 anos,2005-02-01,2,0,2,0,2
MACHACAMARCA,consulta externa,repetidas en personas de 5 a 14 anos,2005-02-01,3,4,3,4,7
MACHARETI,consulta externa,repetidas en personas de 5 a 14 anos,2005-02-01,0,1,0,1,1
MAGDALENA,consulta externa,repetidas en personas de 5 a 14 anos,2005-02-01,21,22,21,22,43
MAIRANA,consulta externa,repetidas en personas de 5 a 14 anos,2005-02-01,1,0,1,0,1
MALLA,consulta externa,repetidas en personas de 5 a 14 anos,2005-02-01,0,1,0,1,1
MAPIRI,consulta externa,repetidas en personas de 5 a 14 anos,2005-02-01,0,1,0,1,1
MECAPACA,consulta externa,repetidas en personas de 5 a 14 anos,2005-02-01,14,7,14,7,21
MINEROS,consulta externa,repetidas en personas de 5 a 14 anos,2005-02-01,1,0,1,0,1
MOCOMOCO,consulta externa,repetidas en personas de 5 a 14 anos,2005-02-01,1,0,1,0,1
MOJINETE,consulta externa,repetidas en personas de 5 a 14 anos,2005-02-01,0,2,0,2,2
MONTEAGUDO,consulta externa,repetidas en personas de 5 a 14 anos,2005-02-01,15,20,15,20,35
MONTERO,consulta externa,repetidas en personas de 5 a 14 anos,2005-02-01,83,95,83,95,178
MOROCHATA,consulta externa,repetidas en personas de 5 a 14 anos,2005-02-01,2,3,2,3,5
NUEVO MANOA (NUEVA ESPERANZA),consulta externa,repetidas en personas de 5 a 14 anos,2005-02-01,1,0,1,0,1
OKINAWA,consulta externa,repetidas en personas de 5 a 14 anos,2005-02-01,10,10,10,10,20
ORURO,consulta externa,repetidas en personas de 5 a 14 anos,2005-02-01,322,436,322,436,758
PADCAYA,consulta externa,repetidas en personas de 5 a 14 anos,2005-02-01,1,0,1,0,1
PADILLA,consulta externa,repetidas en personas de 5 a 14 anos,2005-02-01,5,3,5,3,8
PALCA,consulta externa,repetidas en personas de 5 a 14 anos,2005-02-01,3,3,3,3,6
PALOS BLANCOS,consulta externa,repetidas en personas de 5 a 14 anos,2005-02-01,4,6,4,6,10
PAMPA GRANDE,consulta externa,repetidas en personas de 5 a 14 anos,2005-02-01,4,2,4,2,6
PAPEL PAMPA,consulta externa,repetidas en personas de 5 a 14 anos,2005-02-01,0,2,0,2,2
PAZÑA,consulta externa,repetidas en personas de 5 a 14 anos,2005-02-01,0,1,0,1,1
PELECHUCO,consulta externa,repetidas en personas de 5 a 14 anos,2005-02-01,1,1,1,1,2
POCONA,consulta externa,repetidas en personas de 5 a 14 anos,2005-02-01,2,1,2,1,3
POOPO,consulta externa,repetidas en personas de 5 a 14 anos,2005-02-01,1,2,1,2,3
POROMA,consulta externa,repetidas en personas de 5 a 14 anos,2005-02-01,1,4,1,4,5
PORONGO,consulta externa,repetidas en personas de 5 a 14 anos,2005-02-01,2,7,2,7,9
PORTACHUELO,consulta externa,repetidas en personas de 5 a 14 anos,2005-02-01,16,25,16,25,41
POSTRER VALLE,consulta externa,repetidas en personas de 5 a 14 anos,2005-02-01,0,1,0,1,1
POTOSI,consulta externa,repetidas en personas de 5 a 14 anos,2005-02-01,320,383,320,383,703
PRESTO,consulta externa,repetidas en personas de 5 a 14 anos,2005-02-01,0,1,0,1,1
PUCARANI,consulta externa,repetidas en personas de 5 a 14 anos,2005-02-01,2,0,2,0,2
PUERTO ACOSTA,consulta externa,repetidas en personas de 5 a 14 anos,2005-02-01,1,4,1,4,5
PUERTO CARABUCO,consulta externa,repetidas en personas de 5 a 14 anos,2005-02-01,1,1,1,1,2
PUERTO GONZALO MORENO,consulta externa,repetidas en personas de 5 a 14 anos,2005-02-01,6,1,6,1,7
PUERTO QUIJARRO,consulta externa,repetidas en personas de 5 a 14 anos,2005-02-01,19,19,19,19,38
PUERTO RICO,consulta externa,repetidas en personas de 5 a 14 anos,2005-02-01,1,0,1,0,1
PUERTO SUAREZ,consulta externa,repetidas en personas de 5 a 14 anos,2005-02-01,1,9,1,9,10
PUERTO VILLARROEL,consulta externa,repetidas en personas de 5 a 14 anos,2005-02-01,11,7,11,7,18
PUNA,consulta externa,repetidas en personas de 5 a 14 anos,2005-02-01,2,3,2,3,5
PUNATA,consulta externa,repetidas en personas de 5 a 14 anos,2005-02-01,25,13,25,13,38
QUIABAYA,consulta externa,repetidas en personas de 5 a 14 anos,2005-02-01,0,1,0,1,1
QUILLACOLLO,consulta externa,repetidas en personas de 5 a 14 anos,2005-02-01,54,55,54,55,109
REYES,consulta externa,repetidas en personas de 5 a 14 anos,2005-02-01,10,6,10,6,16
RIBERALTA,consulta externa,repetidas en personas de 5 a 14 anos,2005-02-01,98,181,98,181,279
ROBORE,consulta externa,repetidas en personas de 5 a 14 anos,2005-02-01,9,5,9,5,14
RURRENABAQUE,consulta externa,repetidas en personas de 5 a 14 anos,2005-02-01,4,3,4,3,7
SACABA,consulta externa,repetidas en personas de 5 a 14 anos,2005-02-01,47,56,47,56,103
SACABAMBA,consulta externa,repetidas en personas de 5 a 14 anos,2005-02-01,2,3,2,3,5
SACACA,consulta externa,repetidas en personas de 5 a 14 anos,2005-02-01,1,0,1,0,1
SAIPINA,consulta externa,repetidas en personas de 5 a 14 anos,2005-02-01,3,4,3,4,7
SALINAS DE GARCI MENDOZA,consulta externa,repetidas en personas de 5 a 14 anos,2005-02-01,3,2,3,2,5
SAMAIPATA,consulta externa,repetidas en personas de 5 a 14 anos,2005-02-01,2,0,2,0,2
SAN ANDRES,consulta externa,repetidas en personas de 5 a 14 anos,2005-02-01,1,0,1,0,1
SAN ANDRES DE MACHACA,consulta externa,repetidas en personas de 5 a 14 anos,2005-02-01,1,0,1,0,1
SAN ANTONIO DE ESMORUCO,consulta externa,repetidas en personas de 5 a 14 anos,2005-02-01,2,0,2,0,2
SAN ANTONIO DE LOMERIO,consulta externa,repetidas en personas de 5 a 14 anos,2005-02-01,1,1,1,1,2
SAN BENITO,consulta externa,repetidas en personas de 5 a 14 anos,2005-02-01,1,2,1,2,3
SAN BORJA,consulta externa,repetidas en personas de 5 a 14 anos,2005-02-01,20,14,20,14,34
SAN BUENA VENTURA,consulta externa,repetidas en personas de 5 a 14 anos,2005-02-01,0,1,0,1,1
SAN CARLOS,consulta externa,repetidas en personas de 5 a 14 anos,2005-02-01,17,11,17,11,28
SAN IGNACIO,consulta externa,repetidas en personas de 5 a 14 anos,2005-02-01,13,17,13,17,30
SAN IGNACIO DE VELASCO,consulta externa,repetidas en personas de 5 a 14 anos,2005-02-01,27,27,27,27,54
SAN JAVIER(BNI),consulta externa,repetidas en personas de 5 a 14 anos,2005-02-01,0,1,0,1,1
SAN JAVIER(STC),consulta externa,repetidas en personas de 5 a 14 anos,2005-02-01,3,1,3,1,4
SAN JOAQUIN,consulta externa,repetidas en personas de 5 a 14 anos,2005-02-01,2,8,2,8,10
SAN JOSE DE CHIQUITOS,consulta externa,repetidas en personas de 5 a 14 anos,2005-02-01,5,0,5,0,5
SAN JUAN DE YAPACANI,consulta externa,repetidas en personas de 5 a 14 anos,2005-02-01,5,3,5,3,8
SAN JULIAN,consulta externa,repetidas en personas de 5 a 14 anos,2005-02-01,9,11,9,11,20
SAN LORENZO(PND),consulta externa,repetidas en personas de 5 a 14 anos,2005-02-01,1,0,1,0,1
SAN LORENZO(TJA),consulta externa,repetidas en personas de 5 a 14 anos,2005-02-01,4,12,4,12,16
SAN LUCAS,consulta externa,repetidas en personas de 5 a 14 anos,2005-02-01,3,0,3,0,3
SAN MIGUEL DE VELASCO,consulta externa,repetidas en personas de 5 a 14 anos,2005-02-01,11,6,11,6,17
SAN PABLO DE LIPEZ,consulta externa,repetidas en personas de 5 a 14 anos,2005-02-01,1,1,1,1,2
SAN PEDRO,consulta externa,repetidas en personas de 5 a 14 anos,2005-02-01,8,2,8,2,10
SAN PEDRO DE BUENA VISTA,consulta externa,repetidas en personas de 5 a 14 anos,2005-02-01,1,0,1,0,1
SAN PEDRO DE TIQUINA,consulta externa,repetidas en personas de 5 a 14 anos,2005-02-01,0,2,0,2,2
SAN RAFAEL,consulta externa,repetidas en personas de 5 a 14 anos,2005-02-01,2,2,2,2,4
SAN RAMON,consulta externa,repetidas en personas de 5 a 14 anos,2005-02-01,2,3,2,3,5
SAN RAMON,consulta externa,repetidas en personas de 5 a 14 anos,2005-02-01,3,3,3,3,6
SANTA ANA,consulta externa,repetidas en personas de 5 a 14 anos,2005-02-01,30,15,30,15,45
SANTA CRUZ DE LA SIERRA,consulta externa,repetidas en personas de 5 a 14 anos,2005-02-01,1880,2582,1880,2582,4462
SANTA ROSA,consulta externa,repetidas en personas de 5 a 14 anos,2005-02-01,1,4,1,4,5
SANTA ROSA DEL SARA,consulta externa,repetidas en personas de 5 a 14 anos,2005-02-01,1,4,1,4,5
SANTIAGO DE CALLAPA,consulta externa,repetidas en personas de 5 a 14 anos,2005-02-01,1,1,1,1,2
SANTIAGO DE HUARI,consulta externa,repetidas en personas de 5 a 14 anos,2005-02-01,1,0,1,0,1
SANTIVAÑES,consulta externa,repetidas en personas de 5 a 14 anos,2005-02-01,0,2,0,2,2
SAPAHAQUI,consulta externa,repetidas en personas de 5 a 14 anos,2005-02-01,0,1,0,1,1
SENA,consulta externa,repetidas en personas de 5 a 14 anos,2005-02-01,0,1,0,1,1
SICA SICA (VILLA AROMA),consulta externa,repetidas en personas de 5 a 14 anos,2005-02-01,2,0,2,0,2
SIPE SIPE,consulta externa,repetidas en personas de 5 a 14 anos,2005-02-01,3,11,3,11,14
SOPACHUY,consulta externa,repetidas en personas de 5 a 14 anos,2005-02-01,0,3,0,3,3
SORACACHI,consulta externa,repetidas en personas de 5 a 14 anos,2005-02-01,2,2,2,2,4
SORATA,consulta externa,repetidas en personas de 5 a 14 anos,2005-02-01,3,0,3,0,3
SUCRE,consulta externa,repetidas en personas de 5 a 14 anos,2005-02-01,821,640,821,640,1461
TACACHI,consulta externa,repetidas en personas de 5 a 14 anos,2005-02-01,4,3,4,3,7
TACOBAMBA,consulta externa,repetidas en personas de 5 a 14 anos,2005-02-01,1,0,1,0,1
TACOPAYA,consulta externa,repetidas en personas de 5 a 14 anos,2005-02-01,2,0,2,0,2
TAPACARI,consulta externa,repetidas en personas de 5 a 14 anos,2005-02-01,0,1,0,1,1
TARABUCO,consulta externa,repetidas en personas de 5 a 14 anos,2005-02-01,7,4,7,4,11
TARATA,consulta externa,repetidas en personas de 5 a 14 anos,2005-02-01,5,3,5,3,8
TARIJA,consulta externa,repetidas en personas de 5 a 14 anos,2005-02-01,382,515,382,515,897
TARVITA,consulta externa,repetidas en personas de 5 a 14 anos,2005-02-01,1,0,1,0,1
TEOPONTE,consulta externa,repetidas en personas de 5 a 14 anos,2005-02-01,1,0,1,0,1
TIAWANACU,consulta externa,repetidas en personas de 5 a 14 anos,2005-02-01,1,3,1,3,4
TIPUANI,consulta externa,repetidas en personas de 5 a 14 anos,2005-02-01,0,1,0,1,1
TIQUIPAYA,consulta externa,repetidas en personas de 5 a 14 anos,2005-02-01,10,10,10,10,20
TIRAQUE (CBBA),consulta externa,repetidas en personas de 5 a 14 anos,2005-02-01,11,18,11,18,29
TOLATA,consulta externa,repetidas en personas de 5 a 14 anos,2005-02-01,0,1,0,1,1
TOLEDO,consulta externa,repetidas en personas de 5 a 14 anos,2005-02-01,2,1,2,1,3
TOMAVE,consulta externa,repetidas en personas de 5 a 14 anos,2005-02-01,2,1,2,1,3
TOMINA,consulta externa,repetidas en personas de 5 a 14 anos,2005-02-01,1,0,1,0,1
TORO TORO,consulta externa,repetidas en personas de 5 a 14 anos,2005-02-01,1,1,1,1,2
TOTORA(ORR),consulta externa,repetidas en personas de 5 a 14 anos,2005-02-01,1,1,1,1,2
TRIGAL,consulta externa,repetidas en personas de 5 a 14 anos,2005-02-01,0,1,0,1,1
TRINIDAD,consulta externa,repetidas en personas de 5 a 14 anos,2005-02-01,48,72,48,72,120
TUPIZA,consulta externa,repetidas en personas de 5 a 14 anos,2005-02-01,60,76,60,76,136
TURCO,consulta externa,repetidas en personas de 5 a 14 anos,2005-02-01,1,0,1,0,1
UNCIA,consulta externa,repetidas en personas de 5 a 14 anos,2005-02-01,11,25,11,25,36
URIONDO (A. CONCEPCION),consulta externa,repetidas en personas de 5 a 14 anos,2005-02-01,6,10,6,10,16
UYUNI,consulta externa,repetidas en personas de 5 a 14 anos,2005-02-01,2,13,2,13,15
VACAS,consulta externa,repetidas en personas de 5 a 14 anos,2005-02-01,3,5,3,5,8
VALLEGRANDE,consulta externa,repetidas en personas de 5 a 14 anos,2005-02-01,8,17,8,17,25
VIACHA,consulta externa,repetidas en personas de 5 a 14 anos,2005-02-01,29,31,29,31,60
VILLA MONTES,consulta externa,repetidas en personas de 5 a 14 anos,2005-02-01,29,34,29,34,63
VILLA RIVERO,consulta externa,repetidas en personas de 5 a 14 anos,2005-02-01,1,0,1,0,1
VILLA TUNARI,consulta externa,repetidas en personas de 5 a 14 anos,2005-02-01,10,20,10,20,30
VILLA VACA GUZMAN (MUYUPAMPA),consulta externa,repetidas en personas de 5 a 14 anos,2005-02-01,4,3,4,3,7
VILLAZON,consulta externa,repetidas en personas de 5 a 14 anos,2005-02-01,10,8,10,8,18
VINTO,consulta externa,repetidas en personas de 5 a 14 anos,2005-02-01,0,8,0,8,8
VITICHI,consulta externa,repetidas en personas de 5 a 14 anos,2005-02-01,6,3,6,3,9
WARNES,consulta externa,repetidas en personas de 5 a 14 anos,2005-02-01,20,27,20,27,47
YACO,consulta externa,repetidas en personas de 5 a 14 anos,2005-02-01,2,0,2,0,2
YACUIBA,consulta externa,repetidas en personas de 5 a 14 anos,2005-02-01,737,69,737,69,806
YAMPARAEZ,consulta externa,repetidas en personas de 5 a 14 anos,2005-02-01,1,0,1,0,1
YANACACHI,consulta externa,repetidas en personas de 5 a 14 anos,2005-02-01,1,3,1,3,4
YAPACANI,consulta externa,repetidas en personas de 5 a 14 anos,2005-02-01,8,4,8,4,12
YOCALLA,consulta externa,repetidas en personas de 5 a 14 anos,2005-02-01,1,0,1,0,1
YOTALA,consulta externa,repetidas en personas de 5 a 14 anos,2005-02-01,10,3,10,3,13
ZUDAÑEZ,consulta externa,repetidas en personas de 5 a 14 anos,2005-02-01,4,14,4,14,18
ACHACACHI,consulta externa,repetidas en personas de 5 a 14 anos,2005-03-01,13,5,13,5,18
ACHOCALLA,consulta externa,repetidas en personas de 5 a 14 anos,2005-03-01,1,6,1,6,7
AIQUILE,consulta externa,repetidas en personas de 5 a 14 anos,2005-03-01,3,20,3,20,23
ANCORAIMES,consulta externa,repetidas en personas de 5 a 14 anos,2005-03-01,0,1,0,1,1
ANTEQUERA,consulta externa,repetidas en personas de 5 a 14 anos,2005-03-01,1,0,1,0,1
ANZALDO,consulta externa,repetidas en personas de 5 a 14 anos,2005-03-01,1,6,1,6,7
ARANI,consulta externa,repetidas en personas de 5 a 14 anos,2005-03-01,6,1,6,1,7
ASCENCION DE GUARAYOS,consulta externa,repetidas en personas de 5 a 14 anos,2005-03-01,7,11,7,11,18
ATOCHA,consulta externa,repetidas en personas de 5 a 14 anos,2005-03-01,37,51,37,51,88
AUCAPATA,consulta externa,repetidas en personas de 5 a 14 anos,2005-03-01,0,1,0,1,1
AYATA,consulta externa,repetidas en personas de 5 a 14 anos,2005-03-01,2,0,2,0,2
AYO AYO,consulta externa,repetidas en personas de 5 a 14 anos,2005-03-01,0,1,0,1,1
AYOPAYA (V. DE INDEPENDENCIA),consulta externa,repetidas en personas de 5 a 14 anos,2005-03-01,1,2,1,2,3
AZURDUY,consulta externa,repetidas en personas de 5 a 14 anos,2005-03-01,1,0,1,0,1
BATALLAS,consulta externa,repetidas en personas de 5 a 14 anos,2005-03-01,0,2,0,2,2
BAURES,consulta externa,repetidas en personas de 5 a 14 anos,2005-03-01,6,0,6,0,6
BELEN DE URMIRI,consulta externa,repetidas en personas de 5 a 14 anos,2005-03-01,1,0,1,0,1
BERMEJO,consulta externa,repetidas en personas de 5 a 14 anos,2005-03-01,77,92,77,92,169
BETANZOS,consulta externa,repetidas en personas de 5 a 14 anos,2005-03-01,2,4,2,4,6
BOLIVAR,consulta externa,repetidas en personas de 5 a 14 anos,2005-03-01,0,1,0,1,1
BOLPEBRA,consulta externa,repetidas en personas de 5 a 14 anos,2005-03-01,1,2,1,2,3
BOYUIBE,consulta externa,repetidas en personas de 5 a 14 anos,2005-03-01,7,21,7,21,28
BUENA VISTA,consulta externa,repetidas en personas de 5 a 14 anos,2005-03-01,12,10,12,10,22
CABEZAS,consulta externa,repetidas en personas de 5 a 14 anos,2005-03-01,3,2,3,2,5
"CAIZA ""D""",consulta externa,repetidas en personas de 5 a 14 anos,2005-03-01,2,3,2,3,5
CALACOTO,consulta externa,repetidas en personas de 5 a 14 anos,2005-03-01,1,1,1,1,2
CALAMARCA,consulta externa,repetidas en personas de 5 a 14 anos,2005-03-01,5,0,5,0,5
CAMARGO,consulta externa,repetidas en personas de 5 a 14 anos,2005-03-01,0,10,0,10,10
CAMIRI,consulta externa,repetidas en personas de 5 a 14 anos,2005-03-01,23,81,23,81,104
CAPINOTA,consulta externa,repetidas en personas de 5 a 14 anos,2005-03-01,8,6,8,6,14
CARACOLLO,consulta externa,repetidas en personas de 5 a 14 anos,2005-03-01,1,1,1,1,2
CARANAVI,consulta externa,repetidas en personas de 5 a 14 anos,2005-03-01,6,5,6,5,11
CARAPARI,consulta externa,repetidas en personas de 5 a 14 anos,2005-03-01,1,1,1,1,2
CARIPUYO,consulta externa,repetidas en personas de 5 a 14 anos,2005-03-01,4,1,4,1,5
CATACORA,consulta externa,repetidas en personas de 5 a 14 anos,2005-03-01,1,0,1,0,1
CHACARILLA,consulta externa,repetidas en personas de 5 a 14 anos,2005-03-01,1,1,1,1,2
CHALLAPATA,consulta externa,repetidas en personas de 5 a 14 anos,2005-03-01,1,2,1,2,3
CHARAGUA,consulta externa,repetidas en personas de 5 a 14 anos,2005-03-01,1,4,1,4,5
CHARAÑA,consulta externa,repetidas en personas de 5 a 14 anos,2005-03-01,2,4,2,4,6
CHAYANTA,consulta externa,repetidas en personas de 5 a 14 anos,2005-03-01,6,9,6,9,15
CHIMORE,consulta externa,repetidas en personas de 5 a 14 anos,2005-03-01,4,2,4,2,6
CHOQUE COTA,consulta externa,repetidas en personas de 5 a 14 anos,2005-03-01,15,11,15,11,26
CHULUMANI (V. DE LA LIBERTAD),consulta externa,repetidas en personas de 5 a 14 anos,2005-03-01,3,2,3,2,5
CHUMA,consulta externa,repetidas en personas de 5 a 14 anos,2005-03-01,6,2,6,2,8
CLIZA,consulta externa,repetidas en personas de 5 a 14 anos,2005-03-01,3,1,3,1,4
COBIJA,consulta externa,repetidas en personas de 5 a 14 anos,2005-03-01,42,65,42,65,107
COCHABAMBA,consulta externa,repetidas en personas de 5 a 14 anos,2005-03-01,1826,1946,1826,1946,3772
COLCAPIRHUA,consulta externa,repetidas en personas de 5 a 14 anos,2005-03-01,66,62,66,62,128
"COLCHA ""K""",consulta externa,repetidas en personas de 5 a 14 anos,2005-03-01,1,3,1,3,4
COLOMI,consulta externa,repetidas en personas de 5 a 14 anos,2005-03-01,3,13,3,13,16
COLPA BELGICA,consulta externa,repetidas en personas de 5 a 14 anos,2005-03-01,4,3,4,3,7
COLQUECHACA,consulta externa,repetidas en personas de 5 a 14 anos,2005-03-01,5,4,5,4,9
COLQUENCHA,consulta externa,repetidas en personas de 5 a 14 anos,2005-03-01,2,1,2,1,3
COLQUIRI,consulta externa,repetidas en personas de 5 a 14 anos,2005-03-01,2,0,2,0,2
COMANCHE,consulta externa,repetidas en personas de 5 a 14 anos,2005-03-01,0,4,0,4,4
COMARAPA,consulta externa,repetidas en personas de 5 a 14 anos,2005-03-01,8,14,8,14,22
COMBAYA,consulta externa,repetidas en personas de 5 a 14 anos,2005-03-01,2,5,2,5,7
CONCEPCION,consulta externa,repetidas en personas de 5 a 14 anos,2005-03-01,1,0,1,0,1
COPACABANA,consulta externa,repetidas en personas de 5 a 14 anos,2005-03-01,1,0,1,0,1
COROICO,consulta externa,repetidas en personas de 5 a 14 anos,2005-03-01,7,5,7,5,12
CORQUE,consulta externa,repetidas en personas de 5 a 14 anos,2005-03-01,10,12,10,12,22
COTAGAITA,consulta externa,repetidas en personas de 5 a 14 anos,2005-03-01,25,24,25,24,49
COTOCA,consulta externa,repetidas en personas de 5 a 14 anos,2005-03-01,12,6,12,6,18
CUATRO CAÑADAS,consulta externa,repetidas en personas de 5 a 14 anos,2005-03-01,22,16,22,16,38
CUEVO,consulta externa,repetidas en personas de 5 a 14 anos,2005-03-01,1,4,1,4,5
CULPINA,consulta externa,repetidas en personas de 5 a 14 anos,2005-03-01,2,1,2,1,3
CURVA,consulta externa,repetidas en personas de 5 a 14 anos,2005-03-01,1,0,1,0,1
EL ALTO,consulta externa,repetidas en personas de 5 a 14 anos,2005-03-01,2632,1891,2632,1891,4523
EL PUENTE(STC),consulta externa,repetidas en personas de 5 a 14 anos,2005-03-01,1,0,1,0,1
EL TORNO,consulta externa,repetidas en personas de 5 a 14 anos,2005-03-01,47,44,47,44,91
EL VILLAR,consulta externa,repetidas en personas de 5 a 14 anos,2005-03-01,0,1,0,1,1
ENTRE RIOS,consulta externa,repetidas en personas de 5 a 14 anos,2005-03-01,41,33,41,33,74
ENTRE RIOS,consulta externa,repetidas en personas de 5 a 14 anos,2005-03-01,2,4,2,4,6
EXALTACION,consulta externa,repetidas en personas de 5 a 14 anos,2005-03-01,0,3,0,3,3
FERNANDEZ ALONSO,consulta externa,repetidas en personas de 5 a 14 anos,2005-03-01,3,2,3,2,5
FILADELFIA,consulta externa,repetidas en personas de 5 a 14 anos,2005-03-01,3,4,3,4,7
GENERAL SAAVEDRA,consulta externa,repetidas en personas de 5 a 14 anos,2005-03-01,4,5,4,5,9
GUANAY,consulta externa,repetidas en personas de 5 a 14 anos,2005-03-01,7,4,7,4,11
GUAQUI,consulta externa,repetidas en personas de 5 a 14 anos,2005-03-01,1,0,1,0,1
GUAYARAMERIN,consulta externa,repetidas en personas de 5 a 14 anos,2005-03-01,69,52,69,52,121
GUTIERREZ,consulta externa,repetidas en personas de 5 a 14 anos,2005-03-01,5,12,5,12,17
HUACARETA,consulta externa,repetidas en personas de 5 a 14 anos,2005-03-01,2,2,2,2,4
HUACHACALLA,consulta externa,repetidas en personas de 5 a 14 anos,2005-03-01,0,1,0,1,1
HUANUNI,consulta externa,repetidas en personas de 5 a 14 anos,2005-03-01,84,83,84,83,167
HUARACAJE,consulta externa,repetidas en personas de 5 a 14 anos,2005-03-01,1,0,1,0,1
HUAYLLAMARCA,consulta externa,repetidas en personas de 5 a 14 anos,2005-03-01,7,6,7,6,13
ICLA,consulta externa,repetidas en personas de 5 a 14 anos,2005-03-01,3,7,3,7,10
INCAHUASI,consulta externa,repetidas en personas de 5 a 14 anos,2005-03-01,0,1,0,1,1
INGAVI (HUMAITA),consulta externa,repetidas en personas de 5 a 14 anos,2005-03-01,5,0,5,0,5
INQUISIVI,consulta externa,repetidas en personas de 5 a 14 anos,2005-03-01,1,0,1,0,1
IRUPANA (VILLA DE LANZA),consulta externa,repetidas en personas de 5 a 14 anos,2005-03-01,1,2,1,2,3
IXIAMAS,consulta externa,repetidas en personas de 5 a 14 anos,2005-03-01,1,4,1,4,5
JESUS DE MACHACA,consulta externa,repetidas en personas de 5 a 14 anos,2005-03-01,3,0,3,0,3
LA ASUNTA,consulta externa,repetidas en personas de 5 a 14 anos,2005-03-01,2,2,2,2,4
LA GUARDIA,consulta externa,repetidas en personas de 5 a 14 anos,2005-03-01,3,11,3,11,14
LA PAZ,consulta externa,repetidas en personas de 5 a 14 anos,2005-03-01,2764,2533,2764,2533,5297
LAJA,consulta externa,repetidas en personas de 5 a 14 anos,2005-03-01,3,3,3,3,6
LAS CARRERAS,consulta externa,repetidas en personas de 5 a 14 anos,2005-03-01,2,4,2,4,6
LICOMA PAMPA,consulta externa,repetidas en personas de 5 a 14 anos,2005-03-01,0,2,0,2,2
LLALLAGUA,consulta externa,repetidas en personas de 5 a 14 anos,2005-03-01,5,8,5,8,13
LLICA,consulta externa,repetidas en personas de 5 a 14 anos,2005-03-01,2,2,2,2,4
LORETO,consulta externa,repetidas en personas de 5 a 14 anos,2005-03-01,2,2,2,2,4
MACHACAMARCA,consulta externa,repetidas en personas de 5 a 14 anos,2005-03-01,2,5,2,5,7
MACHARETI,consulta externa,repetidas en personas de 5 a 14 anos,2005-03-01,4,3,4,3,7
MAGDALENA,consulta externa,repetidas en personas de 5 a 14 anos,2005-03-01,16,11,16,11,27
MAIRANA,consulta externa,repetidas en personas de 5 a 14 anos,2005-03-01,1,0,1,0,1
MAPIRI,consulta externa,repetidas en personas de 5 a 14 anos,2005-03-01,1,0,1,0,1
MECAPACA,consulta externa,repetidas en personas de 5 a 14 anos,2005-03-01,8,7,8,7,15
MINEROS,consulta externa,repetidas en personas de 5 a 14 anos,2005-03-01,3,3,3,3,6
MOCOMOCO,consulta externa,repetidas en personas de 5 a 14 anos,2005-03-01,4,1,4,1,5
MOJINETE,consulta externa,repetidas en personas de 5 a 14 anos,2005-03-01,3,0,3,0,3
MOJOCOYA,consulta externa,repetidas en personas de 5 a 14 anos,2005-03-01,1,2,1,2,3
MONTEAGUDO,consulta externa,repetidas en personas de 5 a 14 anos,2005-03-01,22,18,22,18,40
MONTERO,consulta externa,repetidas en personas de 5 a 14 anos,2005-03-01,124,152,124,152,276
MOROCHATA,consulta externa,repetidas en personas de 5 a 14 anos,2005-03-01,0,1,0,1,1
NUEVO MANOA (NUEVA ESPERANZA),consulta externa,repetidas en personas de 5 a 14 anos,2005-03-01,1,0,1,0,1
OKINAWA,consulta externa,repetidas en personas de 5 a 14 anos,2005-03-01,6,9,6,9,15
OMEREQUE,consulta externa,repetidas en personas de 5 a 14 anos,2005-03-01,5,8,5,8,13
ORURO,consulta externa,repetidas en personas de 5 a 14 anos,2005-03-01,622,578,622,578,1200
PADCAYA,consulta externa,repetidas en personas de 5 a 14 anos,2005-03-01,1,1,1,1,2
PADILLA,consulta externa,repetidas en personas de 5 a 14 anos,2005-03-01,1,1,1,1,2
PAILON,consulta externa,repetidas en personas de 5 a 14 anos,2005-03-01,0,1,0,1,1
PALCA,consulta externa,repetidas en personas de 5 a 14 anos,2005-03-01,7,0,7,0,7
PALOS BLANCOS,consulta externa,repetidas en personas de 5 a 14 anos,2005-03-01,16,34,16,34,50
PAMPA GRANDE,consulta externa,repetidas en personas de 5 a 14 anos,2005-03-01,10,5,10,5,15
PAPEL PAMPA,consulta externa,repetidas en personas de 5 a 14 anos,2005-03-01,1,0,1,0,1
PASORAPA,consulta externa,repetidas en personas de 5 a 14 anos,2005-03-01,0,1,0,1,1
PAZÑA,consulta externa,repetidas en personas de 5 a 14 anos,2005-03-01,0,3,0,3,3
PELECHUCO,consulta externa,repetidas en personas de 5 a 14 anos,2005-03-01,2,1,2,1,3
POCOATA,consulta externa,repetidas en personas de 5 a 14 anos,2005-03-01,2,1,2,1,3
POCONA,consulta externa,repetidas en personas de 5 a 14 anos,2005-03-01,2,6,2,6,8
POJO (CBBA),consulta externa,repetidas en personas de 5 a 14 anos,2005-03-01,2,2,2,2,4
POOPO,consulta externa,repetidas en personas de 5 a 14 anos,2005-03-01,0,1,0,1,1
PORCO,consulta externa,repetidas en personas de 5 a 14 anos,2005-03-01,1,0,1,0,1
POROMA,consulta externa,repetidas en personas de 5 a 14 anos,2005-03-01,5,2,5,2,7
PORONGO,consulta externa,repetidas en personas de 5 a 14 anos,2005-03-01,4,13,4,13,17
PORTACHUELO,consulta externa,repetidas en personas de 5 a 14 anos,2005-03-01,22,19,22,19,41
POSTRER VALLE,consulta externa,repetidas en personas de 5 a 14 anos,2005-03-01,0,5,0,5,5
POTOSI,consulta externa,repetidas en personas de 5 a 14 anos,2005-03-01,347,288,347,288,635
PUCARANI,consulta externa,repetidas en personas de 5 a 14 anos,2005-03-01,1,0,1,0,1
PUERTO ACOSTA,consulta externa,repetidas en personas de 5 a 14 anos,2005-03-01,0,1,0,1,1
PUERTO CARABUCO,consulta externa,repetidas en personas de 5 a 14 anos,2005-03-01,2,0,2,0,2
PUERTO GONZALO MORENO,consulta externa,repetidas en personas de 5 a 14 anos,2005-03-01,5,14,5,14,19
PUERTO QUIJARRO,consulta externa,repetidas en personas de 5 a 14 anos,2005-03-01,11,9,11,9,20
PUERTO RICO,consulta externa,repetidas en personas de 5 a 14 anos,2005-03-01,20,27,20,27,47
PUERTO SUAREZ,consulta externa,repetidas en personas de 5 a 14 anos,2005-03-01,10,11,10,11,21
PUERTO VILLARROEL,consulta externa,repetidas en personas de 5 a 14 anos,2005-03-01,8,5,8,5,13
PUNA,consulta externa,repetidas en personas de 5 a 14 anos,2005-03-01,4,2,4,2,6
PUNATA,consulta externa,repetidas en personas de 5 a 14 anos,2005-03-01,23,27,23,27,50
QUILLACOLLO,consulta externa,repetidas en personas de 5 a 14 anos,2005-03-01,69,146,69,146,215
QUIME,consulta externa,repetidas en personas de 5 a 14 anos,2005-03-01,0,1,0,1,1
QUIRUSILLAS,consulta externa,repetidas en personas de 5 a 14 anos,2005-03-01,0,1,0,1,1
REYES,consulta externa,repetidas en personas de 5 a 14 anos,2005-03-01,7,4,7,4,11
RIBERALTA,consulta externa,repetidas en personas de 5 a 14 anos,2005-03-01,89,179,89,179,268
ROBORE,consulta externa,repetidas en personas de 5 a 14 anos,2005-03-01,5,18,5,18,23
RURRENABAQUE,consulta externa,repetidas en personas de 5 a 14 anos,2005-03-01,5,5,5,5,10
SABAYA,consulta externa,repetidas en personas de 5 a 14 anos,2005-03-01,1,0,1,0,1
SACABA,consulta externa,repetidas en personas de 5 a 14 anos,2005-03-01,53,55,53,55,108
SACABAMBA,consulta externa,repetidas en personas de 5 a 14 anos,2005-03-01,1,0,1,0,1
SAIPINA,consulta externa,repetidas en personas de 5 a 14 anos,2005-03-01,4,3,4,3,7
SALINAS DE GARCI MENDOZA,consulta externa,repetidas en personas de 5 a 14 anos,2005-03-01,1,3,1,3,4
SAMAIPATA,consulta externa,repetidas en personas de 5 a 14 anos,2005-03-01,1,1,1,1,2
SAN ANDRES,consulta externa,repetidas en personas de 5 a 14 anos,2005-03-01,3,2,3,2,5
SAN ANTONIO DE LOMERIO,consulta externa,repetidas en personas de 5 a 14 anos,2005-03-01,2,1,2,1,3
SAN BENITO,consulta externa,repetidas en personas de 5 a 14 anos,2005-03-01,4,5,4,5,9
SAN BORJA,consulta externa,repetidas en personas de 5 a 14 anos,2005-03-01,9,23,9,23,32
SAN BUENA VENTURA,consulta externa,repetidas en personas de 5 a 14 anos,2005-03-01,3,4,3,4,7
SAN CARLOS,consulta externa,repetidas en personas de 5 a 14 anos,2005-03-01,5,2,5,2,7
SAN IGNACIO,consulta externa,repetidas en personas de 5 a 14 anos,2005-03-01,9,14,9,14,23
SAN IGNACIO DE VELASCO,consulta externa,repetidas en personas de 5 a 14 anos,2005-03-01,27,24,27,24,51
SAN JAVIER(BNI),consulta externa,repetidas en personas de 5 a 14 anos,2005-03-01,2,6,2,6,8
SAN JAVIER(STC),consulta externa,repetidas en personas de 5 a 14 anos,2005-03-01,7,6,7,6,13
SAN JOAQUIN,consulta externa,repetidas en personas de 5 a 14 anos,2005-03-01,2,11,2,11,13
SAN JOSE DE CHIQUITOS,consulta externa,repetidas en personas de 5 a 14 anos,2005-03-01,2,3,2,3,5
SAN JUAN DE YAPACANI,consulta externa,repetidas en personas de 5 a 14 anos,2005-03-01,3,7,3,7,10
SAN JULIAN,consulta externa,repetidas en personas de 5 a 14 anos,2005-03-01,17,16,17,16,33
SAN LORENZO(PND),consulta externa,repetidas en personas de 5 a 14 anos,2005-03-01,4,8,4,8,12
SAN LORENZO(TJA),consulta externa,repetidas en personas de 5 a 14 anos,2005-03-01,13,29,13,29,42
SAN LUCAS,consulta externa,repetidas en personas de 5 a 14 anos,2005-03-01,6,1,6,1,7
SAN MATIAS,consulta externa,repetidas en personas de 5 a 14 anos,2005-03-01,4,1,4,1,5
SAN MIGUEL DE VELASCO,consulta externa,repetidas en personas de 5 a 14 anos,2005-03-01,14,10,14,10,24
SAN PABLO DE LIPEZ,consulta externa,repetidas en personas de 5 a 14 anos,2005-03-01,2,0,2,0,2
SAN PEDRO,consulta externa,repetidas en personas de 5 a 14 anos,2005-03-01,6,8,6,8,14
SAN PEDRO DE BUENA VISTA,consulta externa,repetidas en personas de 5 a 14 anos,2005-03-01,1,0,1,0,1
SAN PEDRO DE TIQUINA,consulta externa,repetidas en personas de 5 a 14 anos,2005-03-01,0,2,0,2,2
SAN RAFAEL,consulta externa,repetidas en personas de 5 a 14 anos,2005-03-01,4,1,4,1,5
SAN RAMON,consulta externa,repetidas en personas de 5 a 14 anos,2005-03-01,4,4,4,4,8
SAN RAMON,consulta externa,repetidas en personas de 5 a 14 anos,2005-03-01,2,3,2,3,5
SANTA ANA,consulta externa,repetidas en personas de 5 a 14 anos,2005-03-01,21,29,21,29,50
SANTA CRUZ DE LA SIERRA,consulta externa,repetidas en personas de 5 a 14 anos,2005-03-01,2885,3081,2885,3081,5966
SANTA ROSA DEL SARA,consulta externa,repetidas en personas de 5 a 14 anos,2005-03-01,2,4,2,4,6
SANTIAGO DE CALLAPA,consulta externa,repetidas en personas de 5 a 14 anos,2005-03-01,8,5,8,5,13
SANTIAGO DE HUARI,consulta externa,repetidas en personas de 5 a 14 anos,2005-03-01,0,2,0,2,2
SANTIVAÑES,consulta externa,repetidas en personas de 5 a 14 anos,2005-03-01,1,0,1,0,1
SAPAHAQUI,consulta externa,repetidas en personas de 5 a 14 anos,2005-03-01,2,1,2,1,3
SENA,consulta externa,repetidas en personas de 5 a 14 anos,2005-03-01,1,4,1,4,5
SIPE SIPE,consulta externa,repetidas en personas de 5 a 14 anos,2005-03-01,5,7,5,7,12
SOPACHUY,consulta externa,repetidas en personas de 5 a 14 anos,2005-03-01,0,2,0,2,2
SORACACHI,consulta externa,repetidas en personas de 5 a 14 anos,2005-03-01,0,1,0,1,1
SORATA,consulta externa,repetidas en personas de 5 a 14 anos,2005-03-01,3,4,3,4,7
SUCRE,consulta externa,repetidas en personas de 5 a 14 anos,2005-03-01,831,658,831,658,1489
TACACHI,consulta externa,repetidas en personas de 5 a 14 anos,2005-03-01,4,1,4,1,5
TACOPAYA,consulta externa,repetidas en personas de 5 a 14 anos,2005-03-01,1,0,1,0,1
TAHUA,consulta externa,repetidas en personas de 5 a 14 anos,2005-03-01,1,0,1,0,1
TAPACARI,consulta externa,repetidas en personas de 5 a 14 anos,2005-03-01,5,4,5,4,9
TARABUCO,consulta externa,repetidas en personas de 5 a 14 anos,2005-03-01,10,4,10,4,14
TARATA,consulta externa,repetidas en personas de 5 a 14 anos,2005-03-01,7,2,7,2,9
TARIJA,consulta externa,repetidas en personas de 5 a 14 anos,2005-03-01,511,606,511,606,1117
TARVITA,consulta externa,repetidas en personas de 5 a 14 anos,2005-03-01,3,1,3,1,4
TEOPONTE,consulta externa,repetidas en personas de 5 a 14 anos,2005-03-01,1,0,1,0,1
TIAWANACU,consulta externa,repetidas en personas de 5 a 14 anos,2005-03-01,1,0,1,0,1
TINGUIPAYA,consulta externa,repetidas en personas de 5 a 14 anos,2005-03-01,0,1,0,1,1
TIPUANI,consulta externa,repetidas en personas de 5 a 14 anos,2005-03-01,7,8,7,8,15
TIQUIPAYA,consulta externa,repetidas en personas de 5 a 14 anos,2005-03-01,43,43,43,43,86
TIRAQUE (CBBA),consulta externa,repetidas en personas de 5 a 14 anos,2005-03-01,8,7,8,7,15
TOLATA,consulta externa,repetidas en personas de 5 a 14 anos,2005-03-01,3,0,3,0,3
TOLEDO,consulta externa,repetidas en personas de 5 a 14 anos,2005-03-01,0,1,0,1,1
TOMAVE,consulta externa,repetidas en personas de 5 a 14 anos,2005-03-01,1,0,1,0,1
TORO TORO,consulta externa,repetidas en personas de 5 a 14 anos,2005-03-01,1,1,1,1,2
TOTORA(ORR),consulta externa,repetidas en personas de 5 a 14 anos,2005-03-01,7,0,7,0,7
TRINIDAD,consulta externa,repetidas en personas de 5 a 14 anos,2005-03-01,98,95,98,95,193
TUPIZA,consulta externa,repetidas en personas de 5 a 14 anos,2005-03-01,58,72,58,72,130
UNCIA,consulta externa,repetidas en personas de 5 a 14 anos,2005-03-01,14,9,14,9,23
URIONDO (A. CONCEPCION),consulta externa,repetidas en personas de 5 a 14 anos,2005-03-01,42,108,42,108,150
URUBICHA,consulta externa,repetidas en personas de 5 a 14 anos,2005-03-01,2,2,2,2,4
UYUNI,consulta externa,repetidas en personas de 5 a 14 anos,2005-03-01,16,10,16,10,26
VACAS,consulta externa,repetidas en personas de 5 a 14 anos,2005-03-01,10,4,10,4,14
VALLEGRANDE,consulta externa,repetidas en personas de 5 a 14 anos,2005-03-01,19,17,19,17,36
VIACHA,consulta externa,repetidas en personas de 5 a 14 anos,2005-03-01,31,46,31,46,77
VILLA MONTES,consulta externa,repetidas en personas de 5 a 14 anos,2005-03-01,28,19,28,19,47
VILLA RIVERO,consulta externa,repetidas en personas de 5 a 14 anos,2005-03-01,1,1,1,1,2
VILLA SERRANO,consulta externa,repetidas en personas de 5 a 14 anos,2005-03-01,1,1,1,1,2
VILLA TUNARI,consulta externa,repetidas en personas de 5 a 14 anos,2005-03-01,23,29,23,29,52
VILLA VACA GUZMAN (MUYUPAMPA),consulta externa,repetidas en personas de 5 a 14 anos,2005-03-01,6,4,6,4,10
VILLAZON,consulta externa,repetidas en personas de 5 a 14 anos,2005-03-01,7,23,7,23,30
VINTO,consulta externa,repetidas en personas de 5 a 14 anos,2005-03-01,2,4,2,4,6
VITICHI,consulta externa,repetidas en personas de 5 a 14 anos,2005-03-01,3,6,3,6,9
WARNES,consulta externa,repetidas en personas de 5 a 14 anos,2005-03-01,11,13,11,13,24
YACO,consulta externa,repetidas en personas de 5 a 14 anos,2005-03-01,0,1,0,1,1
YACUIBA,consulta externa,repetidas en personas de 5 a 14 anos,2005-03-01,89,78,89,78,167
YAMPARAEZ,consulta externa,repetidas en personas de 5 a 14 anos,2005-03-01,2,1,2,1,3
YANACACHI,consulta externa,repetidas en personas de 5 a 14 anos,2005-03-01,2,1,2,1,3
YAPACANI,consulta externa,repetidas en personas de 5 a 14 anos,2005-03-01,4,12,4,12,16
YOCALLA,consulta externa,repetidas en personas de 5 a 14 anos,2005-03-01,0,2,0,2,2
YOTALA,consulta externa,repetidas en personas de 5 a 14 anos,2005-03-01,6,0,6,0,6
ZUDAÑEZ,consulta externa,repetidas en personas de 5 a 14 anos,2005-03-01,1,0,1,0,1
ACHACACHI,consulta externa,repetidas en personas de 5 a 14 anos,2005-04-01,7,5,7,5,12
ACHOCALLA,consulta externa,repetidas en personas de 5 a 14 anos,2005-04-01,5,13,5,13,18
AIQUILE,consulta externa,repetidas en personas de 5 a 14 anos,2005-04-01,10,8,10,8,18
ANCORAIMES,consulta externa,repetidas en personas de 5 a 14 anos,2005-04-01,1,1,1,1,2
ANTEQUERA,consulta externa,repetidas en personas de 5 a 14 anos,2005-04-01,0,3,0,3,3
ANZALDO,consulta externa,repetidas en personas de 5 a 14 anos,2005-04-01,3,0,3,0,3
APOLO,consulta externa,repetidas en personas de 5 a 14 anos,2005-04-01,1,3,1,3,4
ARAMPAMPA,consulta externa,repetidas en personas de 5 a 14 anos,2005-04-01,1,0,1,0,1
ARANI,consulta externa,repetidas en personas de 5 a 14 anos,2005-04-01,6,1,6,1,7
ARBIETO,consulta externa,repetidas en personas de 5 a 14 anos,2005-04-01,0,1,0,1,1
ASCENCION DE GUARAYOS,consulta externa,repetidas en personas de 5 a 14 anos,2005-04-01,3,39,3,39,42
ATOCHA,consulta externa,repetidas en personas de 5 a 14 anos,2005-04-01,30,35,30,35,65
AUCAPATA,consulta externa,repetidas en personas de 5 a 14 anos,2005-04-01,1,0,1,0,1
AYO AYO,consulta externa,repetidas en personas de 5 a 14 anos,2005-04-01,1,0,1,0,1
BATALLAS,consulta externa,repetidas en personas de 5 a 14 anos,2005-04-01,1,0,1,0,1
BAURES,consulta externa,repetidas en personas de 5 a 14 anos,2005-04-01,11,8,11,8,19
BELLA FLOR,consulta externa,repetidas en personas de 5 a 14 anos,2005-04-01,1,0,1,0,1
BERMEJO,consulta externa,repetidas en personas de 5 a 14 anos,2005-04-01,39,34,39,34,73
BETANZOS,consulta externa,repetidas en personas de 5 a 14 anos,2005-04-01,4,7,4,7,11
BOLIVAR,consulta externa,repetidas en personas de 5 a 14 anos,2005-04-01,0,2,0,2,2
BOYUIBE,consulta externa,repetidas en personas de 5 a 14 anos,2005-04-01,3,0,3,0,3
BUENA VISTA,consulta externa,repetidas en personas de 5 a 14 anos,2005-04-01,26,23,26,23,49
"CAIZA ""D""",consulta externa,repetidas en personas de 5 a 14 anos,2005-04-01,1,1,1,1,2
CALACOTO,consulta externa,repetidas en personas de 5 a 14 anos,2005-04-01,8,11,8,11,19
CALAMARCA,consulta externa,repetidas en personas de 5 a 14 anos,2005-04-01,13,5,13,5,18
CAMARGO,consulta externa,repetidas en personas de 5 a 14 anos,2005-04-01,3,14,3,14,17
CAMATAQUI (C. VILLA ABECIA),consulta externa,repetidas en personas de 5 a 14 anos,2005-04-01,13,0,13,0,13
CAMIRI,consulta externa,repetidas en personas de 5 a 14 anos,2005-04-01,39,92,39,92,131
CAPINOTA,consulta externa,repetidas en personas de 5 a 14 anos,2005-04-01,4,7,4,7,11
CAQUIAVIRI,consulta externa,repetidas en personas de 5 a 14 anos,2005-04-01,1,1,1,1,2
CARACOLLO,consulta externa,repetidas en personas de 5 a 14 anos,2005-04-01,5,1,5,1,6
CARANAVI,consulta externa,repetidas en personas de 5 a 14 anos,2005-04-01,4,5,4,5,9
CARAPARI,consulta externa,repetidas en personas de 5 a 14 anos,2005-04-01,3,1,3,1,4
CHACARILLA,consulta externa,repetidas en personas de 5 a 14 anos,2005-04-01,2,3,2,3,5
CHALLAPATA,consulta externa,repetidas en personas de 5 a 14 anos,2005-04-01,14,6,14,6,20
CHAQUI,consulta externa,repetidas en personas de 5 a 14 anos,2005-04-01,1,1,1,1,2
CHARAGUA,consulta externa,repetidas en personas de 5 a 14 anos,2005-04-01,7,11,7,11,18
CHAYANTA,consulta externa,repetidas en personas de 5 a 14 anos,2005-04-01,8,0,8,0,8
CHIMORE,consulta externa,repetidas en personas de 5 a 14 anos,2005-04-01,4,0,4,0,4
CHOQUE COTA,consulta externa,repetidas en personas de 5 a 14 anos,2005-04-01,1,1,1,1,2
CHULUMANI (V. DE LA LIBERTAD),consulta externa,repetidas en personas de 5 a 14 anos,2005-04-01,12,8,12,8,20
CHUMA,consulta externa,repetidas en personas de 5 a 14 anos,2005-04-01,10,4,10,4,14
CLIZA,consulta externa,repetidas en personas de 5 a 14 anos,2005-04-01,0,2,0,2,2
COBIJA,consulta externa,repetidas en personas de 5 a 14 anos,2005-04-01,34,52,34,52,86
COCHABAMBA,consulta externa,repetidas en personas de 5 a 14 anos,2005-04-01,1941,1907,1941,1907,3848
COLCAPIRHUA,consulta externa,repetidas en personas de 5 a 14 anos,2005-04-01,61,60,61,60,121
"COLCHA ""K""",consulta externa,repetidas en personas de 5 a 14 anos,2005-04-01,1,3,1,3,4
COLOMI,consulta externa,repetidas en personas de 5 a 14 anos,2005-04-01,1,0,1,0,1
COLPA BELGICA,consulta externa,repetidas en personas de 5 a 14 anos,2005-04-01,20,10,20,10,30
COLQUECHACA,consulta externa,repetidas en personas de 5 a 14 anos,2005-04-01,1,3,1,3,4
COLQUIRI,consulta externa,repetidas en personas de 5 a 14 anos,2005-04-01,1,1,1,1,2
COMARAPA,consulta externa,repetidas en personas de 5 a 14 anos,2005-04-01,7,12,7,12,19
COMBAYA,consulta externa,repetidas en personas de 5 a 14 anos,2005-04-01,3,1,3,1,4
CONCEPCION,consulta externa,repetidas en personas de 5 a 14 anos,2005-04-01,1,1,1,1,2
COPACABANA,consulta externa,repetidas en personas de 5 a 14 anos,2005-04-01,2,1,2,1,3
COROICO,consulta externa,repetidas en personas de 5 a 14 anos,2005-04-01,20,14,20,14,34
CORQUE,consulta externa,repetidas en personas de 5 a 14 anos,2005-04-01,0,3,0,3,3
COTAGAITA,consulta externa,repetidas en personas de 5 a 14 anos,2005-04-01,20,22,20,22,42
CUATRO CAÑADAS,consulta externa,repetidas en personas de 5 a 14 anos,2005-04-01,5,1,5,1,6
CUEVO,consulta externa,repetidas en personas de 5 a 14 anos,2005-04-01,5,2,5,2,7
CULPINA,consulta externa,repetidas en personas de 5 a 14 anos,2005-04-01,9,9,9,9,18
CURVA,consulta externa,repetidas en personas de 5 a 14 anos,2005-04-01,1,1,1,1,2
EL ALTO,consulta externa,repetidas en personas de 5 a 14 anos,2005-04-01,1702,1818,1702,1818,3520
EL PUENTE(STC),consulta externa,repetidas en personas de 5 a 14 anos,2005-04-01,4,1,4,1,5
EL TORNO,consulta externa,repetidas en personas de 5 a 14 anos,2005-04-01,27,30,27,30,57
EL VILLAR,consulta externa,repetidas en personas de 5 a 14 anos,2005-04-01,0,1,0,1,1
ENTRE RIOS,consulta externa,repetidas en personas de 5 a 14 anos,2005-04-01,16,20,16,20,36
ENTRE RIOS,consulta externa,repetidas en personas de 5 a 14 anos,2005-04-01,7,3,7,3,10
EUCALIPTUS,consulta externa,repetidas en personas de 5 a 14 anos,2005-04-01,1,0,1,0,1
EUREKA (SANTOS MERCADO),consulta externa,repetidas en personas de 5 a 14 anos,2005-04-01,0,1,0,1,1
EXALTACION,consulta externa,repetidas en personas de 5 a 14 anos,2005-04-01,3,3,3,3,6
FERNANDEZ ALONSO,consulta externa,repetidas en personas de 5 a 14 anos,2005-04-01,1,6,1,6,7
GENERAL SAAVEDRA,consulta externa,repetidas en personas de 5 a 14 anos,2005-04-01,3,2,3,2,5
GRAL. J.J. PEREZ (CHARAZANI),consulta externa,repetidas en personas de 5 a 14 anos,2005-04-01,2,1,2,1,3
GUAQUI,consulta externa,repetidas en personas de 5 a 14 anos,2005-04-01,3,1,3,1,4
GUAYARAMERIN,consulta externa,repetidas en personas de 5 a 14 anos,2005-04-01,113,77,113,77,190
GUTIERREZ,consulta externa,repetidas en personas de 5 a 14 anos,2005-04-01,0,3,0,3,3
HUACARETA,consulta externa,repetidas en personas de 5 a 14 anos,2005-04-01,1,12,1,12,13
HUACHACALLA,consulta externa,repetidas en personas de 5 a 14 anos,2005-04-01,2,0,2,0,2
HUANUNI,consulta externa,repetidas en personas de 5 a 14 anos,2005-04-01,4,16,4,16,20
HUARACAJE,consulta externa,repetidas en personas de 5 a 14 anos,2005-04-01,2,3,2,3,5
ICLA,consulta externa,repetidas en personas de 5 a 14 anos,2005-04-01,8,4,8,4,12
IRUPANA (VILLA DE LANZA),consulta externa,repetidas en personas de 5 a 14 anos,2005-04-01,4,3,4,3,7
IXIAMAS,consulta externa,repetidas en personas de 5 a 14 anos,2005-04-01,11,23,11,23,34
JESUS DE MACHACA,consulta externa,repetidas en personas de 5 a 14 anos,2005-04-01,0,2,0,2,2
LA ASUNTA,consulta externa,repetidas en personas de 5 a 14 anos,2005-04-01,1,1,1,1,2
LA GUARDIA,consulta externa,repetidas en personas de 5 a 14 anos,2005-04-01,7,14,7,14,21
LA PAZ,consulta externa,repetidas en personas de 5 a 14 anos,2005-04-01,2611,2636,2611,2636,5247
LAGUNILLAS,consulta externa,repetidas en personas de 5 a 14 anos,2005-04-01,2,0,2,0,2
LAJA,consulta externa,repetidas en personas de 5 a 14 anos,2005-04-01,4,2,4,2,6
LAS CARRERAS,consulta externa,repetidas en personas de 5 a 14 anos,2005-04-01,0,1,0,1,1
LICOMA PAMPA,consulta externa,repetidas en personas de 5 a 14 anos,2005-04-01,1,0,1,0,1
LLALLAGUA,consulta externa,repetidas en personas de 5 a 14 anos,2005-04-01,14,10,14,10,24
MACHACAMARCA,consulta externa,repetidas en personas de 5 a 14 anos,2005-04-01,4,3,4,3,7
MACHARETI,consulta externa,repetidas en personas de 5 a 14 anos,2005-04-01,5,4,5,4,9
MAGDALENA,consulta externa,repetidas en personas de 5 a 14 anos,2005-04-01,13,10,13,10,23
MALLA,consulta externa,repetidas en personas de 5 a 14 anos,2005-04-01,5,1,5,1,6
MECAPACA,consulta externa,repetidas en personas de 5 a 14 anos,2005-04-01,9,12,9,12,21
MINEROS,consulta externa,repetidas en personas de 5 a 14 anos,2005-04-01,3,2,3,2,5
MIZQUE,consulta externa,repetidas en personas de 5 a 14 anos,2005-04-01,1,6,1,6,7
MOCOMOCO,consulta externa,repetidas en personas de 5 a 14 anos,2005-04-01,0,4,0,4,4
MOJINETE,consulta externa,repetidas en personas de 5 a 14 anos,2005-04-01,1,0,1,0,1
MONTEAGUDO,consulta externa,repetidas en personas de 5 a 14 anos,2005-04-01,19,27,19,27,46
MONTERO,consulta externa,repetidas en personas de 5 a 14 anos,2005-04-01,183,191,183,191,374
MORO MORO,consulta externa,repetidas en personas de 5 a 14 anos,2005-04-01,0,1,0,1,1
MOROCHATA,consulta externa,repetidas en personas de 5 a 14 anos,2005-04-01,1,0,1,0,1
OKINAWA,consulta externa,repetidas en personas de 5 a 14 anos,2005-04-01,5,6,5,6,11
ORURO,consulta externa,repetidas en personas de 5 a 14 anos,2005-04-01,476,719,476,719,1195
PADCAYA,consulta externa,repetidas en personas de 5 a 14 anos,2005-04-01,2,8,2,8,10
PADILLA,consulta externa,repetidas en personas de 5 a 14 anos,2005-04-01,2,1,2,1,3
PAILON,consulta externa,repetidas en personas de 5 a 14 anos,2005-04-01,1,1,1,1,2
PALCA,consulta externa,repetidas en personas de 5 a 14 anos,2005-04-01,2,4,2,4,6
PALOS BLANCOS,consulta externa,repetidas en personas de 5 a 14 anos,2005-04-01,16,4,16,4,20
PAMPA GRANDE,consulta externa,repetidas en personas de 5 a 14 anos,2005-04-01,4,4,4,4,8
PASORAPA,consulta externa,repetidas en personas de 5 a 14 anos,2005-04-01,5,10,5,10,15
PATACAMAYA,consulta externa,repetidas en personas de 5 a 14 anos,2005-04-01,2,0,2,0,2
PAZÑA,consulta externa,repetidas en personas de 5 a 14 anos,2005-04-01,1,4,1,4,5
PELECHUCO,consulta externa,repetidas en personas de 5 a 14 anos,2005-04-01,0,2,0,2,2
POCOATA,consulta externa,repetidas en personas de 5 a 14 anos,2005-04-01,0,2,0,2,2
POCONA,consulta externa,repetidas en personas de 5 a 14 anos,2005-04-01,1,3,1,3,4
PORCO,consulta externa,repetidas en personas de 5 a 14 anos,2005-04-01,0,2,0,2,2
POROMA,consulta externa,repetidas en personas de 5 a 14 anos,2005-04-01,2,0,2,0,2
PORONGO,consulta externa,repetidas en personas de 5 a 14 anos,2005-04-01,14,6,14,6,20
PORTACHUELO,consulta externa,repetidas en personas de 5 a 14 anos,2005-04-01,27,31,27,31,58
PORVENIR,consulta externa,repetidas en personas de 5 a 14 anos,2005-04-01,4,1,4,1,5
POSTRER VALLE,consulta externa,repetidas en personas de 5 a 14 anos,2005-04-01,2,0,2,0,2
POTOSI,consulta externa,repetidas en personas de 5 a 14 anos,2005-04-01,382,316,382,316,698
PUCARA,consulta externa,repetidas en personas de 5 a 14 anos,2005-04-01,6,6,6,6,12
PUCARANI,consulta externa,repetidas en personas de 5 a 14 anos,2005-04-01,1,1,1,1,2
PUERTO ACOSTA,consulta externa,repetidas en personas de 5 a 14 anos,2005-04-01,5,2,5,2,7
PUERTO CARABUCO,consulta externa,repetidas en personas de 5 a 14 anos,2005-04-01,3,1,3,1,4
PUERTO GONZALO MORENO,consulta externa,repetidas en personas de 5 a 14 anos,2005-04-01,2,2,2,2,4
PUERTO QUIJARRO,consulta externa,repetidas en personas de 5 a 14 anos,2005-04-01,13,14,13,14,27
PUERTO RICO,consulta externa,repetidas en personas de 5 a 14 anos,2005-04-01,3,5,3,5,8
PUERTO SILES,consulta externa,repetidas en personas de 5 a 14 anos,2005-04-01,1,0,1,0,1
PUERTO SUAREZ,consulta externa,repetidas en personas de 5 a 14 anos,2005-04-01,10,5,10,5,15
PUERTO VILLARROEL,consulta externa,repetidas en personas de 5 a 14 anos,2005-04-01,8,8,8,8,16
PUNA,consulta externa,repetidas en personas de 5 a 14 anos,2005-04-01,0,6,0,6,6
PUNATA,consulta externa,repetidas en personas de 5 a 14 anos,2005-04-01,27,24,27,24,51
QUIABAYA,consulta externa,repetidas en personas de 5 a 14 anos,2005-04-01,0,2,0,2,2
QUILLACOLLO,consulta externa,repetidas en personas de 5 a 14 anos,2005-04-01,26,39,26,39,65
QUIME,consulta externa,repetidas en personas de 5 a 14 anos,2005-04-01,3,8,3,8,11
QUIRUSILLAS,consulta externa,repetidas en personas de 5 a 14 anos,2005-04-01,2,0,2,0,2
REYES,consulta externa,repetidas en personas de 5 a 14 anos,2005-04-01,2,2,2,2,4
RIBERALTA,consulta externa,repetidas en personas de 5 a 14 anos,2005-04-01,12,39,12,39,51
ROBORE,consulta externa,repetidas en personas de 5 a 14 anos,2005-04-01,23,18,23,18,41
RURRENABAQUE,consulta externa,repetidas en personas de 5 a 14 anos,2005-04-01,0,2,0,2,2
SACABA,consulta externa,repetidas en personas de 5 a 14 anos,2005-04-01,67,56,67,56,123
SACABAMBA,consulta externa,repetidas en personas de 5 a 14 anos,2005-04-01,2,2,2,2,4
SAIPINA,consulta externa,repetidas en personas de 5 a 14 anos,2005-04-01,4,3,4,3,7
SALINAS DE GARCI MENDOZA,consulta externa,repetidas en personas de 5 a 14 anos,2005-04-01,1,1,1,1,2
SAMAIPATA,consulta externa,repetidas en personas de 5 a 14 anos,2005-04-01,1,0,1,0,1
SAN ANDRES,consulta externa,repetidas en personas de 5 a 14 anos,2005-04-01,4,7,4,7,11
SAN ANTONIO DE ESMORUCO,consulta externa,repetidas en personas de 5 a 14 anos,2005-04-01,0,1,0,1,1
SAN BENITO,consulta externa,repetidas en personas de 5 a 14 anos,2005-04-01,6,2,6,2,8
SAN BORJA,consulta externa,repetidas en personas de 5 a 14 anos,2005-04-01,6,5,6,5,11
SAN BUENA VENTURA,consulta externa,repetidas en personas de 5 a 14 anos,2005-04-01,1,4,1,4,5
SAN CARLOS,consulta externa,repetidas en personas de 5 a 14 anos,2005-04-01,6,4,6,4,10
SAN IGNACIO,consulta externa,repetidas en personas de 5 a 14 anos,2005-04-01,23,13,23,13,36
SAN IGNACIO DE VELASCO,consulta externa,repetidas en personas de 5 a 14 anos,2005-04-01,18,24,18,24,42
SAN JAVIER(BNI),consulta externa,repetidas en personas de 5 a 14 anos,2005-04-01,3,3,3,3,6
SAN JAVIER(STC),consulta externa,repetidas en personas de 5 a 14 anos,2005-04-01,38,58,38,58,96
SAN JOAQUIN,consulta externa,repetidas en personas de 5 a 14 anos,2005-04-01,8,7,8,7,15
SAN JOSE DE CHIQUITOS,consulta externa,repetidas en personas de 5 a 14 anos,2005-04-01,3,4,3,4,7
SAN JUAN DE YAPACANI,consulta externa,repetidas en personas de 5 a 14 anos,2005-04-01,1,4,1,4,5
SAN JULIAN,consulta externa,repetidas en personas de 5 a 14 anos,2005-04-01,5,12,5,12,17
SAN LORENZO(PND),consulta externa,repetidas en personas de 5 a 14 anos,2005-04-01,2,2,2,2,4
SAN LORENZO(TJA),consulta externa,repetidas en personas de 5 a 14 anos,2005-04-01,13,7,13,7,20
SAN LUCAS,consulta externa,repetidas en personas de 5 a 14 anos,2005-04-01,7,7,7,7,14
SAN MATIAS,consulta externa,repetidas en personas de 5 a 14 anos,2005-04-01,1,0,1,0,1
SAN MIGUEL DE VELASCO,consulta externa,repetidas en personas de 5 a 14 anos,2005-04-01,8,8,8,8,16
SAN PABLO DE LIPEZ,consulta externa,repetidas en personas de 5 a 14 anos,2005-04-01,4,2,4,2,6
SAN PEDRO,consulta externa,repetidas en personas de 5 a 14 anos,2005-04-01,73,5,73,5,78
SAN PEDRO DE TIQUINA,consulta externa,repetidas en personas de 5 a 14 anos,2005-04-01,1,0,1,0,1
SAN RAFAEL,consulta externa,repetidas en personas de 5 a 14 anos,2005-04-01,0,1,0,1,1
SAN RAMON,consulta externa,repetidas en personas de 5 a 14 anos,2005-04-01,4,3,4,3,7
SAN RAMON,consulta externa,repetidas en personas de 5 a 14 anos,2005-04-01,10,4,10,4,14
SANTA ANA,consulta externa,repetidas en personas de 5 a 14 anos,2005-04-01,41,35,41,35,76
SANTA CRUZ DE LA SIERRA,consulta externa,repetidas en personas de 5 a 14 anos,2005-04-01,1784,2567,1784,2567,4351
SANTA ROSA,consulta externa,repetidas en personas de 5 a 14 anos,2005-04-01,3,3,3,3,6
SANTA ROSA DEL SARA,consulta externa,repetidas en personas de 5 a 14 anos,2005-04-01,12,11,12,11,23
SANTIAGO DE CALLAPA,consulta externa,repetidas en personas de 5 a 14 anos,2005-04-01,5,1,5,1,6
SANTIAGO DE HUARI,consulta externa,repetidas en personas de 5 a 14 anos,2005-04-01,4,2,4,2,6
SANTIVAÑES,consulta externa,repetidas en personas de 5 a 14 anos,2005-04-01,2,3,2,3,5
SANTUARIO DE QUILLACAS,consulta externa,repetidas en personas de 5 a 14 anos,2005-04-01,0,2,0,2,2
SENA,consulta externa,repetidas en personas de 5 a 14 anos,2005-04-01,1,0,1,0,1
SIPE SIPE,consulta externa,repetidas en personas de 5 a 14 anos,2005-04-01,15,21,15,21,36
SOPACHUY,consulta externa,repetidas en personas de 5 a 14 anos,2005-04-01,0,2,0,2,2
SORATA,consulta externa,repetidas en personas de 5 a 14 anos,2005-04-01,3,3,3,3,6
SUCRE,consulta externa,repetidas en personas de 5 a 14 anos,2005-04-01,896,798,896,798,1694
TACACHI,consulta externa,repetidas en personas de 5 a 14 anos,2005-04-01,3,5,3,5,8
TACOBAMBA,consulta externa,repetidas en personas de 5 a 14 anos,2005-04-01,1,1,1,1,2
TACOPAYA,consulta externa,repetidas en personas de 5 a 14 anos,2005-04-01,0,2,0,2,2
TAHUA,consulta externa,repetidas en personas de 5 a 14 anos,2005-04-01,2,0,2,0,2
TAPACARI,consulta externa,repetidas en personas de 5 a 14 anos,2005-04-01,6,2,6,2,8
TARABUCO,consulta externa,repetidas en personas de 5 a 14 anos,2005-04-01,11,7,11,7,18
TARACO,consulta externa,repetidas en personas de 5 a 14 anos,2005-04-01,1,0,1,0,1
TARATA,consulta externa,repetidas en personas de 5 a 14 anos,2005-04-01,1,3,1,3,4
TARIJA,consulta externa,repetidas en personas de 5 a 14 anos,2005-04-01,491,460,491,460,951
TEOPONTE,consulta externa,repetidas en personas de 5 a 14 anos,2005-04-01,4,7,4,7,11
TIAWANACU,consulta externa,repetidas en personas de 5 a 14 anos,2005-04-01,2,2,2,2,4
TIPUANI,consulta externa,repetidas en personas de 5 a 14 anos,2005-04-01,1,2,1,2,3
TIQUIPAYA,consulta externa,repetidas en personas de 5 a 14 anos,2005-04-01,15,18,15,18,33
TIRAQUE (CBBA),consulta externa,repetidas en personas de 5 a 14 anos,2005-04-01,16,11,16,11,27
TITO YUPANQUI (PARQUIPUJIO),consulta externa,repetidas en personas de 5 a 14 anos,2005-04-01,1,0,1,0,1
TOCO,consulta externa,repetidas en personas de 5 a 14 anos,2005-04-01,1,0,1,0,1
TOLATA,consulta externa,repetidas en personas de 5 a 14 anos,2005-04-01,3,2,3,2,5
TOLEDO,consulta externa,repetidas en personas de 5 a 14 anos,2005-04-01,2,2,2,2,4
TOMAVE,consulta externa,repetidas en personas de 5 a 14 anos,2005-04-01,0,1,0,1,1
TOMINA,consulta externa,repetidas en personas de 5 a 14 anos,2005-04-01,0,5,0,5,5
TORO TORO,consulta externa,repetidas en personas de 5 a 14 anos,2005-04-01,1,0,1,0,1
TOTORA(CBBA),consulta externa,repetidas en personas de 5 a 14 anos,2005-04-01,1,1,1,1,2
TRINIDAD,consulta externa,repetidas en personas de 5 a 14 anos,2005-04-01,85,97,85,97,182
TUPIZA,consulta externa,repetidas en personas de 5 a 14 anos,2005-04-01,60,77,60,77,137
UMALA,consulta externa,repetidas en personas de 5 a 14 anos,2005-04-01,1,0,1,0,1
UNCIA,consulta externa,repetidas en personas de 5 a 14 anos,2005-04-01,11,16,11,16,27
URIONDO (A. CONCEPCION),consulta externa,repetidas en personas de 5 a 14 anos,2005-04-01,3,2,3,2,5
URUBICHA,consulta externa,repetidas en personas de 5 a 14 anos,2005-04-01,0,2,0,2,2
UYUNI,consulta externa,repetidas en personas de 5 a 14 anos,2005-04-01,3,6,3,6,9
VACAS,consulta externa,repetidas en personas de 5 a 14 anos,2005-04-01,1,4,1,4,5
VALLEGRANDE,consulta externa,repetidas en personas de 5 a 14 anos,2005-04-01,17,13,17,13,30
VIACHA,consulta externa,repetidas en personas de 5 a 14 anos,2005-04-01,20,34,20,34,54
VILA VILA,consulta externa,repetidas en personas de 5 a 14 anos,2005-04-01,0,1,0,1,1
VILLA MONTES,consulta externa,repetidas en personas de 5 a 14 anos,2005-04-01,10,13,10,13,23
VILLA NUEVA (LOMA ALTA),consulta externa,repetidas en personas de 5 a 14 anos,2005-04-01,0,1,0,1,1
VILLA RIVERO,consulta externa,repetidas en personas de 5 a 14 anos,2005-04-01,5,0,5,0,5
VILLA SERRANO,consulta externa,repetidas en personas de 5 a 14 anos,2005-04-01,0,1,0,1,1
VILLA TUNARI,consulta externa,repetidas en personas de 5 a 14 anos,2005-04-01,19,18,19,18,37
VILLA VACA GUZMAN (MUYUPAMPA),consulta externa,repetidas en personas de 5 a 14 anos,2005-04-01,12,7,12,7,19
VILLAZON,consulta externa,repetidas en personas de 5 a 14 anos,2005-04-01,21,20,21,20,41
VINTO,consulta externa,repetidas en personas de 5 a 14 anos,2005-04-01,3,6,3,6,9
VITICHI,consulta externa,repetidas en personas de 5 a 14 anos,2005-04-01,1,6,1,6,7
WARNES,consulta externa,repetidas en personas de 5 a 14 anos,2005-04-01,10,8,10,8,18
YACUIBA,consulta externa,repetidas en personas de 5 a 14 anos,2005-04-01,95,96,95,96,191
YAMPARAEZ,consulta externa,repetidas en personas de 5 a 14 anos,2005-04-01,5,4,5,4,9
YANACACHI,consulta externa,repetidas en personas de 5 a 14 anos,2005-04-01,2,1,2,1,3
YAPACANI,consulta externa,repetidas en personas de 5 a 14 anos,2005-04-01,29,8,29,8,37
YOCALLA,consulta externa,repetidas en personas de 5 a 14 anos,2005-04-01,5,0,5,0,5
YOTALA,consulta externa,repetidas en personas de 5 a 14 anos,2005-04-01,5,11,5,11,16
ZUDAÑEZ,consulta externa,repetidas en personas de 5 a 14 anos,2005-04-01,2,0,2,0,2
ACHACACHI,consulta externa,repetidas en personas de 5 a 14 anos,2005-05-01,8,7,8,7,15
ACHOCALLA,consulta externa,repetidas en personas de 5 a 14 anos,2005-05-01,2,2,2,2,4
AIQUILE,consulta externa,repetidas en personas de 5 a 14 anos,2005-05-01,42,47,42,47,89
ALALAY,consulta externa,repetidas en personas de 5 a 14 anos,2005-05-01,0,1,0,1,1
ANCORAIMES,consulta externa,repetidas en personas de 5 a 14 anos,2005-05-01,0,1,0,1,1
ANDAMARCA,consulta externa,repetidas en personas de 5 a 14 anos,2005-05-01,0,1,0,1,1
ANZALDO,consulta externa,repetidas en personas de 5 a 14 anos,2005-05-01,1,2,1,2,3
APOLO,consulta externa,repetidas en personas de 5 a 14 anos,2005-05-01,4,2,4,2,6
ARANI,consulta externa,repetidas en personas de 5 a 14 anos,2005-05-01,2,1,2,1,3
ARBIETO,consulta externa,repetidas en personas de 5 a 14 anos,2005-05-01,5,1,5,1,6
ARQUE,consulta externa,repetidas en personas de 5 a 14 anos,2005-05-01,0,1,0,1,1
ASCENCION DE GUARAYOS,consulta externa,repetidas en personas de 5 a 14 anos,2005-05-01,2,0,2,0,2
ATOCHA,consulta externa,repetidas en personas de 5 a 14 anos,2005-05-01,26,32,26,32,58
AUCAPATA,consulta externa,repetidas en personas de 5 a 14 anos,2005-05-01,0,1,0,1,1
AYATA,consulta externa,repetidas en personas de 5 a 14 anos,2005-05-01,2,3,2,3,5
AYOPAYA (V. DE INDEPENDENCIA),consulta externa,repetidas en personas de 5 a 14 anos,2005-05-01,4,1,4,1,5
BATALLAS,consulta externa,repetidas en personas de 5 a 14 anos,2005-05-01,3,4,3,4,7
BAURES,consulta externa,repetidas en personas de 5 a 14 anos,2005-05-01,12,2,12,2,14
BELEN DE ANDAMARCA,consulta externa,repetidas en personas de 5 a 14 anos,2005-05-01,2,1,2,1,3
BELEN DE URMIRI,consulta externa,repetidas en personas de 5 a 14 anos,2005-05-01,2,0,2,0,2
BERMEJO,consulta externa,repetidas en personas de 5 a 14 anos,2005-05-01,33,31,33,31,64
BETANZOS,consulta externa,repetidas en personas de 5 a 14 anos,2005-05-01,5,1,5,1,6
BOLIVAR,consulta externa,repetidas en personas de 5 a 14 anos,2005-05-01,0,2,0,2,2
BOLPEBRA,consulta externa,repetidas en personas de 5 a 14 anos,2005-05-01,10,15,10,15,25
BOYUIBE,consulta externa,repetidas en personas de 5 a 14 anos,2005-05-01,7,4,7,4,11
BUENA VISTA,consulta externa,repetidas en personas de 5 a 14 anos,2005-05-01,9,5,9,5,14
CABEZAS,consulta externa,repetidas en personas de 5 a 14 anos,2005-05-01,2,5,2,5,7
CAIROMA,consulta externa,repetidas en personas de 5 a 14 anos,2005-05-01,0,1,0,1,1
CAJUATA,consulta externa,repetidas en personas de 5 a 14 anos,2005-05-01,0,2,0,2,2
CALACOTO,consulta externa,repetidas en personas de 5 a 14 anos,2005-05-01,1,0,1,0,1
CALAMARCA,consulta externa,repetidas en personas de 5 a 14 anos,2005-05-01,5,0,5,0,5
CAMARGO,consulta externa,repetidas en personas de 5 a 14 anos,2005-05-01,4,6,4,6,10
CAMATAQUI (C. VILLA ABECIA),consulta externa,repetidas en personas de 5 a 14 anos,2005-05-01,0,1,0,1,1
CAMIRI,consulta externa,repetidas en personas de 5 a 14 anos,2005-05-01,17,107,17,107,124
CAPINOTA,consulta externa,repetidas en personas de 5 a 14 anos,2005-05-01,3,5,3,5,8
CAQUIAVIRI,consulta externa,repetidas en personas de 5 a 14 anos,2005-05-01,0,2,0,2,2
CARACOLLO,consulta externa,repetidas en personas de 5 a 14 anos,2005-05-01,5,1,5,1,6
CARANAVI,consulta externa,repetidas en personas de 5 a 14 anos,2005-05-01,6,14,6,14,20
CARAPARI,consulta externa,repetidas en personas de 5 a 14 anos,2005-05-01,2,1,2,1,3
CHACARILLA,consulta externa,repetidas en personas de 5 a 14 anos,2005-05-01,0,1,0,1,1
CHALLAPATA,consulta externa,repetidas en personas de 5 a 14 anos,2005-05-01,11,12,11,12,23
CHAQUI,consulta externa,repetidas en personas de 5 a 14 anos,2005-05-01,1,0,1,0,1
CHARAGUA,consulta externa,repetidas en personas de 5 a 14 anos,2005-05-01,8,3,8,3,11
CHARAÑA,consulta externa,repetidas en personas de 5 a 14 anos,2005-05-01,1,1,1,1,2
CHAYANTA,consulta externa,repetidas en personas de 5 a 14 anos,2005-05-01,7,4,7,4,11
CHIMORE,consulta externa,repetidas en personas de 5 a 14 anos,2005-05-01,6,5,6,5,11
CHOQUE COTA,consulta externa,repetidas en personas de 5 a 14 anos,2005-05-01,1,1,1,1,2
CHULUMANI (V. DE LA LIBERTAD),consulta externa,repetidas en personas de 5 a 14 anos,2005-05-01,5,3,5,3,8
CHUMA,consulta externa,repetidas en personas de 5 a 14 anos,2005-05-01,4,0,4,0,4
CLIZA,consulta externa,repetidas en personas de 5 a 14 anos,2005-05-01,2,0,2,0,2
COBIJA,consulta externa,repetidas en personas de 5 a 14 anos,2005-05-01,38,40,38,40,78
COCHABAMBA,consulta externa,repetidas en personas de 5 a 14 anos,2005-05-01,1515,1322,1515,1322,2837
COLCAPIRHUA,consulta externa,repetidas en personas de 5 a 14 anos,2005-05-01,56,50,56,50,106
"COLCHA ""K""",consulta externa,repetidas en personas de 5 a 14 anos,2005-05-01,4,1,4,1,5
COLLANA,consulta externa,repetidas en personas de 5 a 14 anos,2005-05-01,0,1,0,1,1
COLOMI,consulta externa,repetidas en personas de 5 a 14 anos,2005-05-01,0,1,0,1,1
COLPA BELGICA,consulta externa,repetidas en personas de 5 a 14 anos,2005-05-01,22,9,22,9,31
COLQUECHACA,consulta externa,repetidas en personas de 5 a 14 anos,2005-05-01,1,3,1,3,4
COLQUENCHA,consulta externa,repetidas en personas de 5 a 14 anos,2005-05-01,0,1,0,1,1
COLQUIRI,consulta externa,repetidas en personas de 5 a 14 anos,2005-05-01,3,2,3,2,5
COMANCHE,consulta externa,repetidas en personas de 5 a 14 anos,2005-05-01,3,0,3,0,3
COMARAPA,consulta externa,repetidas en personas de 5 a 14 anos,2005-05-01,17,12,17,12,29
COMBAYA,consulta externa,repetidas en personas de 5 a 14 anos,2005-05-01,2,1,2,1,3
CORIPATA,consulta externa,repetidas en personas de 5 a 14 anos,2005-05-01,1,0,1,0,1
CORO CORO,consulta externa,repetidas en personas de 5 a 14 anos,2005-05-01,1,3,1,3,4
COROICO,consulta externa,repetidas en personas de 5 a 14 anos,2005-05-01,14,9,14,9,23
CORQUE,consulta externa,repetidas en personas de 5 a 14 anos,2005-05-01,13,9,13,9,22
COTAGAITA,consulta externa,repetidas en personas de 5 a 14 anos,2005-05-01,12,10,12,10,22
CUATRO CAÑADAS,consulta externa,repetidas en personas de 5 a 14 anos,2005-05-01,2,2,2,2,4
CUEVO,consulta externa,repetidas en personas de 5 a 14 anos,2005-05-01,0,2,0,2,2
CULPINA,consulta externa,repetidas en personas de 5 a 14 anos,2005-05-01,0,1,0,1,1
DESAGUADERO,consulta externa,repetidas en personas de 5 a 14 anos,2005-05-01,1,0,1,0,1
EL ALTO,consulta externa,repetidas en personas de 5 a 14 anos,2005-05-01,2126,3040,2126,3040,5166
EL TORNO,consulta externa,repetidas en personas de 5 a 14 anos,2005-05-01,22,51,22,51,73
EL VILLAR,consulta externa,repetidas en personas de 5 a 14 anos,2005-05-01,0,1,0,1,1
ENTRE RIOS,consulta externa,repetidas en personas de 5 a 14 anos,2005-05-01,25,36,25,36,61
ENTRE RIOS,consulta externa,repetidas en personas de 5 a 14 anos,2005-05-01,4,3,4,3,7
EUCALIPTUS,consulta externa,repetidas en personas de 5 a 14 anos,2005-05-01,0,4,0,4,4
EUREKA (SANTOS MERCADO),consulta externa,repetidas en personas de 5 a 14 anos,2005-05-01,0,1,0,1,1
EXALTACION,consulta externa,repetidas en personas de 5 a 14 anos,2005-05-01,1,1,1,1,2
FERNANDEZ ALONSO,consulta externa,repetidas en personas de 5 a 14 anos,2005-05-01,7,6,7,6,13
FILADELFIA,consulta externa,repetidas en personas de 5 a 14 anos,2005-05-01,12,25,12,25,37
GENERAL SAAVEDRA,consulta externa,repetidas en personas de 5 a 14 anos,2005-05-01,8,16,8,16,24
GRAL. J.J. PEREZ (CHARAZANI),consulta externa,repetidas en personas de 5 a 14 anos,2005-05-01,0,1,0,1,1
GUANAY,consulta externa,repetidas en personas de 5 a 14 anos,2005-05-01,10,7,10,7,17
GUAYARAMERIN,consulta externa,repetidas en personas de 5 a 14 anos,2005-05-01,84,113,84,113,197
GUTIERREZ,consulta externa,repetidas en personas de 5 a 14 anos,2005-05-01,2,1,2,1,3
HUACARETA,consulta externa,repetidas en personas de 5 a 14 anos,2005-05-01,2,0,2,0,2
HUANUNI,consulta externa,repetidas en personas de 5 a 14 anos,2005-05-01,78,81,78,81,159
HUARACAJE,consulta externa,repetidas en personas de 5 a 14 anos,2005-05-01,1,1,1,1,2
HUAYLLAMARCA,consulta externa,repetidas en personas de 5 a 14 anos,2005-05-01,3,9,3,9,12
ICHOCA,consulta externa,repetidas en personas de 5 a 14 anos,2005-05-01,2,0,2,0,2
INCAHUASI,consulta externa,repetidas en personas de 5 a 14 anos,2005-05-01,0,1,0,1,1
INGAVI (HUMAITA),consulta externa,repetidas en personas de 5 a 14 anos,2005-05-01,1,6,1,6,7
INQUISIVI,consulta externa,repetidas en personas de 5 a 14 anos,2005-05-01,1,0,1,0,1
IRUPANA (VILLA DE LANZA),consulta externa,repetidas en personas de 5 a 14 anos,2005-05-01,4,4,4,4,8
IXIAMAS,consulta externa,repetidas en personas de 5 a 14 anos,2005-05-01,1,1,1,1,2
JESUS DE MACHACA,consulta externa,repetidas en personas de 5 a 14 anos,2005-05-01,1,1,1,1,2
LA GUARDIA,consulta externa,repetidas en personas de 5 a 14 anos,2005-05-01,7,9,7,9,16
LA PAZ,consulta externa,repetidas en personas de 5 a 14 anos,2005-05-01,2633,2579,2633,2579,5212
LAGUNILLAS,consulta externa,repetidas en personas de 5 a 14 anos,2005-05-01,0,1,0,1,1
LAJA,consulta externa,repetidas en personas de 5 a 14 anos,2005-05-01,3,0,3,0,3
LAS CARRERAS,consulta externa,repetidas en personas de 5 a 14 anos,2005-05-01,2,12,2,12,14
LICOMA PAMPA,consulta externa,repetidas en personas de 5 a 14 anos,2005-05-01,0,1,0,1,1
LLALLAGUA,consulta externa,repetidas en personas de 5 a 14 anos,2005-05-01,5,8,5,8,13
LLICA,consulta externa,repetidas en personas de 5 a 14 anos,2005-05-01,2,2,2,2,4
LORETO,consulta externa,repetidas en personas de 5 a 14 anos,2005-05-01,4,2,4,2,6
LURIBAY,consulta externa,repetidas en personas de 5 a 14 anos,2005-05-01,0,1,0,1,1
MACHACAMARCA,consulta externa,repetidas en personas de 5 a 14 anos,2005-05-01,5,11,5,11,16
MACHARETI,consulta externa,repetidas en personas de 5 a 14 anos,2005-05-01,0,4,0,4,4
MAGDALENA,consulta externa,repetidas en personas de 5 a 14 anos,2005-05-01,12,11,12,11,23
MAIRANA,consulta externa,repetidas en personas de 5 a 14 anos,2005-05-01,1,3,1,3,4
MALLA,consulta externa,repetidas en personas de 5 a 14 anos,2005-05-01,1,4,1,4,5
MAPIRI,consulta externa,repetidas en personas de 5 a 14 anos,2005-05-01,2,0,2,0,2
MECAPACA,consulta externa,repetidas en personas de 5 a 14 anos,2005-05-01,22,18,22,18,40
MINEROS,consulta externa,repetidas en personas de 5 a 14 anos,2005-05-01,1,0,1,0,1
MIZQUE,consulta externa,repetidas en personas de 5 a 14 anos,2005-05-01,1,2,1,2,3
MOCOMOCO,consulta externa,repetidas en personas de 5 a 14 anos,2005-05-01,1,0,1,0,1
MOJOCOYA,consulta externa,repetidas en personas de 5 a 14 anos,2005-05-01,2,3,2,3,5
MONTEAGUDO,consulta externa,repetidas en personas de 5 a 14 anos,2005-05-01,8,21,8,21,29
MONTERO,consulta externa,repetidas en personas de 5 a 14 anos,2005-05-01,112,142,112,142,254
MOROCHATA,consulta externa,repetidas en personas de 5 a 14 anos,2005-05-01,3,3,3,3,6
OKINAWA,consulta externa,repetidas en personas de 5 a 14 anos,2005-05-01,1,1,1,1,2
OMEREQUE,consulta externa,repetidas en personas de 5 a 14 anos,2005-05-01,6,10,6,10,16
ORURO,consulta externa,repetidas en personas de 5 a 14 anos,2005-05-01,519,608,519,608,1127
PADCAYA,consulta externa,repetidas en personas de 5 a 14 anos,2005-05-01,1,1,1,1,2
PADILLA,consulta externa,repetidas en personas de 5 a 14 anos,2005-05-01,1,1,1,1,2
PAILON,consulta externa,repetidas en personas de 5 a 14 anos,2005-05-01,0,1,0,1,1
PALCA,consulta externa,repetidas en personas de 5 a 14 anos,2005-05-01,2,3,2,3,5
PALOS BLANCOS,consulta externa,repetidas en personas de 5 a 14 anos,2005-05-01,21,10,21,10,31
PAPEL PAMPA,consulta externa,repetidas en personas de 5 a 14 anos,2005-05-01,2,0,2,0,2
PATACAMAYA,consulta externa,repetidas en personas de 5 a 14 anos,2005-05-01,1,0,1,0,1
PAZÑA,consulta externa,repetidas en personas de 5 a 14 anos,2005-05-01,3,2,3,2,5
PELECHUCO,consulta externa,repetidas en personas de 5 a 14 anos,2005-05-01,0,1,0,1,1
POCOATA,consulta externa,repetidas en personas de 5 a 14 anos,2005-05-01,1,1,1,1,2
POCONA,consulta externa,repetidas en personas de 5 a 14 anos,2005-05-01,3,0,3,0,3
POJO (CBBA),consulta externa,repetidas en personas de 5 a 14 anos,2005-05-01,1,0,1,0,1
PORCO,consulta externa,repetidas en personas de 5 a 14 anos,2005-05-01,1,1,1,1,2
POROMA,consulta externa,repetidas en personas de 5 a 14 anos,2005-05-01,1,2,1,2,3
PORONGO,consulta externa,repetidas en personas de 5 a 14 anos,2005-05-01,3,3,3,3,6
PORTACHUELO,consulta externa,repetidas en personas de 5 a 14 anos,2005-05-01,13,13,13,13,26
PORVENIR,consulta externa,repetidas en personas de 5 a 14 anos,2005-05-01,3,0,3,0,3
POSTRER VALLE,consulta externa,repetidas en personas de 5 a 14 anos,2005-05-01,0,1,0,1,1
POTOSI,consulta externa,repetidas en personas de 5 a 14 anos,2005-05-01,266,250,266,250,516
PRESTO,consulta externa,repetidas en personas de 5 a 14 anos,2005-05-01,3,1,3,1,4
PUCARANI,consulta externa,repetidas en personas de 5 a 14 anos,2005-05-01,3,0,3,0,3
PUERTO ACOSTA,consulta externa,repetidas en personas de 5 a 14 anos,2005-05-01,3,3,3,3,6
PUERTO CARABUCO,consulta externa,repetidas en personas de 5 a 14 anos,2005-05-01,4,0,4,0,4
PUERTO GONZALO MORENO,consulta externa,repetidas en personas de 5 a 14 anos,2005-05-01,2,0,2,0,2
PUERTO QUIJARRO,consulta externa,repetidas en personas de 5 a 14 anos,2005-05-01,18,21,18,21,39
PUERTO SILES,consulta externa,repetidas en personas de 5 a 14 anos,2005-05-01,1,1,1,1,2
PUERTO SUAREZ,consulta externa,repetidas en personas de 5 a 14 anos,2005-05-01,10,18,10,18,28
PUERTO VILLARROEL,consulta externa,repetidas en personas de 5 a 14 anos,2005-05-01,13,9,13,9,22
PUNA,consulta externa,repetidas en personas de 5 a 14 anos,2005-05-01,5,1,5,1,6
PUNATA,consulta externa,repetidas en personas de 5 a 14 anos,2005-05-01,21,9,21,9,30
QUILLACOLLO,consulta externa,repetidas en personas de 5 a 14 anos,2005-05-01,69,71,69,71,140
QUIME,consulta externa,repetidas en personas de 5 a 14 anos,2005-05-01,0,8,0,8,8
RAVELO,consulta externa,repetidas en personas de 5 a 14 anos,2005-05-01,1,1,1,1,2
REYES,consulta externa,repetidas en personas de 5 a 14 anos,2005-05-01,6,2,6,2,8
RIBERALTA,consulta externa,repetidas en personas de 5 a 14 anos,2005-05-01,14,9,14,9,23
ROBORE,consulta externa,repetidas en personas de 5 a 14 anos,2005-05-01,18,52,18,52,70
RURRENABAQUE,consulta externa,repetidas en personas de 5 a 14 anos,2005-05-01,9,4,9,4,13
SABAYA,consulta externa,repetidas en personas de 5 a 14 anos,2005-05-01,1,0,1,0,1
SACABA,consulta externa,repetidas en personas de 5 a 14 anos,2005-05-01,79,56,79,56,135
SACABAMBA,consulta externa,repetidas en personas de 5 a 14 anos,2005-05-01,7,2,7,2,9
SAIPINA,consulta externa,repetidas en personas de 5 a 14 anos,2005-05-01,7,3,7,3,10
SALINAS DE GARCI MENDOZA,consulta externa,repetidas en personas de 5 a 14 anos,2005-05-01,1,0,1,0,1
SAMAIPATA,consulta externa,repetidas en personas de 5 a 14 anos,2005-05-01,1,1,1,1,2
SAN AGUSTIN,consulta externa,repetidas en personas de 5 a 14 anos,2005-05-01,0,1,0,1,1
SAN ANDRES,consulta externa,repetidas en personas de 5 a 14 anos,2005-05-01,8,5,8,5,13
SAN ANDRES DE MACHACA,consulta externa,repetidas en personas de 5 a 14 anos,2005-05-01,0,1,0,1,1
SAN ANTONIO DE ESMORUCO,consulta externa,repetidas en personas de 5 a 14 anos,2005-05-01,3,1,3,1,4
SAN BENITO,consulta externa,repetidas en personas de 5 a 14 anos,2005-05-01,5,3,5,3,8
SAN BORJA,consulta externa,repetidas en personas de 5 a 14 anos,2005-05-01,20,15,20,15,35
SAN BUENA VENTURA,consulta externa,repetidas en personas de 5 a 14 anos,2005-05-01,1,0,1,0,1
SAN CARLOS,consulta externa,repetidas en personas de 5 a 14 anos,2005-05-01,2,6,2,6,8
SAN IGNACIO,consulta externa,repetidas en personas de 5 a 14 anos,2005-05-01,10,22,10,22,32
SAN IGNACIO DE VELASCO,consulta externa,repetidas en personas de 5 a 14 anos,2005-05-01,25,35,25,35,60
SAN JAVIER(BNI),consulta externa,repetidas en personas de 5 a 14 anos,2005-05-01,0,2,0,2,2
SAN JAVIER(STC),consulta externa,repetidas en personas de 5 a 14 anos,2005-05-01,6,2,6,2,8
SAN JOAQUIN,consulta externa,repetidas en personas de 5 a 14 anos,2005-05-01,4,6,4,6,10
SAN JOSE DE CHIQUITOS,consulta externa,repetidas en personas de 5 a 14 anos,2005-05-01,1,1,1,1,2
SAN JUAN DE YAPACANI,consulta externa,repetidas en personas de 5 a 14 anos,2005-05-01,9,8,9,8,17
SAN JULIAN,consulta externa,repetidas en personas de 5 a 14 anos,2005-05-01,7,10,7,10,17
SAN LORENZO(PND),consulta externa,repetidas en personas de 5 a 14 anos,2005-05-01,3,0,3,0,3
SAN LORENZO(TJA),consulta externa,repetidas en personas de 5 a 14 anos,2005-05-01,12,10,12,10,22
SAN LUCAS,consulta externa,repetidas en personas de 5 a 14 anos,2005-05-01,2,4,2,4,6
SAN MATIAS,consulta externa,repetidas en personas de 5 a 14 anos,2005-05-01,0,1,0,1,1
SAN MIGUEL DE VELASCO,consulta externa,repetidas en personas de 5 a 14 anos,2005-05-01,9,7,9,7,16
SAN PABLO DE LIPEZ,consulta externa,repetidas en personas de 5 a 14 anos,2005-05-01,2,2,2,2,4
SAN PEDRO,consulta externa,repetidas en personas de 5 a 14 anos,2005-05-01,6,7,6,7,13
SAN PEDRO DE CURAHUARA,consulta externa,repetidas en personas de 5 a 14 anos,2005-05-01,1,0,1,0,1
SAN PEDRO DE TIQUINA,consulta externa,repetidas en personas de 5 a 14 anos,2005-05-01,2,0,2,0,2
SAN RAFAEL,consulta externa,repetidas en personas de 5 a 14 anos,2005-05-01,1,1,1,1,2
SAN RAMON,consulta externa,repetidas en personas de 5 a 14 anos,2005-05-01,8,3,8,3,11
SAN RAMON,consulta externa,repetidas en personas de 5 a 14 anos,2005-05-01,2,6,2,6,8
SANTA ANA,consulta externa,repetidas en personas de 5 a 14 anos,2005-05-01,37,30,37,30,67
SANTA CRUZ DE LA SIERRA,consulta externa,repetidas en personas de 5 a 14 anos,2005-05-01,1972,2284,1972,2284,4256
SANTA ROSA,consulta externa,repetidas en personas de 5 a 14 anos,2005-05-01,4,6,4,6,10
SANTA ROSA DEL SARA,consulta externa,repetidas en personas de 5 a 14 anos,2005-05-01,10,8,10,8,18
SANTIAGO DE HUARI,consulta externa,repetidas en personas de 5 a 14 anos,2005-05-01,3,5,3,5,8
SANTIVAÑES,consulta externa,repetidas en personas de 5 a 14 anos,2005-05-01,7,0,7,0,7
SAPAHAQUI,consulta externa,repetidas en personas de 5 a 14 anos,2005-05-01,0,1,0,1,1
SICA SICA (VILLA AROMA),consulta externa,repetidas en personas de 5 a 14 anos,2005-05-01,1,0,1,0,1
SIPE SIPE,consulta externa,repetidas en personas de 5 a 14 anos,2005-05-01,9,5,9,5,14
SOPACHUY,consulta externa,repetidas en personas de 5 a 14 anos,2005-05-01,1,1,1,1,2
SORACACHI,consulta externa,repetidas en personas de 5 a 14 anos,2005-05-01,2,0,2,0,2
SORATA,consulta externa,repetidas en personas de 5 a 14 anos,2005-05-01,0,1,0,1,1
SUCRE,consulta externa,repetidas en personas de 5 a 14 anos,2005-05-01,759,645,759,645,1404
TACACHI,consulta externa,repetidas en personas de 5 a 14 anos,2005-05-01,4,6,4,6,10
TACOBAMBA,consulta externa,repetidas en personas de 5 a 14 anos,2005-05-01,1,0,1,0,1
TACOPAYA,consulta externa,repetidas en personas de 5 a 14 anos,2005-05-01,0,1,0,1,1
TAPACARI,consulta externa,repetidas en personas de 5 a 14 anos,2005-05-01,29,22,29,22,51
TARABUCO,consulta externa,repetidas en personas de 5 a 14 anos,2005-05-01,10,9,10,9,19
TARACO,consulta externa,repetidas en personas de 5 a 14 anos,2005-05-01,4,2,4,2,6
TARATA,consulta externa,repetidas en personas de 5 a 14 anos,2005-05-01,6,1,6,1,7
TARIJA,consulta externa,repetidas en personas de 5 a 14 anos,2005-05-01,362,374,362,374,736
TARVITA,consulta externa,repetidas en personas de 5 a 14 anos,2005-05-01,2,3,2,3,5
TEOPONTE,consulta externa,repetidas en personas de 5 a 14 anos,2005-05-01,1,0,1,0,1
TINGUIPAYA,consulta externa,repetidas en personas de 5 a 14 anos,2005-05-01,0,2,0,2,2
TIPUANI,consulta externa,repetidas en personas de 5 a 14 anos,2005-05-01,4,3,4,3,7
TIQUIPAYA,consulta externa,repetidas en personas de 5 a 14 anos,2005-05-01,16,19,16,19,35
TIRAQUE (CBBA),consulta externa,repetidas en personas de 5 a 14 anos,2005-05-01,17,14,17,14,31
TOLATA,consulta externa,repetidas en personas de 5 a 14 anos,2005-05-01,3,1,3,1,4
TOLEDO,consulta externa,repetidas en personas de 5 a 14 anos,2005-05-01,1,0,1,0,1
TOMAVE,consulta externa,repetidas en personas de 5 a 14 anos,2005-05-01,4,2,4,2,6
TOMINA,consulta externa,repetidas en personas de 5 a 14 anos,2005-05-01,1,2,1,2,3
TORO TORO,consulta externa,repetidas en personas de 5 a 14 anos,2005-05-01,1,0,1,0,1
TRINIDAD,consulta externa,repetidas en personas de 5 a 14 anos,2005-05-01,71,140,71,140,211
TUPIZA,consulta externa,repetidas en personas de 5 a 14 anos,2005-05-01,76,91,76,91,167
UNCIA,consulta externa,repetidas en personas de 5 a 14 anos,2005-05-01,20,20,20,20,40
URIONDO (A. CONCEPCION),consulta externa,repetidas en personas de 5 a 14 anos,2005-05-01,3,1,3,1,4
URUBICHA,consulta externa,repetidas en personas de 5 a 14 anos,2005-05-01,0,3,0,3,3
UYUNI,consulta externa,repetidas en personas de 5 a 14 anos,2005-05-01,3,6,3,6,9
VACAS,consulta externa,repetidas en personas de 5 a 14 anos,2005-05-01,4,3,4,3,7
VALLEGRANDE,consulta externa,repetidas en personas de 5 a 14 anos,2005-05-01,34,39,34,39,73
VIACHA,consulta externa,repetidas en personas de 5 a 14 anos,2005-05-01,52,40,52,40,92
VILLA MONTES,consulta externa,repetidas en personas de 5 a 14 anos,2005-05-01,12,27,12,27,39
VILLA NUEVA (LOMA ALTA),consulta externa,repetidas en personas de 5 a 14 anos,2005-05-01,0,1,0,1,1
VILLA RIVERO,consulta externa,repetidas en personas de 5 a 14 anos,2005-05-01,2,4,2,4,6
VILLA TUNARI,consulta externa,repetidas en personas de 5 a 14 anos,2005-05-01,15,16,15,16,31
VILLA VACA GUZMAN (MUYUPAMPA),consulta externa,repetidas en personas de 5 a 14 anos,2005-05-01,5,1,5,1,6
VILLAZON,consulta externa,repetidas en personas de 5 a 14 anos,2005-05-01,13,19,13,19,32
VINTO,consulta externa,repetidas en personas de 5 a 14 anos,2005-05-01,6,18,6,18,24
VITICHI,consulta externa,repetidas en personas de 5 a 14 anos,2005-05-01,3,5,3,5,8
WALDO BALLIVIAN,consulta externa,repetidas en personas de 5 a 14 anos,2005-05-01,0,2,0,2,2
WARNES,consulta externa,repetidas en personas de 5 a 14 anos,2005-05-01,11,9,11,9,20
YACO,consulta externa,repetidas en personas de 5 a 14 anos,2005-05-01,7,3,7,3,10
YACUIBA,consulta externa,repetidas en personas de 5 a 14 anos,2005-05-01,84,76,84,76,160
YAMPARAEZ,consulta externa,repetidas en personas de 5 a 14 anos,2005-05-01,0,2,0,2,2
YANACACHI,consulta externa,repetidas en personas de 5 a 14 anos,2005-05-01,5,5,5,5,10
YAPACANI,consulta externa,repetidas en personas de 5 a 14 anos,2005-05-01,8,7,8,7,15
YOCALLA,consulta externa,repetidas en personas de 5 a 14 anos,2005-05-01,0,1,0,1,1
YOTALA,consulta externa,repetidas en personas de 5 a 14 anos,2005-05-01,7,8,7,8,15
YUNCHARA,consulta externa,repetidas en personas de 5 a 14 anos,2005-05-01,1,0,1,0,1
ZUDAÑEZ,consulta externa,repetidas en personas de 5 a 14 anos,2005-05-01,2,0,2,0,2
ACACIO,consulta externa,repetidas en personas de 5 a 14 anos,2005-06-01,0,1,0,1,1
ACHACACHI,consulta externa,repetidas en personas de 5 a 14 anos,2005-06-01,7,4,7,4,11
ACHOCALLA,consulta externa,repetidas en personas de 5 a 14 anos,2005-06-01,1,1,1,1,2
AIQUILE,consulta externa,repetidas en personas de 5 a 14 anos,2005-06-01,7,13,7,13,20
ANCORAIMES,consulta externa,repetidas en personas de 5 a 14 anos,2005-06-01,2,2,2,2,4
ANZALDO,consulta externa,repetidas en personas de 5 a 14 anos,2005-06-01,0,1,0,1,1
APOLO,consulta externa,repetidas en personas de 5 a 14 anos,2005-06-01,1,1,1,1,2
ARANI,consulta externa,repetidas en personas de 5 a 14 anos,2005-06-01,2,5,2,5,7
ARBIETO,consulta externa,repetidas en personas de 5 a 14 anos,2005-06-01,2,1,2,1,3
ASCENCION DE GUARAYOS,consulta externa,repetidas en personas de 5 a 14 anos,2005-06-01,1,7,1,7,8
ATOCHA,consulta externa,repetidas en personas de 5 a 14 anos,2005-06-01,39,29,39,29,68
AUCAPATA,consulta externa,repetidas en personas de 5 a 14 anos,2005-06-01,1,1,1,1,2
AYATA,consulta externa,repetidas en personas de 5 a 14 anos,2005-06-01,2,5,2,5,7
AYO AYO,consulta externa,repetidas en personas de 5 a 14 anos,2005-06-01,3,6,3,6,9
AYOPAYA (V. DE INDEPENDENCIA),consulta externa,repetidas en personas de 5 a 14 anos,2005-06-01,1,0,1,0,1
AZURDUY,consulta externa,repetidas en personas de 5 a 14 anos,2005-06-01,0,2,0,2,2
BAURES,consulta externa,repetidas en personas de 5 a 14 anos,2005-06-01,5,5,5,5,10
BERMEJO,consulta externa,repetidas en personas de 5 a 14 anos,2005-06-01,26,16,26,16,42
BETANZOS,consulta externa,repetidas en personas de 5 a 14 anos,2005-06-01,5,9,5,9,14
BOLIVAR,consulta externa,repetidas en personas de 5 a 14 anos,2005-06-01,1,0,1,0,1
BOYUIBE,consulta externa,repetidas en personas de 5 a 14 anos,2005-06-01,4,0,4,0,4
BUENA VISTA,consulta externa,repetidas en personas de 5 a 14 anos,2005-06-01,11,17,11,17,28
CABEZAS,consulta externa,repetidas en personas de 5 a 14 anos,2005-06-01,1,4,1,4,5
CAIROMA,consulta externa,repetidas en personas de 5 a 14 anos,2005-06-01,0,1,0,1,1
"CAIZA ""D""",consulta externa,repetidas en personas de 5 a 14 anos,2005-06-01,3,0,3,0,3
CALACOTO,consulta externa,repetidas en personas de 5 a 14 anos,2005-06-01,1,0,1,0,1
CALAMARCA,consulta externa,repetidas en personas de 5 a 14 anos,2005-06-01,1,0,1,0,1
CAMARGO,consulta externa,repetidas en personas de 5 a 14 anos,2005-06-01,3,7,3,7,10
CAMATAQUI (C. VILLA ABECIA),consulta externa,repetidas en personas de 5 a 14 anos,2005-06-01,1,0,1,0,1
CAMIRI,consulta externa,repetidas en personas de 5 a 14 anos,2005-06-01,24,109,24,109,133
CAPINOTA,consulta externa,repetidas en personas de 5 a 14 anos,2005-06-01,14,8,14,8,22
CAQUIAVIRI,consulta externa,repetidas en personas de 5 a 14 anos,2005-06-01,2,3,2,3,5
CARACOLLO,consulta externa,repetidas en personas de 5 a 14 anos,2005-06-01,4,1,4,1,5
CARANAVI,consulta externa,repetidas en personas de 5 a 14 anos,2005-06-01,23,50,23,50,73
CARAPARI,consulta externa,repetidas en personas de 5 a 14 anos,2005-06-01,10,14,10,14,24
CARMEN RIVERO TORREZ,consulta externa,repetidas en personas de 5 a 14 anos,2005-06-01,2,0,2,0,2
CHALLAPATA,consulta externa,repetidas en personas de 5 a 14 anos,2005-06-01,6,17,6,17,23
CHAQUI,consulta externa,repetidas en personas de 5 a 14 anos,2005-06-01,1,1,1,1,2
CHARAGUA,consulta externa,repetidas en personas de 5 a 14 anos,2005-06-01,5,14,5,14,19
CHARAÑA,consulta externa,repetidas en personas de 5 a 14 anos,2005-06-01,0,1,0,1,1
CHAYANTA,consulta externa,repetidas en personas de 5 a 14 anos,2005-06-01,2,2,2,2,4
CHIMORE,consulta externa,repetidas en personas de 5 a 14 anos,2005-06-01,3,5,3,5,8
CHULUMANI (V. DE LA LIBERTAD),consulta externa,repetidas en personas de 5 a 14 anos,2005-06-01,6,4,6,4,10
CHUMA,consulta externa,repetidas en personas de 5 a 14 anos,2005-06-01,3,0,3,0,3
CLIZA,consulta externa,repetidas en personas de 5 a 14 anos,2005-06-01,6,0,6,0,6
COBIJA,consulta externa,repetidas en personas de 5 a 14 anos,2005-06-01,30,27,30,27,57
COCHABAMBA,consulta externa,repetidas en personas de 5 a 14 anos,2005-06-01,2207,1824,2207,1824,4031
COLCAPIRHUA,consulta externa,repetidas en personas de 5 a 14 anos,2005-06-01,38,22,38,22,60
"COLCHA ""K""",consulta externa,repetidas en personas de 5 a 14 anos,2005-06-01,1,1,1,1,2
COLOMI,consulta externa,repetidas en personas de 5 a 14 anos,2005-06-01,3,0,3,0,3
COLPA BELGICA,consulta externa,repetidas en personas de 5 a 14 anos,2005-06-01,26,16,26,16,42
COLQUECHACA,consulta externa,repetidas en personas de 5 a 14 anos,2005-06-01,2,6,2,6,8
COLQUENCHA,consulta externa,repetidas en personas de 5 a 14 anos,2005-06-01,2,0,2,0,2
COLQUIRI,consulta externa,repetidas en personas de 5 a 14 anos,2005-06-01,1,0,1,0,1
COMANCHE,consulta externa,repetidas en personas de 5 a 14 anos,2005-06-01,1,0,1,0,1
COMARAPA,consulta externa,repetidas en personas de 5 a 14 anos,2005-06-01,18,8,18,8,26
COMBAYA,consulta externa,repetidas en personas de 5 a 14 anos,2005-06-01,0,1,0,1,1
CONCEPCION,consulta externa,repetidas en personas de 5 a 14 anos,2005-06-01,1,0,1,0,1
COPACABANA,consulta externa,repetidas en personas de 5 a 14 anos,2005-06-01,1,0,1,0,1
CORIPATA,consulta externa,repetidas en personas de 5 a 14 anos,2005-06-01,0,1,0,1,1
CORO CORO,consulta externa,repetidas en personas de 5 a 14 anos,2005-06-01,2,0,2,0,2
COROICO,consulta externa,repetidas en personas de 5 a 14 anos,2005-06-01,16,9,16,9,25
CORQUE,consulta externa,repetidas en personas de 5 a 14 anos,2005-06-01,3,3,3,3,6
COTAGAITA,consulta externa,repetidas en personas de 5 a 14 anos,2005-06-01,23,29,23,29,52
COTOCA,consulta externa,repetidas en personas de 5 a 14 anos,2005-06-01,1,2,1,2,3
CUATRO CAÑADAS,consulta externa,repetidas en personas de 5 a 14 anos,2005-06-01,1,2,1,2,3
CUCHUMUELA (V. G. VILLARROEL),consulta externa,repetidas en personas de 5 a 14 anos,2005-06-01,1,0,1,0,1
CUEVO,consulta externa,repetidas en personas de 5 a 14 anos,2005-06-01,4,2,4,2,6
CULPINA,consulta externa,repetidas en personas de 5 a 14 anos,2005-06-01,1,1,1,1,2
EL ALTO,consulta externa,repetidas en personas de 5 a 14 anos,2005-06-01,1652,1991,1652,1991,3643
EL PUENTE(STC),consulta externa,repetidas en personas de 5 a 14 anos,2005-06-01,2,0,2,0,2
EL TORNO,consulta externa,repetidas en personas de 5 a 14 anos,2005-06-01,27,44,27,44,71
EL VILLAR,consulta externa,repetidas en personas de 5 a 14 anos,2005-06-01,4,4,4,4,8
ENTRE RIOS,consulta externa,repetidas en personas de 5 a 14 anos,2005-06-01,6,4,6,4,10
ENTRE RIOS,consulta externa,repetidas en personas de 5 a 14 anos,2005-06-01,5,4,5,4,9
EUCALIPTUS,consulta externa,repetidas en personas de 5 a 14 anos,2005-06-01,1,0,1,0,1
FERNANDEZ ALONSO,consulta externa,repetidas en personas de 5 a 14 anos,2005-06-01,3,4,3,4,7
GENERAL SAAVEDRA,consulta externa,repetidas en personas de 5 a 14 anos,2005-06-01,1,1,1,1,2
GRAL. J.J. PEREZ (CHARAZANI),consulta externa,repetidas en personas de 5 a 14 anos,2005-06-01,1,0,1,0,1
GUAQUI,consulta externa,repetidas en personas de 5 a 14 anos,2005-06-01,1,0,1,0,1
GUAYARAMERIN,consulta externa,repetidas en personas de 5 a 14 anos,2005-06-01,76,164,76,164,240
GUTIERREZ,consulta externa,repetidas en personas de 5 a 14 anos,2005-06-01,7,14,7,14,21
HUACARETA,consulta externa,repetidas en personas de 5 a 14 anos,2005-06-01,0,2,0,2,2
HUANUNI,consulta externa,repetidas en personas de 5 a 14 anos,2005-06-01,52,64,52,64,116
HUARACAJE,consulta externa,repetidas en personas de 5 a 14 anos,2005-06-01,6,4,6,4,10
HUAYLLAMARCA,consulta externa,repetidas en personas de 5 a 14 anos,2005-06-01,0,1,0,1,1
ICLA,consulta externa,repetidas en personas de 5 a 14 anos,2005-06-01,0,1,0,1,1
INCAHUASI,consulta externa,repetidas en personas de 5 a 14 anos,2005-06-01,0,2,0,2,2
INQUISIVI,consulta externa,repetidas en personas de 5 a 14 anos,2005-06-01,3,3,3,3,6
IRUPANA (VILLA DE LANZA),consulta externa,repetidas en personas de 5 a 14 anos,2005-06-01,8,4,8,4,12
IXIAMAS,consulta externa,repetidas en personas de 5 a 14 anos,2005-06-01,3,3,3,3,6
JESUS DE MACHACA,consulta externa,repetidas en personas de 5 a 14 anos,2005-06-01,2,0,2,0,2
LA ASUNTA,consulta externa,repetidas en personas de 5 a 14 anos,2005-06-01,1,1,1,1,2
LA GUARDIA,consulta externa,repetidas en personas de 5 a 14 anos,2005-06-01,9,16,9,16,25
LA PAZ,consulta externa,repetidas en personas de 5 a 14 anos,2005-06-01,2011,2140,2011,2140,4151
LAGUNILLAS,consulta externa,repetidas en personas de 5 a 14 anos,2005-06-01,3,8,3,8,11
LAJA,consulta externa,repetidas en personas de 5 a 14 anos,2005-06-01,3,1,3,1,4
LAS CARRERAS,consulta externa,repetidas en personas de 5 a 14 anos,2005-06-01,1,0,1,0,1
LLALLAGUA,consulta externa,repetidas en personas de 5 a 14 anos,2005-06-01,6,8,6,8,14
LLICA,consulta externa,repetidas en personas de 5 a 14 anos,2005-06-01,2,2,2,2,4
LORETO,consulta externa,repetidas en personas de 5 a 14 anos,2005-06-01,3,0,3,0,3
MACHACAMARCA,consulta externa,repetidas en personas de 5 a 14 anos,2005-06-01,8,3,8,3,11
MACHARETI,consulta externa,repetidas en personas de 5 a 14 anos,2005-06-01,1,3,1,3,4
MAGDALENA,consulta externa,repetidas en personas de 5 a 14 anos,2005-06-01,16,17,16,17,33
MAIRANA,consulta externa,repetidas en personas de 5 a 14 anos,2005-06-01,1,3,1,3,4
MALLA,consulta externa,repetidas en personas de 5 a 14 anos,2005-06-01,1,1,1,1,2
MAPIRI,consulta externa,repetidas en personas de 5 a 14 anos,2005-06-01,3,4,3,4,7
MECAPACA,consulta externa,repetidas en personas de 5 a 14 anos,2005-06-01,17,3,17,3,20
MINEROS,consulta externa,repetidas en personas de 5 a 14 anos,2005-06-01,1,0,1,0,1
MIZQUE,consulta externa,repetidas en personas de 5 a 14 anos,2005-06-01,1,2,1,2,3
MOCOMOCO,consulta externa,repetidas en personas de 5 a 14 anos,2005-06-01,4,4,4,4,8
MOJOCOYA,consulta externa,repetidas en personas de 5 a 14 anos,2005-06-01,1,0,1,0,1
MONTEAGUDO,consulta externa,repetidas en personas de 5 a 14 anos,2005-06-01,8,13,8,13,21
MONTERO,consulta externa,repetidas en personas de 5 a 14 anos,2005-06-01,113,154,113,154,267
MOROCHATA,consulta externa,repetidas en personas de 5 a 14 anos,2005-06-01,3,1,3,1,4
OKINAWA,consulta externa,repetidas en personas de 5 a 14 anos,2005-06-01,5,3,5,3,8
OMEREQUE,consulta externa,repetidas en personas de 5 a 14 anos,2005-06-01,1,1,1,1,2
ORURO,consulta externa,repetidas en personas de 5 a 14 anos,2005-06-01,388,434,388,434,822
PADCAYA,consulta externa,repetidas en personas de 5 a 14 anos,2005-06-01,3,2,3,2,5
PADILLA,consulta externa,repetidas en personas de 5 a 14 anos,2005-06-01,4,1,4,1,5
PAILON,consulta externa,repetidas en personas de 5 a 14 anos,2005-06-01,1,1,1,1,2
PALCA,consulta externa,repetidas en personas de 5 a 14 anos,2005-06-01,2,0,2,0,2
PALOS BLANCOS,consulta externa,repetidas en personas de 5 a 14 anos,2005-06-01,11,2,11,2,13
PAMPA GRANDE,consulta externa,repetidas en personas de 5 a 14 anos,2005-06-01,0,2,0,2,2
PAPEL PAMPA,consulta externa,repetidas en personas de 5 a 14 anos,2005-06-01,4,0,4,0,4
PASORAPA,consulta externa,repetidas en personas de 5 a 14 anos,2005-06-01,0,1,0,1,1
PATACAMAYA,consulta externa,repetidas en personas de 5 a 14 anos,2005-06-01,1,0,1,0,1
PAZÑA,consulta externa,repetidas en personas de 5 a 14 anos,2005-06-01,3,4,3,4,7
PELECHUCO,consulta externa,repetidas en personas de 5 a 14 anos,2005-06-01,1,1,1,1,2
POCOATA,consulta externa,repetidas en personas de 5 a 14 anos,2005-06-01,3,0,3,0,3
POCONA,consulta externa,repetidas en personas de 5 a 14 anos,2005-06-01,1,0,1,0,1
POJO (CBBA),consulta externa,repetidas en personas de 5 a 14 anos,2005-06-01,2,1,2,1,3
PORCO,consulta externa,repetidas en personas de 5 a 14 anos,2005-06-01,0,1,0,1,1
POROMA,consulta externa,repetidas en personas de 5 a 14 anos,2005-06-01,3,0,3,0,3
PORONGO,consulta externa,repetidas en personas de 5 a 14 anos,2005-06-01,4,4,4,4,8
PORTACHUELO,consulta externa,repetidas en personas de 5 a 14 anos,2005-06-01,14,25,14,25,39
PORVENIR,consulta externa,repetidas en personas de 5 a 14 anos,2005-06-01,1,0,1,0,1
POSTRER VALLE,consulta externa,repetidas en personas de 5 a 14 anos,2005-06-01,0,2,0,2,2
POTOSI,consulta externa,repetidas en personas de 5 a 14 anos,2005-06-01,277,236,277,236,513
PUCARA,consulta externa,repetidas en personas de 5 a 14 anos,2005-06-01,1,4,1,4,5
PUCARANI,consulta externa,repetidas en personas de 5 a 14 anos,2005-06-01,2,0,2,0,2
PUERTO ACOSTA,consulta externa,repetidas en personas de 5 a 14 anos,2005-06-01,8,2,8,2,10
PUERTO CARABUCO,consulta externa,repetidas en personas de 5 a 14 anos,2005-06-01,1,0,1,0,1
PUERTO GONZALO MORENO,consulta externa,repetidas en personas de 5 a 14 anos,2005-06-01,5,9,5,9,14
PUERTO PEREZ,consulta externa,repetidas en personas de 5 a 14 anos,2005-06-01,1,0,1,0,1
PUERTO QUIJARRO,consulta externa,repetidas en personas de 5 a 14 anos,2005-06-01,9,8,9,8,17
PUERTO RICO,consulta externa,repetidas en personas de 5 a 14 anos,2005-06-01,58,54,58,54,112
PUERTO SUAREZ,consulta externa,repetidas en personas de 5 a 14 anos,2005-06-01,16,15,16,15,31
PUERTO VILLARROEL,consulta externa,repetidas en personas de 5 a 14 anos,2005-06-01,17,11,17,11,28
PUNA,consulta externa,repetidas en personas de 5 a 14 anos,2005-06-01,6,4,6,4,10
PUNATA,consulta externa,repetidas en personas de 5 a 14 anos,2005-06-01,44,19,44,19,63
QUILLACOLLO,consulta externa,repetidas en personas de 5 a 14 anos,2005-06-01,51,43,51,43,94
QUIME,consulta externa,repetidas en personas de 5 a 14 anos,2005-06-01,1,1,1,1,2
RAVELO,consulta externa,repetidas en personas de 5 a 14 anos,2005-06-01,0,1,0,1,1
REYES,consulta externa,repetidas en personas de 5 a 14 anos,2005-06-01,3,1,3,1,4
RIBERALTA,consulta externa,repetidas en personas de 5 a 14 anos,2005-06-01,30,173,30,173,203
ROBORE,consulta externa,repetidas en personas de 5 a 14 anos,2005-06-01,13,6,13,6,19
RURRENABAQUE,consulta externa,repetidas en personas de 5 a 14 anos,2005-06-01,12,5,12,5,17
SACABA,consulta externa,repetidas en personas de 5 a 14 anos,2005-06-01,65,66,65,66,131
SAIPINA,consulta externa,repetidas en personas de 5 a 14 anos,2005-06-01,4,3,4,3,7
SALINAS DE GARCI MENDOZA,consulta externa,repetidas en personas de 5 a 14 anos,2005-06-01,3,5,3,5,8
SAN ANDRES,consulta externa,repetidas en personas de 5 a 14 anos,2005-06-01,3,1,3,1,4
SAN ANDRES DE MACHACA,consulta externa,repetidas en personas de 5 a 14 anos,2005-06-01,1,0,1,0,1
SAN ANTONIO DE ESMORUCO,consulta externa,repetidas en personas de 5 a 14 anos,2005-06-01,0,1,0,1,1
SAN BENITO,consulta externa,repetidas en personas de 5 a 14 anos,2005-06-01,8,1,8,1,9
SAN BORJA,consulta externa,repetidas en personas de 5 a 14 anos,2005-06-01,13,15,13,15,28
SAN BUENA VENTURA,consulta externa,repetidas en personas de 5 a 14 anos,2005-06-01,1,2,1,2,3
SAN CARLOS,consulta externa,repetidas en personas de 5 a 14 anos,2005-06-01,6,4,6,4,10
SAN IGNACIO,consulta externa,repetidas en personas de 5 a 14 anos,2005-06-01,19,25,19,25,44
SAN IGNACIO DE VELASCO,consulta externa,repetidas en personas de 5 a 14 anos,2005-06-01,21,17,21,17,38
SAN JAVIER(STC),consulta externa,repetidas en personas de 5 a 14 anos,2005-06-01,0,3,0,3,3
SAN JOAQUIN,consulta externa,repetidas en personas de 5 a 14 anos,2005-06-01,3,9,3,9,12
SAN JOSE DE CHIQUITOS,consulta externa,repetidas en personas de 5 a 14 anos,2005-06-01,1,7,1,7,8
SAN JUAN DE YAPACANI,consulta externa,repetidas en personas de 5 a 14 anos,2005-06-01,1,2,1,2,3
SAN JULIAN,consulta externa,repetidas en personas de 5 a 14 anos,2005-06-01,5,11,5,11,16
SAN LORENZO(PND),consulta externa,repetidas en personas de 5 a 14 anos,2005-06-01,2,1,2,1,3
SAN LORENZO(TJA),consulta externa,repetidas en personas de 5 a 14 anos,2005-06-01,8,11,8,11,19
SAN LUCAS,consulta externa,repetidas en personas de 5 a 14 anos,2005-06-01,2,3,2,3,5
SAN MATIAS,consulta externa,repetidas en personas de 5 a 14 anos,2005-06-01,3,4,3,4,7
SAN MIGUEL DE VELASCO,consulta externa,repetidas en personas de 5 a 14 anos,2005-06-01,12,17,12,17,29
SAN PABLO DE LIPEZ,consulta externa,repetidas en personas de 5 a 14 anos,2005-06-01,2,0,2,0,2
SAN PEDRO,consulta externa,repetidas en personas de 5 a 14 anos,2005-06-01,6,6,6,6,12
SAN PEDRO DE CURAHUARA,consulta externa,repetidas en personas de 5 a 14 anos,2005-06-01,2,0,2,0,2
SAN PEDRO DE TIQUINA,consulta externa,repetidas en personas de 5 a 14 anos,2005-06-01,1,0,1,0,1
SAN RAFAEL,consulta externa,repetidas en personas de 5 a 14 anos,2005-06-01,2,0,2,0,2
SAN RAMON,consulta externa,repetidas en personas de 5 a 14 anos,2005-06-01,5,12,5,12,17
SAN RAMON,consulta externa,repetidas en personas de 5 a 14 anos,2005-06-01,2,3,2,3,5
SANTA ANA,consulta externa,repetidas en personas de 5 a 14 anos,2005-06-01,41,35,41,35,76
SANTA CRUZ DE LA SIERRA,consulta externa,repetidas en personas de 5 a 14 anos,2005-06-01,2504,3518,2504,3518,6022
SANTA ROSA,consulta externa,repetidas en personas de 5 a 14 anos,2005-06-01,2,4,2,4,6
SANTA ROSA DEL SARA,consulta externa,repetidas en personas de 5 a 14 anos,2005-06-01,5,5,5,5,10
SANTIAGO DE HUARI,consulta externa,repetidas en personas de 5 a 14 anos,2005-06-01,2,3,2,3,5
SANTIVAÑES,consulta externa,repetidas en personas de 5 a 14 anos,2005-06-01,6,1,6,1,7
SICAYA,consulta externa,repetidas en personas de 5 a 14 anos,2005-06-01,1,0,1,0,1
SIPE SIPE,consulta externa,repetidas en personas de 5 a 14 anos,2005-06-01,6,5,6,5,11
SORATA,consulta externa,repetidas en personas de 5 a 14 anos,2005-06-01,5,1,5,1,6
SUCRE,consulta externa,repetidas en personas de 5 a 14 anos,2005-06-01,787,769,787,769,1556
TACACHI,consulta externa,repetidas en personas de 5 a 14 anos,2005-06-01,3,7,3,7,10
TACACOMA,consulta externa,repetidas en personas de 5 a 14 anos,2005-06-01,0,1,0,1,1
TACOBAMBA,consulta externa,repetidas en personas de 5 a 14 anos,2005-06-01,1,0,1,0,1
TACOPAYA,consulta externa,repetidas en personas de 5 a 14 anos,2005-06-01,0,1,0,1,1
TAPACARI,consulta externa,repetidas en personas de 5 a 14 anos,2005-06-01,3,3,3,3,6
TARABUCO,consulta externa,repetidas en personas de 5 a 14 anos,2005-06-01,8,7,8,7,15
TARACO,consulta externa,repetidas en personas de 5 a 14 anos,2005-06-01,0,1,0,1,1
TARATA,consulta externa,repetidas en personas de 5 a 14 anos,2005-06-01,4,1,4,1,5
TARIJA,consulta externa,repetidas en personas de 5 a 14 anos,2005-06-01,451,413,451,413,864
TARVITA,consulta externa,repetidas en personas de 5 a 14 anos,2005-06-01,1,2,1,2,3
TIAWANACU,consulta externa,repetidas en personas de 5 a 14 anos,2005-06-01,0,1,0,1,1
TINGUIPAYA,consulta externa,repetidas en personas de 5 a 14 anos,2005-06-01,0,2,0,2,2
TIPUANI,consulta externa,repetidas en personas de 5 a 14 anos,2005-06-01,2,4,2,4,6
TIQUIPAYA,consulta externa,repetidas en personas de 5 a 14 anos,2005-06-01,18,24,18,24,42
TIRAQUE (CBBA),consulta externa,repetidas en personas de 5 a 14 anos,2005-06-01,14,7,14,7,21
TITO YUPANQUI (PARQUIPUJIO),consulta externa,repetidas en personas de 5 a 14 anos,2005-06-01,0,1,0,1,1
TOLATA,consulta externa,repetidas en personas de 5 a 14 anos,2005-06-01,1,2,1,2,3
TOLEDO,consulta externa,repetidas en personas de 5 a 14 anos,2005-06-01,2,0,2,0,2
TOMAVE,consulta externa,repetidas en personas de 5 a 14 anos,2005-06-01,2,6,2,6,8
TOMINA,consulta externa,repetidas en personas de 5 a 14 anos,2005-06-01,0,1,0,1,1
TOTORA(CBBA),consulta externa,repetidas en personas de 5 a 14 anos,2005-06-01,0,1,0,1,1
TOTORA(ORR),consulta externa,repetidas en personas de 5 a 14 anos,2005-06-01,1,0,1,0,1
TRIGAL,consulta externa,repetidas en personas de 5 a 14 anos,2005-06-01,1,1,1,1,2
TRINIDAD,consulta externa,repetidas en personas de 5 a 14 anos,2005-06-01,124,117,124,117,241
TUPIZA,consulta externa,repetidas en personas de 5 a 14 anos,2005-06-01,68,83,68,83,151
TURCO,consulta externa,repetidas en personas de 5 a 14 anos,2005-06-01,2,0,2,0,2
UNCIA,consulta externa,repetidas en personas de 5 a 14 anos,2005-06-01,11,8,11,8,19
URIONDO (A. CONCEPCION),consulta externa,repetidas en personas de 5 a 14 anos,2005-06-01,3,1,3,1,4
URUBICHA,consulta externa,repetidas en personas de 5 a 14 anos,2005-06-01,0,2,0,2,2
UYUNI,consulta externa,repetidas en personas de 5 a 14 anos,2005-06-01,12,13,12,13,25
VACAS,consulta externa,repetidas en personas de 5 a 14 anos,2005-06-01,6,4,6,4,10
VALLEGRANDE,consulta externa,repetidas en personas de 5 a 14 anos,2005-06-01,20,21,20,21,41
VIACHA,consulta externa,repetidas en personas de 5 a 14 anos,2005-06-01,37,30,37,30,67
VILLA MONTES,consulta externa,repetidas en personas de 5 a 14 anos,2005-06-01,19,18,19,18,37
VILLA RIVERO,consulta externa,repetidas en personas de 5 a 14 anos,2005-06-01,3,1,3,1,4
VILLA TUNARI,consulta externa,repetidas en personas de 5 a 14 anos,2005-06-01,4,15,4,15,19
VILLA VACA GUZMAN (MUYUPAMPA),consulta externa,repetidas en personas de 5 a 14 anos,2005-06-01,4,7,4,7,11
VILLAZON,consulta externa,repetidas en personas de 5 a 14 anos,2005-06-01,18,21,18,21,39
VINTO,consulta externa,repetidas en personas de 5 a 14 anos,2005-06-01,4,1,4,1,5
VITICHI,consulta externa,repetidas en personas de 5 a 14 anos,2005-06-01,0,3,0,3,3
WALDO BALLIVIAN,consulta externa,repetidas en personas de 5 a 14 anos,2005-06-01,2,0,2,0,2
WARNES,consulta externa,repetidas en personas de 5 a 14 anos,2005-06-01,5,7,5,7,12
YACO,consulta externa,repetidas en personas de 5 a 14 anos,2005-06-01,0,2,0,2,2
YACUIBA,consulta externa,repetidas en personas de 5 a 14 anos,2005-06-01,149,119,149,119,268
YAMPARAEZ,consulta externa,repetidas en personas de 5 a 14 anos,2005-06-01,0,5,0,5,5
YANACACHI,consulta externa,repetidas en personas de 5 a 14 anos,2005-06-01,2,0,2,0,2
YAPACANI,consulta externa,repetidas en personas de 5 a 14 anos,2005-06-01,8,5,8,5,13
YOCALLA,consulta externa,repetidas en personas de 5 a 14 anos,2005-06-01,1,2,1,2,3
YOTALA,consulta externa,repetidas en personas de 5 a 14 anos,2005-06-01,16,9,16,9,25
ZUDAÑEZ,consulta externa,repetidas en personas de 5 a 14 anos,2005-06-01,1,0,1,0,1
ACACIO,consulta externa,repetidas en personas de 5 a 14 anos,2005-07-01,2,1,2,1,3
ACHACACHI,consulta externa,repetidas en personas de 5 a 14 anos,2005-07-01,8,4,8,4,12
ACHOCALLA,consulta externa,repetidas en personas de 5 a 14 anos,2005-07-01,3,1,3,1,4
AIQUILE,consulta externa,repetidas en personas de 5 a 14 anos,2005-07-01,37,42,37,42,79
ALALAY,consulta externa,repetidas en personas de 5 a 14 anos,2005-07-01,2,0,2,0,2
ANCORAIMES,consulta externa,repetidas en personas de 5 a 14 anos,2005-07-01,3,3,3,3,6
ANZALDO,consulta externa,repetidas en personas de 5 a 14 anos,2005-07-01,0,2,0,2,2
APOLO,consulta externa,repetidas en personas de 5 a 14 anos,2005-07-01,6,5,6,5,11
ARANI,consulta externa,repetidas en personas de 5 a 14 anos,2005-07-01,3,4,3,4,7
ARBIETO,consulta externa,repetidas en personas de 5 a 14 anos,2005-07-01,1,3,1,3,4
ASCENCION DE GUARAYOS,consulta externa,repetidas en personas de 5 a 14 anos,2005-07-01,3,1,3,1,4
ATOCHA,consulta externa,repetidas en personas de 5 a 14 anos,2005-07-01,43,37,43,37,80
AUCAPATA,consulta externa,repetidas en personas de 5 a 14 anos,2005-07-01,0,1,0,1,1
AYATA,consulta externa,repetidas en personas de 5 a 14 anos,2005-07-01,9,7,9,7,16
AYO AYO,consulta externa,repetidas en personas de 5 a 14 anos,2005-07-01,3,1,3,1,4
AYOPAYA (V. DE INDEPENDENCIA),consulta externa,repetidas en personas de 5 a 14 anos,2005-07-01,0,1,0,1,1
AZURDUY,consulta externa,repetidas en personas de 5 a 14 anos,2005-07-01,0,1,0,1,1
BATALLAS,consulta externa,repetidas en personas de 5 a 14 anos,2005-07-01,0,1,0,1,1
BAURES,consulta externa,repetidas en personas de 5 a 14 anos,2005-07-01,1,1,1,1,2
BERMEJO,consulta externa,repetidas en personas de 5 a 14 anos,2005-07-01,32,30,32,30,62
BETANZOS,consulta externa,repetidas en personas de 5 a 14 anos,2005-07-01,4,13,4,13,17
BOLIVAR,consulta externa,repetidas en personas de 5 a 14 anos,2005-07-01,0,1,0,1,1
BOYUIBE,consulta externa,repetidas en personas de 5 a 14 anos,2005-07-01,1,0,1,0,1
BUENA VISTA,consulta externa,repetidas en personas de 5 a 14 anos,2005-07-01,20,15,20,15,35
CABEZAS,consulta externa,repetidas en personas de 5 a 14 anos,2005-07-01,2,2,2,2,4
CAIROMA,consulta externa,repetidas en personas de 5 a 14 anos,2005-07-01,1,1,1,1,2
"CAIZA ""D""",consulta externa,repetidas en personas de 5 a 14 anos,2005-07-01,3,0,3,0,3
CALACOTO,consulta externa,repetidas en personas de 5 a 14 anos,2005-07-01,4,0,4,0,4
CALAMARCA,consulta externa,repetidas en personas de 5 a 14 anos,2005-07-01,2,3,2,3,5
CAMARGO,consulta externa,repetidas en personas de 5 a 14 anos,2005-07-01,1,4,1,4,5
CAMATAQUI (C. VILLA ABECIA),consulta externa,repetidas en personas de 5 a 14 anos,2005-07-01,1,3,1,3,4
CAMIRI,consulta externa,repetidas en personas de 5 a 14 anos,2005-07-01,17,82,17,82,99
CAPINOTA,consulta externa,repetidas en personas de 5 a 14 anos,2005-07-01,9,3,9,3,12
CAQUIAVIRI,consulta externa,repetidas en personas de 5 a 14 anos,2005-07-01,0,2,0,2,2
CARACOLLO,consulta externa,repetidas en personas de 5 a 14 anos,2005-07-01,4,3,4,3,7
CARANAVI,consulta externa,repetidas en personas de 5 a 14 anos,2005-07-01,4,6,4,6,10
CARAPARI,consulta externa,repetidas en personas de 5 a 14 anos,2005-07-01,2,0,2,0,2
CARMEN RIVERO TORREZ,consulta externa,repetidas en personas de 5 a 14 anos,2005-07-01,0,1,0,1,1
CHALLAPATA,consulta externa,repetidas en personas de 5 a 14 anos,2005-07-01,14,4,14,4,18
CHAQUI,consulta externa,repetidas en personas de 5 a 14 anos,2005-07-01,1,0,1,0,1
CHARAGUA,consulta externa,repetidas en personas de 5 a 14 anos,2005-07-01,13,6,13,6,19
CHARAÑA,consulta externa,repetidas en personas de 5 a 14 anos,2005-07-01,0,1,0,1,1
CHAYANTA,consulta externa,repetidas en personas de 5 a 14 anos,2005-07-01,2,2,2,2,4
CHIMORE,consulta externa,repetidas en personas de 5 a 14 anos,2005-07-01,4,4,4,4,8
CHOQUE COTA,consulta externa,repetidas en personas de 5 a 14 anos,2005-07-01,2,1,2,1,3
CHULUMANI (V. DE LA LIBERTAD),consulta externa,repetidas en personas de 5 a 14 anos,2005-07-01,7,5,7,5,12
CHUMA,consulta externa,repetidas en personas de 5 a 14 anos,2005-07-01,0,1,0,1,1
CLIZA,consulta externa,repetidas en personas de 5 a 14 anos,2005-07-01,3,1,3,1,4
COBIJA,consulta externa,repetidas en personas de 5 a 14 anos,2005-07-01,50,59,50,59,109
COCHABAMBA,consulta externa,repetidas en personas de 5 a 14 anos,2005-07-01,2165,1679,2165,1679,3844
COLCAPIRHUA,consulta externa,repetidas en personas de 5 a 14 anos,2005-07-01,39,41,39,41,80
"COLCHA ""K""",consulta externa,repetidas en personas de 5 a 14 anos,2005-07-01,1,3,1,3,4
COLLANA,consulta externa,repetidas en personas de 5 a 14 anos,2005-07-01,0,1,0,1,1
COLOMI,consulta externa,repetidas en personas de 5 a 14 anos,2005-07-01,0,3,0,3,3
COLPA BELGICA,consulta externa,repetidas en personas de 5 a 14 anos,2005-07-01,12,16,12,16,28
COLQUECHACA,consulta externa,repetidas en personas de 5 a 14 anos,2005-07-01,0,1,0,1,1
COLQUENCHA,consulta externa,repetidas en personas de 5 a 14 anos,2005-07-01,1,0,1,0,1
COLQUIRI,consulta externa,repetidas en personas de 5 a 14 anos,2005-07-01,2,1,2,1,3
COMANCHE,consulta externa,repetidas en personas de 5 a 14 anos,2005-07-01,3,1,3,1,4
COMARAPA,consulta externa,repetidas en personas de 5 a 14 anos,2005-07-01,30,39,30,39,69
CONCEPCION,consulta externa,repetidas en personas de 5 a 14 anos,2005-07-01,2,3,2,3,5
CORIPATA,consulta externa,repetidas en personas de 5 a 14 anos,2005-07-01,2,0,2,0,2
CORO CORO,consulta externa,repetidas en personas de 5 a 14 anos,2005-07-01,1,0,1,0,1
COROICO,consulta externa,repetidas en personas de 5 a 14 anos,2005-07-01,7,4,7,4,11
CORQUE,consulta externa,repetidas en personas de 5 a 14 anos,2005-07-01,15,17,15,17,32
COTAGAITA,consulta externa,repetidas en personas de 5 a 14 anos,2005-07-01,21,40,21,40,61
COTOCA,consulta externa,repetidas en personas de 5 a 14 anos,2005-07-01,0,3,0,3,3
CUATRO CAÑADAS,consulta externa,repetidas en personas de 5 a 14 anos,2005-07-01,5,8,5,8,13
CUCHUMUELA (V. G. VILLARROEL),consulta externa,repetidas en personas de 5 a 14 anos,2005-07-01,1,0,1,0,1
CUEVO,consulta externa,repetidas en personas de 5 a 14 anos,2005-07-01,3,1,3,1,4
CULPINA,consulta externa,repetidas en personas de 5 a 14 anos,2005-07-01,1,1,1,1,2
CURAHUARA DE CARANGAS,consulta externa,repetidas en personas de 5 a 14 anos,2005-07-01,0,2,0,2,2
DESAGUADERO,consulta externa,repetidas en personas de 5 a 14 anos,2005-07-01,1,2,1,2,3
EL ALTO,consulta externa,repetidas en personas de 5 a 14 anos,2005-07-01,1938,2253,1938,2253,4191
EL CHORO,consulta externa,repetidas en personas de 5 a 14 anos,2005-07-01,1,0,1,0,1
EL PUENTE(STC),consulta externa,repetidas en personas de 5 a 14 anos,2005-07-01,5,11,5,11,16
EL PUENTE(TJA),consulta externa,repetidas en personas de 5 a 14 anos,2005-07-01,1,1,1,1,2
EL TORNO,consulta externa,repetidas en personas de 5 a 14 anos,2005-07-01,49,46,49,46,95
EL VILLAR,consulta externa,repetidas en personas de 5 a 14 anos,2005-07-01,0,2,0,2,2
ENTRE RIOS,consulta externa,repetidas en personas de 5 a 14 anos,2005-07-01,2,4,2,4,6
ENTRE RIOS,consulta externa,repetidas en personas de 5 a 14 anos,2005-07-01,3,2,3,2,5
EUCALIPTUS,consulta externa,repetidas en personas de 5 a 14 anos,2005-07-01,1,1,1,1,2
EXALTACION,consulta externa,repetidas en personas de 5 a 14 anos,2005-07-01,2,5,2,5,7
FERNANDEZ ALONSO,consulta externa,repetidas en personas de 5 a 14 anos,2005-07-01,4,4,4,4,8
GENERAL SAAVEDRA,consulta externa,repetidas en personas de 5 a 14 anos,2005-07-01,3,2,3,2,5
GRAL. J.J. PEREZ (CHARAZANI),consulta externa,repetidas en personas de 5 a 14 anos,2005-07-01,2,3,2,3,5
GUAQUI,consulta externa,repetidas en personas de 5 a 14 anos,2005-07-01,0,1,0,1,1
GUAYARAMERIN,consulta externa,repetidas en personas de 5 a 14 anos,2005-07-01,312,89,312,89,401
GUTIERREZ,consulta externa,repetidas en personas de 5 a 14 anos,2005-07-01,36,46,36,46,82
HUACARETA,consulta externa,repetidas en personas de 5 a 14 anos,2005-07-01,7,8,7,8,15
HUANUNI,consulta externa,repetidas en personas de 5 a 14 anos,2005-07-01,74,89,74,89,163
HUARACAJE,consulta externa,repetidas en personas de 5 a 14 anos,2005-07-01,2,0,2,0,2
HUAYLLAMARCA,consulta externa,repetidas en personas de 5 a 14 anos,2005-07-01,5,7,5,7,12
ICHOCA,consulta externa,repetidas en personas de 5 a 14 anos,2005-07-01,0,2,0,2,2
ICLA,consulta externa,repetidas en personas de 5 a 14 anos,2005-07-01,4,2,4,2,6
INCAHUASI,consulta externa,repetidas en personas de 5 a 14 anos,2005-07-01,1,2,1,2,3
INQUISIVI,consulta externa,repetidas en personas de 5 a 14 anos,2005-07-01,1,0,1,0,1
IRUPANA (VILLA DE LANZA),consulta externa,repetidas en personas de 5 a 14 anos,2005-07-01,6,3,6,3,9
IXIAMAS,consulta externa,repetidas en personas de 5 a 14 anos,2005-07-01,1,0,1,0,1
JESUS DE MACHACA,consulta externa,repetidas en personas de 5 a 14 anos,2005-07-01,0,3,0,3,3
LA ASUNTA,consulta externa,repetidas en personas de 5 a 14 anos,2005-07-01,1,1,1,1,2
LA GUARDIA,consulta externa,repetidas en personas de 5 a 14 anos,2005-07-01,10,13,10,13,23
LA PAZ,consulta externa,repetidas en personas de 5 a 14 anos,2005-07-01,2779,2380,2779,2380,5159
LAJA,consulta externa,repetidas en personas de 5 a 14 anos,2005-07-01,4,1,4,1,5
LAS CARRERAS,consulta externa,repetidas en personas de 5 a 14 anos,2005-07-01,2,4,2,4,6
LLALLAGUA,consulta externa,repetidas en personas de 5 a 14 anos,2005-07-01,9,9,9,9,18
LLICA,consulta externa,repetidas en personas de 5 a 14 anos,2005-07-01,2,0,2,0,2
LORETO,consulta externa,repetidas en personas de 5 a 14 anos,2005-07-01,7,7,7,7,14
MACHACAMARCA,consulta externa,repetidas en personas de 5 a 14 anos,2005-07-01,2,2,2,2,4
MACHARETI,consulta externa,repetidas en personas de 5 a 14 anos,2005-07-01,4,2,4,2,6
MAGDALENA,consulta externa,repetidas en personas de 5 a 14 anos,2005-07-01,11,16,11,16,27
MAIRANA,consulta externa,repetidas en personas de 5 a 14 anos,2005-07-01,0,1,0,1,1
MALLA,consulta externa,repetidas en personas de 5 a 14 anos,2005-07-01,2,0,2,0,2
MAPIRI,consulta externa,repetidas en personas de 5 a 14 anos,2005-07-01,0,1,0,1,1
MECAPACA,consulta externa,repetidas en personas de 5 a 14 anos,2005-07-01,8,10,8,10,18
MINEROS,consulta externa,repetidas en personas de 5 a 14 anos,2005-07-01,6,7,6,7,13
MIZQUE,consulta externa,repetidas en personas de 5 a 14 anos,2005-07-01,2,4,2,4,6
MOCOMOCO,consulta externa,repetidas en personas de 5 a 14 anos,2005-07-01,0,1,0,1,1
MOJINETE,consulta externa,repetidas en personas de 5 a 14 anos,2005-07-01,1,3,1,3,4
MOJOCOYA,consulta externa,repetidas en personas de 5 a 14 anos,2005-07-01,4,0,4,0,4
MONTEAGUDO,consulta externa,repetidas en personas de 5 a 14 anos,2005-07-01,21,38,21,38,59
MONTERO,consulta externa,repetidas en personas de 5 a 14 anos,2005-07-01,154,176,154,176,330
MOROCHATA,consulta externa,repetidas en personas de 5 a 14 anos,2005-07-01,2,4,2,4,6
OKINAWA,consulta externa,repetidas en personas de 5 a 14 anos,2005-07-01,4,8,4,8,12
OMEREQUE,consulta externa,repetidas en personas de 5 a 14 anos,2005-07-01,1,0,1,0,1
ORURO,consulta externa,repetidas en personas de 5 a 14 anos,2005-07-01,437,494,437,494,931
PADCAYA,consulta externa,repetidas en personas de 5 a 14 anos,2005-07-01,0,4,0,4,4
PADILLA,consulta externa,repetidas en personas de 5 a 14 anos,2005-07-01,5,4,5,4,9
PAILON,consulta externa,repetidas en personas de 5 a 14 anos,2005-07-01,1,0,1,0,1
PALCA,consulta externa,repetidas en personas de 5 a 14 anos,2005-07-01,0,1,0,1,1
PALOS BLANCOS,consulta externa,repetidas en personas de 5 a 14 anos,2005-07-01,2,2,2,2,4
PAMPA GRANDE,consulta externa,repetidas en personas de 5 a 14 anos,2005-07-01,0,2,0,2,2
PAPEL PAMPA,consulta externa,repetidas en personas de 5 a 14 anos,2005-07-01,2,0,2,0,2
PATACAMAYA,consulta externa,repetidas en personas de 5 a 14 anos,2005-07-01,1,1,1,1,2
PAZÑA,consulta externa,repetidas en personas de 5 a 14 anos,2005-07-01,1,4,1,4,5
POCOATA,consulta externa,repetidas en personas de 5 a 14 anos,2005-07-01,15,1,15,1,16
POCONA,consulta externa,repetidas en personas de 5 a 14 anos,2005-07-01,7,2,7,2,9
POJO (CBBA),consulta externa,repetidas en personas de 5 a 14 anos,2005-07-01,3,0,3,0,3
PORCO,consulta externa,repetidas en personas de 5 a 14 anos,2005-07-01,1,0,1,0,1
POROMA,consulta externa,repetidas en personas de 5 a 14 anos,2005-07-01,1,2,1,2,3
PORONGO,consulta externa,repetidas en personas de 5 a 14 anos,2005-07-01,3,7,3,7,10
PORTACHUELO,consulta externa,repetidas en personas de 5 a 14 anos,2005-07-01,11,15,11,15,26
PORVENIR,consulta externa,repetidas en personas de 5 a 14 anos,2005-07-01,2,2,2,2,4
POSTRER VALLE,consulta externa,repetidas en personas de 5 a 14 anos,2005-07-01,1,2,1,2,3
POTOSI,consulta externa,repetidas en personas de 5 a 14 anos,2005-07-01,333,343,333,343,676
PRESTO,consulta externa,repetidas en personas de 5 a 14 anos,2005-07-01,3,0,3,0,3
PUCARANI,consulta externa,repetidas en personas de 5 a 14 anos,2005-07-01,0,3,0,3,3
PUERTO ACOSTA,consulta externa,repetidas en personas de 5 a 14 anos,2005-07-01,5,3,5,3,8
PUERTO CARABUCO,consulta externa,repetidas en personas de 5 a 14 anos,2005-07-01,2,0,2,0,2
PUERTO GONZALO MORENO,consulta externa,repetidas en personas de 5 a 14 anos,2005-07-01,5,2,5,2,7
PUERTO PEREZ,consulta externa,repetidas en personas de 5 a 14 anos,2005-07-01,1,0,1,0,1
PUERTO QUIJARRO,consulta externa,repetidas en personas de 5 a 14 anos,2005-07-01,10,2,10,2,12
PUERTO SUAREZ,consulta externa,repetidas en personas de 5 a 14 anos,2005-07-01,7,6,7,6,13
PUERTO VILLARROEL,consulta externa,repetidas en personas de 5 a 14 anos,2005-07-01,10,1,10,1,11
PUNATA,consulta externa,repetidas en personas de 5 a 14 anos,2005-07-01,20,23,20,23,43
QUIABAYA,consulta externa,repetidas en personas de 5 a 14 anos,2005-07-01,1,0,1,0,1
QUILLACOLLO,consulta externa,repetidas en personas de 5 a 14 anos,2005-07-01,71,76,71,76,147
REYES,consulta externa,repetidas en personas de 5 a 14 anos,2005-07-01,2,4,2,4,6
RIBERALTA,consulta externa,repetidas en personas de 5 a 14 anos,2005-07-01,41,37,41,37,78
ROBORE,consulta externa,repetidas en personas de 5 a 14 anos,2005-07-01,12,20,12,20,32
RURRENABAQUE,consulta externa,repetidas en personas de 5 a 14 anos,2005-07-01,6,7,6,7,13
SABAYA,consulta externa,repetidas en personas de 5 a 14 anos,2005-07-01,2,0,2,0,2
SACABA,consulta externa,repetidas en personas de 5 a 14 anos,2005-07-01,58,61,58,61,119
SACABAMBA,consulta externa,repetidas en personas de 5 a 14 anos,2005-07-01,1,0,1,0,1
SACACA,consulta externa,repetidas en personas de 5 a 14 anos,2005-07-01,0,1,0,1,1
SAIPINA,consulta externa,repetidas en personas de 5 a 14 anos,2005-07-01,1,0,1,0,1
SALINAS DE GARCI MENDOZA,consulta externa,repetidas en personas de 5 a 14 anos,2005-07-01,1,0,1,0,1
SAMAIPATA,consulta externa,repetidas en personas de 5 a 14 anos,2005-07-01,2,1,2,1,3
SAN AGUSTIN,consulta externa,repetidas en personas de 5 a 14 anos,2005-07-01,1,1,1,1,2
SAN ANDRES,consulta externa,repetidas en personas de 5 a 14 anos,2005-07-01,9,10,9,10,19
SAN ANDRES DE MACHACA,consulta externa,repetidas en personas de 5 a 14 anos,2005-07-01,1,1,1,1,2
SAN ANTONIO DE ESMORUCO,consulta externa,repetidas en personas de 5 a 14 anos,2005-07-01,1,1,1,1,2
SAN ANTONIO DE LOMERIO,consulta externa,repetidas en personas de 5 a 14 anos,2005-07-01,1,0,1,0,1
SAN BENITO,consulta externa,repetidas en personas de 5 a 14 anos,2005-07-01,8,4,8,4,12
SAN BORJA,consulta externa,repetidas en personas de 5 a 14 anos,2005-07-01,6,15,6,15,21
SAN BUENA VENTURA,consulta externa,repetidas en personas de 5 a 14 anos,2005-07-01,10,4,10,4,14
SAN CARLOS,consulta externa,repetidas en personas de 5 a 14 anos,2005-07-01,4,8,4,8,12
SAN IGNACIO,consulta externa,repetidas en personas de 5 a 14 anos,2005-07-01,23,25,23,25,48
SAN IGNACIO DE VELASCO,consulta externa,repetidas en personas de 5 a 14 anos,2005-07-01,10,15,10,15,25
SAN JAVIER(STC),consulta externa,repetidas en personas de 5 a 14 anos,2005-07-01,15,6,15,6,21
SAN JOAQUIN,consulta externa,repetidas en personas de 5 a 14 anos,2005-07-01,3,2,3,2,5
SAN JOSE DE CHIQUITOS,consulta externa,repetidas en personas de 5 a 14 anos,2005-07-01,0,3,0,3,3
SAN JUAN DE YAPACANI,consulta externa,repetidas en personas de 5 a 14 anos,2005-07-01,4,6,4,6,10
SAN JULIAN,consulta externa,repetidas en personas de 5 a 14 anos,2005-07-01,10,8,10,8,18
SAN LORENZO(PND),consulta externa,repetidas en personas de 5 a 14 anos,2005-07-01,1,0,1,0,1
SAN LORENZO(TJA),consulta externa,repetidas en personas de 5 a 14 anos,2005-07-01,18,30,18,30,48
SAN LUCAS,consulta externa,repetidas en personas de 5 a 14 anos,2005-07-01,10,1,10,1,11
SAN MATIAS,consulta externa,repetidas en personas de 5 a 14 anos,2005-07-01,2,1,2,1,3
SAN MIGUEL DE VELASCO,consulta externa,repetidas en personas de 5 a 14 anos,2005-07-01,11,18,11,18,29
SAN PABLO DE LIPEZ,consulta externa,repetidas en personas de 5 a 14 anos,2005-07-01,1,0,1,0,1
SAN PEDRO,consulta externa,repetidas en personas de 5 a 14 anos,2005-07-01,7,10,7,10,17
SAN PEDRO DE CURAHUARA,consulta externa,repetidas en personas de 5 a 14 anos,2005-07-01,0,1,0,1,1
SAN PEDRO DE QUEMES,consulta externa,repetidas en personas de 5 a 14 anos,2005-07-01,0,1,0,1,1
SAN PEDRO DE TIQUINA,consulta externa,repetidas en personas de 5 a 14 anos,2005-07-01,2,0,2,0,2
SAN RAFAEL,consulta externa,repetidas en personas de 5 a 14 anos,2005-07-01,1,2,1,2,3
SAN RAMON,consulta externa,repetidas en personas de 5 a 14 anos,2005-07-01,2,8,2,8,10
SAN RAMON,consulta externa,repetidas en personas de 5 a 14 anos,2005-07-01,1,0,1,0,1
SANTA ANA,consulta externa,repetidas en personas de 5 a 14 anos,2005-07-01,20,17,20,17,37
SANTA CRUZ DE LA SIERRA,consulta externa,repetidas en personas de 5 a 14 anos,2005-07-01,2455,3799,2455,3799,6254
SANTA ROSA,consulta externa,repetidas en personas de 5 a 14 anos,2005-07-01,6,7,6,7,13
SANTA ROSA DEL SARA,consulta externa,repetidas en personas de 5 a 14 anos,2005-07-01,3,4,3,4,7
SANTIAGO DE HUARI,consulta externa,repetidas en personas de 5 a 14 anos,2005-07-01,2,1,2,1,3
SANTIAGO DE MACHACA,consulta externa,repetidas en personas de 5 a 14 anos,2005-07-01,2,0,2,0,2
SANTIVAÑES,consulta externa,repetidas en personas de 5 a 14 anos,2005-07-01,1,0,1,0,1
SAPAHAQUI,consulta externa,repetidas en personas de 5 a 14 anos,2005-07-01,0,1,0,1,1
SICA SICA (VILLA AROMA),consulta externa,repetidas en personas de 5 a 14 anos,2005-07-01,0,1,0,1,1
SIPE SIPE,consulta externa,repetidas en personas de 5 a 14 anos,2005-07-01,9,17,9,17,26
SORACACHI,consulta externa,repetidas en personas de 5 a 14 anos,2005-07-01,2,1,2,1,3
SORATA,consulta externa,repetidas en personas de 5 a 14 anos,2005-07-01,1,3,1,3,4
SUCRE,consulta externa,repetidas en personas de 5 a 14 anos,2005-07-01,686,753,686,753,1439
TACACHI,consulta externa,repetidas en personas de 5 a 14 anos,2005-07-01,1,3,1,3,4
TACOBAMBA,consulta externa,repetidas en personas de 5 a 14 anos,2005-07-01,0,1,0,1,1
TAHUA,consulta externa,repetidas en personas de 5 a 14 anos,2005-07-01,0,1,0,1,1
TAPACARI,consulta externa,repetidas en personas de 5 a 14 anos,2005-07-01,2,2,2,2,4
TARABUCO,consulta externa,repetidas en personas de 5 a 14 anos,2005-07-01,4,6,4,6,10
TARATA,consulta externa,repetidas en personas de 5 a 14 anos,2005-07-01,1,2,1,2,3
TARIJA,consulta externa,repetidas en personas de 5 a 14 anos,2005-07-01,601,548,601,548,1149
TARVITA,consulta externa,repetidas en personas de 5 a 14 anos,2005-07-01,0,2,0,2,2
TIAWANACU,consulta externa,repetidas en personas de 5 a 14 anos,2005-07-01,0,1,0,1,1
TINGUIPAYA,consulta externa,repetidas en personas de 5 a 14 anos,2005-07-01,1,0,1,0,1
TIPUANI,consulta externa,repetidas en personas de 5 a 14 anos,2005-07-01,0,2,0,2,2
TIQUIPAYA,consulta externa,repetidas en personas de 5 a 14 anos,2005-07-01,10,12,10,12,22
TIRAQUE (CBBA),consulta externa,repetidas en personas de 5 a 14 anos,2005-07-01,29,12,29,12,41
TITO YUPANQUI (PARQUIPUJIO),consulta externa,repetidas en personas de 5 a 14 anos,2005-07-01,0,2,0,2,2
TOLATA,consulta externa,repetidas en personas de 5 a 14 anos,2005-07-01,2,2,2,2,4
TOMAVE,consulta externa,repetidas en personas de 5 a 14 anos,2005-07-01,0,1,0,1,1
TOMINA,consulta externa,repetidas en personas de 5 a 14 anos,2005-07-01,1,2,1,2,3
TORO TORO,consulta externa,repetidas en personas de 5 a 14 anos,2005-07-01,1,0,1,0,1
TOTORA(CBBA),consulta externa,repetidas en personas de 5 a 14 anos,2005-07-01,1,4,1,4,5
TRIGAL,consulta externa,repetidas en personas de 5 a 14 anos,2005-07-01,1,0,1,0,1
TRINIDAD,consulta externa,repetidas en personas de 5 a 14 anos,2005-07-01,93,112,93,112,205
TUPIZA,consulta externa,repetidas en personas de 5 a 14 anos,2005-07-01,75,85,75,85,160
UMALA,consulta externa,repetidas en personas de 5 a 14 anos,2005-07-01,5,3,5,3,8
UNCIA,consulta externa,repetidas en personas de 5 a 14 anos,2005-07-01,33,16,33,16,49
URIONDO (A. CONCEPCION),consulta externa,repetidas en personas de 5 a 14 anos,2005-07-01,13,11,13,11,24
URUBICHA,consulta externa,repetidas en personas de 5 a 14 anos,2005-07-01,1,4,1,4,5
UYUNI,consulta externa,repetidas en personas de 5 a 14 anos,2005-07-01,10,13,10,13,23
VACAS,consulta externa,repetidas en personas de 5 a 14 anos,2005-07-01,6,4,6,4,10
VALLEGRANDE,consulta externa,repetidas en personas de 5 a 14 anos,2005-07-01,20,20,20,20,40
VIACHA,consulta externa,repetidas en personas de 5 a 14 anos,2005-07-01,27,52,27,52,79
VILA VILA,consulta externa,repetidas en personas de 5 a 14 anos,2005-07-01,1,0,1,0,1
VILLA MONTES,consulta externa,repetidas en personas de 5 a 14 anos,2005-07-01,25,43,25,43,68
VILLA NUEVA (LOMA ALTA),consulta externa,repetidas en personas de 5 a 14 anos,2005-07-01,1,0,1,0,1
VILLA RIVERO,consulta externa,repetidas en personas de 5 a 14 anos,2005-07-01,1,1,1,1,2
VILLA SERRANO,consulta externa,repetidas en personas de 5 a 14 anos,2005-07-01,2,3,2,3,5
VILLA TUNARI,consulta externa,repetidas en personas de 5 a 14 anos,2005-07-01,6,17,6,17,23
VILLA VACA GUZMAN (MUYUPAMPA),consulta externa,repetidas en personas de 5 a 14 anos,2005-07-01,4,2,4,2,6
VILLAZON,consulta externa,repetidas en personas de 5 a 14 anos,2005-07-01,14,17,14,17,31
VINTO,consulta externa,repetidas en personas de 5 a 14 anos,2005-07-01,2,3,2,3,5
VITICHI,consulta externa,repetidas en personas de 5 a 14 anos,2005-07-01,3,0,3,0,3
WARNES,consulta externa,repetidas en personas de 5 a 14 anos,2005-07-01,17,12,17,12,29
YACUIBA,consulta externa,repetidas en personas de 5 a 14 anos,2005-07-01,139,158,139,158,297
YAMPARAEZ,consulta externa,repetidas en personas de 5 a 14 anos,2005-07-01,2,3,2,3,5
YANACACHI,consulta externa,repetidas en personas de 5 a 14 anos,2005-07-01,0,1,0,1,1
YAPACANI,consulta externa,repetidas en personas de 5 a 14 anos,2005-07-01,17,7,17,7,24
YOCALLA,consulta externa,repetidas en personas de 5 a 14 anos,2005-07-01,2,0,2,0,2
YOTALA,consulta externa,repetidas en personas de 5 a 14 anos,2005-07-01,17,13,17,13,30
YUNCHARA,consulta externa,repetidas en personas de 5 a 14 anos,2005-07-01,3,15,3,15,18
ZUDAÑEZ,consulta externa,repetidas en personas de 5 a 14 anos,2005-07-01,0,1,0,1,1
ACHACACHI,consulta externa,repetidas en personas de 5 a 14 anos,2005-08-01,7,7,7,7,14
ACHOCALLA,consulta externa,repetidas en personas de 5 a 14 anos,2005-08-01,3,4,3,4,7
AIQUILE,consulta externa,repetidas en personas de 5 a 14 anos,2005-08-01,9,10,9,10,19
ANCORAIMES,consulta externa,repetidas en personas de 5 a 14 anos,2005-08-01,4,2,4,2,6
ANDAMARCA,consulta externa,repetidas en personas de 5 a 14 anos,2005-08-01,1,2,1,2,3
ANTEQUERA,consulta externa,repetidas en personas de 5 a 14 anos,2005-08-01,1,0,1,0,1
ANZALDO,consulta externa,repetidas en personas de 5 a 14 anos,2005-08-01,1,2,1,2,3
APOLO,consulta externa,repetidas en personas de 5 a 14 anos,2005-08-01,2,4,2,4,6
ARANI,consulta externa,repetidas en personas de 5 a 14 anos,2005-08-01,3,3,3,3,6
ARBIETO,consulta externa,repetidas en personas de 5 a 14 anos,2005-08-01,3,6,3,6,9
ASCENCION DE GUARAYOS,consulta externa,repetidas en personas de 5 a 14 anos,2005-08-01,9,16,9,16,25
ATOCHA,consulta externa,repetidas en personas de 5 a 14 anos,2005-08-01,62,71,62,71,133
AUCAPATA,consulta externa,repetidas en personas de 5 a 14 anos,2005-08-01,1,0,1,0,1
AYATA,consulta externa,repetidas en personas de 5 a 14 anos,2005-08-01,4,7,4,7,11
AYOPAYA (V. DE INDEPENDENCIA),consulta externa,repetidas en personas de 5 a 14 anos,2005-08-01,3,1,3,1,4
AZURDUY,consulta externa,repetidas en personas de 5 a 14 anos,2005-08-01,0,1,0,1,1
BATALLAS,consulta externa,repetidas en personas de 5 a 14 anos,2005-08-01,1,1,1,1,2
BAURES,consulta externa,repetidas en personas de 5 a 14 anos,2005-08-01,0,5,0,5,5
BELEN DE ANDAMARCA,consulta externa,repetidas en personas de 5 a 14 anos,2005-08-01,1,0,1,0,1
BERMEJO,consulta externa,repetidas en personas de 5 a 14 anos,2005-08-01,56,29,56,29,85
BETANZOS,consulta externa,repetidas en personas de 5 a 14 anos,2005-08-01,5,1,5,1,6
BOLPEBRA,consulta externa,repetidas en personas de 5 a 14 anos,2005-08-01,5,2,5,2,7
BOYUIBE,consulta externa,repetidas en personas de 5 a 14 anos,2005-08-01,1,4,1,4,5
BUENA VISTA,consulta externa,repetidas en personas de 5 a 14 anos,2005-08-01,10,17,10,17,27
CABEZAS,consulta externa,repetidas en personas de 5 a 14 anos,2005-08-01,2,1,2,1,3
CAIROMA,consulta externa,repetidas en personas de 5 a 14 anos,2005-08-01,0,1,0,1,1
CALAMARCA,consulta externa,repetidas en personas de 5 a 14 anos,2005-08-01,1,6,1,6,7
CAMARGO,consulta externa,repetidas en personas de 5 a 14 anos,2005-08-01,5,2,5,2,7
CAMATAQUI (C. VILLA ABECIA),consulta externa,repetidas en personas de 5 a 14 anos,2005-08-01,4,2,4,2,6
CAMIRI,consulta externa,repetidas en personas de 5 a 14 anos,2005-08-01,21,67,21,67,88
CAPINOTA,consulta externa,repetidas en personas de 5 a 14 anos,2005-08-01,4,8,4,8,12
CAQUIAVIRI,consulta externa,repetidas en personas de 5 a 14 anos,2005-08-01,1,1,1,1,2
CARACOLLO,consulta externa,repetidas en personas de 5 a 14 anos,2005-08-01,2,3,2,3,5
CARANAVI,consulta externa,repetidas en personas de 5 a 14 anos,2005-08-01,3,8,3,8,11
CARAPARI,consulta externa,repetidas en personas de 5 a 14 anos,2005-08-01,2,0,2,0,2
CARIPUYO,consulta externa,repetidas en personas de 5 a 14 anos,2005-08-01,2,1,2,1,3
CATACORA,consulta externa,repetidas en personas de 5 a 14 anos,2005-08-01,0,2,0,2,2
CHALLAPATA,consulta externa,repetidas en personas de 5 a 14 anos,2005-08-01,12,15,12,15,27
CHAQUI,consulta externa,repetidas en personas de 5 a 14 anos,2005-08-01,0,1,0,1,1
CHARAGUA,consulta externa,repetidas en personas de 5 a 14 anos,2005-08-01,11,9,11,9,20
CHARAÑA,consulta externa,repetidas en personas de 5 a 14 anos,2005-08-01,1,1,1,1,2
CHAYANTA,consulta externa,repetidas en personas de 5 a 14 anos,2005-08-01,1,3,1,3,4
CHIMORE,consulta externa,repetidas en personas de 5 a 14 anos,2005-08-01,3,7,3,7,10
CHOQUE COTA,consulta externa,repetidas en personas de 5 a 14 anos,2005-08-01,0,1,0,1,1
CHULUMANI (V. DE LA LIBERTAD),consulta externa,repetidas en personas de 5 a 14 anos,2005-08-01,9,10,9,10,19
CHUMA,consulta externa,repetidas en personas de 5 a 14 anos,2005-08-01,3,0,3,0,3
CLIZA,consulta externa,repetidas en personas de 5 a 14 anos,2005-08-01,1,1,1,1,2
COBIJA,consulta externa,repetidas en personas de 5 a 14 anos,2005-08-01,46,52,46,52,98
COCHABAMBA,consulta externa,repetidas en personas de 5 a 14 anos,2005-08-01,1647,1456,1647,1456,3103
COLCAPIRHUA,consulta externa,repetidas en personas de 5 a 14 anos,2005-08-01,42,56,42,56,98
"COLCHA ""K""",consulta externa,repetidas en personas de 5 a 14 anos,2005-08-01,0,2,0,2,2
COLOMI,consulta externa,repetidas en personas de 5 a 14 anos,2005-08-01,1,2,1,2,3
COLPA BELGICA,consulta externa,repetidas en personas de 5 a 14 anos,2005-08-01,3,5,3,5,8
COLQUECHACA,consulta externa,repetidas en personas de 5 a 14 anos,2005-08-01,1,1,1,1,2
COLQUIRI,consulta externa,repetidas en personas de 5 a 14 anos,2005-08-01,1,4,1,4,5
COMANCHE,consulta externa,repetidas en personas de 5 a 14 anos,2005-08-01,2,0,2,0,2
COMARAPA,consulta externa,repetidas en personas de 5 a 14 anos,2005-08-01,16,7,16,7,23
COMBAYA,consulta externa,repetidas en personas de 5 a 14 anos,2005-08-01,0,1,0,1,1
COPACABANA,consulta externa,repetidas en personas de 5 a 14 anos,2005-08-01,0,1,0,1,1
CORIPATA,consulta externa,repetidas en personas de 5 a 14 anos,2005-08-01,3,1,3,1,4
CORO CORO,consulta externa,repetidas en personas de 5 a 14 anos,2005-08-01,3,2,3,2,5
COROICO,consulta externa,repetidas en personas de 5 a 14 anos,2005-08-01,13,8,13,8,21
CORQUE,consulta externa,repetidas en personas de 5 a 14 anos,2005-08-01,5,1,5,1,6
COTAGAITA,consulta externa,repetidas en personas de 5 a 14 anos,2005-08-01,10,8,10,8,18
COTOCA,consulta externa,repetidas en personas de 5 a 14 anos,2005-08-01,1,1,1,1,2
CUATRO CAÑADAS,consulta externa,repetidas en personas de 5 a 14 anos,2005-08-01,4,7,4,7,11
CUEVO,consulta externa,repetidas en personas de 5 a 14 anos,2005-08-01,1,1,1,1,2
CULPINA,consulta externa,repetidas en personas de 5 a 14 anos,2005-08-01,11,4,11,4,15
CURAHUARA DE CARANGAS,consulta externa,repetidas en personas de 5 a 14 anos,2005-08-01,1,1,1,1,2
DESAGUADERO,consulta externa,repetidas en personas de 5 a 14 anos,2005-08-01,1,1,1,1,2
EL ALTO,consulta externa,repetidas en personas de 5 a 14 anos,2005-08-01,2385,2315,2385,2315,4700
EL CHORO,consulta externa,repetidas en personas de 5 a 14 anos,2005-08-01,1,1,1,1,2
EL PUENTE(STC),consulta externa,repetidas en personas de 5 a 14 anos,2005-08-01,1,0,1,0,1
EL PUENTE(TJA),consulta externa,repetidas en personas de 5 a 14 anos,2005-08-01,1,1,1,1,2
EL TORNO,consulta externa,repetidas en personas de 5 a 14 anos,2005-08-01,39,56,39,56,95
EL VILLAR,consulta externa,repetidas en personas de 5 a 14 anos,2005-08-01,1,1,1,1,2
ENTRE RIOS,consulta externa,repetidas en personas de 5 a 14 anos,2005-08-01,6,3,6,3,9
ENTRE RIOS,consulta externa,repetidas en personas de 5 a 14 anos,2005-08-01,1,7,1,7,8
FERNANDEZ ALONSO,consulta externa,repetidas en personas de 5 a 14 anos,2005-08-01,0,1,0,1,1
FILADELFIA,consulta externa,repetidas en personas de 5 a 14 anos,2005-08-01,1,0,1,0,1
GENERAL SAAVEDRA,consulta externa,repetidas en personas de 5 a 14 anos,2005-08-01,3,2,3,2,5
GRAL. J.J. PEREZ (CHARAZANI),consulta externa,repetidas en personas de 5 a 14 anos,2005-08-01,2,0,2,0,2
GUANAY,consulta externa,repetidas en personas de 5 a 14 anos,2005-08-01,1,0,1,0,1
GUAYARAMERIN,consulta externa,repetidas en personas de 5 a 14 anos,2005-08-01,81,49,81,49,130
GUTIERREZ,consulta externa,repetidas en personas de 5 a 14 anos,2005-08-01,29,19,29,19,48
HUACARETA,consulta externa,repetidas en personas de 5 a 14 anos,2005-08-01,10,8,10,8,18
HUANUNI,consulta externa,repetidas en personas de 5 a 14 anos,2005-08-01,73,88,73,88,161
HUARACAJE,consulta externa,repetidas en personas de 5 a 14 anos,2005-08-01,5,2,5,2,7
ICHOCA,consulta externa,repetidas en personas de 5 a 14 anos,2005-08-01,1,0,1,0,1
ICLA,consulta externa,repetidas en personas de 5 a 14 anos,2005-08-01,0,1,0,1,1
INCAHUASI,consulta externa,repetidas en personas de 5 a 14 anos,2005-08-01,1,2,1,2,3
INQUISIVI,consulta externa,repetidas en personas de 5 a 14 anos,2005-08-01,1,1,1,1,2
IRUPANA (VILLA DE LANZA),consulta externa,repetidas en personas de 5 a 14 anos,2005-08-01,0,5,0,5,5
IXIAMAS,consulta externa,repetidas en personas de 5 a 14 anos,2005-08-01,3,2,3,2,5
JESUS DE MACHACA,consulta externa,repetidas en personas de 5 a 14 anos,2005-08-01,3,4,3,4,7
LA ASUNTA,consulta externa,repetidas en personas de 5 a 14 anos,2005-08-01,6,2,6,2,8
LA GUARDIA,consulta externa,repetidas en personas de 5 a 14 anos,2005-08-01,8,8,8,8,16
LA PAZ,consulta externa,repetidas en personas de 5 a 14 anos,2005-08-01,3128,2656,3128,2656,5784
LAGUNILLAS,consulta externa,repetidas en personas de 5 a 14 anos,2005-08-01,5,3,5,3,8
LAJA,consulta externa,repetidas en personas de 5 a 14 anos,2005-08-01,1,0,1,0,1
LAS CARRERAS,consulta externa,repetidas en personas de 5 a 14 anos,2005-08-01,2,9,2,9,11
LLALLAGUA,consulta externa,repetidas en personas de 5 a 14 anos,2005-08-01,1,6,1,6,7
MACHACAMARCA,consulta externa,repetidas en personas de 5 a 14 anos,2005-08-01,3,2,3,2,5
MACHARETI,consulta externa,repetidas en personas de 5 a 14 anos,2005-08-01,3,2,3,2,5
MAGDALENA,consulta externa,repetidas en personas de 5 a 14 anos,2005-08-01,5,8,5,8,13
MAIRANA,consulta externa,repetidas en personas de 5 a 14 anos,2005-08-01,1,1,1,1,2
MALLA,consulta externa,repetidas en personas de 5 a 14 anos,2005-08-01,4,1,4,1,5
MAPIRI,consulta externa,repetidas en personas de 5 a 14 anos,2005-08-01,0,1,0,1,1
MECAPACA,consulta externa,repetidas en personas de 5 a 14 anos,2005-08-01,8,7,8,7,15
MINEROS,consulta externa,repetidas en personas de 5 a 14 anos,2005-08-01,1,11,1,11,12
MIZQUE,consulta externa,repetidas en personas de 5 a 14 anos,2005-08-01,3,3,3,3,6
MOCOMOCO,consulta externa,repetidas en personas de 5 a 14 anos,2005-08-01,2,0,2,0,2
MOJINETE,consulta externa,repetidas en personas de 5 a 14 anos,2005-08-01,5,8,5,8,13
MOJOCOYA,consulta externa,repetidas en personas de 5 a 14 anos,2005-08-01,1,0,1,0,1
MONTEAGUDO,consulta externa,repetidas en personas de 5 a 14 anos,2005-08-01,49,49,49,49,98
MONTERO,consulta externa,repetidas en personas de 5 a 14 anos,2005-08-01,131,182,131,182,313
MORO MORO,consulta externa,repetidas en personas de 5 a 14 anos,2005-08-01,0,1,0,1,1
MOROCHATA,consulta externa,repetidas en personas de 5 a 14 anos,2005-08-01,9,3,9,3,12
NACEBE (SANTA ROSA DEL ABUNA),consulta externa,repetidas en personas de 5 a 14 anos,2005-08-01,0,1,0,1,1
NUEVO MANOA (NUEVA ESPERANZA),consulta externa,repetidas en personas de 5 a 14 anos,2005-08-01,1,1,1,1,2
OKINAWA,consulta externa,repetidas en personas de 5 a 14 anos,2005-08-01,14,10,14,10,24
OMEREQUE,consulta externa,repetidas en personas de 5 a 14 anos,2005-08-01,2,2,2,2,4
ORURO,consulta externa,repetidas en personas de 5 a 14 anos,2005-08-01,396,503,396,503,899
PADCAYA,consulta externa,repetidas en personas de 5 a 14 anos,2005-08-01,3,4,3,4,7
PADILLA,consulta externa,repetidas en personas de 5 a 14 anos,2005-08-01,2,2,2,2,4
PAILON,consulta externa,repetidas en personas de 5 a 14 anos,2005-08-01,0,2,0,2,2
PALCA,consulta externa,repetidas en personas de 5 a 14 anos,2005-08-01,2,1,2,1,3
PALOS BLANCOS,consulta externa,repetidas en personas de 5 a 14 anos,2005-08-01,7,8,7,8,15
PAMPA GRANDE,consulta externa,repetidas en personas de 5 a 14 anos,2005-08-01,1,1,1,1,2
PAZÑA,consulta externa,repetidas en personas de 5 a 14 anos,2005-08-01,0,1,0,1,1
PELECHUCO,consulta externa,repetidas en personas de 5 a 14 anos,2005-08-01,0,2,0,2,2
POCOATA,consulta externa,repetidas en personas de 5 a 14 anos,2005-08-01,3,2,3,2,5
POCONA,consulta externa,repetidas en personas de 5 a 14 anos,2005-08-01,3,0,3,0,3
POJO (CBBA),consulta externa,repetidas en personas de 5 a 14 anos,2005-08-01,2,3,2,3,5
POOPO,consulta externa,repetidas en personas de 5 a 14 anos,2005-08-01,3,0,3,0,3
PORCO,consulta externa,repetidas en personas de 5 a 14 anos,2005-08-01,0,2,0,2,2
POROMA,consulta externa,repetidas en personas de 5 a 14 anos,2005-08-01,2,5,2,5,7
PORONGO,consulta externa,repetidas en personas de 5 a 14 anos,2005-08-01,3,1,3,1,4
PORTACHUELO,consulta externa,repetidas en personas de 5 a 14 anos,2005-08-01,7,3,7,3,10
POTOSI,consulta externa,repetidas en personas de 5 a 14 anos,2005-08-01,304,304,304,304,608
PRESTO,consulta externa,repetidas en personas de 5 a 14 anos,2005-08-01,1,1,1,1,2
PUCARANI,consulta externa,repetidas en personas de 5 a 14 anos,2005-08-01,1,2,1,2,3
PUERTO ACOSTA,consulta externa,repetidas en personas de 5 a 14 anos,2005-08-01,2,7,2,7,9
PUERTO CARABUCO,consulta externa,repetidas en personas de 5 a 14 anos,2005-08-01,1,0,1,0,1
PUERTO GONZALO MORENO,consulta externa,repetidas en personas de 5 a 14 anos,2005-08-01,3,5,3,5,8
PUERTO QUIJARRO,consulta externa,repetidas en personas de 5 a 14 anos,2005-08-01,7,13,7,13,20
PUERTO RICO,consulta externa,repetidas en personas de 5 a 14 anos,2005-08-01,5,3,5,3,8
PUERTO SUAREZ,consulta externa,repetidas en personas de 5 a 14 anos,2005-08-01,8,5,8,5,13
PUERTO VILLARROEL,consulta externa,repetidas en personas de 5 a 14 anos,2005-08-01,9,7,9,7,16
PUNA,consulta externa,repetidas en personas de 5 a 14 anos,2005-08-01,7,0,7,0,7
PUNATA,consulta externa,repetidas en personas de 5 a 14 anos,2005-08-01,9,11,9,11,20
QUILLACOLLO,consulta externa,repetidas en personas de 5 a 14 anos,2005-08-01,55,50,55,50,105
QUIME,consulta externa,repetidas en personas de 5 a 14 anos,2005-08-01,2,2,2,2,4
RAVELO,consulta externa,repetidas en personas de 5 a 14 anos,2005-08-01,0,1,0,1,1
REYES,consulta externa,repetidas en personas de 5 a 14 anos,2005-08-01,3,4,3,4,7
RIBERALTA,consulta externa,repetidas en personas de 5 a 14 anos,2005-08-01,17,25,17,25,42
ROBORE,consulta externa,repetidas en personas de 5 a 14 anos,2005-08-01,9,18,9,18,27
RURRENABAQUE,consulta externa,repetidas en personas de 5 a 14 anos,2005-08-01,10,6,10,6,16
SABAYA,consulta externa,repetidas en personas de 5 a 14 anos,2005-08-01,0,2,0,2,2
SACABA,consulta externa,repetidas en personas de 5 a 14 anos,2005-08-01,44,30,44,30,74
SACABAMBA,consulta externa,repetidas en personas de 5 a 14 anos,2005-08-01,2,6,2,6,8
SACACA,consulta externa,repetidas en personas de 5 a 14 anos,2005-08-01,2,0,2,0,2
SAIPINA,consulta externa,repetidas en personas de 5 a 14 anos,2005-08-01,5,8,5,8,13
SALINAS DE GARCI MENDOZA,consulta externa,repetidas en personas de 5 a 14 anos,2005-08-01,1,0,1,0,1
SAN ANDRES,consulta externa,repetidas en personas de 5 a 14 anos,2005-08-01,6,3,6,3,9
SAN ANTONIO DE ESMORUCO,consulta externa,repetidas en personas de 5 a 14 anos,2005-08-01,0,2,0,2,2
SAN BENITO,consulta externa,repetidas en personas de 5 a 14 anos,2005-08-01,4,7,4,7,11
SAN BORJA,consulta externa,repetidas en personas de 5 a 14 anos,2005-08-01,19,12,19,12,31
SAN BUENA VENTURA,consulta externa,repetidas en personas de 5 a 14 anos,2005-08-01,5,5,5,5,10
SAN CARLOS,consulta externa,repetidas en personas de 5 a 14 anos,2005-08-01,3,8,3,8,11
SAN IGNACIO,consulta externa,repetidas en personas de 5 a 14 anos,2005-08-01,6,14,6,14,20
SAN IGNACIO DE VELASCO,consulta externa,repetidas en personas de 5 a 14 anos,2005-08-01,18,25,18,25,43
SAN JAVIER(BNI),consulta externa,repetidas en personas de 5 a 14 anos,2005-08-01,0,6,0,6,6
SAN JAVIER(STC),consulta externa,repetidas en personas de 5 a 14 anos,2005-08-01,4,2,4,2,6
SAN JOAQUIN,consulta externa,repetidas en personas de 5 a 14 anos,2005-08-01,2,2,2,2,4
SAN JOSE DE CHIQUITOS,consulta externa,repetidas en personas de 5 a 14 anos,2005-08-01,5,8,5,8,13
SAN JUAN DE YAPACANI,consulta externa,repetidas en personas de 5 a 14 anos,2005-08-01,6,8,6,8,14
SAN JULIAN,consulta externa,repetidas en personas de 5 a 14 anos,2005-08-01,13,8,13,8,21
SAN LORENZO(PND),consulta externa,repetidas en personas de 5 a 14 anos,2005-08-01,0,1,0,1,1
SAN LORENZO(TJA),consulta externa,repetidas en personas de 5 a 14 anos,2005-08-01,7,4,7,4,11
SAN LUCAS,consulta externa,repetidas en personas de 5 a 14 anos,2005-08-01,17,8,17,8,25
SAN MATIAS,consulta externa,repetidas en personas de 5 a 14 anos,2005-08-01,1,3,1,3,4
SAN MIGUEL DE VELASCO,consulta externa,repetidas en personas de 5 a 14 anos,2005-08-01,5,21,5,21,26
SAN PABLO DE LIPEZ,consulta externa,repetidas en personas de 5 a 14 anos,2005-08-01,2,1,2,1,3
SAN PEDRO,consulta externa,repetidas en personas de 5 a 14 anos,2005-08-01,11,18,11,18,29
SAN PEDRO DE BUENA VISTA,consulta externa,repetidas en personas de 5 a 14 anos,2005-08-01,1,0,1,0,1
SAN PEDRO DE TIQUINA,consulta externa,repetidas en personas de 5 a 14 anos,2005-08-01,0,2,0,2,2
SAN PEDRO(PND),consulta externa,repetidas en personas de 5 a 14 anos,2005-08-01,1,17,1,17,18
SAN RAFAEL,consulta externa,repetidas en personas de 5 a 14 anos,2005-08-01,0,3,0,3,3
SAN RAMON,consulta externa,repetidas en personas de 5 a 14 anos,2005-08-01,7,5,7,5,12
SAN RAMON,consulta externa,repetidas en personas de 5 a 14 anos,2005-08-01,1,11,1,11,12
SANTA ANA,consulta externa,repetidas en personas de 5 a 14 anos,2005-08-01,30,37,30,37,67
SANTA CRUZ DE LA SIERRA,consulta externa,repetidas en personas de 5 a 14 anos,2005-08-01,3531,3820,3531,3820,7351
SANTA ROSA,consulta externa,repetidas en personas de 5 a 14 anos,2005-08-01,2,0,2,0,2
SANTA ROSA DEL SARA,consulta externa,repetidas en personas de 5 a 14 anos,2005-08-01,5,16,5,16,21
SANTIAGO DE HUARI,consulta externa,repetidas en personas de 5 a 14 anos,2005-08-01,1,2,1,2,3
SANTIVAÑES,consulta externa,repetidas en personas de 5 a 14 anos,2005-08-01,1,2,1,2,3
SAPAHAQUI,consulta externa,repetidas en personas de 5 a 14 anos,2005-08-01,2,1,2,1,3
SENA,consulta externa,repetidas en personas de 5 a 14 anos,2005-08-01,1,2,1,2,3
SICA SICA (VILLA AROMA),consulta externa,repetidas en personas de 5 a 14 anos,2005-08-01,1,0,1,0,1
SIPE SIPE,consulta externa,repetidas en personas de 5 a 14 anos,2005-08-01,4,2,4,2,6
SORACACHI,consulta externa,repetidas en personas de 5 a 14 anos,2005-08-01,1,2,1,2,3
SORATA,consulta externa,repetidas en personas de 5 a 14 anos,2005-08-01,2,3,2,3,5
SUCRE,consulta externa,repetidas en personas de 5 a 14 anos,2005-08-01,895,845,895,845,1740
TACACHI,consulta externa,repetidas en personas de 5 a 14 anos,2005-08-01,3,3,3,3,6
TACOPAYA,consulta externa,repetidas en personas de 5 a 14 anos,2005-08-01,0,1,0,1,1
TAPACARI,consulta externa,repetidas en personas de 5 a 14 anos,2005-08-01,4,2,4,2,6
TARABUCO,consulta externa,repetidas en personas de 5 a 14 anos,2005-08-01,3,2,3,2,5
TARACO,consulta externa,repetidas en personas de 5 a 14 anos,2005-08-01,1,0,1,0,1
TARATA,consulta externa,repetidas en personas de 5 a 14 anos,2005-08-01,0,4,0,4,4
TARIJA,consulta externa,repetidas en personas de 5 a 14 anos,2005-08-01,491,437,491,437,928
TARVITA,consulta externa,repetidas en personas de 5 a 14 anos,2005-08-01,7,4,7,4,11
TEOPONTE,consulta externa,repetidas en personas de 5 a 14 anos,2005-08-01,2,1,2,1,3
TIAWANACU,consulta externa,repetidas en personas de 5 a 14 anos,2005-08-01,2,1,2,1,3
TINGUIPAYA,consulta externa,repetidas en personas de 5 a 14 anos,2005-08-01,3,0,3,0,3
TIPUANI,consulta externa,repetidas en personas de 5 a 14 anos,2005-08-01,1,3,1,3,4
TIQUIPAYA,consulta externa,repetidas en personas de 5 a 14 anos,2005-08-01,11,19,11,19,30
TIRAQUE (CBBA),consulta externa,repetidas en personas de 5 a 14 anos,2005-08-01,14,10,14,10,24
TITO YUPANQUI (PARQUIPUJIO),consulta externa,repetidas en personas de 5 a 14 anos,2005-08-01,1,0,1,0,1
TOCO,consulta externa,repetidas en personas de 5 a 14 anos,2005-08-01,1,0,1,0,1
TOLATA,consulta externa,repetidas en personas de 5 a 14 anos,2005-08-01,2,1,2,1,3
TOLEDO,consulta externa,repetidas en personas de 5 a 14 anos,2005-08-01,2,2,2,2,4
TOMAVE,consulta externa,repetidas en personas de 5 a 14 anos,2005-08-01,1,0,1,0,1
TOMINA,consulta externa,repetidas en personas de 5 a 14 anos,2005-08-01,3,3,3,3,6
TORO TORO,consulta externa,repetidas en personas de 5 a 14 anos,2005-08-01,0,3,0,3,3
TOTORA(ORR),consulta externa,repetidas en personas de 5 a 14 anos,2005-08-01,3,1,3,1,4
TRIGAL,consulta externa,repetidas en personas de 5 a 14 anos,2005-08-01,4,1,4,1,5
TRINIDAD,consulta externa,repetidas en personas de 5 a 14 anos,2005-08-01,155,177,155,177,332
TUPIZA,consulta externa,repetidas en personas de 5 a 14 anos,2005-08-01,60,61,60,61,121
UMALA,consulta externa,repetidas en personas de 5 a 14 anos,2005-08-01,0,2,0,2,2
UNCIA,consulta externa,repetidas en personas de 5 a 14 anos,2005-08-01,27,31,27,31,58
URIONDO (A. CONCEPCION),consulta externa,repetidas en personas de 5 a 14 anos,2005-08-01,2,2,2,2,4
URUBICHA,consulta externa,repetidas en personas de 5 a 14 anos,2005-08-01,1,0,1,0,1
UYUNI,consulta externa,repetidas en personas de 5 a 14 anos,2005-08-01,6,7,6,7,13
VACAS,consulta externa,repetidas en personas de 5 a 14 anos,2005-08-01,4,5,4,5,9
VALLEGRANDE,consulta externa,repetidas en personas de 5 a 14 anos,2005-08-01,15,22,15,22,37
VIACHA,consulta externa,repetidas en personas de 5 a 14 anos,2005-08-01,29,46,29,46,75
VILLA MONTES,consulta externa,repetidas en personas de 5 a 14 anos,2005-08-01,42,67,42,67,109
VILLA NUEVA (LOMA ALTA),consulta externa,repetidas en personas de 5 a 14 anos,2005-08-01,1,0,1,0,1
VILLA RIVERO,consulta externa,repetidas en personas de 5 a 14 anos,2005-08-01,3,3,3,3,6
VILLA SERRANO,consulta externa,repetidas en personas de 5 a 14 anos,2005-08-01,1,0,1,0,1
VILLA TUNARI,consulta externa,repetidas en personas de 5 a 14 anos,2005-08-01,8,9,8,9,17
VILLA VACA GUZMAN (MUYUPAMPA),consulta externa,repetidas en personas de 5 a 14 anos,2005-08-01,5,3,5,3,8
VILLAZON,consulta externa,repetidas en personas de 5 a 14 anos,2005-08-01,20,26,20,26,46
VINTO,consulta externa,repetidas en personas de 5 a 14 anos,2005-08-01,2,1,2,1,3
WALDO BALLIVIAN,consulta externa,repetidas en personas de 5 a 14 anos,2005-08-01,0,2,0,2,2
WARNES,consulta externa,repetidas en personas de 5 a 14 anos,2005-08-01,9,8,9,8,17
YACO,consulta externa,repetidas en personas de 5 a 14 anos,2005-08-01,2,1,2,1,3
YACUIBA,consulta externa,repetidas en personas de 5 a 14 anos,2005-08-01,65,64,65,64,129
YAMPARAEZ,consulta externa,repetidas en personas de 5 a 14 anos,2005-08-01,4,11,4,11,15
YANACACHI,consulta externa,repetidas en personas de 5 a 14 anos,2005-08-01,0,4,0,4,4
YAPACANI,consulta externa,repetidas en personas de 5 a 14 anos,2005-08-01,7,8,7,8,15
YOCALLA,consulta externa,repetidas en personas de 5 a 14 anos,2005-08-01,1,1,1,1,2
YOTALA,consulta externa,repetidas en personas de 5 a 14 anos,2005-08-01,11,12,11,12,23
YUNCHARA,consulta externa,repetidas en personas de 5 a 14 anos,2005-08-01,1,0,1,0,1
ZUDAÑEZ,consulta externa,repetidas en personas de 5 a 14 anos,2005-08-01,1,1,1,1,2
ACACIO,consulta externa,repetidas en personas de 5 a 14 anos,2005-09-01,0,2,0,2,2
ACHACACHI,consulta externa,repetidas en personas de 5 a 14 anos,2005-09-01,18,7,18,7,25
AIQUILE,consulta externa,repetidas en personas de 5 a 14 anos,2005-09-01,38,53,38,53,91
ANCORAIMES,consulta externa,repetidas en personas de 5 a 14 anos,2005-09-01,4,6,4,6,10
ANDAMARCA,consulta externa,repetidas en personas de 5 a 14 anos,2005-09-01,2,1,2,1,3
ANTEQUERA,consulta externa,repetidas en personas de 5 a 14 anos,2005-09-01,1,3,1,3,4
ANZALDO,consulta externa,repetidas en personas de 5 a 14 anos,2005-09-01,7,5,7,5,12
APOLO,consulta externa,repetidas en personas de 5 a 14 anos,2005-09-01,1,3,1,3,4
ARANI,consulta externa,repetidas en personas de 5 a 14 anos,2005-09-01,4,4,4,4,8
ARBIETO,consulta externa,repetidas en personas de 5 a 14 anos,2005-09-01,2,1,2,1,3
ARQUE,consulta externa,repetidas en personas de 5 a 14 anos,2005-09-01,0,1,0,1,1
ASCENCION DE GUARAYOS,consulta externa,repetidas en personas de 5 a 14 anos,2005-09-01,20,7,20,7,27
ATOCHA,consulta externa,repetidas en personas de 5 a 14 anos,2005-09-01,26,35,26,35,61
AUCAPATA,consulta externa,repetidas en personas de 5 a 14 anos,2005-09-01,0,1,0,1,1
AYATA,consulta externa,repetidas en personas de 5 a 14 anos,2005-09-01,8,5,8,5,13
AYO AYO,consulta externa,repetidas en personas de 5 a 14 anos,2005-09-01,0,1,0,1,1
AYOPAYA (V. DE INDEPENDENCIA),consulta externa,repetidas en personas de 5 a 14 anos,2005-09-01,1,0,1,0,1
AZURDUY,consulta externa,repetidas en personas de 5 a 14 anos,2005-09-01,1,0,1,0,1
BATALLAS,consulta externa,repetidas en personas de 5 a 14 anos,2005-09-01,1,0,1,0,1
BAURES,consulta externa,repetidas en personas de 5 a 14 anos,2005-09-01,4,2,4,2,6
BELEN DE ANDAMARCA,consulta externa,repetidas en personas de 5 a 14 anos,2005-09-01,0,1,0,1,1
BELEN DE URMIRI,consulta externa,repetidas en personas de 5 a 14 anos,2005-09-01,0,1,0,1,1
BERMEJO,consulta externa,repetidas en personas de 5 a 14 anos,2005-09-01,35,23,35,23,58
BETANZOS,consulta externa,repetidas en personas de 5 a 14 anos,2005-09-01,6,3,6,3,9
BOLIVAR,consulta externa,repetidas en personas de 5 a 14 anos,2005-09-01,2,4,2,4,6
BOLPEBRA,consulta externa,repetidas en personas de 5 a 14 anos,2005-09-01,11,11,11,11,22
BOYUIBE,consulta externa,repetidas en personas de 5 a 14 anos,2005-09-01,13,15,13,15,28
BUENA VISTA,consulta externa,repetidas en personas de 5 a 14 anos,2005-09-01,14,7,14,7,21
CABEZAS,consulta externa,repetidas en personas de 5 a 14 anos,2005-09-01,4,5,4,5,9
CAJUATA,consulta externa,repetidas en personas de 5 a 14 anos,2005-09-01,0,1,0,1,1
CALACOTO,consulta externa,repetidas en personas de 5 a 14 anos,2005-09-01,2,2,2,2,4
CALAMARCA,consulta externa,repetidas en personas de 5 a 14 anos,2005-09-01,1,0,1,0,1
CAMARGO,consulta externa,repetidas en personas de 5 a 14 anos,2005-09-01,4,5,4,5,9
CAMIRI,consulta externa,repetidas en personas de 5 a 14 anos,2005-09-01,27,50,27,50,77
CAPINOTA,consulta externa,repetidas en personas de 5 a 14 anos,2005-09-01,4,13,4,13,17
CAQUIAVIRI,consulta externa,repetidas en personas de 5 a 14 anos,2005-09-01,2,2,2,2,4
CARACOLLO,consulta externa,repetidas en personas de 5 a 14 anos,2005-09-01,3,3,3,3,6
CARANAVI,consulta externa,repetidas en personas de 5 a 14 anos,2005-09-01,5,3,5,3,8
CHALLAPATA,consulta externa,repetidas en personas de 5 a 14 anos,2005-09-01,12,6,12,6,18
CHAQUI,consulta externa,repetidas en personas de 5 a 14 anos,2005-09-01,0,1,0,1,1
CHARAGUA,consulta externa,repetidas en personas de 5 a 14 anos,2005-09-01,9,22,9,22,31
CHARAÑA,consulta externa,repetidas en personas de 5 a 14 anos,2005-09-01,5,2,5,2,7
CHAYANTA,consulta externa,repetidas en personas de 5 a 14 anos,2005-09-01,2,3,2,3,5
CHIMORE,consulta externa,repetidas en personas de 5 a 14 anos,2005-09-01,3,3,3,3,6
CHIPAYA,consulta externa,repetidas en personas de 5 a 14 anos,2005-09-01,1,1,1,1,2
CHOQUE COTA,consulta externa,repetidas en personas de 5 a 14 anos,2005-09-01,9,11,9,11,20
CHULUMANI (V. DE LA LIBERTAD),consulta externa,repetidas en personas de 5 a 14 anos,2005-09-01,12,14,12,14,26
CHUMA,consulta externa,repetidas en personas de 5 a 14 anos,2005-09-01,4,2,4,2,6
CLIZA,consulta externa,repetidas en personas de 5 a 14 anos,2005-09-01,1,2,1,2,3
COBIJA,consulta externa,repetidas en personas de 5 a 14 anos,2005-09-01,44,48,44,48,92
COCHABAMBA,consulta externa,repetidas en personas de 5 a 14 anos,2005-09-01,1658,1605,1658,1605,3263
COLCAPIRHUA,consulta externa,repetidas en personas de 5 a 14 anos,2005-09-01,41,45,41,45,86
"COLCHA ""K""",consulta externa,repetidas en personas de 5 a 14 anos,2005-09-01,4,5,4,5,9
COLPA BELGICA,consulta externa,repetidas en personas de 5 a 14 anos,2005-09-01,1,4,1,4,5
COLQUECHACA,consulta externa,repetidas en personas de 5 a 14 anos,2005-09-01,3,1,3,1,4
COLQUENCHA,consulta externa,repetidas en personas de 5 a 14 anos,2005-09-01,0,3,0,3,3
COLQUIRI,consulta externa,repetidas en personas de 5 a 14 anos,2005-09-01,7,5,7,5,12
COMANCHE,consulta externa,repetidas en personas de 5 a 14 anos,2005-09-01,0,1,0,1,1
COMARAPA,consulta externa,repetidas en personas de 5 a 14 anos,2005-09-01,9,7,9,7,16
COMBAYA,consulta externa,repetidas en personas de 5 a 14 anos,2005-09-01,0,1,0,1,1
CONCEPCION,consulta externa,repetidas en personas de 5 a 14 anos,2005-09-01,1,2,1,2,3
COPACABANA,consulta externa,repetidas en personas de 5 a 14 anos,2005-09-01,1,0,1,0,1
CORIPATA,consulta externa,repetidas en personas de 5 a 14 anos,2005-09-01,2,1,2,1,3
CORO CORO,consulta externa,repetidas en personas de 5 a 14 anos,2005-09-01,2,0,2,0,2
COROICO,consulta externa,repetidas en personas de 5 a 14 anos,2005-09-01,4,9,4,9,13
CORQUE,consulta externa,repetidas en personas de 5 a 14 anos,2005-09-01,27,37,27,37,64
COTAGAITA,consulta externa,repetidas en personas de 5 a 14 anos,2005-09-01,22,24,22,24,46
COTOCA,consulta externa,repetidas en personas de 5 a 14 anos,2005-09-01,1,3,1,3,4
CUATRO CAÑADAS,consulta externa,repetidas en personas de 5 a 14 anos,2005-09-01,1,2,1,2,3
CUEVO,consulta externa,repetidas en personas de 5 a 14 anos,2005-09-01,5,0,5,0,5
CULPINA,consulta externa,repetidas en personas de 5 a 14 anos,2005-09-01,5,3,5,3,8
CURAHUARA DE CARANGAS,consulta externa,repetidas en personas de 5 a 14 anos,2005-09-01,2,2,2,2,4
EL ALTO,consulta externa,repetidas en personas de 5 a 14 anos,2005-09-01,2310,2438,2310,2438,4748
EL PUENTE(TJA),consulta externa,repetidas en personas de 5 a 14 anos,2005-09-01,3,1,3,1,4
EL TORNO,consulta externa,repetidas en personas de 5 a 14 anos,2005-09-01,45,48,45,48,93
EL VILLAR,consulta externa,repetidas en personas de 5 a 14 anos,2005-09-01,1,2,1,2,3
ENTRE RIOS,consulta externa,repetidas en personas de 5 a 14 anos,2005-09-01,5,3,5,3,8
ENTRE RIOS,consulta externa,repetidas en personas de 5 a 14 anos,2005-09-01,7,4,7,4,11
EUCALIPTUS,consulta externa,repetidas en personas de 5 a 14 anos,2005-09-01,5,1,5,1,6
EXALTACION,consulta externa,repetidas en personas de 5 a 14 anos,2005-09-01,3,2,3,2,5
FERNANDEZ ALONSO,consulta externa,repetidas en personas de 5 a 14 anos,2005-09-01,3,6,3,6,9
GENERAL SAAVEDRA,consulta externa,repetidas en personas de 5 a 14 anos,2005-09-01,7,5,7,5,12
GRAL. J.J. PEREZ (CHARAZANI),consulta externa,repetidas en personas de 5 a 14 anos,2005-09-01,1,0,1,0,1
GUANAY,consulta externa,repetidas en personas de 5 a 14 anos,2005-09-01,7,0,7,0,7
GUAQUI,consulta externa,repetidas en personas de 5 a 14 anos,2005-09-01,4,3,4,3,7
GUAYARAMERIN,consulta externa,repetidas en personas de 5 a 14 anos,2005-09-01,102,54,102,54,156
GUTIERREZ,consulta externa,repetidas en personas de 5 a 14 anos,2005-09-01,6,3,6,3,9
HUACARETA,consulta externa,repetidas en personas de 5 a 14 anos,2005-09-01,0,3,0,3,3
HUANUNI,consulta externa,repetidas en personas de 5 a 14 anos,2005-09-01,196,99,196,99,295
HUARACAJE,consulta externa,repetidas en personas de 5 a 14 anos,2005-09-01,1,0,1,0,1
ICHOCA,consulta externa,repetidas en personas de 5 a 14 anos,2005-09-01,1,4,1,4,5
ICLA,consulta externa,repetidas en personas de 5 a 14 anos,2005-09-01,0,6,0,6,6
INCAHUASI,consulta externa,repetidas en personas de 5 a 14 anos,2005-09-01,3,3,3,3,6
INQUISIVI,consulta externa,repetidas en personas de 5 a 14 anos,2005-09-01,0,1,0,1,1
IRUPANA (VILLA DE LANZA),consulta externa,repetidas en personas de 5 a 14 anos,2005-09-01,1,1,1,1,2
IXIAMAS,consulta externa,repetidas en personas de 5 a 14 anos,2005-09-01,2,5,2,5,7
JESUS DE MACHACA,consulta externa,repetidas en personas de 5 a 14 anos,2005-09-01,1,4,1,4,5
LA ASUNTA,consulta externa,repetidas en personas de 5 a 14 anos,2005-09-01,3,6,3,6,9
LA GUARDIA,consulta externa,repetidas en personas de 5 a 14 anos,2005-09-01,16,17,16,17,33
LA PAZ,consulta externa,repetidas en personas de 5 a 14 anos,2005-09-01,3004,3080,3004,3080,6084
LAGUNILLAS,consulta externa,repetidas en personas de 5 a 14 anos,2005-09-01,3,0,3,0,3
LAJA,consulta externa,repetidas en personas de 5 a 14 anos,2005-09-01,1,10,1,10,11
LLALLAGUA,consulta externa,repetidas en personas de 5 a 14 anos,2005-09-01,3,7,3,7,10
LLICA,consulta externa,repetidas en personas de 5 a 14 anos,2005-09-01,2,3,2,3,5
LORETO,consulta externa,repetidas en personas de 5 a 14 anos,2005-09-01,1,0,1,0,1
MACHACAMARCA,consulta externa,repetidas en personas de 5 a 14 anos,2005-09-01,4,7,4,7,11
MACHARETI,consulta externa,repetidas en personas de 5 a 14 anos,2005-09-01,2,1,2,1,3
MAGDALENA,consulta externa,repetidas en personas de 5 a 14 anos,2005-09-01,12,20,12,20,32
MAIRANA,consulta externa,repetidas en personas de 5 a 14 anos,2005-09-01,0,2,0,2,2
MALLA,consulta externa,repetidas en personas de 5 a 14 anos,2005-09-01,3,1,3,1,4
MECAPACA,consulta externa,repetidas en personas de 5 a 14 anos,2005-09-01,14,8,14,8,22
MINEROS,consulta externa,repetidas en personas de 5 a 14 anos,2005-09-01,1,1,1,1,2
MIZQUE,consulta externa,repetidas en personas de 5 a 14 anos,2005-09-01,0,3,0,3,3
MOCOMOCO,consulta externa,repetidas en personas de 5 a 14 anos,2005-09-01,3,1,3,1,4
MOJOCOYA,consulta externa,repetidas en personas de 5 a 14 anos,2005-09-01,1,0,1,0,1
MONTEAGUDO,consulta externa,repetidas en personas de 5 a 14 anos,2005-09-01,43,37,43,37,80
MONTERO,consulta externa,repetidas en personas de 5 a 14 anos,2005-09-01,122,116,122,116,238
MORO MORO,consulta externa,repetidas en personas de 5 a 14 anos,2005-09-01,0,1,0,1,1
MOROCHATA,consulta externa,repetidas en personas de 5 a 14 anos,2005-09-01,2,2,2,2,4
OKINAWA,consulta externa,repetidas en personas de 5 a 14 anos,2005-09-01,0,6,0,6,6
OMEREQUE,consulta externa,repetidas en personas de 5 a 14 anos,2005-09-01,0,1,0,1,1
ORURO,consulta externa,repetidas en personas de 5 a 14 anos,2005-09-01,547,509,547,509,1056
PADCAYA,consulta externa,repetidas en personas de 5 a 14 anos,2005-09-01,2,1,2,1,3
PADILLA,consulta externa,repetidas en personas de 5 a 14 anos,2005-09-01,3,1,3,1,4
PALCA,consulta externa,repetidas en personas de 5 a 14 anos,2005-09-01,4,3,4,3,7
PALOS BLANCOS,consulta externa,repetidas en personas de 5 a 14 anos,2005-09-01,6,5,6,5,11
PAMPA GRANDE,consulta externa,repetidas en personas de 5 a 14 anos,2005-09-01,3,3,3,3,6
PASORAPA,consulta externa,repetidas en personas de 5 a 14 anos,2005-09-01,0,1,0,1,1
PATACAMAYA,consulta externa,repetidas en personas de 5 a 14 anos,2005-09-01,0,1,0,1,1
PAZÑA,consulta externa,repetidas en personas de 5 a 14 anos,2005-09-01,1,3,1,3,4
POCOATA,consulta externa,repetidas en personas de 5 a 14 anos,2005-09-01,0,2,0,2,2
POJO (CBBA),consulta externa,repetidas en personas de 5 a 14 anos,2005-09-01,1,1,1,1,2
POOPO,consulta externa,repetidas en personas de 5 a 14 anos,2005-09-01,1,0,1,0,1
POROMA,consulta externa,repetidas en personas de 5 a 14 anos,2005-09-01,3,1,3,1,4
PORONGO,consulta externa,repetidas en personas de 5 a 14 anos,2005-09-01,4,4,4,4,8
PORTACHUELO,consulta externa,repetidas en personas de 5 a 14 anos,2005-09-01,15,13,15,13,28
PORVENIR,consulta externa,repetidas en personas de 5 a 14 anos,2005-09-01,1,0,1,0,1
POSTRER VALLE,consulta externa,repetidas en personas de 5 a 14 anos,2005-09-01,1,0,1,0,1
POTOSI,consulta externa,repetidas en personas de 5 a 14 anos,2005-09-01,426,357,426,357,783
PRESTO,consulta externa,repetidas en personas de 5 a 14 anos,2005-09-01,4,0,4,0,4
PUCARA,consulta externa,repetidas en personas de 5 a 14 anos,2005-09-01,2,1,2,1,3
PUCARANI,consulta externa,repetidas en personas de 5 a 14 anos,2005-09-01,1,2,1,2,3
PUERTO ACOSTA,consulta externa,repetidas en personas de 5 a 14 anos,2005-09-01,5,0,5,0,5
PUERTO CARABUCO,consulta externa,repetidas en personas de 5 a 14 anos,2005-09-01,1,0,1,0,1
PUERTO GONZALO MORENO,consulta externa,repetidas en personas de 5 a 14 anos,2005-09-01,1,0,1,0,1
PUERTO PEREZ,consulta externa,repetidas en personas de 5 a 14 anos,2005-09-01,1,1,1,1,2
PUERTO QUIJARRO,consulta externa,repetidas en personas de 5 a 14 anos,2005-09-01,8,13,8,13,21
PUERTO RICO,consulta externa,repetidas en personas de 5 a 14 anos,2005-09-01,0,2,0,2,2
PUERTO SUAREZ,consulta externa,repetidas en personas de 5 a 14 anos,2005-09-01,9,10,9,10,19
PUERTO VILLARROEL,consulta externa,repetidas en personas de 5 a 14 anos,2005-09-01,12,9,12,9,21
PUNA,consulta externa,repetidas en personas de 5 a 14 anos,2005-09-01,3,1,3,1,4
PUNATA,consulta externa,repetidas en personas de 5 a 14 anos,2005-09-01,52,24,52,24,76
QUILLACOLLO,consulta externa,repetidas en personas de 5 a 14 anos,2005-09-01,57,68,57,68,125
QUIME,consulta externa,repetidas en personas de 5 a 14 anos,2005-09-01,0,3,0,3,3
REYES,consulta externa,repetidas en personas de 5 a 14 anos,2005-09-01,5,5,5,5,10
RIBERALTA,consulta externa,repetidas en personas de 5 a 14 anos,2005-09-01,18,32,18,32,50
ROBORE,consulta externa,repetidas en personas de 5 a 14 anos,2005-09-01,6,7,6,7,13
RURRENABAQUE,consulta externa,repetidas en personas de 5 a 14 anos,2005-09-01,9,1,9,1,10
SACABA,consulta externa,repetidas en personas de 5 a 14 anos,2005-09-01,63,68,63,68,131
SACACA,consulta externa,repetidas en personas de 5 a 14 anos,2005-09-01,1,0,1,0,1
SAIPINA,consulta externa,repetidas en personas de 5 a 14 anos,2005-09-01,1,3,1,3,4
SALINAS DE GARCI MENDOZA,consulta externa,repetidas en personas de 5 a 14 anos,2005-09-01,1,0,1,0,1
SAMAIPATA,consulta externa,repetidas en personas de 5 a 14 anos,2005-09-01,2,0,2,0,2
SAN ANDRES,consulta externa,repetidas en personas de 5 a 14 anos,2005-09-01,6,4,6,4,10
SAN ANDRES DE MACHACA,consulta externa,repetidas en personas de 5 a 14 anos,2005-09-01,8,3,8,3,11
SAN BENITO,consulta externa,repetidas en personas de 5 a 14 anos,2005-09-01,2,9,2,9,11
SAN BORJA,consulta externa,repetidas en personas de 5 a 14 anos,2005-09-01,13,15,13,15,28
SAN BUENA VENTURA,consulta externa,repetidas en personas de 5 a 14 anos,2005-09-01,9,7,9,7,16
SAN CARLOS,consulta externa,repetidas en personas de 5 a 14 anos,2005-09-01,2,3,2,3,5
SAN IGNACIO,consulta externa,repetidas en personas de 5 a 14 anos,2005-09-01,2,5,2,5,7
SAN IGNACIO DE VELASCO,consulta externa,repetidas en personas de 5 a 14 anos,2005-09-01,33,32,33,32,65
SAN JAVIER(STC),consulta externa,repetidas en personas de 5 a 14 anos,2005-09-01,3,2,3,2,5
SAN JOAQUIN,consulta externa,repetidas en personas de 5 a 14 anos,2005-09-01,3,7,3,7,10
SAN JOSE DE CHIQUITOS,consulta externa,repetidas en personas de 5 a 14 anos,2005-09-01,3,1,3,1,4
SAN JUAN DE YAPACANI,consulta externa,repetidas en personas de 5 a 14 anos,2005-09-01,6,9,6,9,15
SAN JULIAN,consulta externa,repetidas en personas de 5 a 14 anos,2005-09-01,9,15,9,15,24
SAN LORENZO(PND),consulta externa,repetidas en personas de 5 a 14 anos,2005-09-01,0,1,0,1,1
SAN LORENZO(TJA),consulta externa,repetidas en personas de 5 a 14 anos,2005-09-01,9,5,9,5,14
SAN LUCAS,consulta externa,repetidas en personas de 5 a 14 anos,2005-09-01,18,11,18,11,29
SAN MIGUEL DE VELASCO,consulta externa,repetidas en personas de 5 a 14 anos,2005-09-01,15,13,15,13,28
SAN PABLO DE LIPEZ,consulta externa,repetidas en personas de 5 a 14 anos,2005-09-01,3,4,3,4,7
SAN PEDRO,consulta externa,repetidas en personas de 5 a 14 anos,2005-09-01,2,10,2,10,12
SAN PEDRO DE BUENA VISTA,consulta externa,repetidas en personas de 5 a 14 anos,2005-09-01,2,0,2,0,2
SAN PEDRO DE TIQUINA,consulta externa,repetidas en personas de 5 a 14 anos,2005-09-01,1,0,1,0,1
SAN RAMON,consulta externa,repetidas en personas de 5 a 14 anos,2005-09-01,3,10,3,10,13
SAN RAMON,consulta externa,repetidas en personas de 5 a 14 anos,2005-09-01,4,4,4,4,8
SANTA ANA,consulta externa,repetidas en personas de 5 a 14 anos,2005-09-01,50,42,50,42,92
SANTA CRUZ DE LA SIERRA,consulta externa,repetidas en personas de 5 a 14 anos,2005-09-01,2257,2437,2257,2437,4694
SANTA ROSA,consulta externa,repetidas en personas de 5 a 14 anos,2005-09-01,2,11,2,11,13
SANTA ROSA DEL SARA,consulta externa,repetidas en personas de 5 a 14 anos,2005-09-01,4,4,4,4,8
SANTIAGO DE HUARI,consulta externa,repetidas en personas de 5 a 14 anos,2005-09-01,2,1,2,1,3
SANTUARIO DE QUILLACAS,consulta externa,repetidas en personas de 5 a 14 anos,2005-09-01,5,2,5,2,7
SAPAHAQUI,consulta externa,repetidas en personas de 5 a 14 anos,2005-09-01,2,0,2,0,2
SIPE SIPE,consulta externa,repetidas en personas de 5 a 14 anos,2005-09-01,16,11,16,11,27
SOPACHUY,consulta externa,repetidas en personas de 5 a 14 anos,2005-09-01,0,1,0,1,1
SORACACHI,consulta externa,repetidas en personas de 5 a 14 anos,2005-09-01,1,3,1,3,4
SORATA,consulta externa,repetidas en personas de 5 a 14 anos,2005-09-01,0,2,0,2,2
SUCRE,consulta externa,repetidas en personas de 5 a 14 anos,2005-09-01,839,776,839,776,1615
TACACHI,consulta externa,repetidas en personas de 5 a 14 anos,2005-09-01,5,5,5,5,10
TACOBAMBA,consulta externa,repetidas en personas de 5 a 14 anos,2005-09-01,1,0,1,0,1
TAPACARI,consulta externa,repetidas en personas de 5 a 14 anos,2005-09-01,8,6,8,6,14
TARABUCO,consulta externa,repetidas en personas de 5 a 14 anos,2005-09-01,6,0,6,0,6
TARIJA,consulta externa,repetidas en personas de 5 a 14 anos,2005-09-01,585,605,585,605,1190
TARVITA,consulta externa,repetidas en personas de 5 a 14 anos,2005-09-01,7,3,7,3,10
TEOPONTE,consulta externa,repetidas en personas de 5 a 14 anos,2005-09-01,2,0,2,0,2
TIAWANACU,consulta externa,repetidas en personas de 5 a 14 anos,2005-09-01,1,2,1,2,3
TINGUIPAYA,consulta externa,repetidas en personas de 5 a 14 anos,2005-09-01,1,0,1,0,1
TIPUANI,consulta externa,repetidas en personas de 5 a 14 anos,2005-09-01,0,1,0,1,1
TIQUIPAYA,consulta externa,repetidas en personas de 5 a 14 anos,2005-09-01,22,28,22,28,50
TIRAQUE (CBBA),consulta externa,repetidas en personas de 5 a 14 anos,2005-09-01,13,17,13,17,30
TODOS SANTOS,consulta externa,repetidas en personas de 5 a 14 anos,2005-09-01,0,1,0,1,1
TOLATA,consulta externa,repetidas en personas de 5 a 14 anos,2005-09-01,2,2,2,2,4
TOLEDO,consulta externa,repetidas en personas de 5 a 14 anos,2005-09-01,0,1,0,1,1
TOMAVE,consulta externa,repetidas en personas de 5 a 14 anos,2005-09-01,2,0,2,0,2
TOMINA,consulta externa,repetidas en personas de 5 a 14 anos,2005-09-01,1,2,1,2,3
TOTORA(CBBA),consulta externa,repetidas en personas de 5 a 14 anos,2005-09-01,0,1,0,1,1
TRIGAL,consulta externa,repetidas en personas de 5 a 14 anos,2005-09-01,1,0,1,0,1
TRINIDAD,consulta externa,repetidas en personas de 5 a 14 anos,2005-09-01,81,117,81,117,198
TUPIZA,consulta externa,repetidas en personas de 5 a 14 anos,2005-09-01,91,100,91,100,191
TURCO,consulta externa,repetidas en personas de 5 a 14 anos,2005-09-01,1,0,1,0,1
UMALA,consulta externa,repetidas en personas de 5 a 14 anos,2005-09-01,1,0,1,0,1
UNCIA,consulta externa,repetidas en personas de 5 a 14 anos,2005-09-01,33,31,33,31,64
URIONDO (A. CONCEPCION),consulta externa,repetidas en personas de 5 a 14 anos,2005-09-01,2,4,2,4,6
URUBICHA,consulta externa,repetidas en personas de 5 a 14 anos,2005-09-01,2,2,2,2,4
UYUNI,consulta externa,repetidas en personas de 5 a 14 anos,2005-09-01,7,4,7,4,11
VACAS,consulta externa,repetidas en personas de 5 a 14 anos,2005-09-01,5,15,5,15,20
VALLEGRANDE,consulta externa,repetidas en personas de 5 a 14 anos,2005-09-01,15,25,15,25,40
VIACHA,consulta externa,repetidas en personas de 5 a 14 anos,2005-09-01,70,55,70,55,125
VILLA MONTES,consulta externa,repetidas en personas de 5 a 14 anos,2005-09-01,77,68,77,68,145
VILLA NUEVA (LOMA ALTA),consulta externa,repetidas en personas de 5 a 14 anos,2005-09-01,0,1,0,1,1
VILLA RIVERO,consulta externa,repetidas en personas de 5 a 14 anos,2005-09-01,2,1,2,1,3
VILLA SERRANO,consulta externa,repetidas en personas de 5 a 14 anos,2005-09-01,3,0,3,0,3
VILLA TUNARI,consulta externa,repetidas en personas de 5 a 14 anos,2005-09-01,9,12,9,12,21
VILLA VACA GUZMAN (MUYUPAMPA),consulta externa,repetidas en personas de 5 a 14 anos,2005-09-01,1,3,1,3,4
VILLAZON,consulta externa,repetidas en personas de 5 a 14 anos,2005-09-01,34,29,34,29,63
VINTO,consulta externa,repetidas en personas de 5 a 14 anos,2005-09-01,3,0,3,0,3
VITICHI,consulta externa,repetidas en personas de 5 a 14 anos,2005-09-01,3,1,3,1,4
WALDO BALLIVIAN,consulta externa,repetidas en personas de 5 a 14 anos,2005-09-01,3,1,3,1,4
WARNES,consulta externa,repetidas en personas de 5 a 14 anos,2005-09-01,8,8,8,8,16
YACO,consulta externa,repetidas en personas de 5 a 14 anos,2005-09-01,0,2,0,2,2
YACUIBA,consulta externa,repetidas en personas de 5 a 14 anos,2005-09-01,157,137,157,137,294
YAMPARAEZ,consulta externa,repetidas en personas de 5 a 14 anos,2005-09-01,1,1,1,1,2
YANACACHI,consulta externa,repetidas en personas de 5 a 14 anos,2005-09-01,2,1,2,1,3
YAPACANI,consulta externa,repetidas en personas de 5 a 14 anos,2005-09-01,6,7,6,7,13
YOCALLA,consulta externa,repetidas en personas de 5 a 14 anos,2005-09-01,0,1,0,1,1
YOTALA,consulta externa,repetidas en personas de 5 a 14 anos,2005-09-01,8,5,8,5,13
YUNCHARA,consulta externa,repetidas en personas de 5 a 14 anos,2005-09-01,1,1,1,1,2
ZUDAÑEZ,consulta externa,repetidas en personas de 5 a 14 anos,2005-09-01,2,0,2,0,2
ACHACACHI,consulta externa,repetidas en personas de 5 a 14 anos,2005-10-01,8,11,8,11,19
ACHOCALLA,consulta externa,repetidas en personas de 5 a 14 anos,2005-10-01,3,2,3,2,5
AIQUILE,consulta externa,repetidas en personas de 5 a 14 anos,2005-10-01,13,6,13,6,19
ANCORAIMES,consulta externa,repetidas en personas de 5 a 14 anos,2005-10-01,1,2,1,2,3
ANDAMARCA,consulta externa,repetidas en personas de 5 a 14 anos,2005-10-01,2,0,2,0,2
ANTEQUERA,consulta externa,repetidas en personas de 5 a 14 anos,2005-10-01,2,1,2,1,3
ANZALDO,consulta externa,repetidas en personas de 5 a 14 anos,2005-10-01,1,7,1,7,8
APOLO,consulta externa,repetidas en personas de 5 a 14 anos,2005-10-01,2,1,2,1,3
ARANI,consulta externa,repetidas en personas de 5 a 14 anos,2005-10-01,0,6,0,6,6
ARBIETO,consulta externa,repetidas en personas de 5 a 14 anos,2005-10-01,7,3,7,3,10
ARQUE,consulta externa,repetidas en personas de 5 a 14 anos,2005-10-01,1,2,1,2,3
ASCENCION DE GUARAYOS,consulta externa,repetidas en personas de 5 a 14 anos,2005-10-01,25,21,25,21,46
ATOCHA,consulta externa,repetidas en personas de 5 a 14 anos,2005-10-01,45,33,45,33,78
AUCAPATA,consulta externa,repetidas en personas de 5 a 14 anos,2005-10-01,1,2,1,2,3
AYATA,consulta externa,repetidas en personas de 5 a 14 anos,2005-10-01,3,7,3,7,10
AYO AYO,consulta externa,repetidas en personas de 5 a 14 anos,2005-10-01,1,1,1,1,2
AYOPAYA (V. DE INDEPENDENCIA),consulta externa,repetidas en personas de 5 a 14 anos,2005-10-01,0,2,0,2,2
BATALLAS,consulta externa,repetidas en personas de 5 a 14 anos,2005-10-01,3,0,3,0,3
BAURES,consulta externa,repetidas en personas de 5 a 14 anos,2005-10-01,1,8,1,8,9
BELEN DE ANDAMARCA,consulta externa,repetidas en personas de 5 a 14 anos,2005-10-01,5,2,5,2,7
BELEN DE URMIRI,consulta externa,repetidas en personas de 5 a 14 anos,2005-10-01,1,1,1,1,2
BERMEJO,consulta externa,repetidas en personas de 5 a 14 anos,2005-10-01,45,59,45,59,104
BETANZOS,consulta externa,repetidas en personas de 5 a 14 anos,2005-10-01,5,4,5,4,9
BOLPEBRA,consulta externa,repetidas en personas de 5 a 14 anos,2005-10-01,0,1,0,1,1
BOYUIBE,consulta externa,repetidas en personas de 5 a 14 anos,2005-10-01,4,2,4,2,6
BUENA VISTA,consulta externa,repetidas en personas de 5 a 14 anos,2005-10-01,16,9,16,9,25
CABEZAS,consulta externa,repetidas en personas de 5 a 14 anos,2005-10-01,6,2,6,2,8
CAIROMA,consulta externa,repetidas en personas de 5 a 14 anos,2005-10-01,1,1,1,1,2
"CAIZA ""D""",consulta externa,repetidas en personas de 5 a 14 anos,2005-10-01,1,1,1,1,2
CALAMARCA,consulta externa,repetidas en personas de 5 a 14 anos,2005-10-01,2,1,2,1,3
CAMARGO,consulta externa,repetidas en personas de 5 a 14 anos,2005-10-01,4,2,4,2,6
CAMATAQUI (C. VILLA ABECIA),consulta externa,repetidas en personas de 5 a 14 anos,2005-10-01,2,0,2,0,2
CAMIRI,consulta externa,repetidas en personas de 5 a 14 anos,2005-10-01,41,64,41,64,105
CAPINOTA,consulta externa,repetidas en personas de 5 a 14 anos,2005-10-01,15,20,15,20,35
CAQUIAVIRI,consulta externa,repetidas en personas de 5 a 14 anos,2005-10-01,0,2,0,2,2
CARACOLLO,consulta externa,repetidas en personas de 5 a 14 anos,2005-10-01,2,1,2,1,3
CARANAVI,consulta externa,repetidas en personas de 5 a 14 anos,2005-10-01,4,3,4,3,7
CARMEN RIVERO TORREZ,consulta externa,repetidas en personas de 5 a 14 anos,2005-10-01,0,2,0,2,2
CATACORA,consulta externa,repetidas en personas de 5 a 14 anos,2005-10-01,1,0,1,0,1
CHALLAPATA,consulta externa,repetidas en personas de 5 a 14 anos,2005-10-01,14,8,14,8,22
CHAQUI,consulta externa,repetidas en personas de 5 a 14 anos,2005-10-01,0,2,0,2,2
CHARAGUA,consulta externa,repetidas en personas de 5 a 14 anos,2005-10-01,17,14,17,14,31
CHARAÑA,consulta externa,repetidas en personas de 5 a 14 anos,2005-10-01,0,1,0,1,1
CHAYANTA,consulta externa,repetidas en personas de 5 a 14 anos,2005-10-01,8,5,8,5,13
CHIMORE,consulta externa,repetidas en personas de 5 a 14 anos,2005-10-01,7,7,7,7,14
CHOQUE COTA,consulta externa,repetidas en personas de 5 a 14 anos,2005-10-01,2,2,2,2,4
CHULUMANI (V. DE LA LIBERTAD),consulta externa,repetidas en personas de 5 a 14 anos,2005-10-01,5,7,5,7,12
CHUMA,consulta externa,repetidas en personas de 5 a 14 anos,2005-10-01,0,2,0,2,2
CLIZA,consulta externa,repetidas en personas de 5 a 14 anos,2005-10-01,1,0,1,0,1
COBIJA,consulta externa,repetidas en personas de 5 a 14 anos,2005-10-01,13,25,13,25,38
COCHABAMBA,consulta externa,repetidas en personas de 5 a 14 anos,2005-10-01,2217,1975,2217,1975,4192
COLCAPIRHUA,consulta externa,repetidas en personas de 5 a 14 anos,2005-10-01,62,44,62,44,106
"COLCHA ""K""",consulta externa,repetidas en personas de 5 a 14 anos,2005-10-01,0,1,0,1,1
COLLANA,consulta externa,repetidas en personas de 5 a 14 anos,2005-10-01,1,1,1,1,2
COLOMI,consulta externa,repetidas en personas de 5 a 14 anos,2005-10-01,1,0,1,0,1
COLPA BELGICA,consulta externa,repetidas en personas de 5 a 14 anos,2005-10-01,6,12,6,12,18
COLQUECHACA,consulta externa,repetidas en personas de 5 a 14 anos,2005-10-01,1,3,1,3,4
COLQUIRI,consulta externa,repetidas en personas de 5 a 14 anos,2005-10-01,3,0,3,0,3
COMANCHE,consulta externa,repetidas en personas de 5 a 14 anos,2005-10-01,1,2,1,2,3
COMARAPA,consulta externa,repetidas en personas de 5 a 14 anos,2005-10-01,17,4,17,4,21
COMBAYA,consulta externa,repetidas en personas de 5 a 14 anos,2005-10-01,1,0,1,0,1
CORIPATA,consulta externa,repetidas en personas de 5 a 14 anos,2005-10-01,1,0,1,0,1
CORO CORO,consulta externa,repetidas en personas de 5 a 14 anos,2005-10-01,2,0,2,0,2
COROICO,consulta externa,repetidas en personas de 5 a 14 anos,2005-10-01,19,15,19,15,34
CORQUE,consulta externa,repetidas en personas de 5 a 14 anos,2005-10-01,8,6,8,6,14
COTAGAITA,consulta externa,repetidas en personas de 5 a 14 anos,2005-10-01,15,20,15,20,35
COTOCA,consulta externa,repetidas en personas de 5 a 14 anos,2005-10-01,0,1,0,1,1
CUATRO CAÑADAS,consulta externa,repetidas en personas de 5 a 14 anos,2005-10-01,5,5,5,5,10
CUCHUMUELA (V. G. VILLARROEL),consulta externa,repetidas en personas de 5 a 14 anos,2005-10-01,4,0,4,0,4
CUEVO,consulta externa,repetidas en personas de 5 a 14 anos,2005-10-01,1,7,1,7,8
CULPINA,consulta externa,repetidas en personas de 5 a 14 anos,2005-10-01,5,3,5,3,8
EL ALTO,consulta externa,repetidas en personas de 5 a 14 anos,2005-10-01,1847,1668,1847,1668,3515
EL CHORO,consulta externa,repetidas en personas de 5 a 14 anos,2005-10-01,5,5,5,5,10
EL PUENTE(STC),consulta externa,repetidas en personas de 5 a 14 anos,2005-10-01,27,22,27,22,49
EL PUENTE(TJA),consulta externa,repetidas en personas de 5 a 14 anos,2005-10-01,1,1,1,1,2
EL TORNO,consulta externa,repetidas en personas de 5 a 14 anos,2005-10-01,58,42,58,42,100
EL VILLAR,consulta externa,repetidas en personas de 5 a 14 anos,2005-10-01,1,0,1,0,1
ENTRE RIOS,consulta externa,repetidas en personas de 5 a 14 anos,2005-10-01,15,7,15,7,22
ENTRE RIOS,consulta externa,repetidas en personas de 5 a 14 anos,2005-10-01,3,2,3,2,5
EUCALIPTUS,consulta externa,repetidas en personas de 5 a 14 anos,2005-10-01,5,3,5,3,8
EUREKA (SANTOS MERCADO),consulta externa,repetidas en personas de 5 a 14 anos,2005-10-01,1,0,1,0,1
EXALTACION,consulta externa,repetidas en personas de 5 a 14 anos,2005-10-01,2,0,2,0,2
FERNANDEZ ALONSO,consulta externa,repetidas en personas de 5 a 14 anos,2005-10-01,1,2,1,2,3
FILADELFIA,consulta externa,repetidas en personas de 5 a 14 anos,2005-10-01,2,1,2,1,3
GENERAL SAAVEDRA,consulta externa,repetidas en personas de 5 a 14 anos,2005-10-01,3,0,3,0,3
GRAL. J.J. PEREZ (CHARAZANI),consulta externa,repetidas en personas de 5 a 14 anos,2005-10-01,2,1,2,1,3
GUAQUI,consulta externa,repetidas en personas de 5 a 14 anos,2005-10-01,7,6,7,6,13
GUAYARAMERIN,consulta externa,repetidas en personas de 5 a 14 anos,2005-10-01,61,79,61,79,140
GUTIERREZ,consulta externa,repetidas en personas de 5 a 14 anos,2005-10-01,9,4,9,4,13
HUACARETA,consulta externa,repetidas en personas de 5 a 14 anos,2005-10-01,3,2,3,2,5
HUACHACALLA,consulta externa,repetidas en personas de 5 a 14 anos,2005-10-01,0,1,0,1,1
HUANUNI,consulta externa,repetidas en personas de 5 a 14 anos,2005-10-01,180,128,180,128,308
HUARACAJE,consulta externa,repetidas en personas de 5 a 14 anos,2005-10-01,3,0,3,0,3
HUAYLLAMARCA,consulta externa,repetidas en personas de 5 a 14 anos,2005-10-01,5,1,5,1,6
INCAHUASI,consulta externa,repetidas en personas de 5 a 14 anos,2005-10-01,0,37,0,37,37
IRUPANA (VILLA DE LANZA),consulta externa,repetidas en personas de 5 a 14 anos,2005-10-01,3,1,3,1,4
IXIAMAS,consulta externa,repetidas en personas de 5 a 14 anos,2005-10-01,0,1,0,1,1
JESUS DE MACHACA,consulta externa,repetidas en personas de 5 a 14 anos,2005-10-01,2,6,2,6,8
LA GUARDIA,consulta externa,repetidas en personas de 5 a 14 anos,2005-10-01,20,19,20,19,39
LA PAZ,consulta externa,repetidas en personas de 5 a 14 anos,2005-10-01,2748,2688,2748,2688,5436
LAJA,consulta externa,repetidas en personas de 5 a 14 anos,2005-10-01,0,3,0,3,3
LAS CARRERAS,consulta externa,repetidas en personas de 5 a 14 anos,2005-10-01,1,0,1,0,1
LLALLAGUA,consulta externa,repetidas en personas de 5 a 14 anos,2005-10-01,14,12,14,12,26
LLICA,consulta externa,repetidas en personas de 5 a 14 anos,2005-10-01,3,4,3,4,7
LORETO,consulta externa,repetidas en personas de 5 a 14 anos,2005-10-01,6,7,6,7,13
LURIBAY,consulta externa,repetidas en personas de 5 a 14 anos,2005-10-01,0,1,0,1,1
MACHACAMARCA,consulta externa,repetidas en personas de 5 a 14 anos,2005-10-01,2,7,2,7,9
MACHARETI,consulta externa,repetidas en personas de 5 a 14 anos,2005-10-01,2,5,2,5,7
MAGDALENA,consulta externa,repetidas en personas de 5 a 14 anos,2005-10-01,8,13,8,13,21
MAIRANA,consulta externa,repetidas en personas de 5 a 14 anos,2005-10-01,0,2,0,2,2
MALLA,consulta externa,repetidas en personas de 5 a 14 anos,2005-10-01,3,8,3,8,11
MECAPACA,consulta externa,repetidas en personas de 5 a 14 anos,2005-10-01,9,1,9,1,10
MINEROS,consulta externa,repetidas en personas de 5 a 14 anos,2005-10-01,2,3,2,3,5
MIZQUE,consulta externa,repetidas en personas de 5 a 14 anos,2005-10-01,0,2,0,2,2
MOCOMOCO,consulta externa,repetidas en personas de 5 a 14 anos,2005-10-01,5,1,5,1,6
MOJINETE,consulta externa,repetidas en personas de 5 a 14 anos,2005-10-01,2,1,2,1,3
MONTEAGUDO,consulta externa,repetidas en personas de 5 a 14 anos,2005-10-01,15,16,15,16,31
MONTERO,consulta externa,repetidas en personas de 5 a 14 anos,2005-10-01,195,143,195,143,338
MOROCHATA,consulta externa,repetidas en personas de 5 a 14 anos,2005-10-01,16,9,16,9,25
NACEBE (SANTA ROSA DEL ABUNA),consulta externa,repetidas en personas de 5 a 14 anos,2005-10-01,0,1,0,1,1
NUEVO MANOA (NUEVA ESPERANZA),consulta externa,repetidas en personas de 5 a 14 anos,2005-10-01,0,2,0,2,2
OCURI,consulta externa,repetidas en personas de 5 a 14 anos,2005-10-01,0,1,0,1,1
OKINAWA,consulta externa,repetidas en personas de 5 a 14 anos,2005-10-01,1,16,1,16,17
OMEREQUE,consulta externa,repetidas en personas de 5 a 14 anos,2005-10-01,1,0,1,0,1
ORURO,consulta externa,repetidas en personas de 5 a 14 anos,2005-10-01,494,495,494,495,989
PADCAYA,consulta externa,repetidas en personas de 5 a 14 anos,2005-10-01,3,2,3,2,5
PADILLA,consulta externa,repetidas en personas de 5 a 14 anos,2005-10-01,6,2,6,2,8
PAILON,consulta externa,repetidas en personas de 5 a 14 anos,2005-10-01,0,2,0,2,2
PALCA,consulta externa,repetidas en personas de 5 a 14 anos,2005-10-01,6,0,6,0,6
PALOS BLANCOS,consulta externa,repetidas en personas de 5 a 14 anos,2005-10-01,16,21,16,21,37
PAMPA AULLAGAS,consulta externa,repetidas en personas de 5 a 14 anos,2005-10-01,1,0,1,0,1
PAMPA GRANDE,consulta externa,repetidas en personas de 5 a 14 anos,2005-10-01,6,2,6,2,8
PAPEL PAMPA,consulta externa,repetidas en personas de 5 a 14 anos,2005-10-01,1,0,1,0,1
PATACAMAYA,consulta externa,repetidas en personas de 5 a 14 anos,2005-10-01,1,1,1,1,2
PAZÑA,consulta externa,repetidas en personas de 5 a 14 anos,2005-10-01,3,5,3,5,8
PELECHUCO,consulta externa,repetidas en personas de 5 a 14 anos,2005-10-01,1,0,1,0,1
POCOATA,consulta externa,repetidas en personas de 5 a 14 anos,2005-10-01,1,2,1,2,3
POCONA,consulta externa,repetidas en personas de 5 a 14 anos,2005-10-01,1,5,1,5,6
POOPO,consulta externa,repetidas en personas de 5 a 14 anos,2005-10-01,0,1,0,1,1
PORCO,consulta externa,repetidas en personas de 5 a 14 anos,2005-10-01,3,2,3,2,5
PORONGO,consulta externa,repetidas en personas de 5 a 14 anos,2005-10-01,0,3,0,3,3
PORTACHUELO,consulta externa,repetidas en personas de 5 a 14 anos,2005-10-01,23,14,23,14,37
POTOSI,consulta externa,repetidas en personas de 5 a 14 anos,2005-10-01,529,479,529,479,1008
PRESTO,consulta externa,repetidas en personas de 5 a 14 anos,2005-10-01,4,1,4,1,5
PUCARANI,consulta externa,repetidas en personas de 5 a 14 anos,2005-10-01,2,3,2,3,5
PUERTO ACOSTA,consulta externa,repetidas en personas de 5 a 14 anos,2005-10-01,0,2176,0,2176,2176
PUERTO CARABUCO,consulta externa,repetidas en personas de 5 a 14 anos,2005-10-01,1,2,1,2,3
PUERTO GONZALO MORENO,consulta externa,repetidas en personas de 5 a 14 anos,2005-10-01,2,2,2,2,4
PUERTO PEREZ,consulta externa,repetidas en personas de 5 a 14 anos,2005-10-01,9,1,9,1,10
PUERTO QUIJARRO,consulta externa,repetidas en personas de 5 a 14 anos,2005-10-01,12,10,12,10,22
PUERTO SUAREZ,consulta externa,repetidas en personas de 5 a 14 anos,2005-10-01,10,11,10,11,21
PUERTO VILLARROEL,consulta externa,repetidas en personas de 5 a 14 anos,2005-10-01,16,17,16,17,33
PUNA,consulta externa,repetidas en personas de 5 a 14 anos,2005-10-01,2,3,2,3,5
PUNATA,consulta externa,repetidas en personas de 5 a 14 anos,2005-10-01,33,38,33,38,71
QUILLACOLLO,consulta externa,repetidas en personas de 5 a 14 anos,2005-10-01,36,42,36,42,78
QUIRUSILLAS,consulta externa,repetidas en personas de 5 a 14 anos,2005-10-01,1,0,1,0,1
REYES,consulta externa,repetidas en personas de 5 a 14 anos,2005-10-01,2,4,2,4,6
RIBERALTA,consulta externa,repetidas en personas de 5 a 14 anos,2005-10-01,7,19,7,19,26
ROBORE,consulta externa,repetidas en personas de 5 a 14 anos,2005-10-01,2,1,2,1,3
RURRENABAQUE,consulta externa,repetidas en personas de 5 a 14 anos,2005-10-01,9,9,9,9,18
SACABA,consulta externa,repetidas en personas de 5 a 14 anos,2005-10-01,54,70,54,70,124
SACABAMBA,consulta externa,repetidas en personas de 5 a 14 anos,2005-10-01,6,2,6,2,8
SACACA,consulta externa,repetidas en personas de 5 a 14 anos,2005-10-01,1,1,1,1,2
SAN AGUSTIN,consulta externa,repetidas en personas de 5 a 14 anos,2005-10-01,2,0,2,0,2
SAN ANDRES,consulta externa,repetidas en personas de 5 a 14 anos,2005-10-01,1,1,1,1,2
SAN ANDRES DE MACHACA,consulta externa,repetidas en personas de 5 a 14 anos,2005-10-01,0,1,0,1,1
SAN ANTONIO DE ESMORUCO,consulta externa,repetidas en personas de 5 a 14 anos,2005-10-01,0,1,0,1,1
SAN ANTONIO DE LOMERIO,consulta externa,repetidas en personas de 5 a 14 anos,2005-10-01,1,0,1,0,1
SAN BENITO,consulta externa,repetidas en personas de 5 a 14 anos,2005-10-01,7,15,7,15,22
SAN BORJA,consulta externa,repetidas en personas de 5 a 14 anos,2005-10-01,10,13,10,13,23
SAN BUENA VENTURA,consulta externa,repetidas en personas de 5 a 14 anos,2005-10-01,2,2,2,2,4
SAN CARLOS,consulta externa,repetidas en personas de 5 a 14 anos,2005-10-01,3,25,3,25,28
SAN IGNACIO,consulta externa,repetidas en personas de 5 a 14 anos,2005-10-01,15,13,15,13,28
SAN IGNACIO DE VELASCO,consulta externa,repetidas en personas de 5 a 14 anos,2005-10-01,13,13,13,13,26
SAN JAVIER(BNI),consulta externa,repetidas en personas de 5 a 14 anos,2005-10-01,1,1,1,1,2
SAN JAVIER(STC),consulta externa,repetidas en personas de 5 a 14 anos,2005-10-01,14,3,14,3,17
SAN JOAQUIN,consulta externa,repetidas en personas de 5 a 14 anos,2005-10-01,1,1,1,1,2
SAN JOSE DE CHIQUITOS,consulta externa,repetidas en personas de 5 a 14 anos,2005-10-01,4,5,4,5,9
SAN JUAN DE YAPACANI,consulta externa,repetidas en personas de 5 a 14 anos,2005-10-01,8,8,8,8,16
SAN JULIAN,consulta externa,repetidas en personas de 5 a 14 anos,2005-10-01,10,7,10,7,17
SAN LORENZO(PND),consulta externa,repetidas en personas de 5 a 14 anos,2005-10-01,10,42,10,42,52
SAN LORENZO(TJA),consulta externa,repetidas en personas de 5 a 14 anos,2005-10-01,12,12,12,12,24
SAN LUCAS,consulta externa,repetidas en personas de 5 a 14 anos,2005-10-01,8,6,8,6,14
SAN MATIAS,consulta externa,repetidas en personas de 5 a 14 anos,2005-10-01,0,2,0,2,2
SAN MIGUEL DE VELASCO,consulta externa,repetidas en personas de 5 a 14 anos,2005-10-01,8,13,8,13,21
SAN PABLO DE LIPEZ,consulta externa,repetidas en personas de 5 a 14 anos,2005-10-01,1,5,1,5,6
SAN PEDRO,consulta externa,repetidas en personas de 5 a 14 anos,2005-10-01,14,11,14,11,25
SAN PEDRO DE BUENA VISTA,consulta externa,repetidas en personas de 5 a 14 anos,2005-10-01,1,1,1,1,2
SAN PEDRO DE CURAHUARA,consulta externa,repetidas en personas de 5 a 14 anos,2005-10-01,2,1,2,1,3
SAN PEDRO DE TIQUINA,consulta externa,repetidas en personas de 5 a 14 anos,2005-10-01,1,0,1,0,1
SAN RAFAEL,consulta externa,repetidas en personas de 5 a 14 anos,2005-10-01,2,1,2,1,3
SAN RAMON,consulta externa,repetidas en personas de 5 a 14 anos,2005-10-01,2,4,2,4,6
SAN RAMON,consulta externa,repetidas en personas de 5 a 14 anos,2005-10-01,3,5,3,5,8
SANTA ANA,consulta externa,repetidas en personas de 5 a 14 anos,2005-10-01,9,6,9,6,15
SANTA CRUZ DE LA SIERRA,consulta externa,repetidas en personas de 5 a 14 anos,2005-10-01,2755,3881,2755,3881,6636
SANTA ROSA,consulta externa,repetidas en personas de 5 a 14 anos,2005-10-01,3,5,3,5,8
SANTA ROSA DEL SARA,consulta externa,repetidas en personas de 5 a 14 anos,2005-10-01,4,6,4,6,10
SANTIAGO DE HUARI,consulta externa,repetidas en personas de 5 a 14 anos,2005-10-01,14,1,14,1,15
SANTIAGO DE MACHACA,consulta externa,repetidas en personas de 5 a 14 anos,2005-10-01,0,1,0,1,1
SANTIVAÑES,consulta externa,repetidas en personas de 5 a 14 anos,2005-10-01,5,1,5,1,6
SAPAHAQUI,consulta externa,repetidas en personas de 5 a 14 anos,2005-10-01,1,4,1,4,5
SICA SICA (VILLA AROMA),consulta externa,repetidas en personas de 5 a 14 anos,2005-10-01,1,0,1,0,1
SIPE SIPE,consulta externa,repetidas en personas de 5 a 14 anos,2005-10-01,6,9,6,9,15
SORACACHI,consulta externa,repetidas en personas de 5 a 14 anos,2005-10-01,1,3,1,3,4
SORATA,consulta externa,repetidas en personas de 5 a 14 anos,2005-10-01,8,3,8,3,11
SUCRE,consulta externa,repetidas en personas de 5 a 14 anos,2005-10-01,1127,702,1127,702,1829
TACACHI,consulta externa,repetidas en personas de 5 a 14 anos,2005-10-01,3,4,3,4,7
TACOBAMBA,consulta externa,repetidas en personas de 5 a 14 anos,2005-10-01,1,1,1,1,2
TAPACARI,consulta externa,repetidas en personas de 5 a 14 anos,2005-10-01,7,7,7,7,14
TARABUCO,consulta externa,repetidas en personas de 5 a 14 anos,2005-10-01,3,1,3,1,4
TARACO,consulta externa,repetidas en personas de 5 a 14 anos,2005-10-01,1,0,1,0,1
TARATA,consulta externa,repetidas en personas de 5 a 14 anos,2005-10-01,7,5,7,5,12
TARIJA,consulta externa,repetidas en personas de 5 a 14 anos,2005-10-01,585,562,585,562,1147
TARVITA,consulta externa,repetidas en personas de 5 a 14 anos,2005-10-01,32,76,32,76,108
TEOPONTE,consulta externa,repetidas en personas de 5 a 14 anos,2005-10-01,0,4,0,4,4
TIAWANACU,consulta externa,repetidas en personas de 5 a 14 anos,2005-10-01,0,1,0,1,1
TINGUIPAYA,consulta externa,repetidas en personas de 5 a 14 anos,2005-10-01,1,0,1,0,1
TIPUANI,consulta externa,repetidas en personas de 5 a 14 anos,2005-10-01,2,0,2,0,2
TIQUIPAYA,consulta externa,repetidas en personas de 5 a 14 anos,2005-10-01,28,32,28,32,60
TIRAQUE (CBBA),consulta externa,repetidas en personas de 5 a 14 anos,2005-10-01,28,26,28,26,54
TITO YUPANQUI (PARQUIPUJIO),consulta externa,repetidas en personas de 5 a 14 anos,2005-10-01,0,1,0,1,1
TOCO,consulta externa,repetidas en personas de 5 a 14 anos,2005-10-01,0,1,0,1,1
TOLATA,consulta externa,repetidas en personas de 5 a 14 anos,2005-10-01,1,2,1,2,3
TOLEDO,consulta externa,repetidas en personas de 5 a 14 anos,2005-10-01,1,3,1,3,4
TOMAVE,consulta externa,repetidas en personas de 5 a 14 anos,2005-10-01,2,1,2,1,3
TOMINA,consulta externa,repetidas en personas de 5 a 14 anos,2005-10-01,2,4,2,4,6
TOTORA(CBBA),consulta externa,repetidas en personas de 5 a 14 anos,2005-10-01,2,3,2,3,5
TOTORA(ORR),consulta externa,repetidas en personas de 5 a 14 anos,2005-10-01,1,0,1,0,1
TRIGAL,consulta externa,repetidas en personas de 5 a 14 anos,2005-10-01,1,0,1,0,1
TRINIDAD,consulta externa,repetidas en personas de 5 a 14 anos,2005-10-01,74,122,74,122,196
TUPIZA,consulta externa,repetidas en personas de 5 a 14 anos,2005-10-01,60,87,60,87,147
UNCIA,consulta externa,repetidas en personas de 5 a 14 anos,2005-10-01,53,33,53,33,86
URIONDO (A. CONCEPCION),consulta externa,repetidas en personas de 5 a 14 anos,2005-10-01,5,1,5,1,6
UYUNI,consulta externa,repetidas en personas de 5 a 14 anos,2005-10-01,7,7,7,7,14
VACAS,consulta externa,repetidas en personas de 5 a 14 anos,2005-10-01,14,4,14,4,18
VALLEGRANDE,consulta externa,repetidas en personas de 5 a 14 anos,2005-10-01,22,34,22,34,56
VIACHA,consulta externa,repetidas en personas de 5 a 14 anos,2005-10-01,42,40,42,40,82
VILLA MONTES,consulta externa,repetidas en personas de 5 a 14 anos,2005-10-01,62,26,62,26,88
VILLA NUEVA (LOMA ALTA),consulta externa,repetidas en personas de 5 a 14 anos,2005-10-01,0,1,0,1,1
VILLA RIVERO,consulta externa,repetidas en personas de 5 a 14 anos,2005-10-01,1,0,1,0,1
VILLA SERRANO,consulta externa,repetidas en personas de 5 a 14 anos,2005-10-01,1,0,1,0,1
VILLA TUNARI,consulta externa,repetidas en personas de 5 a 14 anos,2005-10-01,8,11,8,11,19
VILLA VACA GUZMAN (MUYUPAMPA),consulta externa,repetidas en personas de 5 a 14 anos,2005-10-01,8,7,8,7,15
VILLAZON,consulta externa,repetidas en personas de 5 a 14 anos,2005-10-01,10,15,10,15,25
VINTO,consulta externa,repetidas en personas de 5 a 14 anos,2005-10-01,30,11,30,11,41
VITICHI,consulta externa,repetidas en personas de 5 a 14 anos,2005-10-01,2,0,2,0,2
WALDO BALLIVIAN,consulta externa,repetidas en personas de 5 a 14 anos,2005-10-01,1,2,1,2,3
WARNES,consulta externa,repetidas en personas de 5 a 14 anos,2005-10-01,13,13,13,13,26
YACUIBA,consulta externa,repetidas en personas de 5 a 14 anos,2005-10-01,170,154,170,154,324
YAMPARAEZ,consulta externa,repetidas en personas de 5 a 14 anos,2005-10-01,5,6,5,6,11
YANACACHI,consulta externa,repetidas en personas de 5 a 14 anos,2005-10-01,0,2,0,2,2
YAPACANI,consulta externa,repetidas en personas de 5 a 14 anos,2005-10-01,2,5,2,5,7
YOTALA,consulta externa,repetidas en personas de 5 a 14 anos,2005-10-01,7,7,7,7,14
ACACIO,consulta externa,repetidas en personas de 5 a 14 anos,2005-11-01,3,0,3,0,3
ACHACACHI,consulta externa,repetidas en personas de 5 a 14 anos,2005-11-01,11,7,11,7,18
ACHOCALLA,consulta externa,repetidas en personas de 5 a 14 anos,2005-11-01,3,1,3,1,4
AIQUILE,consulta externa,repetidas en personas de 5 a 14 anos,2005-11-01,30,38,30,38,68
ANCORAIMES,consulta externa,repetidas en personas de 5 a 14 anos,2005-11-01,1,0,1,0,1
ANTEQUERA,consulta externa,repetidas en personas de 5 a 14 anos,2005-11-01,0,2,0,2,2
ANZALDO,consulta externa,repetidas en personas de 5 a 14 anos,2005-11-01,1,2,1,2,3
APOLO,consulta externa,repetidas en personas de 5 a 14 anos,2005-11-01,0,1,0,1,1
ARANI,consulta externa,repetidas en personas de 5 a 14 anos,2005-11-01,0,5,0,5,5
ARBIETO,consulta externa,repetidas en personas de 5 a 14 anos,2005-11-01,8,4,8,4,12
ARQUE,consulta externa,repetidas en personas de 5 a 14 anos,2005-11-01,2,1,2,1,3
ASCENCION DE GUARAYOS,consulta externa,repetidas en personas de 5 a 14 anos,2005-11-01,5,8,5,8,13
ATOCHA,consulta externa,repetidas en personas de 5 a 14 anos,2005-11-01,70,52,70,52,122
AUCAPATA,consulta externa,repetidas en personas de 5 a 14 anos,2005-11-01,0,2,0,2,2
AYATA,consulta externa,repetidas en personas de 5 a 14 anos,2005-11-01,10,5,10,5,15
AYO AYO,consulta externa,repetidas en personas de 5 a 14 anos,2005-11-01,1,3,1,3,4
AYOPAYA (V. DE INDEPENDENCIA),consulta externa,repetidas en personas de 5 a 14 anos,2005-11-01,3,2,3,2,5
BATALLAS,consulta externa,repetidas en personas de 5 a 14 anos,2005-11-01,3,0,3,0,3
BAURES,consulta externa,repetidas en personas de 5 a 14 anos,2005-11-01,2,3,2,3,5
BELEN DE ANDAMARCA,consulta externa,repetidas en personas de 5 a 14 anos,2005-11-01,1,0,1,0,1
BELEN DE URMIRI,consulta externa,repetidas en personas de 5 a 14 anos,2005-11-01,0,1,0,1,1
BELLA FLOR,consulta externa,repetidas en personas de 5 a 14 anos,2005-11-01,9,11,9,11,20
BERMEJO,consulta externa,repetidas en personas de 5 a 14 anos,2005-11-01,31,25,31,25,56
BETANZOS,consulta externa,repetidas en personas de 5 a 14 anos,2005-11-01,12,2,12,2,14
BOLIVAR,consulta externa,repetidas en personas de 5 a 14 anos,2005-11-01,3,0,3,0,3
BOYUIBE,consulta externa,repetidas en personas de 5 a 14 anos,2005-11-01,2,1,2,1,3
BUENA VISTA,consulta externa,repetidas en personas de 5 a 14 anos,2005-11-01,19,9,19,9,28
CABEZAS,consulta externa,repetidas en personas de 5 a 14 anos,2005-11-01,3,9,3,9,12
CAIROMA,consulta externa,repetidas en personas de 5 a 14 anos,2005-11-01,1,0,1,0,1
"CAIZA ""D""",consulta externa,repetidas en personas de 5 a 14 anos,2005-11-01,5,1,5,1,6
CAJUATA,consulta externa,repetidas en personas de 5 a 14 anos,2005-11-01,0,2,0,2,2
CALACOTO,consulta externa,repetidas en personas de 5 a 14 anos,2005-11-01,0,1,0,1,1
CALAMARCA,consulta externa,repetidas en personas de 5 a 14 anos,2005-11-01,1,0,1,0,1
CAMARGO,consulta externa,repetidas en personas de 5 a 14 anos,2005-11-01,3,3,3,3,6
CAMATAQUI (C. VILLA ABECIA),consulta externa,repetidas en personas de 5 a 14 anos,2005-11-01,2,1,2,1,3
CAMIRI,consulta externa,repetidas en personas de 5 a 14 anos,2005-11-01,29,52,29,52,81
CAPINOTA,consulta externa,repetidas en personas de 5 a 14 anos,2005-11-01,11,12,11,12,23
CARACOLLO,consulta externa,repetidas en personas de 5 a 14 anos,2005-11-01,1,0,1,0,1
CARANAVI,consulta externa,repetidas en personas de 5 a 14 anos,2005-11-01,1,12,1,12,13
CARAPARI,consulta externa,repetidas en personas de 5 a 14 anos,2005-11-01,1,2,1,2,3
CARMEN RIVERO TORREZ,consulta externa,repetidas en personas de 5 a 14 anos,2005-11-01,1,2,1,2,3
CHALLAPATA,consulta externa,repetidas en personas de 5 a 14 anos,2005-11-01,12,8,12,8,20
CHAQUI,consulta externa,repetidas en personas de 5 a 14 anos,2005-11-01,1,1,1,1,2
CHARAGUA,consulta externa,repetidas en personas de 5 a 14 anos,2005-11-01,7,4,7,4,11
CHAYANTA,consulta externa,repetidas en personas de 5 a 14 anos,2005-11-01,6,6,6,6,12
CHIMORE,consulta externa,repetidas en personas de 5 a 14 anos,2005-11-01,3,8,3,8,11
CHIPAYA,consulta externa,repetidas en personas de 5 a 14 anos,2005-11-01,1,1,1,1,2
CHOQUE COTA,consulta externa,repetidas en personas de 5 a 14 anos,2005-11-01,12,5,12,5,17
CHULUMANI (V. DE LA LIBERTAD),consulta externa,repetidas en personas de 5 a 14 anos,2005-11-01,13,11,13,11,24
CHUMA,consulta externa,repetidas en personas de 5 a 14 anos,2005-11-01,0,2,0,2,2
CLIZA,consulta externa,repetidas en personas de 5 a 14 anos,2005-11-01,3,3,3,3,6
COBIJA,consulta externa,repetidas en personas de 5 a 14 anos,2005-11-01,27,27,27,27,54
COCHABAMBA,consulta externa,repetidas en personas de 5 a 14 anos,2005-11-01,1633,1614,1633,1614,3247
COLCAPIRHUA,consulta externa,repetidas en personas de 5 a 14 anos,2005-11-01,30,34,30,34,64
"COLCHA ""K""",consulta externa,repetidas en personas de 5 a 14 anos,2005-11-01,1,2,1,2,3
COLLANA,consulta externa,repetidas en personas de 5 a 14 anos,2005-11-01,2,0,2,0,2
COLOMI,consulta externa,repetidas en personas de 5 a 14 anos,2005-11-01,0,2,0,2,2
COLPA BELGICA,consulta externa,repetidas en personas de 5 a 14 anos,2005-11-01,0,3,0,3,3
COLQUECHACA,consulta externa,repetidas en personas de 5 a 14 anos,2005-11-01,7,4,7,4,11
COLQUENCHA,consulta externa,repetidas en personas de 5 a 14 anos,2005-11-01,0,1,0,1,1
COLQUIRI,consulta externa,repetidas en personas de 5 a 14 anos,2005-11-01,3,3,3,3,6
COMANCHE,consulta externa,repetidas en personas de 5 a 14 anos,2005-11-01,0,1,0,1,1
COMARAPA,consulta externa,repetidas en personas de 5 a 14 anos,2005-11-01,9,18,9,18,27
COMBAYA,consulta externa,repetidas en personas de 5 a 14 anos,2005-11-01,0,1,0,1,1
CONCEPCION,consulta externa,repetidas en personas de 5 a 14 anos,2005-11-01,2,1,2,1,3
CORIPATA,consulta externa,repetidas en personas de 5 a 14 anos,2005-11-01,0,3,0,3,3
CORO CORO,consulta externa,repetidas en personas de 5 a 14 anos,2005-11-01,5,0,5,0,5
COROICO,consulta externa,repetidas en personas de 5 a 14 anos,2005-11-01,8,10,8,10,18
CORQUE,consulta externa,repetidas en personas de 5 a 14 anos,2005-11-01,5,2,5,2,7
COTAGAITA,consulta externa,repetidas en personas de 5 a 14 anos,2005-11-01,8,8,8,8,16
COTOCA,consulta externa,repetidas en personas de 5 a 14 anos,2005-11-01,2,0,2,0,2
CUATRO CAÑADAS,consulta externa,repetidas en personas de 5 a 14 anos,2005-11-01,8,2,8,2,10
CUCHUMUELA (V. G. VILLARROEL),consulta externa,repetidas en personas de 5 a 14 anos,2005-11-01,4,1,4,1,5
CUEVO,consulta externa,repetidas en personas de 5 a 14 anos,2005-11-01,2,2,2,2,4
CULPINA,consulta externa,repetidas en personas de 5 a 14 anos,2005-11-01,4,2,4,2,6
CURAHUARA DE CARANGAS,consulta externa,repetidas en personas de 5 a 14 anos,2005-11-01,1,3,1,3,4
EL ALTO,consulta externa,repetidas en personas de 5 a 14 anos,2005-11-01,1828,2192,1828,2192,4020
EL CHORO,consulta externa,repetidas en personas de 5 a 14 anos,2005-11-01,3,1,3,1,4
EL PUENTE(STC),consulta externa,repetidas en personas de 5 a 14 anos,2005-11-01,0,1,0,1,1
EL PUENTE(TJA),consulta externa,repetidas en personas de 5 a 14 anos,2005-11-01,1,1,1,1,2
EL TORNO,consulta externa,repetidas en personas de 5 a 14 anos,2005-11-01,61,57,61,57,118
EL VILLAR,consulta externa,repetidas en personas de 5 a 14 anos,2005-11-01,0,1,0,1,1
ENTRE RIOS,consulta externa,repetidas en personas de 5 a 14 anos,2005-11-01,19,11,19,11,30
ENTRE RIOS,consulta externa,repetidas en personas de 5 a 14 anos,2005-11-01,8,6,8,6,14
EUCALIPTUS,consulta externa,repetidas en personas de 5 a 14 anos,2005-11-01,3,0,3,0,3
EUREKA (SANTOS MERCADO),consulta externa,repetidas en personas de 5 a 14 anos,2005-11-01,1,0,1,0,1
FERNANDEZ ALONSO,consulta externa,repetidas en personas de 5 a 14 anos,2005-11-01,2,6,2,6,8
GENERAL SAAVEDRA,consulta externa,repetidas en personas de 5 a 14 anos,2005-11-01,4,11,4,11,15
GUANAY,consulta externa,repetidas en personas de 5 a 14 anos,2005-11-01,0,1,0,1,1
GUAQUI,consulta externa,repetidas en personas de 5 a 14 anos,2005-11-01,3,2,3,2,5
GUAYARAMERIN,consulta externa,repetidas en personas de 5 a 14 anos,2005-11-01,55,69,55,69,124
GUTIERREZ,consulta externa,repetidas en personas de 5 a 14 anos,2005-11-01,6,17,6,17,23
HUACARETA,consulta externa,repetidas en personas de 5 a 14 anos,2005-11-01,7,5,7,5,12
HUACAYA (VILLA DE HUACAYA),consulta externa,repetidas en personas de 5 a 14 anos,2005-11-01,0,1,0,1,1
HUANUNI,consulta externa,repetidas en personas de 5 a 14 anos,2005-11-01,202,274,202,274,476
HUARACAJE,consulta externa,repetidas en personas de 5 a 14 anos,2005-11-01,7,2,7,2,9
HUAYLLAMARCA,consulta externa,repetidas en personas de 5 a 14 anos,2005-11-01,2,0,2,0,2
ICHOCA,consulta externa,repetidas en personas de 5 a 14 anos,2005-11-01,1,1,1,1,2
ICLA,consulta externa,repetidas en personas de 5 a 14 anos,2005-11-01,0,1,0,1,1
INQUISIVI,consulta externa,repetidas en personas de 5 a 14 anos,2005-11-01,2,0,2,0,2
IRUPANA (VILLA DE LANZA),consulta externa,repetidas en personas de 5 a 14 anos,2005-11-01,3,2,3,2,5
IXIAMAS,consulta externa,repetidas en personas de 5 a 14 anos,2005-11-01,4,2,4,2,6
JESUS DE MACHACA,consulta externa,repetidas en personas de 5 a 14 anos,2005-11-01,2,6,2,6,8
LA GUARDIA,consulta externa,repetidas en personas de 5 a 14 anos,2005-11-01,13,8,13,8,21
LA PAZ,consulta externa,repetidas en personas de 5 a 14 anos,2005-11-01,2718,2708,2718,2708,5426
LAGUNILLAS,consulta externa,repetidas en personas de 5 a 14 anos,2005-11-01,2,1,2,1,3
LAJA,consulta externa,repetidas en personas de 5 a 14 anos,2005-11-01,2,0,2,0,2
LAS CARRERAS,consulta externa,repetidas en personas de 5 a 14 anos,2005-11-01,1,1,1,1,2
LICOMA PAMPA,consulta externa,repetidas en personas de 5 a 14 anos,2005-11-01,2,0,2,0,2
LLALLAGUA,consulta externa,repetidas en personas de 5 a 14 anos,2005-11-01,10,11,10,11,21
LLICA,consulta externa,repetidas en personas de 5 a 14 anos,2005-11-01,1,2,1,2,3
LORETO,consulta externa,repetidas en personas de 5 a 14 anos,2005-11-01,2,1,2,1,3
LURIBAY,consulta externa,repetidas en personas de 5 a 14 anos,2005-11-01,3,0,3,0,3
MACHACAMARCA,consulta externa,repetidas en personas de 5 a 14 anos,2005-11-01,1,3,1,3,4
MACHARETI,consulta externa,repetidas en personas de 5 a 14 anos,2005-11-01,1,0,1,0,1
MAGDALENA,consulta externa,repetidas en personas de 5 a 14 anos,2005-11-01,13,12,13,12,25
MAIRANA,consulta externa,repetidas en personas de 5 a 14 anos,2005-11-01,1,1,1,1,2
MALLA,consulta externa,repetidas en personas de 5 a 14 anos,2005-11-01,2,18,2,18,20
MAPIRI,consulta externa,repetidas en personas de 5 a 14 anos,2005-11-01,1,1,1,1,2
MECAPACA,consulta externa,repetidas en personas de 5 a 14 anos,2005-11-01,13,13,13,13,26
MINEROS,consulta externa,repetidas en personas de 5 a 14 anos,2005-11-01,3,37,3,37,40
MIZQUE,consulta externa,repetidas en personas de 5 a 14 anos,2005-11-01,1,2,1,2,3
MOCOMOCO,consulta externa,repetidas en personas de 5 a 14 anos,2005-11-01,3,1,3,1,4
MONTEAGUDO,consulta externa,repetidas en personas de 5 a 14 anos,2005-11-01,23,21,23,21,44
MONTERO,consulta externa,repetidas en personas de 5 a 14 anos,2005-11-01,168,156,168,156,324
MOROCHATA,consulta externa,repetidas en personas de 5 a 14 anos,2005-11-01,1,1,1,1,2
NACEBE (SANTA ROSA DEL ABUNA),consulta externa,repetidas en personas de 5 a 14 anos,2005-11-01,8,0,8,0,8
NUEVO MANOA (NUEVA ESPERANZA),consulta externa,repetidas en personas de 5 a 14 anos,2005-11-01,0,2,0,2,2
OCURI,consulta externa,repetidas en personas de 5 a 14 anos,2005-11-01,2,1,2,1,3
OKINAWA,consulta externa,repetidas en personas de 5 a 14 anos,2005-11-01,9,7,9,7,16
OMEREQUE,consulta externa,repetidas en personas de 5 a 14 anos,2005-11-01,1,1,1,1,2
ORURO,consulta externa,repetidas en personas de 5 a 14 anos,2005-11-01,450,452,450,452,902
PADCAYA,consulta externa,repetidas en personas de 5 a 14 anos,2005-11-01,4,6,4,6,10
PADILLA,consulta externa,repetidas en personas de 5 a 14 anos,2005-11-01,4,1,4,1,5
PAILON,consulta externa,repetidas en personas de 5 a 14 anos,2005-11-01,2,1,2,1,3
PALCA,consulta externa,repetidas en personas de 5 a 14 anos,2005-11-01,6,2,6,2,8
PALOS BLANCOS,consulta externa,repetidas en personas de 5 a 14 anos,2005-11-01,20,9,20,9,29
PAMPA AULLAGAS,consulta externa,repetidas en personas de 5 a 14 anos,2005-11-01,0,2,0,2,2
PAMPA GRANDE,consulta externa,repetidas en personas de 5 a 14 anos,2005-11-01,0,2,0,2,2
PATACAMAYA,consulta externa,repetidas en personas de 5 a 14 anos,2005-11-01,1,0,1,0,1
PAZÑA,consulta externa,repetidas en personas de 5 a 14 anos,2005-11-01,0,2,0,2,2
POCOATA,consulta externa,repetidas en personas de 5 a 14 anos,2005-11-01,3,1,3,1,4
POCONA,consulta externa,repetidas en personas de 5 a 14 anos,2005-11-01,2,0,2,0,2
POJO (CBBA),consulta externa,repetidas en personas de 5 a 14 anos,2005-11-01,2,2,2,2,4
POOPO,consulta externa,repetidas en personas de 5 a 14 anos,2005-11-01,0,2,0,2,2
PORCO,consulta externa,repetidas en personas de 5 a 14 anos,2005-11-01,1,0,1,0,1
POROMA,consulta externa,repetidas en personas de 5 a 14 anos,2005-11-01,4,0,4,0,4
PORONGO,consulta externa,repetidas en personas de 5 a 14 anos,2005-11-01,15,12,15,12,27
PORTACHUELO,consulta externa,repetidas en personas de 5 a 14 anos,2005-11-01,10,20,10,20,30
PORVENIR,consulta externa,repetidas en personas de 5 a 14 anos,2005-11-01,0,1,0,1,1
POTOSI,consulta externa,repetidas en personas de 5 a 14 anos,2005-11-01,478,476,478,476,954
PUERTO ACOSTA,consulta externa,repetidas en personas de 5 a 14 anos,2005-11-01,2,4,2,4,6
PUERTO CARABUCO,consulta externa,repetidas en personas de 5 a 14 anos,2005-11-01,5,0,5,0,5
PUERTO GONZALO MORENO,consulta externa,repetidas en personas de 5 a 14 anos,2005-11-01,1,2,1,2,3
PUERTO PEREZ,consulta externa,repetidas en personas de 5 a 14 anos,2005-11-01,3,3,3,3,6
PUERTO QUIJARRO,consulta externa,repetidas en personas de 5 a 14 anos,2005-11-01,16,15,16,15,31
PUERTO RICO,consulta externa,repetidas en personas de 5 a 14 anos,2005-11-01,0,2,0,2,2
PUERTO SILES,consulta externa,repetidas en personas de 5 a 14 anos,2005-11-01,1,0,1,0,1
PUERTO SUAREZ,consulta externa,repetidas en personas de 5 a 14 anos,2005-11-01,7,7,7,7,14
PUERTO VILLARROEL,consulta externa,repetidas en personas de 5 a 14 anos,2005-11-01,54,35,54,35,89
PUNA,consulta externa,repetidas en personas de 5 a 14 anos,2005-11-01,1,3,1,3,4
PUNATA,consulta externa,repetidas en personas de 5 a 14 anos,2005-11-01,33,18,33,18,51
QUILLACOLLO,consulta externa,repetidas en personas de 5 a 14 anos,2005-11-01,35,39,35,39,74
QUIRUSILLAS,consulta externa,repetidas en personas de 5 a 14 anos,2005-11-01,0,1,0,1,1
REYES,consulta externa,repetidas en personas de 5 a 14 anos,2005-11-01,5,6,5,6,11
RIBERALTA,consulta externa,repetidas en personas de 5 a 14 anos,2005-11-01,32,16,32,16,48
ROBORE,consulta externa,repetidas en personas de 5 a 14 anos,2005-11-01,9,5,9,5,14
RURRENABAQUE,consulta externa,repetidas en personas de 5 a 14 anos,2005-11-01,8,7,8,7,15
SABAYA,consulta externa,repetidas en personas de 5 a 14 anos,2005-11-01,10,0,10,0,10
SACABA,consulta externa,repetidas en personas de 5 a 14 anos,2005-11-01,54,53,54,53,107
SACABAMBA,consulta externa,repetidas en personas de 5 a 14 anos,2005-11-01,0,2,0,2,2
SACACA,consulta externa,repetidas en personas de 5 a 14 anos,2005-11-01,1,0,1,0,1
SAIPINA,consulta externa,repetidas en personas de 5 a 14 anos,2005-11-01,10,20,10,20,30
SALINAS DE GARCI MENDOZA,consulta externa,repetidas en personas de 5 a 14 anos,2005-11-01,0,1,0,1,1
SAMAIPATA,consulta externa,repetidas en personas de 5 a 14 anos,2005-11-01,1,0,1,0,1
SAN ANDRES,consulta externa,repetidas en personas de 5 a 14 anos,2005-11-01,0,1,0,1,1
SAN ANTONIO DE ESMORUCO,consulta externa,repetidas en personas de 5 a 14 anos,2005-11-01,0,4,0,4,4
SAN ANTONIO DE LOMERIO,consulta externa,repetidas en personas de 5 a 14 anos,2005-11-01,2,0,2,0,2
SAN BENITO,consulta externa,repetidas en personas de 5 a 14 anos,2005-11-01,3,8,3,8,11
SAN BORJA,consulta externa,repetidas en personas de 5 a 14 anos,2005-11-01,17,18,17,18,35
SAN BUENA VENTURA,consulta externa,repetidas en personas de 5 a 14 anos,2005-11-01,1,2,1,2,3
SAN CARLOS,consulta externa,repetidas en personas de 5 a 14 anos,2005-11-01,6,5,6,5,11
SAN IGNACIO,consulta externa,repetidas en personas de 5 a 14 anos,2005-11-01,17,21,17,21,38
SAN IGNACIO DE VELASCO,consulta externa,repetidas en personas de 5 a 14 anos,2005-11-01,16,15,16,15,31
SAN JAVIER(BNI),consulta externa,repetidas en personas de 5 a 14 anos,2005-11-01,2,2,2,2,4
SAN JAVIER(STC),consulta externa,repetidas en personas de 5 a 14 anos,2005-11-01,6,1,6,1,7
SAN JOAQUIN,consulta externa,repetidas en personas de 5 a 14 anos,2005-11-01,1,2,1,2,3
SAN JOSE DE CHIQUITOS,consulta externa,repetidas en personas de 5 a 14 anos,2005-11-01,3,2,3,2,5
SAN JUAN DE YAPACANI,consulta externa,repetidas en personas de 5 a 14 anos,2005-11-01,6,10,6,10,16
SAN JULIAN,consulta externa,repetidas en personas de 5 a 14 anos,2005-11-01,10,5,10,5,15
SAN LORENZO(TJA),consulta externa,repetidas en personas de 5 a 14 anos,2005-11-01,5,2,5,2,7
SAN LUCAS,consulta externa,repetidas en personas de 5 a 14 anos,2005-11-01,12,5,12,5,17
SAN MATIAS,consulta externa,repetidas en personas de 5 a 14 anos,2005-11-01,2,0,2,0,2
SAN MIGUEL DE VELASCO,consulta externa,repetidas en personas de 5 a 14 anos,2005-11-01,14,10,14,10,24
SAN PABLO DE LIPEZ,consulta externa,repetidas en personas de 5 a 14 anos,2005-11-01,3,3,3,3,6
SAN PEDRO,consulta externa,repetidas en personas de 5 a 14 anos,2005-11-01,24,45,24,45,69
SAN PEDRO DE BUENA VISTA,consulta externa,repetidas en personas de 5 a 14 anos,2005-11-01,2,0,2,0,2
SAN PEDRO DE CURAHUARA,consulta externa,repetidas en personas de 5 a 14 anos,2005-11-01,2,1,2,1,3
SAN PEDRO DE TIQUINA,consulta externa,repetidas en personas de 5 a 14 anos,2005-11-01,1,0,1,0,1
SAN RAFAEL,consulta externa,repetidas en personas de 5 a 14 anos,2005-11-01,2,0,2,0,2
SAN RAMON,consulta externa,repetidas en personas de 5 a 14 anos,2005-11-01,6,6,6,6,12
SAN RAMON,consulta externa,repetidas en personas de 5 a 14 anos,2005-11-01,3,5,3,5,8
SANTA ANA,consulta externa,repetidas en personas de 5 a 14 anos,2005-11-01,14,19,14,19,33
SANTA CRUZ DE LA SIERRA,consulta externa,repetidas en personas de 5 a 14 anos,2005-11-01,2000,2334,2000,2334,4334
SANTA ROSA,consulta externa,repetidas en personas de 5 a 14 anos,2005-11-01,1,0,1,0,1
SANTA ROSA DEL SARA,consulta externa,repetidas en personas de 5 a 14 anos,2005-11-01,5,11,5,11,16
SANTIAGO DE HUARI,consulta externa,repetidas en personas de 5 a 14 anos,2005-11-01,3,2,3,2,5
SANTIVAÑES,consulta externa,repetidas en personas de 5 a 14 anos,2005-11-01,2,2,2,2,4
SANTUARIO DE QUILLACAS,consulta externa,repetidas en personas de 5 a 14 anos,2005-11-01,1,0,1,0,1
SAPAHAQUI,consulta externa,repetidas en personas de 5 a 14 anos,2005-11-01,1,1,1,1,2
SICA SICA (VILLA AROMA),consulta externa,repetidas en personas de 5 a 14 anos,2005-11-01,5,0,5,0,5
SICAYA,consulta externa,repetidas en personas de 5 a 14 anos,2005-11-01,0,1,0,1,1
SIPE SIPE,consulta externa,repetidas en personas de 5 a 14 anos,2005-11-01,7,9,7,9,16
SOPACHUY,consulta externa,repetidas en personas de 5 a 14 anos,2005-11-01,0,1,0,1,1
SORACACHI,consulta externa,repetidas en personas de 5 a 14 anos,2005-11-01,3,1,3,1,4
SORATA,consulta externa,repetidas en personas de 5 a 14 anos,2005-11-01,5,1,5,1,6
SUCRE,consulta externa,repetidas en personas de 5 a 14 anos,2005-11-01,812,762,812,762,1574
TACACHI,consulta externa,repetidas en personas de 5 a 14 anos,2005-11-01,4,5,4,5,9
TACOBAMBA,consulta externa,repetidas en personas de 5 a 14 anos,2005-11-01,2,1,2,1,3
TACOPAYA,consulta externa,repetidas en personas de 5 a 14 anos,2005-11-01,1,0,1,0,1
TAPACARI,consulta externa,repetidas en personas de 5 a 14 anos,2005-11-01,11,5,11,5,16
TARABUCO,consulta externa,repetidas en personas de 5 a 14 anos,2005-11-01,2,5,2,5,7
TARATA,consulta externa,repetidas en personas de 5 a 14 anos,2005-11-01,10,2,10,2,12
TARIJA,consulta externa,repetidas en personas de 5 a 14 anos,2005-11-01,412,454,412,454,866
TARVITA,consulta externa,repetidas en personas de 5 a 14 anos,2005-11-01,2,3,2,3,5
TIAWANACU,consulta externa,repetidas en personas de 5 a 14 anos,2005-11-01,0,2,0,2,2
TINGUIPAYA,consulta externa,repetidas en personas de 5 a 14 anos,2005-11-01,1,0,1,0,1
TIPUANI,consulta externa,repetidas en personas de 5 a 14 anos,2005-11-01,3,1,3,1,4
TIQUIPAYA,consulta externa,repetidas en personas de 5 a 14 anos,2005-11-01,53,100,53,100,153
TIRAQUE (CBBA),consulta externa,repetidas en personas de 5 a 14 anos,2005-11-01,29,23,29,23,52
TOCO,consulta externa,repetidas en personas de 5 a 14 anos,2005-11-01,0,1,0,1,1
TOLATA,consulta externa,repetidas en personas de 5 a 14 anos,2005-11-01,3,1,3,1,4
TOLEDO,consulta externa,repetidas en personas de 5 a 14 anos,2005-11-01,9,1,9,1,10
TOMAVE,consulta externa,repetidas en personas de 5 a 14 anos,2005-11-01,2,1,2,1,3
TOMINA,consulta externa,repetidas en personas de 5 a 14 anos,2005-11-01,0,1,0,1,1
TORO TORO,consulta externa,repetidas en personas de 5 a 14 anos,2005-11-01,0,2,0,2,2
TOTORA(ORR),consulta externa,repetidas en personas de 5 a 14 anos,2005-11-01,1,0,1,0,1
TRINIDAD,consulta externa,repetidas en personas de 5 a 14 anos,2005-11-01,112,143,112,143,255
TUPIZA,consulta externa,repetidas en personas de 5 a 14 anos,2005-11-01,57,81,57,81,138
TURCO,consulta externa,repetidas en personas de 5 a 14 anos,2005-11-01,1,4,1,4,5
UNCIA,consulta externa,repetidas en personas de 5 a 14 anos,2005-11-01,36,23,36,23,59
URIONDO (A. CONCEPCION),consulta externa,repetidas en personas de 5 a 14 anos,2005-11-01,6,4,6,4,10
URUBICHA,consulta externa,repetidas en personas de 5 a 14 anos,2005-11-01,0,1,0,1,1
UYUNI,consulta externa,repetidas en personas de 5 a 14 anos,2005-11-01,3,4,3,4,7
VACAS,consulta externa,repetidas en personas de 5 a 14 anos,2005-11-01,12,4,12,4,16
VALLEGRANDE,consulta externa,repetidas en personas de 5 a 14 anos,2005-11-01,11,13,11,13,24
VIACHA,consulta externa,repetidas en personas de 5 a 14 anos,2005-11-01,29,35,29,35,64
VILA VILA,consulta externa,repetidas en personas de 5 a 14 anos,2005-11-01,2,0,2,0,2
VILLA MONTES,consulta externa,repetidas en personas de 5 a 14 anos,2005-11-01,11,15,11,15,26
VILLA RIVERO,consulta externa,repetidas en personas de 5 a 14 anos,2005-11-01,0,1,0,1,1
VILLA SERRANO,consulta externa,repetidas en personas de 5 a 14 anos,2005-11-01,0,1,0,1,1
VILLA TUNARI,consulta externa,repetidas en personas de 5 a 14 anos,2005-11-01,23,39,23,39,62
VILLA VACA GUZMAN (MUYUPAMPA),consulta externa,repetidas en personas de 5 a 14 anos,2005-11-01,7,2,7,2,9
VILLAZON,consulta externa,repetidas en personas de 5 a 14 anos,2005-11-01,12,13,12,13,25
VINTO,consulta externa,repetidas en personas de 5 a 14 anos,2005-11-01,4,3,4,3,7
VITICHI,consulta externa,repetidas en personas de 5 a 14 anos,2005-11-01,2,0,2,0,2
WALDO BALLIVIAN,consulta externa,repetidas en personas de 5 a 14 anos,2005-11-01,2,0,2,0,2
WARNES,consulta externa,repetidas en personas de 5 a 14 anos,2005-11-01,26,21,26,21,47
YACUIBA,consulta externa,repetidas en personas de 5 a 14 anos,2005-11-01,106,134,106,134,240
YAMPARAEZ,consulta externa,repetidas en personas de 5 a 14 anos,2005-11-01,2,3,2,3,5
YANACACHI,consulta externa,repetidas en personas de 5 a 14 anos,2005-11-01,2,1,2,1,3
YAPACANI,consulta externa,repetidas en personas de 5 a 14 anos,2005-11-01,5,9,5,9,14
YOCALLA,consulta externa,repetidas en personas de 5 a 14 anos,2005-11-01,1,0,1,0,1
YOTALA,consulta externa,repetidas en personas de 5 a 14 anos,2005-11-01,7,1,7,1,8
ZUDAÑEZ,consulta externa,repetidas en personas de 5 a 14 anos,2005-11-01,3,0,3,0,3
ACHACACHI,consulta externa,repetidas en personas de 5 a 14 anos,2005-12-01,9,4,9,4,13
AIQUILE,consulta externa,repetidas en personas de 5 a 14 anos,2005-12-01,9,7,9,7,16
ANCORAIMES,consulta externa,repetidas en personas de 5 a 14 anos,2005-12-01,2,2,2,2,4
ANDAMARCA,consulta externa,repetidas en personas de 5 a 14 anos,2005-12-01,1,2,1,2,3
APOLO,consulta externa,repetidas en personas de 5 a 14 anos,2005-12-01,3,4,3,4,7
ARANI,consulta externa,repetidas en personas de 5 a 14 anos,2005-12-01,10,14,10,14,24
ARBIETO,consulta externa,repetidas en personas de 5 a 14 anos,2005-12-01,5,3,5,3,8
ASCENCION DE GUARAYOS,consulta externa,repetidas en personas de 5 a 14 anos,2005-12-01,7,13,7,13,20
ATOCHA,consulta externa,repetidas en personas de 5 a 14 anos,2005-12-01,33,58,33,58,91
AUCAPATA,consulta externa,repetidas en personas de 5 a 14 anos,2005-12-01,1,1,1,1,2
AYATA,consulta externa,repetidas en personas de 5 a 14 anos,2005-12-01,10,2,10,2,12
AYO AYO,consulta externa,repetidas en personas de 5 a 14 anos,2005-12-01,3,2,3,2,5
AYOPAYA (V. DE INDEPENDENCIA),consulta externa,repetidas en personas de 5 a 14 anos,2005-12-01,2,29,2,29,31
AZURDUY,consulta externa,repetidas en personas de 5 a 14 anos,2005-12-01,1,0,1,0,1
BATALLAS,consulta externa,repetidas en personas de 5 a 14 anos,2005-12-01,1,0,1,0,1
BAURES,consulta externa,repetidas en personas de 5 a 14 anos,2005-12-01,3,2,3,2,5
BELEN DE ANDAMARCA,consulta externa,repetidas en personas de 5 a 14 anos,2005-12-01,1,1,1,1,2
BELEN DE URMIRI,consulta externa,repetidas en personas de 5 a 14 anos,2005-12-01,0,2,0,2,2
BELLA FLOR,consulta externa,repetidas en personas de 5 a 14 anos,2005-12-01,9,9,9,9,18
BERMEJO,consulta externa,repetidas en personas de 5 a 14 anos,2005-12-01,84,70,84,70,154
BETANZOS,consulta externa,repetidas en personas de 5 a 14 anos,2005-12-01,1,1,1,1,2
BOLIVAR,consulta externa,repetidas en personas de 5 a 14 anos,2005-12-01,3,3,3,3,6
BOLPEBRA,consulta externa,repetidas en personas de 5 a 14 anos,2005-12-01,0,2,0,2,2
BOYUIBE,consulta externa,repetidas en personas de 5 a 14 anos,2005-12-01,6,2,6,2,8
BUENA VISTA,consulta externa,repetidas en personas de 5 a 14 anos,2005-12-01,14,9,14,9,23
CABEZAS,consulta externa,repetidas en personas de 5 a 14 anos,2005-12-01,1,1,1,1,2
CAJUATA,consulta externa,repetidas en personas de 5 a 14 anos,2005-12-01,6,2,6,2,8
CALAMARCA,consulta externa,repetidas en personas de 5 a 14 anos,2005-12-01,1,0,1,0,1
CAMARGO,consulta externa,repetidas en personas de 5 a 14 anos,2005-12-01,1,2,1,2,3
CAMIRI,consulta externa,repetidas en personas de 5 a 14 anos,2005-12-01,34,37,34,37,71
CAPINOTA,consulta externa,repetidas en personas de 5 a 14 anos,2005-12-01,3,9,3,9,12
CARANAVI,consulta externa,repetidas en personas de 5 a 14 anos,2005-12-01,3,3,3,3,6
CARAPARI,consulta externa,repetidas en personas de 5 a 14 anos,2005-12-01,0,1,0,1,1
CARMEN RIVERO TORREZ,consulta externa,repetidas en personas de 5 a 14 anos,2005-12-01,1,0,1,0,1
CHALLAPATA,consulta externa,repetidas en personas de 5 a 14 anos,2005-12-01,2,8,2,8,10
CHAQUI,consulta externa,repetidas en personas de 5 a 14 anos,2005-12-01,2,3,2,3,5
CHARAGUA,consulta externa,repetidas en personas de 5 a 14 anos,2005-12-01,4,3,4,3,7
CHAYANTA,consulta externa,repetidas en personas de 5 a 14 anos,2005-12-01,3,2,3,2,5
CHIMORE,consulta externa,repetidas en personas de 5 a 14 anos,2005-12-01,5,4,5,4,9
CHIPAYA,consulta externa,repetidas en personas de 5 a 14 anos,2005-12-01,1,0,1,0,1
CHULUMANI (V. DE LA LIBERTAD),consulta externa,repetidas en personas de 5 a 14 anos,2005-12-01,3,5,3,5,8
CHUMA,consulta externa,repetidas en personas de 5 a 14 anos,2005-12-01,2,0,2,0,2
CLIZA,consulta externa,repetidas en personas de 5 a 14 anos,2005-12-01,5,5,5,5,10
COBIJA,consulta externa,repetidas en personas de 5 a 14 anos,2005-12-01,31,48,31,48,79
COCHABAMBA,consulta externa,repetidas en personas de 5 a 14 anos,2005-12-01,1566,1754,1566,1754,3320
COLCAPIRHUA,consulta externa,repetidas en personas de 5 a 14 anos,2005-12-01,32,29,32,29,61
"COLCHA ""K""",consulta externa,repetidas en personas de 5 a 14 anos,2005-12-01,1,5,1,5,6
COLLANA,consulta externa,repetidas en personas de 5 a 14 anos,2005-12-01,4,0,4,0,4
COLOMI,consulta externa,repetidas en personas de 5 a 14 anos,2005-12-01,1,1,1,1,2
COLPA BELGICA,consulta externa,repetidas en personas de 5 a 14 anos,2005-12-01,3,3,3,3,6
COLQUECHACA,consulta externa,repetidas en personas de 5 a 14 anos,2005-12-01,4,3,4,3,7
COLQUIRI,consulta externa,repetidas en personas de 5 a 14 anos,2005-12-01,3,0,3,0,3
COMANCHE,consulta externa,repetidas en personas de 5 a 14 anos,2005-12-01,2,2,2,2,4
COMARAPA,consulta externa,repetidas en personas de 5 a 14 anos,2005-12-01,11,12,11,12,23
COMBAYA,consulta externa,repetidas en personas de 5 a 14 anos,2005-12-01,1,1,1,1,2
CONCEPCION,consulta externa,repetidas en personas de 5 a 14 anos,2005-12-01,2,1,2,1,3
COPACABANA,consulta externa,repetidas en personas de 5 a 14 anos,2005-12-01,1,0,1,0,1
CORIPATA,consulta externa,repetidas en personas de 5 a 14 anos,2005-12-01,0,2,0,2,2
COROICO,consulta externa,repetidas en personas de 5 a 14 anos,2005-12-01,7,10,7,10,17
CORQUE,consulta externa,repetidas en personas de 5 a 14 anos,2005-12-01,1,2,1,2,3
COTAGAITA,consulta externa,repetidas en personas de 5 a 14 anos,2005-12-01,10,10,10,10,20
COTOCA,consulta externa,repetidas en personas de 5 a 14 anos,2005-12-01,0,1,0,1,1
CUATRO CAÑADAS,consulta externa,repetidas en personas de 5 a 14 anos,2005-12-01,3,2,3,2,5
CUEVO,consulta externa,repetidas en personas de 5 a 14 anos,2005-12-01,2,4,2,4,6
CULPINA,consulta externa,repetidas en personas de 5 a 14 anos,2005-12-01,2,0,2,0,2
EL ALTO,consulta externa,repetidas en personas de 5 a 14 anos,2005-12-01,1465,1404,1465,1404,2869
EL PUENTE(STC),consulta externa,repetidas en personas de 5 a 14 anos,2005-12-01,1,0,1,0,1
EL PUENTE(TJA),consulta externa,repetidas en personas de 5 a 14 anos,2005-12-01,1,2,1,2,3
EL TORNO,consulta externa,repetidas en personas de 5 a 14 anos,2005-12-01,47,50,47,50,97
ENTRE RIOS,consulta externa,repetidas en personas de 5 a 14 anos,2005-12-01,6,5,6,5,11
ENTRE RIOS,consulta externa,repetidas en personas de 5 a 14 anos,2005-12-01,0,1,0,1,1
EUCALIPTUS,consulta externa,repetidas en personas de 5 a 14 anos,2005-12-01,7,4,7,4,11
EXALTACION,consulta externa,repetidas en personas de 5 a 14 anos,2005-12-01,1,0,1,0,1
FERNANDEZ ALONSO,consulta externa,repetidas en personas de 5 a 14 anos,2005-12-01,1,3,1,3,4
FILADELFIA,consulta externa,repetidas en personas de 5 a 14 anos,2005-12-01,0,1,0,1,1
GENERAL SAAVEDRA,consulta externa,repetidas en personas de 5 a 14 anos,2005-12-01,4,4,4,4,8
GRAL. J.J. PEREZ (CHARAZANI),consulta externa,repetidas en personas de 5 a 14 anos,2005-12-01,0,2,0,2,2
GUAQUI,consulta externa,repetidas en personas de 5 a 14 anos,2005-12-01,1,2,1,2,3
GUAYARAMERIN,consulta externa,repetidas en personas de 5 a 14 anos,2005-12-01,47,32,47,32,79
GUTIERREZ,consulta externa,repetidas en personas de 5 a 14 anos,2005-12-01,4,2,4,2,6
HUACARETA,consulta externa,repetidas en personas de 5 a 14 anos,2005-12-01,7,6,7,6,13
HUANUNI,consulta externa,repetidas en personas de 5 a 14 anos,2005-12-01,68,82,68,82,150
HUARACAJE,consulta externa,repetidas en personas de 5 a 14 anos,2005-12-01,3,0,3,0,3
ICLA,consulta externa,repetidas en personas de 5 a 14 anos,2005-12-01,0,3,0,3,3
INCAHUASI,consulta externa,repetidas en personas de 5 a 14 anos,2005-12-01,0,1,0,1,1
INQUISIVI,consulta externa,repetidas en personas de 5 a 14 anos,2005-12-01,1,0,1,0,1
IRUPANA (VILLA DE LANZA),consulta externa,repetidas en personas de 5 a 14 anos,2005-12-01,4,4,4,4,8
IXIAMAS,consulta externa,repetidas en personas de 5 a 14 anos,2005-12-01,1,3,1,3,4
JESUS DE MACHACA,consulta externa,repetidas en personas de 5 a 14 anos,2005-12-01,4,1,4,1,5
LA ASUNTA,consulta externa,repetidas en personas de 5 a 14 anos,2005-12-01,2,0,2,0,2
LA GUARDIA,consulta externa,repetidas en personas de 5 a 14 anos,2005-12-01,8,14,8,14,22
LA PAZ,consulta externa,repetidas en personas de 5 a 14 anos,2005-12-01,2455,2633,2455,2633,5088
LAGUNILLAS,consulta externa,repetidas en personas de 5 a 14 anos,2005-12-01,1,3,1,3,4
LAJA,consulta externa,repetidas en personas de 5 a 14 anos,2005-12-01,0,1,0,1,1
LAS CARRERAS,consulta externa,repetidas en personas de 5 a 14 anos,2005-12-01,2,1,2,1,3
LLALLAGUA,consulta externa,repetidas en personas de 5 a 14 anos,2005-12-01,5,11,5,11,16
LLICA,consulta externa,repetidas en personas de 5 a 14 anos,2005-12-01,0,1,0,1,1
LORETO,consulta externa,repetidas en personas de 5 a 14 anos,2005-12-01,2,2,2,2,4
MACHACAMARCA,consulta externa,repetidas en personas de 5 a 14 anos,2005-12-01,1,2,1,2,3
MACHARETI,consulta externa,repetidas en personas de 5 a 14 anos,2005-12-01,0,1,0,1,1
MAGDALENA,consulta externa,repetidas en personas de 5 a 14 anos,2005-12-01,12,19,12,19,31
MAIRANA,consulta externa,repetidas en personas de 5 a 14 anos,2005-12-01,0,1,0,1,1
MALLA,consulta externa,repetidas en personas de 5 a 14 anos,2005-12-01,2,4,2,4,6
MECAPACA,consulta externa,repetidas en personas de 5 a 14 anos,2005-12-01,15,6,15,6,21
MINEROS,consulta externa,repetidas en personas de 5 a 14 anos,2005-12-01,3,1,3,1,4
MIZQUE,consulta externa,repetidas en personas de 5 a 14 anos,2005-12-01,0,1,0,1,1
MOCOMOCO,consulta externa,repetidas en personas de 5 a 14 anos,2005-12-01,3,1,3,1,4
MONTEAGUDO,consulta externa,repetidas en personas de 5 a 14 anos,2005-12-01,21,19,21,19,40
MONTERO,consulta externa,repetidas en personas de 5 a 14 anos,2005-12-01,249,197,249,197,446
MORO MORO,consulta externa,repetidas en personas de 5 a 14 anos,2005-12-01,2,0,2,0,2
MOROCHATA,consulta externa,repetidas en personas de 5 a 14 anos,2005-12-01,6,5,6,5,11
NUEVO MANOA (NUEVA ESPERANZA),consulta externa,repetidas en personas de 5 a 14 anos,2005-12-01,1,1,1,1,2
OKINAWA,consulta externa,repetidas en personas de 5 a 14 anos,2005-12-01,7,3,7,3,10
OMEREQUE,consulta externa,repetidas en personas de 5 a 14 anos,2005-12-01,2,1,2,1,3
ORURO,consulta externa,repetidas en personas de 5 a 14 anos,2005-12-01,448,467,448,467,915
PADCAYA,consulta externa,repetidas en personas de 5 a 14 anos,2005-12-01,1,2,1,2,3
PADILLA,consulta externa,repetidas en personas de 5 a 14 anos,2005-12-01,3,1,3,1,4
PAILON,consulta externa,repetidas en personas de 5 a 14 anos,2005-12-01,1,3,1,3,4
PALCA,consulta externa,repetidas en personas de 5 a 14 anos,2005-12-01,0,2,0,2,2
PALOS BLANCOS,consulta externa,repetidas en personas de 5 a 14 anos,2005-12-01,9,6,9,6,15
PAMPA AULLAGAS,consulta externa,repetidas en personas de 5 a 14 anos,2005-12-01,0,2,0,2,2
PAMPA GRANDE,consulta externa,repetidas en personas de 5 a 14 anos,2005-12-01,4,1,4,1,5
PAPEL PAMPA,consulta externa,repetidas en personas de 5 a 14 anos,2005-12-01,0,1,0,1,1
PATACAMAYA,consulta externa,repetidas en personas de 5 a 14 anos,2005-12-01,2,1,2,1,3
PAZÑA,consulta externa,repetidas en personas de 5 a 14 anos,2005-12-01,0,2,0,2,2
POCOATA,consulta externa,repetidas en personas de 5 a 14 anos,2005-12-01,1,2,1,2,3
POCONA,consulta externa,repetidas en personas de 5 a 14 anos,2005-12-01,4,2,4,2,6
PORCO,consulta externa,repetidas en personas de 5 a 14 anos,2005-12-01,1,0,1,0,1
POROMA,consulta externa,repetidas en personas de 5 a 14 anos,2005-12-01,0,1,0,1,1
PORONGO,consulta externa,repetidas en personas de 5 a 14 anos,2005-12-01,7,1,7,1,8
PORTACHUELO,consulta externa,repetidas en personas de 5 a 14 anos,2005-12-01,13,10,13,10,23
PORVENIR,consulta externa,repetidas en personas de 5 a 14 anos,2005-12-01,0,1,0,1,1
POTOSI,consulta externa,repetidas en personas de 5 a 14 anos,2005-12-01,399,366,399,366,765
PRESTO,consulta externa,repetidas en personas de 5 a 14 anos,2005-12-01,0,5,0,5,5
PUERTO ACOSTA,consulta externa,repetidas en personas de 5 a 14 anos,2005-12-01,4,0,4,0,4
PUERTO CARABUCO,consulta externa,repetidas en personas de 5 a 14 anos,2005-12-01,1,2,1,2,3
PUERTO GONZALO MORENO,consulta externa,repetidas en personas de 5 a 14 anos,2005-12-01,1,1,1,1,2
PUERTO PEREZ,consulta externa,repetidas en personas de 5 a 14 anos,2005-12-01,0,1,0,1,1
PUERTO QUIJARRO,consulta externa,repetidas en personas de 5 a 14 anos,2005-12-01,21,14,21,14,35
PUERTO RICO,consulta externa,repetidas en personas de 5 a 14 anos,2005-12-01,1,1,1,1,2
PUERTO SUAREZ,consulta externa,repetidas en personas de 5 a 14 anos,2005-12-01,13,12,13,12,25
PUERTO VILLARROEL,consulta externa,repetidas en personas de 5 a 14 anos,2005-12-01,3,4,3,4,7
PUNA,consulta externa,repetidas en personas de 5 a 14 anos,2005-12-01,1,2,1,2,3
PUNATA,consulta externa,repetidas en personas de 5 a 14 anos,2005-12-01,18,16,18,16,34
QUILLACOLLO,consulta externa,repetidas en personas de 5 a 14 anos,2005-12-01,15,25,15,25,40
QUIME,consulta externa,repetidas en personas de 5 a 14 anos,2005-12-01,1,1,1,1,2
QUIRUSILLAS,consulta externa,repetidas en personas de 5 a 14 anos,2005-12-01,1,0,1,0,1
REYES,consulta externa,repetidas en personas de 5 a 14 anos,2005-12-01,4,1,4,1,5
RIBERALTA,consulta externa,repetidas en personas de 5 a 14 anos,2005-12-01,25,14,25,14,39
ROBORE,consulta externa,repetidas en personas de 5 a 14 anos,2005-12-01,11,13,11,13,24
RURRENABAQUE,consulta externa,repetidas en personas de 5 a 14 anos,2005-12-01,3,3,3,3,6
SACABA,consulta externa,repetidas en personas de 5 a 14 anos,2005-12-01,35,56,35,56,91
SACACA,consulta externa,repetidas en personas de 5 a 14 anos,2005-12-01,1,1,1,1,2
SAIPINA,consulta externa,repetidas en personas de 5 a 14 anos,2005-12-01,6,9,6,9,15
SAMAIPATA,consulta externa,repetidas en personas de 5 a 14 anos,2005-12-01,0,3,0,3,3
SAN AGUSTIN,consulta externa,repetidas en personas de 5 a 14 anos,2005-12-01,0,1,0,1,1
SAN ANDRES DE MACHACA,consulta externa,repetidas en personas de 5 a 14 anos,2005-12-01,0,1,0,1,1
SAN BENITO,consulta externa,repetidas en personas de 5 a 14 anos,2005-12-01,5,10,5,10,15
SAN BORJA,consulta externa,repetidas en personas de 5 a 14 anos,2005-12-01,15,12,15,12,27
SAN BUENA VENTURA,consulta externa,repetidas en personas de 5 a 14 anos,2005-12-01,4,0,4,0,4
SAN CARLOS,consulta externa,repetidas en personas de 5 a 14 anos,2005-12-01,4,2,4,2,6
SAN IGNACIO,consulta externa,repetidas en personas de 5 a 14 anos,2005-12-01,14,9,14,9,23
SAN IGNACIO DE VELASCO,consulta externa,repetidas en personas de 5 a 14 anos,2005-12-01,16,22,16,22,38
SAN JAVIER(BNI),consulta externa,repetidas en personas de 5 a 14 anos,2005-12-01,1,1,1,1,2
SAN JAVIER(STC),consulta externa,repetidas en personas de 5 a 14 anos,2005-12-01,8,1,8,1,9
SAN JOAQUIN,consulta externa,repetidas en personas de 5 a 14 anos,2005-12-01,20,1,20,1,21
SAN JUAN DE YAPACANI,consulta externa,repetidas en personas de 5 a 14 anos,2005-12-01,12,20,12,20,32
SAN JULIAN,consulta externa,repetidas en personas de 5 a 14 anos,2005-12-01,7,4,7,4,11
SAN LORENZO(TJA),consulta externa,repetidas en personas de 5 a 14 anos,2005-12-01,3,7,3,7,10
SAN LUCAS,consulta externa,repetidas en personas de 5 a 14 anos,2005-12-01,17,11,17,11,28
SAN MATIAS,consulta externa,repetidas en personas de 5 a 14 anos,2005-12-01,0,3,0,3,3
SAN MIGUEL DE VELASCO,consulta externa,repetidas en personas de 5 a 14 anos,2005-12-01,8,8,8,8,16
SAN PABLO DE LIPEZ,consulta externa,repetidas en personas de 5 a 14 anos,2005-12-01,1,1,1,1,2
SAN PEDRO,consulta externa,repetidas en personas de 5 a 14 anos,2005-12-01,9,19,9,19,28
SAN PEDRO DE BUENA VISTA,consulta externa,repetidas en personas de 5 a 14 anos,2005-12-01,0,1,0,1,1
SAN PEDRO DE CURAHUARA,consulta externa,repetidas en personas de 5 a 14 anos,2005-12-01,2,0,2,0,2
SAN PEDRO DE TIQUINA,consulta externa,repetidas en personas de 5 a 14 anos,2005-12-01,3,0,3,0,3
SAN RAFAEL,consulta externa,repetidas en personas de 5 a 14 anos,2005-12-01,1,1,1,1,2
SAN RAMON,consulta externa,repetidas en personas de 5 a 14 anos,2005-12-01,5,4,5,4,9
SAN RAMON,consulta externa,repetidas en personas de 5 a 14 anos,2005-12-01,1,3,1,3,4
SANTA ANA,consulta externa,repetidas en personas de 5 a 14 anos,2005-12-01,10,12,10,12,22
SANTA CRUZ DE LA SIERRA,consulta externa,repetidas en personas de 5 a 14 anos,2005-12-01,2192,3188,2192,3188,5380
SANTA ROSA,consulta externa,repetidas en personas de 5 a 14 anos,2005-12-01,1,2,1,2,3
SANTA ROSA DEL SARA,consulta externa,repetidas en personas de 5 a 14 anos,2005-12-01,2,4,2,4,6
SANTIAGO DE HUARI,consulta externa,repetidas en personas de 5 a 14 anos,2005-12-01,3,1,3,1,4
SANTIAGO DE MACHACA,consulta externa,repetidas en personas de 5 a 14 anos,2005-12-01,1,0,1,0,1
SANTIVAÑES,consulta externa,repetidas en personas de 5 a 14 anos,2005-12-01,2,5,2,5,7
SAPAHAQUI,consulta externa,repetidas en personas de 5 a 14 anos,2005-12-01,1,0,1,0,1
SIPE SIPE,consulta externa,repetidas en personas de 5 a 14 anos,2005-12-01,9,12,9,12,21
SORACACHI,consulta externa,repetidas en personas de 5 a 14 anos,2005-12-01,0,2,0,2,2
SORATA,consulta externa,repetidas en personas de 5 a 14 anos,2005-12-01,4,0,4,0,4
SUCRE,consulta externa,repetidas en personas de 5 a 14 anos,2005-12-01,1792,1633,1792,1633,3425
TACACHI,consulta externa,repetidas en personas de 5 a 14 anos,2005-12-01,0,3,0,3,3
TACOBAMBA,consulta externa,repetidas en personas de 5 a 14 anos,2005-12-01,0,1,0,1,1
TAPACARI,consulta externa,repetidas en personas de 5 a 14 anos,2005-12-01,4,0,4,0,4
TARABUCO,consulta externa,repetidas en personas de 5 a 14 anos,2005-12-01,5,4,5,4,9
TARATA,consulta externa,repetidas en personas de 5 a 14 anos,2005-12-01,5,3,5,3,8
TARIJA,consulta externa,repetidas en personas de 5 a 14 anos,2005-12-01,476,610,476,610,1086
TARVITA,consulta externa,repetidas en personas de 5 a 14 anos,2005-12-01,0,1,0,1,1
TIAWANACU,consulta externa,repetidas en personas de 5 a 14 anos,2005-12-01,3,1,3,1,4
TINGUIPAYA,consulta externa,repetidas en personas de 5 a 14 anos,2005-12-01,1,0,1,0,1
TIPUANI,consulta externa,repetidas en personas de 5 a 14 anos,2005-12-01,1,1,1,1,2
TIQUIPAYA,consulta externa,repetidas en personas de 5 a 14 anos,2005-12-01,10,5,10,5,15
TIRAQUE (CBBA),consulta externa,repetidas en personas de 5 a 14 anos,2005-12-01,14,19,14,19,33
TOCO,consulta externa,repetidas en personas de 5 a 14 anos,2005-12-01,0,1,0,1,1
TOLEDO,consulta externa,repetidas en personas de 5 a 14 anos,2005-12-01,2,2,2,2,4
TOMAVE,consulta externa,repetidas en personas de 5 a 14 anos,2005-12-01,2,0,2,0,2
TOMINA,consulta externa,repetidas en personas de 5 a 14 anos,2005-12-01,0,3,0,3,3
TOTORA(CBBA),consulta externa,repetidas en personas de 5 a 14 anos,2005-12-01,0,1,0,1,1
TOTORA(ORR),consulta externa,repetidas en personas de 5 a 14 anos,2005-12-01,1,0,1,0,1
TRINIDAD,consulta externa,repetidas en personas de 5 a 14 anos,2005-12-01,134,166,134,166,300
TUPIZA,consulta externa,repetidas en personas de 5 a 14 anos,2005-12-01,74,100,74,100,174
UNCIA,consulta externa,repetidas en personas de 5 a 14 anos,2005-12-01,30,39,30,39,69
URIONDO (A. CONCEPCION),consulta externa,repetidas en personas de 5 a 14 anos,2005-12-01,1,1,1,1,2
URUBICHA,consulta externa,repetidas en personas de 5 a 14 anos,2005-12-01,1,0,1,0,1
UYUNI,consulta externa,repetidas en personas de 5 a 14 anos,2005-12-01,1,3,1,3,4
VACAS,consulta externa,repetidas en personas de 5 a 14 anos,2005-12-01,20,7,20,7,27
VALLEGRANDE,consulta externa,repetidas en personas de 5 a 14 anos,2005-12-01,50,31,50,31,81
VIACHA,consulta externa,repetidas en personas de 5 a 14 anos,2005-12-01,29,31,29,31,60
VILLA MONTES,consulta externa,repetidas en personas de 5 a 14 anos,2005-12-01,17,22,17,22,39
VILLA RIVERO,consulta externa,repetidas en personas de 5 a 14 anos,2005-12-01,4,0,4,0,4
VILLA SERRANO,consulta externa,repetidas en personas de 5 a 14 anos,2005-12-01,0,1,0,1,1
VILLA TUNARI,consulta externa,repetidas en personas de 5 a 14 anos,2005-12-01,64,45,64,45,109
VILLA VACA GUZMAN (MUYUPAMPA),consulta externa,repetidas en personas de 5 a 14 anos,2005-12-01,4,4,4,4,8
VILLAZON,consulta externa,repetidas en personas de 5 a 14 anos,2005-12-01,8,13,8,13,21
VINTO,consulta externa,repetidas en personas de 5 a 14 anos,2005-12-01,5,14,5,14,19
VITICHI,consulta externa,repetidas en personas de 5 a 14 anos,2005-12-01,0,5,0,5,5
WALDO BALLIVIAN,consulta externa,repetidas en personas de 5 a 14 anos,2005-12-01,1,0,1,0,1
WARNES,consulta externa,repetidas en personas de 5 a 14 anos,2005-12-01,10,16,10,16,26
YACUIBA,consulta externa,repetidas en personas de 5 a 14 anos,2005-12-01,131,110,131,110,241
YAMPARAEZ,consulta externa,repetidas en personas de 5 a 14 anos,2005-12-01,6,3,6,3,9
YANACACHI,consulta externa,repetidas en personas de 5 a 14 anos,2005-12-01,0,3,0,3,3
YAPACANI,consulta externa,repetidas en personas de 5 a 14 anos,2005-12-01,12,4,12,4,16
YOCALLA,consulta externa,repetidas en personas de 5 a 14 anos,2005-12-01,1,1,1,1,2
YOTALA,consulta externa,repetidas en personas de 5 a 14 anos,2005-12-01,5,2,5,2,7
ZUDAÑEZ,consulta externa,repetidas en personas de 5 a 14 anos,2005-12-01,1,0,1,0,1
