municipality,group,variable,month,Repetidas en menores de 5 años -Hombre,Repetidas en menores de 5 años -Mujer,TOTAL-H,TOTAL-M,TOTAL
ACACIO,consulta externa,repetidas en menores de 5 anos,2005-01-01,2,2,2,2,4
ACHACACHI,consulta externa,repetidas en menores de 5 anos,2005-01-01,6,12,6,12,18
ACHOCALLA,consulta externa,repetidas en menores de 5 anos,2005-01-01,2,5,2,5,7
AIQUILE,consulta externa,repetidas en menores de 5 anos,2005-01-01,77,84,77,84,161
ALALAY,consulta externa,repetidas en menores de 5 anos,2005-01-01,13,13,13,13,26
ALCALA,consulta externa,repetidas en menores de 5 anos,2005-01-01,5,0,5,0,5
ANCORAIMES,consulta externa,repetidas en menores de 5 anos,2005-01-01,14,12,14,12,26
ANDAMARCA,consulta externa,repetidas en menores de 5 anos,2005-01-01,4,0,4,0,4
ANTEQUERA,consulta externa,repetidas en menores de 5 anos,2005-01-01,9,14,9,14,23
ANZALDO,consulta externa,repetidas en menores de 5 anos,2005-01-01,3,3,3,3,6
APOLO,consulta externa,repetidas en menores de 5 anos,2005-01-01,0,2,0,2,2
ARAMPAMPA,consulta externa,repetidas en menores de 5 anos,2005-01-01,0,3,0,3,3
ARANI,consulta externa,repetidas en menores de 5 anos,2005-01-01,15,10,15,10,25
ARBIETO,consulta externa,repetidas en menores de 5 anos,2005-01-01,7,2,7,2,9
ARQUE,consulta externa,repetidas en menores de 5 anos,2005-01-01,30,25,30,25,55
ASCENCION DE GUARAYOS,consulta externa,repetidas en menores de 5 anos,2005-01-01,0,1,0,1,1
ATOCHA,consulta externa,repetidas en menores de 5 anos,2005-01-01,20,13,20,13,33
AUCAPATA,consulta externa,repetidas en menores de 5 anos,2005-01-01,1,0,1,0,1
AYATA,consulta externa,repetidas en menores de 5 anos,2005-01-01,0,4,0,4,4
AYO AYO,consulta externa,repetidas en menores de 5 anos,2005-01-01,9,2,9,2,11
AYOPAYA (V. DE INDEPENDENCIA),consulta externa,repetidas en menores de 5 anos,2005-01-01,5,7,5,7,12
AZURDUY,consulta externa,repetidas en menores de 5 anos,2005-01-01,1,2,1,2,3
BATALLAS,consulta externa,repetidas en menores de 5 anos,2005-01-01,3,2,3,2,5
BAURES,consulta externa,repetidas en menores de 5 anos,2005-01-01,13,5,13,5,18
BELEN DE URMIRI,consulta externa,repetidas en menores de 5 anos,2005-01-01,5,1,5,1,6
BERMEJO,consulta externa,repetidas en menores de 5 anos,2005-01-01,40,45,40,45,85
BETANZOS,consulta externa,repetidas en menores de 5 anos,2005-01-01,28,28,28,28,56
BOLIVAR,consulta externa,repetidas en menores de 5 anos,2005-01-01,12,6,12,6,18
BOLPEBRA,consulta externa,repetidas en menores de 5 anos,2005-01-01,8,2,8,2,10
BOYUIBE,consulta externa,repetidas en menores de 5 anos,2005-01-01,8,6,8,6,14
BUENA VISTA,consulta externa,repetidas en menores de 5 anos,2005-01-01,123,78,123,78,201
CABEZAS,consulta externa,repetidas en menores de 5 anos,2005-01-01,2,2,2,2,4
"CAIZA ""D""",consulta externa,repetidas en menores de 5 anos,2005-01-01,3,1,3,1,4
CAJUATA,consulta externa,repetidas en menores de 5 anos,2005-01-01,2,0,2,0,2
CALACOTO,consulta externa,repetidas en menores de 5 anos,2005-01-01,3,3,3,3,6
CALAMARCA,consulta externa,repetidas en menores de 5 anos,2005-01-01,15,6,15,6,21
CAMARGO,consulta externa,repetidas en menores de 5 anos,2005-01-01,19,14,19,14,33
CAMATAQUI (C. VILLA ABECIA),consulta externa,repetidas en menores de 5 anos,2005-01-01,3,2,3,2,5
CAMIRI,consulta externa,repetidas en menores de 5 anos,2005-01-01,151,136,151,136,287
CAPINOTA,consulta externa,repetidas en menores de 5 anos,2005-01-01,33,40,33,40,73
CAQUIAVIRI,consulta externa,repetidas en menores de 5 anos,2005-01-01,0,1,0,1,1
CARACOLLO,consulta externa,repetidas en menores de 5 anos,2005-01-01,4,8,4,8,12
CARANAVI,consulta externa,repetidas en menores de 5 anos,2005-01-01,31,23,31,23,54
CARAPARI,consulta externa,repetidas en menores de 5 anos,2005-01-01,1,4,1,4,5
CARMEN RIVERO TORREZ,consulta externa,repetidas en menores de 5 anos,2005-01-01,1,0,1,0,1
CHACARILLA,consulta externa,repetidas en menores de 5 anos,2005-01-01,2,7,2,7,9
CHALLAPATA,consulta externa,repetidas en menores de 5 anos,2005-01-01,2,4,2,4,6
CHAQUI,consulta externa,repetidas en menores de 5 anos,2005-01-01,0,3,0,3,3
CHARAGUA,consulta externa,repetidas en menores de 5 anos,2005-01-01,78,58,78,58,136
CHAYANTA,consulta externa,repetidas en menores de 5 anos,2005-01-01,12,4,12,4,16
CHIMORE,consulta externa,repetidas en menores de 5 anos,2005-01-01,64,64,64,64,128
CHIPAYA,consulta externa,repetidas en menores de 5 anos,2005-01-01,1,6,1,6,7
CHOQUE COTA,consulta externa,repetidas en menores de 5 anos,2005-01-01,1,2,1,2,3
CHULUMANI (V. DE LA LIBERTAD),consulta externa,repetidas en menores de 5 anos,2005-01-01,5,3,5,3,8
CHUMA,consulta externa,repetidas en menores de 5 anos,2005-01-01,3,3,3,3,6
CLIZA,consulta externa,repetidas en menores de 5 anos,2005-01-01,3,5,3,5,8
COBIJA,consulta externa,repetidas en menores de 5 anos,2005-01-01,219,228,219,228,447
COCHABAMBA,consulta externa,repetidas en menores de 5 anos,2005-01-01,2850,2610,2850,2610,5460
COLCAPIRHUA,consulta externa,repetidas en menores de 5 anos,2005-01-01,92,83,92,83,175
"COLCHA ""K""",consulta externa,repetidas en menores de 5 anos,2005-01-01,4,0,4,0,4
COLOMI,consulta externa,repetidas en menores de 5 anos,2005-01-01,20,25,20,25,45
COLPA BELGICA,consulta externa,repetidas en menores de 5 anos,2005-01-01,52,29,52,29,81
COLQUECHACA,consulta externa,repetidas en menores de 5 anos,2005-01-01,3,3,3,3,6
COLQUENCHA,consulta externa,repetidas en menores de 5 anos,2005-01-01,9,5,9,5,14
COLQUIRI,consulta externa,repetidas en menores de 5 anos,2005-01-01,18,21,18,21,39
COMARAPA,consulta externa,repetidas en menores de 5 anos,2005-01-01,24,29,24,29,53
COMBAYA,consulta externa,repetidas en menores de 5 anos,2005-01-01,3,0,3,0,3
CONCEPCION,consulta externa,repetidas en menores de 5 anos,2005-01-01,16,12,16,12,28
COPACABANA,consulta externa,repetidas en menores de 5 anos,2005-01-01,9,4,9,4,13
CORIPATA,consulta externa,repetidas en menores de 5 anos,2005-01-01,5,3,5,3,8
COROICO,consulta externa,repetidas en menores de 5 anos,2005-01-01,25,21,25,21,46
CORQUE,consulta externa,repetidas en menores de 5 anos,2005-01-01,4,6,4,6,10
COTAGAITA,consulta externa,repetidas en menores de 5 anos,2005-01-01,25,26,25,26,51
COTOCA,consulta externa,repetidas en menores de 5 anos,2005-01-01,9,11,9,11,20
CUATRO CAÑADAS,consulta externa,repetidas en menores de 5 anos,2005-01-01,20,16,20,16,36
CUCHUMUELA (V. G. VILLARROEL),consulta externa,repetidas en menores de 5 anos,2005-01-01,3,0,3,0,3
CUEVO,consulta externa,repetidas en menores de 5 anos,2005-01-01,5,9,5,9,14
CULPINA,consulta externa,repetidas en menores de 5 anos,2005-01-01,6,7,6,7,13
CURAHUARA DE CARANGAS,consulta externa,repetidas en menores de 5 anos,2005-01-01,1,4,1,4,5
DESAGUADERO,consulta externa,repetidas en menores de 5 anos,2005-01-01,1,0,1,0,1
EL ALTO,consulta externa,repetidas en menores de 5 anos,2005-01-01,1860,1839,1860,1839,3699
EL CHORO,consulta externa,repetidas en menores de 5 anos,2005-01-01,2,2,2,2,4
EL PUENTE(STC),consulta externa,repetidas en menores de 5 anos,2005-01-01,3,7,3,7,10
EL PUENTE(TJA),consulta externa,repetidas en menores de 5 anos,2005-01-01,20,22,20,22,42
EL TORNO,consulta externa,repetidas en menores de 5 anos,2005-01-01,87,82,87,82,169
EL VILLAR,consulta externa,repetidas en menores de 5 anos,2005-01-01,5,2,5,2,7
ENTRE RIOS,consulta externa,repetidas en menores de 5 anos,2005-01-01,5,7,5,7,12
ENTRE RIOS,consulta externa,repetidas en menores de 5 anos,2005-01-01,57,52,57,52,109
EUCALIPTUS,consulta externa,repetidas en menores de 5 anos,2005-01-01,16,10,16,10,26
EXALTACION,consulta externa,repetidas en menores de 5 anos,2005-01-01,6,7,6,7,13
FERNANDEZ ALONSO,consulta externa,repetidas en menores de 5 anos,2005-01-01,67,42,67,42,109
FILADELFIA,consulta externa,repetidas en menores de 5 anos,2005-01-01,1,1,1,1,2
GENERAL SAAVEDRA,consulta externa,repetidas en menores de 5 anos,2005-01-01,28,25,28,25,53
GRAL. J.J. PEREZ (CHARAZANI),consulta externa,repetidas en menores de 5 anos,2005-01-01,0,2,0,2,2
GUANAY,consulta externa,repetidas en menores de 5 anos,2005-01-01,43,52,43,52,95
GUAQUI,consulta externa,repetidas en menores de 5 anos,2005-01-01,0,5,0,5,5
GUAYARAMERIN,consulta externa,repetidas en menores de 5 anos,2005-01-01,85,69,85,69,154
GUTIERREZ,consulta externa,repetidas en menores de 5 anos,2005-01-01,42,42,42,42,84
HUACARETA,consulta externa,repetidas en menores de 5 anos,2005-01-01,16,11,16,11,27
HUACAYA (VILLA DE HUACAYA),consulta externa,repetidas en menores de 5 anos,2005-01-01,2,0,2,0,2
HUANUNI,consulta externa,repetidas en menores de 5 anos,2005-01-01,73,68,73,68,141
HUARACAJE,consulta externa,repetidas en menores de 5 anos,2005-01-01,19,20,19,20,39
ICLA,consulta externa,repetidas en menores de 5 anos,2005-01-01,7,10,7,10,17
INCAHUASI,consulta externa,repetidas en menores de 5 anos,2005-01-01,1,3,1,3,4
INGAVI (HUMAITA),consulta externa,repetidas en menores de 5 anos,2005-01-01,8,2,8,2,10
INQUISIVI,consulta externa,repetidas en menores de 5 anos,2005-01-01,1,2,1,2,3
IRUPANA (VILLA DE LANZA),consulta externa,repetidas en menores de 5 anos,2005-01-01,3,5,3,5,8
IXIAMAS,consulta externa,repetidas en menores de 5 anos,2005-01-01,27,18,27,18,45
JESUS DE MACHACA,consulta externa,repetidas en menores de 5 anos,2005-01-01,3,2,3,2,5
LA ASUNTA,consulta externa,repetidas en menores de 5 anos,2005-01-01,10,3,10,3,13
LA GUARDIA,consulta externa,repetidas en menores de 5 anos,2005-01-01,79,97,79,97,176
LA PAZ,consulta externa,repetidas en menores de 5 anos,2005-01-01,2879,2584,2879,2584,5463
LAGUNILLAS,consulta externa,repetidas en menores de 5 anos,2005-01-01,3,7,3,7,10
LAJA,consulta externa,repetidas en menores de 5 anos,2005-01-01,2,7,2,7,9
LAS CARRERAS,consulta externa,repetidas en menores de 5 anos,2005-01-01,1,3,1,3,4
LLALLAGUA,consulta externa,repetidas en menores de 5 anos,2005-01-01,10,10,10,10,20
LLICA,consulta externa,repetidas en menores de 5 anos,2005-01-01,1,0,1,0,1
LORETO,consulta externa,repetidas en menores de 5 anos,2005-01-01,2,4,2,4,6
LURIBAY,consulta externa,repetidas en menores de 5 anos,2005-01-01,1,2,1,2,3
MACHACAMARCA,consulta externa,repetidas en menores de 5 anos,2005-01-01,0,1,0,1,1
MACHARETI,consulta externa,repetidas en menores de 5 anos,2005-01-01,9,12,9,12,21
MAGDALENA,consulta externa,repetidas en menores de 5 anos,2005-01-01,23,26,23,26,49
MAIRANA,consulta externa,repetidas en menores de 5 anos,2005-01-01,6,4,6,4,10
MAPIRI,consulta externa,repetidas en menores de 5 anos,2005-01-01,7,9,7,9,16
MECAPACA,consulta externa,repetidas en menores de 5 anos,2005-01-01,15,11,15,11,26
MINEROS,consulta externa,repetidas en menores de 5 anos,2005-01-01,18,15,18,15,33
MIZQUE,consulta externa,repetidas en menores de 5 anos,2005-01-01,22,20,22,20,42
MOCOMOCO,consulta externa,repetidas en menores de 5 anos,2005-01-01,1,1,1,1,2
MOJINETE,consulta externa,repetidas en menores de 5 anos,2005-01-01,2,3,2,3,5
MOJOCOYA,consulta externa,repetidas en menores de 5 anos,2005-01-01,2,3,2,3,5
MONTEAGUDO,consulta externa,repetidas en menores de 5 anos,2005-01-01,23,22,23,22,45
MONTERO,consulta externa,repetidas en menores de 5 anos,2005-01-01,374,318,374,318,692
MORO MORO,consulta externa,repetidas en menores de 5 anos,2005-01-01,0,1,0,1,1
MOROCHATA,consulta externa,repetidas en menores de 5 anos,2005-01-01,17,26,17,26,43
NAZACARA DE PACAJES,consulta externa,repetidas en menores de 5 anos,2005-01-01,1,0,1,0,1
NUEVO MANOA (NUEVA ESPERANZA),consulta externa,repetidas en menores de 5 anos,2005-01-01,7,6,7,6,13
OCURI,consulta externa,repetidas en menores de 5 anos,2005-01-01,1,1,1,1,2
OKINAWA,consulta externa,repetidas en menores de 5 anos,2005-01-01,22,18,22,18,40
OMEREQUE,consulta externa,repetidas en menores de 5 anos,2005-01-01,18,18,18,18,36
ORURO,consulta externa,repetidas en menores de 5 anos,2005-01-01,510,460,510,460,970
PADCAYA,consulta externa,repetidas en menores de 5 anos,2005-01-01,10,13,10,13,23
PADILLA,consulta externa,repetidas en menores de 5 anos,2005-01-01,5,7,5,7,12
PAILON,consulta externa,repetidas en menores de 5 anos,2005-01-01,3,1,3,1,4
PALCA,consulta externa,repetidas en menores de 5 anos,2005-01-01,3,3,3,3,6
PALOS BLANCOS,consulta externa,repetidas en menores de 5 anos,2005-01-01,19,21,19,21,40
PAMPA AULLAGAS,consulta externa,repetidas en menores de 5 anos,2005-01-01,3,1,3,1,4
PAMPA GRANDE,consulta externa,repetidas en menores de 5 anos,2005-01-01,6,17,6,17,23
PAPEL PAMPA,consulta externa,repetidas en menores de 5 anos,2005-01-01,1,0,1,0,1
PATACAMAYA,consulta externa,repetidas en menores de 5 anos,2005-01-01,3,6,3,6,9
PAZÑA,consulta externa,repetidas en menores de 5 anos,2005-01-01,2,1,2,1,3
PELECHUCO,consulta externa,repetidas en menores de 5 anos,2005-01-01,2,1,2,1,3
POCOATA,consulta externa,repetidas en menores de 5 anos,2005-01-01,3,8,3,8,11
POCONA,consulta externa,repetidas en menores de 5 anos,2005-01-01,3,3,3,3,6
POJO (CBBA),consulta externa,repetidas en menores de 5 anos,2005-01-01,37,60,37,60,97
POOPO,consulta externa,repetidas en menores de 5 anos,2005-01-01,0,1,0,1,1
PORCO,consulta externa,repetidas en menores de 5 anos,2005-01-01,4,2,4,2,6
POROMA,consulta externa,repetidas en menores de 5 anos,2005-01-01,3,4,3,4,7
PORONGO,consulta externa,repetidas en menores de 5 anos,2005-01-01,24,23,24,23,47
PORTACHUELO,consulta externa,repetidas en menores de 5 anos,2005-01-01,57,33,57,33,90
POSTRER VALLE,consulta externa,repetidas en menores de 5 anos,2005-01-01,10,3,10,3,13
POTOSI,consulta externa,repetidas en menores de 5 anos,2005-01-01,384,261,384,261,645
PRESTO,consulta externa,repetidas en menores de 5 anos,2005-01-01,1,2,1,2,3
PUCARANI,consulta externa,repetidas en menores de 5 anos,2005-01-01,2,2,2,2,4
PUERTO ACOSTA,consulta externa,repetidas en menores de 5 anos,2005-01-01,10,6,10,6,16
PUERTO CARABUCO,consulta externa,repetidas en menores de 5 anos,2005-01-01,1,1,1,1,2
PUERTO GONZALO MORENO,consulta externa,repetidas en menores de 5 anos,2005-01-01,2,5,2,5,7
PUERTO PEREZ,consulta externa,repetidas en menores de 5 anos,2005-01-01,3,2,3,2,5
PUERTO QUIJARRO,consulta externa,repetidas en menores de 5 anos,2005-01-01,37,21,37,21,58
PUERTO RICO,consulta externa,repetidas en menores de 5 anos,2005-01-01,1,0,1,0,1
PUERTO SILES,consulta externa,repetidas en menores de 5 anos,2005-01-01,8,4,8,4,12
PUERTO SUAREZ,consulta externa,repetidas en menores de 5 anos,2005-01-01,12,11,12,11,23
PUERTO VILLARROEL,consulta externa,repetidas en menores de 5 anos,2005-01-01,57,59,57,59,116
PUNA,consulta externa,repetidas en menores de 5 anos,2005-01-01,8,6,8,6,14
PUNATA,consulta externa,repetidas en menores de 5 anos,2005-01-01,37,33,37,33,70
QUIABAYA,consulta externa,repetidas en menores de 5 anos,2005-01-01,2,0,2,0,2
QUILLACOLLO,consulta externa,repetidas en menores de 5 anos,2005-01-01,187,169,187,169,356
QUIME,consulta externa,repetidas en menores de 5 anos,2005-01-01,2,2,2,2,4
QUIRUSILLAS,consulta externa,repetidas en menores de 5 anos,2005-01-01,2,0,2,0,2
RAVELO,consulta externa,repetidas en menores de 5 anos,2005-01-01,0,4,0,4,4
REYES,consulta externa,repetidas en menores de 5 anos,2005-01-01,30,39,30,39,69
RIBERALTA,consulta externa,repetidas en menores de 5 anos,2005-01-01,476,455,476,455,931
ROBORE,consulta externa,repetidas en menores de 5 anos,2005-01-01,27,25,27,25,52
RURRENABAQUE,consulta externa,repetidas en menores de 5 anos,2005-01-01,41,30,41,30,71
SABAYA,consulta externa,repetidas en menores de 5 anos,2005-01-01,2,3,2,3,5
SACABA,consulta externa,repetidas en menores de 5 anos,2005-01-01,154,153,154,153,307
SACABAMBA,consulta externa,repetidas en menores de 5 anos,2005-01-01,0,1,0,1,1
SACACA,consulta externa,repetidas en menores de 5 anos,2005-01-01,1,1,1,1,2
SAIPINA,consulta externa,repetidas en menores de 5 anos,2005-01-01,15,4,15,4,19
SALINAS DE GARCI MENDOZA,consulta externa,repetidas en menores de 5 anos,2005-01-01,8,4,8,4,12
SAMAIPATA,consulta externa,repetidas en menores de 5 anos,2005-01-01,1,0,1,0,1
SAN AGUSTIN,consulta externa,repetidas en menores de 5 anos,2005-01-01,1,0,1,0,1
SAN ANDRES,consulta externa,repetidas en menores de 5 anos,2005-01-01,15,21,15,21,36
SAN ANDRES DE MACHACA,consulta externa,repetidas en menores de 5 anos,2005-01-01,2,2,2,2,4
SAN ANTONIO DE ESMORUCO,consulta externa,repetidas en menores de 5 anos,2005-01-01,1,1,1,1,2
SAN ANTONIO DE LOMERIO,consulta externa,repetidas en menores de 5 anos,2005-01-01,1,2,1,2,3
SAN BENITO,consulta externa,repetidas en menores de 5 anos,2005-01-01,12,21,12,21,33
SAN BORJA,consulta externa,repetidas en menores de 5 anos,2005-01-01,108,79,108,79,187
SAN BUENA VENTURA,consulta externa,repetidas en menores de 5 anos,2005-01-01,3,2,3,2,5
SAN CARLOS,consulta externa,repetidas en menores de 5 anos,2005-01-01,17,10,17,10,27
SAN IGNACIO,consulta externa,repetidas en menores de 5 anos,2005-01-01,155,125,155,125,280
SAN IGNACIO DE VELASCO,consulta externa,repetidas en menores de 5 anos,2005-01-01,42,46,42,46,88
SAN JAVIER(BNI),consulta externa,repetidas en menores de 5 anos,2005-01-01,4,7,4,7,11
SAN JAVIER(STC),consulta externa,repetidas en menores de 5 anos,2005-01-01,14,10,14,10,24
SAN JOAQUIN,consulta externa,repetidas en menores de 5 anos,2005-01-01,3,11,3,11,14
SAN JOSE DE CHIQUITOS,consulta externa,repetidas en menores de 5 anos,2005-01-01,4,3,4,3,7
SAN JUAN DE YAPACANI,consulta externa,repetidas en menores de 5 anos,2005-01-01,13,16,13,16,29
SAN JULIAN,consulta externa,repetidas en menores de 5 anos,2005-01-01,69,62,69,62,131
SAN LORENZO(PND),consulta externa,repetidas en menores de 5 anos,2005-01-01,5,2,5,2,7
SAN LORENZO(TJA),consulta externa,repetidas en menores de 5 anos,2005-01-01,76,80,76,80,156
SAN LUCAS,consulta externa,repetidas en menores de 5 anos,2005-01-01,7,8,7,8,15
SAN MATIAS,consulta externa,repetidas en menores de 5 anos,2005-01-01,53,48,53,48,101
SAN MIGUEL DE VELASCO,consulta externa,repetidas en menores de 5 anos,2005-01-01,39,32,39,32,71
SAN PABLO DE LIPEZ,consulta externa,repetidas en menores de 5 anos,2005-01-01,4,2,4,2,6
SAN PEDRO,consulta externa,repetidas en menores de 5 anos,2005-01-01,51,61,51,61,112
SAN PEDRO DE BUENA VISTA,consulta externa,repetidas en menores de 5 anos,2005-01-01,2,0,2,0,2
SAN PEDRO DE CURAHUARA,consulta externa,repetidas en menores de 5 anos,2005-01-01,0,3,0,3,3
SAN PEDRO DE TIQUINA,consulta externa,repetidas en menores de 5 anos,2005-01-01,6,2,6,2,8
SAN PEDRO(PND),consulta externa,repetidas en menores de 5 anos,2005-01-01,5,0,5,0,5
SAN RAFAEL,consulta externa,repetidas en menores de 5 anos,2005-01-01,3,5,3,5,8
SAN RAMON,consulta externa,repetidas en menores de 5 anos,2005-01-01,19,15,19,15,34
SAN RAMON,consulta externa,repetidas en menores de 5 anos,2005-01-01,9,1,9,1,10
SANTA ANA,consulta externa,repetidas en menores de 5 anos,2005-01-01,52,36,52,36,88
SANTA CRUZ DE LA SIERRA,consulta externa,repetidas en menores de 5 anos,2005-01-01,3240,3430,3240,3430,6670
SANTA ROSA DEL SARA,consulta externa,repetidas en menores de 5 anos,2005-01-01,34,25,34,25,59
SANTIAGO DE CALLAPA,consulta externa,repetidas en menores de 5 anos,2005-01-01,2,8,2,8,10
SANTIAGO DE HUARI,consulta externa,repetidas en menores de 5 anos,2005-01-01,2,0,2,0,2
SANTIVAÑES,consulta externa,repetidas en menores de 5 anos,2005-01-01,5,9,5,9,14
SAPAHAQUI,consulta externa,repetidas en menores de 5 anos,2005-01-01,2,4,2,4,6
SENA,consulta externa,repetidas en menores de 5 anos,2005-01-01,2,5,2,5,7
SICA SICA (VILLA AROMA),consulta externa,repetidas en menores de 5 anos,2005-01-01,4,7,4,7,11
SICAYA,consulta externa,repetidas en menores de 5 anos,2005-01-01,3,3,3,3,6
SIPE SIPE,consulta externa,repetidas en menores de 5 anos,2005-01-01,82,66,82,66,148
SOPACHUY,consulta externa,repetidas en menores de 5 anos,2005-01-01,3,1,3,1,4
SORACACHI,consulta externa,repetidas en menores de 5 anos,2005-01-01,2,3,2,3,5
SORATA,consulta externa,repetidas en menores de 5 anos,2005-01-01,6,2,6,2,8
SUCRE,consulta externa,repetidas en menores de 5 anos,2005-01-01,674,651,674,651,1325
TACACHI,consulta externa,repetidas en menores de 5 anos,2005-01-01,9,2,9,2,11
TACOBAMBA,consulta externa,repetidas en menores de 5 anos,2005-01-01,0,1,0,1,1
TACOPAYA,consulta externa,repetidas en menores de 5 anos,2005-01-01,2,2,2,2,4
TAHUA,consulta externa,repetidas en menores de 5 anos,2005-01-01,0,3,0,3,3
TAPACARI,consulta externa,repetidas en menores de 5 anos,2005-01-01,6,5,6,5,11
TARABUCO,consulta externa,repetidas en menores de 5 anos,2005-01-01,29,38,29,38,67
TARATA,consulta externa,repetidas en menores de 5 anos,2005-01-01,40,36,40,36,76
TARIJA,consulta externa,repetidas en menores de 5 anos,2005-01-01,711,704,711,704,1415
TARVITA,consulta externa,repetidas en menores de 5 anos,2005-01-01,13,5,13,5,18
TEOPONTE,consulta externa,repetidas en menores de 5 anos,2005-01-01,1,0,1,0,1
TIAWANACU,consulta externa,repetidas en menores de 5 anos,2005-01-01,0,3,0,3,3
TINGUIPAYA,consulta externa,repetidas en menores de 5 anos,2005-01-01,0,3,0,3,3
TIPUANI,consulta externa,repetidas en menores de 5 anos,2005-01-01,6,12,6,12,18
TIQUIPAYA,consulta externa,repetidas en menores de 5 anos,2005-01-01,147,91,147,91,238
TIRAQUE (CBBA),consulta externa,repetidas en menores de 5 anos,2005-01-01,102,92,102,92,194
TITO YUPANQUI (PARQUIPUJIO),consulta externa,repetidas en menores de 5 anos,2005-01-01,1,1,1,1,2
TOLATA,consulta externa,repetidas en menores de 5 anos,2005-01-01,1,0,1,0,1
TOLEDO,consulta externa,repetidas en menores de 5 anos,2005-01-01,3,4,3,4,7
TOMAVE,consulta externa,repetidas en menores de 5 anos,2005-01-01,1,1,1,1,2
TOMINA,consulta externa,repetidas en menores de 5 anos,2005-01-01,2,1,2,1,3
TORO TORO,consulta externa,repetidas en menores de 5 anos,2005-01-01,15,6,15,6,21
TOTORA(CBBA),consulta externa,repetidas en menores de 5 anos,2005-01-01,1,3,1,3,4
TOTORA(ORR),consulta externa,repetidas en menores de 5 anos,2005-01-01,1,1,1,1,2
TRIGAL,consulta externa,repetidas en menores de 5 anos,2005-01-01,0,1,0,1,1
TRINIDAD,consulta externa,repetidas en menores de 5 anos,2005-01-01,442,399,442,399,841
TUPIZA,consulta externa,repetidas en menores de 5 anos,2005-01-01,99,87,99,87,186
TURCO,consulta externa,repetidas en menores de 5 anos,2005-01-01,7,1,7,1,8
UNCIA,consulta externa,repetidas en menores de 5 anos,2005-01-01,8,22,8,22,30
URIONDO (A. CONCEPCION),consulta externa,repetidas en menores de 5 anos,2005-01-01,7,7,7,7,14
URUBICHA,consulta externa,repetidas en menores de 5 anos,2005-01-01,8,4,8,4,12
UYUNI,consulta externa,repetidas en menores de 5 anos,2005-01-01,8,7,8,7,15
VACAS,consulta externa,repetidas en menores de 5 anos,2005-01-01,19,20,19,20,39
VALLEGRANDE,consulta externa,repetidas en menores de 5 anos,2005-01-01,11,14,11,14,25
VIACHA,consulta externa,repetidas en menores de 5 anos,2005-01-01,40,44,40,44,84
VILA VILA,consulta externa,repetidas en menores de 5 anos,2005-01-01,1,0,1,0,1
VILLA MONTES,consulta externa,repetidas en menores de 5 anos,2005-01-01,38,18,38,18,56
VILLA NUEVA (LOMA ALTA),consulta externa,repetidas en menores de 5 anos,2005-01-01,1,0,1,0,1
VILLA RIVERO,consulta externa,repetidas en menores de 5 anos,2005-01-01,18,17,18,17,35
VILLA SERRANO,consulta externa,repetidas en menores de 5 anos,2005-01-01,5,8,5,8,13
VILLA TUNARI,consulta externa,repetidas en menores de 5 anos,2005-01-01,74,68,74,68,142
VILLA VACA GUZMAN (MUYUPAMPA),consulta externa,repetidas en menores de 5 anos,2005-01-01,9,2,9,2,11
VILLAZON,consulta externa,repetidas en menores de 5 anos,2005-01-01,40,26,40,26,66
VINTO,consulta externa,repetidas en menores de 5 anos,2005-01-01,17,26,17,26,43
VITICHI,consulta externa,repetidas en menores de 5 anos,2005-01-01,13,4,13,4,17
WARNES,consulta externa,repetidas en menores de 5 anos,2005-01-01,21,24,21,24,45
YACO,consulta externa,repetidas en menores de 5 anos,2005-01-01,1,1,1,1,2
YACUIBA,consulta externa,repetidas en menores de 5 anos,2005-01-01,150,156,150,156,306
YAMPARAEZ,consulta externa,repetidas en menores de 5 anos,2005-01-01,12,16,12,16,28
YANACACHI,consulta externa,repetidas en menores de 5 anos,2005-01-01,1,3,1,3,4
YAPACANI,consulta externa,repetidas en menores de 5 anos,2005-01-01,55,54,55,54,109
YOCALLA,consulta externa,repetidas en menores de 5 anos,2005-01-01,1,4,1,4,5
YOTALA,consulta externa,repetidas en menores de 5 anos,2005-01-01,51,60,51,60,111
YUNCHARA,consulta externa,repetidas en menores de 5 anos,2005-01-01,2,0,2,0,2
ZUDAÑEZ,consulta externa,repetidas en menores de 5 anos,2005-01-01,3,3,3,3,6
ACACIO,consulta externa,repetidas en menores de 5 anos,2005-02-01,1,0,1,0,1
ACHACACHI,consulta externa,repetidas en menores de 5 anos,2005-02-01,14,6,14,6,20
ACHOCALLA,consulta externa,repetidas en menores de 5 anos,2005-02-01,5,4,5,4,9
AIQUILE,consulta externa,repetidas en menores de 5 anos,2005-02-01,58,53,58,53,111
ALCALA,consulta externa,repetidas en menores de 5 anos,2005-02-01,1,1,1,1,2
ANCORAIMES,consulta externa,repetidas en menores de 5 anos,2005-02-01,12,6,12,6,18
ANDAMARCA,consulta externa,repetidas en menores de 5 anos,2005-02-01,1,0,1,0,1
ANTEQUERA,consulta externa,repetidas en menores de 5 anos,2005-02-01,0,1,0,1,1
ANZALDO,consulta externa,repetidas en menores de 5 anos,2005-02-01,2,3,2,3,5
APOLO,consulta externa,repetidas en menores de 5 anos,2005-02-01,8,4,8,4,12
ARANI,consulta externa,repetidas en menores de 5 anos,2005-02-01,18,8,18,8,26
ARBIETO,consulta externa,repetidas en menores de 5 anos,2005-02-01,0,3,0,3,3
ARQUE,consulta externa,repetidas en menores de 5 anos,2005-02-01,3,6,3,6,9
ASCENCION DE GUARAYOS,consulta externa,repetidas en menores de 5 anos,2005-02-01,23,8,23,8,31
ATOCHA,consulta externa,repetidas en menores de 5 anos,2005-02-01,17,25,17,25,42
AUCAPATA,consulta externa,repetidas en menores de 5 anos,2005-02-01,4,0,4,0,4
AYO AYO,consulta externa,repetidas en menores de 5 anos,2005-02-01,2,0,2,0,2
AYOPAYA (V. DE INDEPENDENCIA),consulta externa,repetidas en menores de 5 anos,2005-02-01,11,8,11,8,19
AZURDUY,consulta externa,repetidas en menores de 5 anos,2005-02-01,1,0,1,0,1
BATALLAS,consulta externa,repetidas en menores de 5 anos,2005-02-01,1,2,1,2,3
BAURES,consulta externa,repetidas en menores de 5 anos,2005-02-01,4,7,4,7,11
BELEN DE ANDAMARCA,consulta externa,repetidas en menores de 5 anos,2005-02-01,0,1,0,1,1
BELEN DE URMIRI,consulta externa,repetidas en menores de 5 anos,2005-02-01,4,6,4,6,10
BELLA FLOR,consulta externa,repetidas en menores de 5 anos,2005-02-01,9,4,9,4,13
BERMEJO,consulta externa,repetidas en menores de 5 anos,2005-02-01,148,84,148,84,232
BETANZOS,consulta externa,repetidas en menores de 5 anos,2005-02-01,20,17,20,17,37
BOLIVAR,consulta externa,repetidas en menores de 5 anos,2005-02-01,6,4,6,4,10
BOLPEBRA,consulta externa,repetidas en menores de 5 anos,2005-02-01,8,3,8,3,11
BOYUIBE,consulta externa,repetidas en menores de 5 anos,2005-02-01,23,41,23,41,64
BUENA VISTA,consulta externa,repetidas en menores de 5 anos,2005-02-01,76,70,76,70,146
CABEZAS,consulta externa,repetidas en menores de 5 anos,2005-02-01,4,2,4,2,6
CAIROMA,consulta externa,repetidas en menores de 5 anos,2005-02-01,0,7,0,7,7
"CAIZA ""D""",consulta externa,repetidas en menores de 5 anos,2005-02-01,2,3,2,3,5
CAJUATA,consulta externa,repetidas en menores de 5 anos,2005-02-01,5,0,5,0,5
CALAMARCA,consulta externa,repetidas en menores de 5 anos,2005-02-01,13,16,13,16,29
CAMARGO,consulta externa,repetidas en menores de 5 anos,2005-02-01,7,5,7,5,12
CAMATAQUI (C. VILLA ABECIA),consulta externa,repetidas en menores de 5 anos,2005-02-01,3,13,3,13,16
CAMIRI,consulta externa,repetidas en menores de 5 anos,2005-02-01,153,146,153,146,299
CAPINOTA,consulta externa,repetidas en menores de 5 anos,2005-02-01,33,34,33,34,67
CAQUIAVIRI,consulta externa,repetidas en menores de 5 anos,2005-02-01,1,1,1,1,2
CARACOLLO,consulta externa,repetidas en menores de 5 anos,2005-02-01,5,5,5,5,10
CARANAVI,consulta externa,repetidas en menores de 5 anos,2005-02-01,2,6,2,6,8
CARAPARI,consulta externa,repetidas en menores de 5 anos,2005-02-01,2,1,2,1,3
CARMEN RIVERO TORREZ,consulta externa,repetidas en menores de 5 anos,2005-02-01,1,0,1,0,1
CHACARILLA,consulta externa,repetidas en menores de 5 anos,2005-02-01,5,7,5,7,12
CHALLAPATA,consulta externa,repetidas en menores de 5 anos,2005-02-01,5,5,5,5,10
CHAQUI,consulta externa,repetidas en menores de 5 anos,2005-02-01,3,1,3,1,4
CHARAGUA,consulta externa,repetidas en menores de 5 anos,2005-02-01,38,36,38,36,74
CHAYANTA,consulta externa,repetidas en menores de 5 anos,2005-02-01,4,3,4,3,7
CHIMORE,consulta externa,repetidas en menores de 5 anos,2005-02-01,40,31,40,31,71
CHIPAYA,consulta externa,repetidas en menores de 5 anos,2005-02-01,1,2,1,2,3
CHOQUE COTA,consulta externa,repetidas en menores de 5 anos,2005-02-01,1,1,1,1,2
CHULUMANI (V. DE LA LIBERTAD),consulta externa,repetidas en menores de 5 anos,2005-02-01,3,5,3,5,8
CHUMA,consulta externa,repetidas en menores de 5 anos,2005-02-01,2,5,2,5,7
CLIZA,consulta externa,repetidas en menores de 5 anos,2005-02-01,21,13,21,13,34
COBIJA,consulta externa,repetidas en menores de 5 anos,2005-02-01,199,204,199,204,403
COCHABAMBA,consulta externa,repetidas en menores de 5 anos,2005-02-01,2356,2282,2356,2282,4638
COLCAPIRHUA,consulta externa,repetidas en menores de 5 anos,2005-02-01,48,69,48,69,117
"COLCHA ""K""",consulta externa,repetidas en menores de 5 anos,2005-02-01,4,2,4,2,6
COLLANA,consulta externa,repetidas en menores de 5 anos,2005-02-01,1,1,1,1,2
COLOMI,consulta externa,repetidas en menores de 5 anos,2005-02-01,13,9,13,9,22
COLPA BELGICA,consulta externa,repetidas en menores de 5 anos,2005-02-01,36,18,36,18,54
COLQUECHACA,consulta externa,repetidas en menores de 5 anos,2005-02-01,8,3,8,3,11
COLQUENCHA,consulta externa,repetidas en menores de 5 anos,2005-02-01,6,7,6,7,13
COLQUIRI,consulta externa,repetidas en menores de 5 anos,2005-02-01,32,38,32,38,70
COMANCHE,consulta externa,repetidas en menores de 5 anos,2005-02-01,0,1,0,1,1
COMARAPA,consulta externa,repetidas en menores de 5 anos,2005-02-01,27,24,27,24,51
COMBAYA,consulta externa,repetidas en menores de 5 anos,2005-02-01,4,1,4,1,5
CONCEPCION,consulta externa,repetidas en menores de 5 anos,2005-02-01,24,19,24,19,43
COPACABANA,consulta externa,repetidas en menores de 5 anos,2005-02-01,4,9,4,9,13
CORIPATA,consulta externa,repetidas en menores de 5 anos,2005-02-01,5,5,5,5,10
COROICO,consulta externa,repetidas en menores de 5 anos,2005-02-01,16,17,16,17,33
CORQUE,consulta externa,repetidas en menores de 5 anos,2005-02-01,2,5,2,5,7
COTAGAITA,consulta externa,repetidas en menores de 5 anos,2005-02-01,13,16,13,16,29
COTOCA,consulta externa,repetidas en menores de 5 anos,2005-02-01,21,23,21,23,44
CUATRO CAÑADAS,consulta externa,repetidas en menores de 5 anos,2005-02-01,31,33,31,33,64
CUCHUMUELA (V. G. VILLARROEL),consulta externa,repetidas en menores de 5 anos,2005-02-01,1,0,1,0,1
CUEVO,consulta externa,repetidas en menores de 5 anos,2005-02-01,1,3,1,3,4
CULPINA,consulta externa,repetidas en menores de 5 anos,2005-02-01,15,13,15,13,28
CURAHUARA DE CARANGAS,consulta externa,repetidas en menores de 5 anos,2005-02-01,1,0,1,0,1
CURVA,consulta externa,repetidas en menores de 5 anos,2005-02-01,1,0,1,0,1
EL ALTO,consulta externa,repetidas en menores de 5 anos,2005-02-01,1622,1592,1622,1592,3214
EL CHORO,consulta externa,repetidas en menores de 5 anos,2005-02-01,1,2,1,2,3
EL PUENTE(STC),consulta externa,repetidas en menores de 5 anos,2005-02-01,10,5,10,5,15
EL PUENTE(TJA),consulta externa,repetidas en menores de 5 anos,2005-02-01,2,2,2,2,4
EL TORNO,consulta externa,repetidas en menores de 5 anos,2005-02-01,67,60,67,60,127
EL VILLAR,consulta externa,repetidas en menores de 5 anos,2005-02-01,8,6,8,6,14
ENTRE RIOS,consulta externa,repetidas en menores de 5 anos,2005-02-01,3,4,3,4,7
ENTRE RIOS,consulta externa,repetidas en menores de 5 anos,2005-02-01,49,28,49,28,77
EUCALIPTUS,consulta externa,repetidas en menores de 5 anos,2005-02-01,4,2,4,2,6
EXALTACION,consulta externa,repetidas en menores de 5 anos,2005-02-01,7,7,7,7,14
FERNANDEZ ALONSO,consulta externa,repetidas en menores de 5 anos,2005-02-01,29,19,29,19,48
FILADELFIA,consulta externa,repetidas en menores de 5 anos,2005-02-01,7,12,7,12,19
GENERAL SAAVEDRA,consulta externa,repetidas en menores de 5 anos,2005-02-01,18,15,18,15,33
GRAL. J.J. PEREZ (CHARAZANI),consulta externa,repetidas en menores de 5 anos,2005-02-01,2,0,2,0,2
GUANAY,consulta externa,repetidas en menores de 5 anos,2005-02-01,54,33,54,33,87
GUAYARAMERIN,consulta externa,repetidas en menores de 5 anos,2005-02-01,69,61,69,61,130
GUTIERREZ,consulta externa,repetidas en menores de 5 anos,2005-02-01,52,59,52,59,111
HUACARETA,consulta externa,repetidas en menores de 5 anos,2005-02-01,15,10,15,10,25
HUACAYA (VILLA DE HUACAYA),consulta externa,repetidas en menores de 5 anos,2005-02-01,1,2,1,2,3
HUACHACALLA,consulta externa,repetidas en menores de 5 anos,2005-02-01,2,1,2,1,3
HUANUNI,consulta externa,repetidas en menores de 5 anos,2005-02-01,54,96,54,96,150
HUARACAJE,consulta externa,repetidas en menores de 5 anos,2005-02-01,16,14,16,14,30
HUAYLLAMARCA,consulta externa,repetidas en menores de 5 anos,2005-02-01,0,1,0,1,1
ICHOCA,consulta externa,repetidas en menores de 5 anos,2005-02-01,1,0,1,0,1
ICLA,consulta externa,repetidas en menores de 5 anos,2005-02-01,8,5,8,5,13
INCAHUASI,consulta externa,repetidas en menores de 5 anos,2005-02-01,5,2,5,2,7
INGAVI (HUMAITA),consulta externa,repetidas en menores de 5 anos,2005-02-01,2,1,2,1,3
INQUISIVI,consulta externa,repetidas en menores de 5 anos,2005-02-01,3,3,3,3,6
IRUPANA (VILLA DE LANZA),consulta externa,repetidas en menores de 5 anos,2005-02-01,4,3,4,3,7
IXIAMAS,consulta externa,repetidas en menores de 5 anos,2005-02-01,20,18,20,18,38
JESUS DE MACHACA,consulta externa,repetidas en menores de 5 anos,2005-02-01,3,3,3,3,6
LA ASUNTA,consulta externa,repetidas en menores de 5 anos,2005-02-01,4,2,4,2,6
LA GUARDIA,consulta externa,repetidas en menores de 5 anos,2005-02-01,85,93,85,93,178
LA PAZ,consulta externa,repetidas en menores de 5 anos,2005-02-01,3238,3293,3238,3293,6531
LAGUNILLAS,consulta externa,repetidas en menores de 5 anos,2005-02-01,4,3,4,3,7
LAJA,consulta externa,repetidas en menores de 5 anos,2005-02-01,3,9,3,9,12
LAS CARRERAS,consulta externa,repetidas en menores de 5 anos,2005-02-01,5,5,5,5,10
LLALLAGUA,consulta externa,repetidas en menores de 5 anos,2005-02-01,13,10,13,10,23
LLICA,consulta externa,repetidas en menores de 5 anos,2005-02-01,1,1,1,1,2
LORETO,consulta externa,repetidas en menores de 5 anos,2005-02-01,11,8,11,8,19
MACHACAMARCA,consulta externa,repetidas en menores de 5 anos,2005-02-01,1,1,1,1,2
MACHARETI,consulta externa,repetidas en menores de 5 anos,2005-02-01,8,8,8,8,16
MAGDALENA,consulta externa,repetidas en menores de 5 anos,2005-02-01,18,26,18,26,44
MAIRANA,consulta externa,repetidas en menores de 5 anos,2005-02-01,8,9,8,9,17
MALLA,consulta externa,repetidas en menores de 5 anos,2005-02-01,1,0,1,0,1
MAPIRI,consulta externa,repetidas en menores de 5 anos,2005-02-01,5,3,5,3,8
MECAPACA,consulta externa,repetidas en menores de 5 anos,2005-02-01,8,13,8,13,21
MINEROS,consulta externa,repetidas en menores de 5 anos,2005-02-01,8,7,8,7,15
MIZQUE,consulta externa,repetidas en menores de 5 anos,2005-02-01,9,11,9,11,20
MOCOMOCO,consulta externa,repetidas en menores de 5 anos,2005-02-01,2,1,2,1,3
MOJINETE,consulta externa,repetidas en menores de 5 anos,2005-02-01,8,3,8,3,11
MOJOCOYA,consulta externa,repetidas en menores de 5 anos,2005-02-01,5,2,5,2,7
MONTEAGUDO,consulta externa,repetidas en menores de 5 anos,2005-02-01,37,25,37,25,62
MONTERO,consulta externa,repetidas en menores de 5 anos,2005-02-01,291,255,291,255,546
MORO MORO,consulta externa,repetidas en menores de 5 anos,2005-02-01,1,2,1,2,3
MOROCHATA,consulta externa,repetidas en menores de 5 anos,2005-02-01,20,24,20,24,44
OCURI,consulta externa,repetidas en menores de 5 anos,2005-02-01,3,0,3,0,3
OKINAWA,consulta externa,repetidas en menores de 5 anos,2005-02-01,19,15,19,15,34
OMEREQUE,consulta externa,repetidas en menores de 5 anos,2005-02-01,15,11,15,11,26
ORURO,consulta externa,repetidas en menores de 5 anos,2005-02-01,400,418,400,418,818
PADCAYA,consulta externa,repetidas en menores de 5 anos,2005-02-01,6,8,6,8,14
PADILLA,consulta externa,repetidas en menores de 5 anos,2005-02-01,5,3,5,3,8
PAILON,consulta externa,repetidas en menores de 5 anos,2005-02-01,8,8,8,8,16
PALCA,consulta externa,repetidas en menores de 5 anos,2005-02-01,5,4,5,4,9
PALOS BLANCOS,consulta externa,repetidas en menores de 5 anos,2005-02-01,16,9,16,9,25
PAMPA GRANDE,consulta externa,repetidas en menores de 5 anos,2005-02-01,8,6,8,6,14
PAPEL PAMPA,consulta externa,repetidas en menores de 5 anos,2005-02-01,1,1,1,1,2
PASORAPA,consulta externa,repetidas en menores de 5 anos,2005-02-01,0,1,0,1,1
PATACAMAYA,consulta externa,repetidas en menores de 5 anos,2005-02-01,2,1,2,1,3
PAZÑA,consulta externa,repetidas en menores de 5 anos,2005-02-01,7,2,7,2,9
PELECHUCO,consulta externa,repetidas en menores de 5 anos,2005-02-01,2,0,2,0,2
POCOATA,consulta externa,repetidas en menores de 5 anos,2005-02-01,5,5,5,5,10
POCONA,consulta externa,repetidas en menores de 5 anos,2005-02-01,22,32,22,32,54
POJO (CBBA),consulta externa,repetidas en menores de 5 anos,2005-02-01,5,3,5,3,8
POOPO,consulta externa,repetidas en menores de 5 anos,2005-02-01,0,1,0,1,1
PORCO,consulta externa,repetidas en menores de 5 anos,2005-02-01,1,3,1,3,4
POROMA,consulta externa,repetidas en menores de 5 anos,2005-02-01,7,0,7,0,7
PORONGO,consulta externa,repetidas en menores de 5 anos,2005-02-01,8,9,8,9,17
PORTACHUELO,consulta externa,repetidas en menores de 5 anos,2005-02-01,77,48,77,48,125
PORVENIR,consulta externa,repetidas en menores de 5 anos,2005-02-01,2,0,2,0,2
POTOSI,consulta externa,repetidas en menores de 5 anos,2005-02-01,307,210,307,210,517
PRESTO,consulta externa,repetidas en menores de 5 anos,2005-02-01,3,0,3,0,3
PUCARANI,consulta externa,repetidas en menores de 5 anos,2005-02-01,4,3,4,3,7
PUERTO ACOSTA,consulta externa,repetidas en menores de 5 anos,2005-02-01,13,5,13,5,18
PUERTO CARABUCO,consulta externa,repetidas en menores de 5 anos,2005-02-01,1,3,1,3,4
PUERTO GONZALO MORENO,consulta externa,repetidas en menores de 5 anos,2005-02-01,7,6,7,6,13
PUERTO PEREZ,consulta externa,repetidas en menores de 5 anos,2005-02-01,0,1,0,1,1
PUERTO QUIJARRO,consulta externa,repetidas en menores de 5 anos,2005-02-01,15,24,15,24,39
PUERTO RICO,consulta externa,repetidas en menores de 5 anos,2005-02-01,1,3,1,3,4
PUERTO SILES,consulta externa,repetidas en menores de 5 anos,2005-02-01,3,5,3,5,8
PUERTO SUAREZ,consulta externa,repetidas en menores de 5 anos,2005-02-01,9,18,9,18,27
PUERTO VILLARROEL,consulta externa,repetidas en menores de 5 anos,2005-02-01,115,78,115,78,193
PUNA,consulta externa,repetidas en menores de 5 anos,2005-02-01,12,6,12,6,18
PUNATA,consulta externa,repetidas en menores de 5 anos,2005-02-01,27,27,27,27,54
QUIABAYA,consulta externa,repetidas en menores de 5 anos,2005-02-01,4,2,4,2,6
QUILLACOLLO,consulta externa,repetidas en menores de 5 anos,2005-02-01,86,104,86,104,190
QUIME,consulta externa,repetidas en menores de 5 anos,2005-02-01,6,4,6,4,10
RAVELO,consulta externa,repetidas en menores de 5 anos,2005-02-01,4,3,4,3,7
REYES,consulta externa,repetidas en menores de 5 anos,2005-02-01,19,11,19,11,30
RIBERALTA,consulta externa,repetidas en menores de 5 anos,2005-02-01,351,331,351,331,682
ROBORE,consulta externa,repetidas en menores de 5 anos,2005-02-01,17,20,17,20,37
RURRENABAQUE,consulta externa,repetidas en menores de 5 anos,2005-02-01,40,22,40,22,62
SABAYA,consulta externa,repetidas en menores de 5 anos,2005-02-01,2,1,2,1,3
SACABA,consulta externa,repetidas en menores de 5 anos,2005-02-01,148,129,148,129,277
SACABAMBA,consulta externa,repetidas en menores de 5 anos,2005-02-01,10,16,10,16,26
SACACA,consulta externa,repetidas en menores de 5 anos,2005-02-01,1,5,1,5,6
SAIPINA,consulta externa,repetidas en menores de 5 anos,2005-02-01,10,6,10,6,16
SALINAS DE GARCI MENDOZA,consulta externa,repetidas en menores de 5 anos,2005-02-01,14,14,14,14,28
SAMAIPATA,consulta externa,repetidas en menores de 5 anos,2005-02-01,1,2,1,2,3
SAN AGUSTIN,consulta externa,repetidas en menores de 5 anos,2005-02-01,1,2,1,2,3
SAN ANDRES,consulta externa,repetidas en menores de 5 anos,2005-02-01,19,12,19,12,31
SAN ANTONIO DE ESMORUCO,consulta externa,repetidas en menores de 5 anos,2005-02-01,1,0,1,0,1
SAN ANTONIO DE LOMERIO,consulta externa,repetidas en menores de 5 anos,2005-02-01,2,5,2,5,7
SAN BENITO,consulta externa,repetidas en menores de 5 anos,2005-02-01,16,17,16,17,33
SAN BORJA,consulta externa,repetidas en menores de 5 anos,2005-02-01,66,37,66,37,103
SAN BUENA VENTURA,consulta externa,repetidas en menores de 5 anos,2005-02-01,3,4,3,4,7
SAN CARLOS,consulta externa,repetidas en menores de 5 anos,2005-02-01,46,35,46,35,81
SAN IGNACIO,consulta externa,repetidas en menores de 5 anos,2005-02-01,125,92,125,92,217
SAN IGNACIO DE VELASCO,consulta externa,repetidas en menores de 5 anos,2005-02-01,32,29,32,29,61
SAN JAVIER(BNI),consulta externa,repetidas en menores de 5 anos,2005-02-01,9,3,9,3,12
SAN JAVIER(STC),consulta externa,repetidas en menores de 5 anos,2005-02-01,36,27,36,27,63
SAN JOAQUIN,consulta externa,repetidas en menores de 5 anos,2005-02-01,3,6,3,6,9
SAN JOSE DE CHIQUITOS,consulta externa,repetidas en menores de 5 anos,2005-02-01,7,3,7,3,10
SAN JUAN DE YAPACANI,consulta externa,repetidas en menores de 5 anos,2005-02-01,13,15,13,15,28
SAN JULIAN,consulta externa,repetidas en menores de 5 anos,2005-02-01,56,37,56,37,93
SAN LORENZO(PND),consulta externa,repetidas en menores de 5 anos,2005-02-01,4,2,4,2,6
SAN LORENZO(TJA),consulta externa,repetidas en menores de 5 anos,2005-02-01,58,74,58,74,132
SAN LUCAS,consulta externa,repetidas en menores de 5 anos,2005-02-01,11,10,11,10,21
SAN MIGUEL DE VELASCO,consulta externa,repetidas en menores de 5 anos,2005-02-01,21,16,21,16,37
SAN PABLO DE LIPEZ,consulta externa,repetidas en menores de 5 anos,2005-02-01,0,1,0,1,1
SAN PEDRO,consulta externa,repetidas en menores de 5 anos,2005-02-01,24,22,24,22,46
SAN PEDRO DE BUENA VISTA,consulta externa,repetidas en menores de 5 anos,2005-02-01,4,0,4,0,4
SAN PEDRO DE TIQUINA,consulta externa,repetidas en menores de 5 anos,2005-02-01,9,10,9,10,19
SAN RAFAEL,consulta externa,repetidas en menores de 5 anos,2005-02-01,7,10,7,10,17
SAN RAMON,consulta externa,repetidas en menores de 5 anos,2005-02-01,0,3,0,3,3
SAN RAMON,consulta externa,repetidas en menores de 5 anos,2005-02-01,6,7,6,7,13
SANTA ANA,consulta externa,repetidas en menores de 5 anos,2005-02-01,38,29,38,29,67
SANTA CRUZ DE LA SIERRA,consulta externa,repetidas en menores de 5 anos,2005-02-01,3370,3651,3370,3651,7021
SANTA ROSA,consulta externa,repetidas en menores de 5 anos,2005-02-01,16,5,16,5,21
SANTA ROSA DEL SARA,consulta externa,repetidas en menores de 5 anos,2005-02-01,20,16,20,16,36
SANTIAGO DE CALLAPA,consulta externa,repetidas en menores de 5 anos,2005-02-01,9,28,9,28,37
SANTIAGO DE HUARI,consulta externa,repetidas en menores de 5 anos,2005-02-01,2,5,2,5,7
SANTIVAÑES,consulta externa,repetidas en menores de 5 anos,2005-02-01,7,7,7,7,14
SAPAHAQUI,consulta externa,repetidas en menores de 5 anos,2005-02-01,1,4,1,4,5
SENA,consulta externa,repetidas en menores de 5 anos,2005-02-01,0,2,0,2,2
SICA SICA (VILLA AROMA),consulta externa,repetidas en menores de 5 anos,2005-02-01,4,5,4,5,9
SIPE SIPE,consulta externa,repetidas en menores de 5 anos,2005-02-01,68,76,68,76,144
SOPACHUY,consulta externa,repetidas en menores de 5 anos,2005-02-01,2,3,2,3,5
SORACACHI,consulta externa,repetidas en menores de 5 anos,2005-02-01,1,5,1,5,6
SORATA,consulta externa,repetidas en menores de 5 anos,2005-02-01,18,7,18,7,25
SUCRE,consulta externa,repetidas en menores de 5 anos,2005-02-01,602,594,602,594,1196
TACACHI,consulta externa,repetidas en menores de 5 anos,2005-02-01,5,9,5,9,14
TACOPAYA,consulta externa,repetidas en menores de 5 anos,2005-02-01,33,23,33,23,56
TAHUA,consulta externa,repetidas en menores de 5 anos,2005-02-01,1,0,1,0,1
TAPACARI,consulta externa,repetidas en menores de 5 anos,2005-02-01,11,9,11,9,20
TARABUCO,consulta externa,repetidas en menores de 5 anos,2005-02-01,118,151,118,151,269
TARACO,consulta externa,repetidas en menores de 5 anos,2005-02-01,1,1,1,1,2
TARATA,consulta externa,repetidas en menores de 5 anos,2005-02-01,24,19,24,19,43
TARIJA,consulta externa,repetidas en menores de 5 anos,2005-02-01,479,549,479,549,1028
TARVITA,consulta externa,repetidas en menores de 5 anos,2005-02-01,6,9,6,9,15
TEOPONTE,consulta externa,repetidas en menores de 5 anos,2005-02-01,11,3,11,3,14
TIAWANACU,consulta externa,repetidas en menores de 5 anos,2005-02-01,3,1,3,1,4
TINGUIPAYA,consulta externa,repetidas en menores de 5 anos,2005-02-01,4,1,4,1,5
TIPUANI,consulta externa,repetidas en menores de 5 anos,2005-02-01,8,3,8,3,11
TIQUIPAYA,consulta externa,repetidas en menores de 5 anos,2005-02-01,221,186,221,186,407
TIRAQUE (CBBA),consulta externa,repetidas en menores de 5 anos,2005-02-01,58,70,58,70,128
TOCO,consulta externa,repetidas en menores de 5 anos,2005-02-01,3,1,3,1,4
TODOS SANTOS,consulta externa,repetidas en menores de 5 anos,2005-02-01,2,3,2,3,5
TOLATA,consulta externa,repetidas en menores de 5 anos,2005-02-01,3,0,3,0,3
TOLEDO,consulta externa,repetidas en menores de 5 anos,2005-02-01,1,0,1,0,1
TOMAVE,consulta externa,repetidas en menores de 5 anos,2005-02-01,6,2,6,2,8
TOMINA,consulta externa,repetidas en menores de 5 anos,2005-02-01,5,3,5,3,8
TORO TORO,consulta externa,repetidas en menores de 5 anos,2005-02-01,26,12,26,12,38
TOTORA(CBBA),consulta externa,repetidas en menores de 5 anos,2005-02-01,13,15,13,15,28
TOTORA(ORR),consulta externa,repetidas en menores de 5 anos,2005-02-01,11,21,11,21,32
TRIGAL,consulta externa,repetidas en menores de 5 anos,2005-02-01,3,3,3,3,6
TRINIDAD,consulta externa,repetidas en menores de 5 anos,2005-02-01,251,235,251,235,486
TUPIZA,consulta externa,repetidas en menores de 5 anos,2005-02-01,73,84,73,84,157
TURCO,consulta externa,repetidas en menores de 5 anos,2005-02-01,0,1,0,1,1
UNCIA,consulta externa,repetidas en menores de 5 anos,2005-02-01,9,9,9,9,18
URIONDO (A. CONCEPCION),consulta externa,repetidas en menores de 5 anos,2005-02-01,13,8,13,8,21
URUBICHA,consulta externa,repetidas en menores de 5 anos,2005-02-01,11,7,11,7,18
UYUNI,consulta externa,repetidas en menores de 5 anos,2005-02-01,8,3,8,3,11
VACAS,consulta externa,repetidas en menores de 5 anos,2005-02-01,9,13,9,13,22
VALLEGRANDE,consulta externa,repetidas en menores de 5 anos,2005-02-01,9,11,9,11,20
VIACHA,consulta externa,repetidas en menores de 5 anos,2005-02-01,44,46,44,46,90
VILA VILA,consulta externa,repetidas en menores de 5 anos,2005-02-01,1,1,1,1,2
VILLA MONTES,consulta externa,repetidas en menores de 5 anos,2005-02-01,32,40,32,40,72
VILLA NUEVA (LOMA ALTA),consulta externa,repetidas en menores de 5 anos,2005-02-01,0,1,0,1,1
VILLA RIVERO,consulta externa,repetidas en menores de 5 anos,2005-02-01,7,9,7,9,16
VILLA SERRANO,consulta externa,repetidas en menores de 5 anos,2005-02-01,10,3,10,3,13
VILLA TUNARI,consulta externa,repetidas en menores de 5 anos,2005-02-01,137,83,137,83,220
VILLA VACA GUZMAN (MUYUPAMPA),consulta externa,repetidas en menores de 5 anos,2005-02-01,14,14,14,14,28
VILLAZON,consulta externa,repetidas en menores de 5 anos,2005-02-01,37,38,37,38,75
VINTO,consulta externa,repetidas en menores de 5 anos,2005-02-01,15,9,15,9,24
VITICHI,consulta externa,repetidas en menores de 5 anos,2005-02-01,5,6,5,6,11
WARNES,consulta externa,repetidas en menores de 5 anos,2005-02-01,120,87,120,87,207
YACO,consulta externa,repetidas en menores de 5 anos,2005-02-01,2,5,2,5,7
YACUIBA,consulta externa,repetidas en menores de 5 anos,2005-02-01,92,108,92,108,200
YAMPARAEZ,consulta externa,repetidas en menores de 5 anos,2005-02-01,7,8,7,8,15
YANACACHI,consulta externa,repetidas en menores de 5 anos,2005-02-01,4,0,4,0,4
YAPACANI,consulta externa,repetidas en menores de 5 anos,2005-02-01,54,36,54,36,90
YOCALLA,consulta externa,repetidas en menores de 5 anos,2005-02-01,1,1,1,1,2
YOTALA,consulta externa,repetidas en menores de 5 anos,2005-02-01,11,14,11,14,25
YUNCHARA,consulta externa,repetidas en menores de 5 anos,2005-02-01,0,1,0,1,1
ZUDAÑEZ,consulta externa,repetidas en menores de 5 anos,2005-02-01,5,2,5,2,7
ACACIO,consulta externa,repetidas en menores de 5 anos,2005-03-01,3,1,3,1,4
ACHACACHI,consulta externa,repetidas en menores de 5 anos,2005-03-01,11,9,11,9,20
ACHOCALLA,consulta externa,repetidas en menores de 5 anos,2005-03-01,4,8,4,8,12
AIQUILE,consulta externa,repetidas en menores de 5 anos,2005-03-01,105,136,105,136,241
ALCALA,consulta externa,repetidas en menores de 5 anos,2005-03-01,2,1,2,1,3
ANCORAIMES,consulta externa,repetidas en menores de 5 anos,2005-03-01,17,11,17,11,28
ANDAMARCA,consulta externa,repetidas en menores de 5 anos,2005-03-01,1,3,1,3,4
ANTEQUERA,consulta externa,repetidas en menores de 5 anos,2005-03-01,0,15,0,15,15
ANZALDO,consulta externa,repetidas en menores de 5 anos,2005-03-01,13,7,13,7,20
APOLO,consulta externa,repetidas en menores de 5 anos,2005-03-01,4,6,4,6,10
ARANI,consulta externa,repetidas en menores de 5 anos,2005-03-01,19,19,19,19,38
ARBIETO,consulta externa,repetidas en menores de 5 anos,2005-03-01,3,3,3,3,6
ARQUE,consulta externa,repetidas en menores de 5 anos,2005-03-01,4,3,4,3,7
ASCENCION DE GUARAYOS,consulta externa,repetidas en menores de 5 anos,2005-03-01,46,25,46,25,71
ATOCHA,consulta externa,repetidas en menores de 5 anos,2005-03-01,32,26,32,26,58
AUCAPATA,consulta externa,repetidas en menores de 5 anos,2005-03-01,1,0,1,0,1
AYO AYO,consulta externa,repetidas en menores de 5 anos,2005-03-01,10,4,10,4,14
AYOPAYA (V. DE INDEPENDENCIA),consulta externa,repetidas en menores de 5 anos,2005-03-01,15,13,15,13,28
AZURDUY,consulta externa,repetidas en menores de 5 anos,2005-03-01,1,0,1,0,1
BATALLAS,consulta externa,repetidas en menores de 5 anos,2005-03-01,3,3,3,3,6
BAURES,consulta externa,repetidas en menores de 5 anos,2005-03-01,7,9,7,9,16
BELEN DE ANDAMARCA,consulta externa,repetidas en menores de 5 anos,2005-03-01,8,3,8,3,11
BELEN DE URMIRI,consulta externa,repetidas en menores de 5 anos,2005-03-01,2,1,2,1,3
BELLA FLOR,consulta externa,repetidas en menores de 5 anos,2005-03-01,1,0,1,0,1
BERMEJO,consulta externa,repetidas en menores de 5 anos,2005-03-01,100,97,100,97,197
BETANZOS,consulta externa,repetidas en menores de 5 anos,2005-03-01,24,20,24,20,44
BOLIVAR,consulta externa,repetidas en menores de 5 anos,2005-03-01,8,3,8,3,11
BOLPEBRA,consulta externa,repetidas en menores de 5 anos,2005-03-01,2,4,2,4,6
BOYUIBE,consulta externa,repetidas en menores de 5 anos,2005-03-01,19,17,19,17,36
BUENA VISTA,consulta externa,repetidas en menores de 5 anos,2005-03-01,77,86,77,86,163
CABEZAS,consulta externa,repetidas en menores de 5 anos,2005-03-01,6,4,6,4,10
"CAIZA ""D""",consulta externa,repetidas en menores de 5 anos,2005-03-01,3,0,3,0,3
CAJUATA,consulta externa,repetidas en menores de 5 anos,2005-03-01,1,0,1,0,1
CALAMARCA,consulta externa,repetidas en menores de 5 anos,2005-03-01,6,7,6,7,13
CAMARGO,consulta externa,repetidas en menores de 5 anos,2005-03-01,9,17,9,17,26
CAMATAQUI (C. VILLA ABECIA),consulta externa,repetidas en menores de 5 anos,2005-03-01,0,2,0,2,2
CAMIRI,consulta externa,repetidas en menores de 5 anos,2005-03-01,210,180,210,180,390
CAPINOTA,consulta externa,repetidas en menores de 5 anos,2005-03-01,38,41,38,41,79
CAQUIAVIRI,consulta externa,repetidas en menores de 5 anos,2005-03-01,1,1,1,1,2
CARACOLLO,consulta externa,repetidas en menores de 5 anos,2005-03-01,3,3,3,3,6
CARANAVI,consulta externa,repetidas en menores de 5 anos,2005-03-01,14,16,14,16,30
CARAPARI,consulta externa,repetidas en menores de 5 anos,2005-03-01,2,1,2,1,3
CARIPUYO,consulta externa,repetidas en menores de 5 anos,2005-03-01,27,25,27,25,52
CHACARILLA,consulta externa,repetidas en menores de 5 anos,2005-03-01,23,30,23,30,53
CHALLAPATA,consulta externa,repetidas en menores de 5 anos,2005-03-01,11,9,11,9,20
CHAQUI,consulta externa,repetidas en menores de 5 anos,2005-03-01,4,0,4,0,4
CHARAGUA,consulta externa,repetidas en menores de 5 anos,2005-03-01,74,70,74,70,144
CHARAÑA,consulta externa,repetidas en menores de 5 anos,2005-03-01,3,10,3,10,13
CHAYANTA,consulta externa,repetidas en menores de 5 anos,2005-03-01,5,3,5,3,8
CHIMORE,consulta externa,repetidas en menores de 5 anos,2005-03-01,54,62,54,62,116
CHIPAYA,consulta externa,repetidas en menores de 5 anos,2005-03-01,2,2,2,2,4
CHOQUE COTA,consulta externa,repetidas en menores de 5 anos,2005-03-01,1,1,1,1,2
CHULUMANI (V. DE LA LIBERTAD),consulta externa,repetidas en menores de 5 anos,2005-03-01,2,1,2,1,3
CHUMA,consulta externa,repetidas en menores de 5 anos,2005-03-01,7,10,7,10,17
CLIZA,consulta externa,repetidas en menores de 5 anos,2005-03-01,30,16,30,16,46
COBIJA,consulta externa,repetidas en menores de 5 anos,2005-03-01,219,204,219,204,423
COCHABAMBA,consulta externa,repetidas en menores de 5 anos,2005-03-01,3095,2677,3095,2677,5772
COLCAPIRHUA,consulta externa,repetidas en menores de 5 anos,2005-03-01,79,78,79,78,157
"COLCHA ""K""",consulta externa,repetidas en menores de 5 anos,2005-03-01,5,2,5,2,7
COLOMI,consulta externa,repetidas en menores de 5 anos,2005-03-01,18,11,18,11,29
COLPA BELGICA,consulta externa,repetidas en menores de 5 anos,2005-03-01,29,10,29,10,39
COLQUECHACA,consulta externa,repetidas en menores de 5 anos,2005-03-01,18,8,18,8,26
COLQUENCHA,consulta externa,repetidas en menores de 5 anos,2005-03-01,9,4,9,4,13
COLQUIRI,consulta externa,repetidas en menores de 5 anos,2005-03-01,25,19,25,19,44
COMANCHE,consulta externa,repetidas en menores de 5 anos,2005-03-01,2,4,2,4,6
COMARAPA,consulta externa,repetidas en menores de 5 anos,2005-03-01,54,46,54,46,100
CONCEPCION,consulta externa,repetidas en menores de 5 anos,2005-03-01,20,22,20,22,42
COPACABANA,consulta externa,repetidas en menores de 5 anos,2005-03-01,2,1,2,1,3
CORIPATA,consulta externa,repetidas en menores de 5 anos,2005-03-01,6,5,6,5,11
CORO CORO,consulta externa,repetidas en menores de 5 anos,2005-03-01,0,1,0,1,1
COROICO,consulta externa,repetidas en menores de 5 anos,2005-03-01,25,20,25,20,45
CORQUE,consulta externa,repetidas en menores de 5 anos,2005-03-01,7,15,7,15,22
COTAGAITA,consulta externa,repetidas en menores de 5 anos,2005-03-01,25,28,25,28,53
COTOCA,consulta externa,repetidas en menores de 5 anos,2005-03-01,8,5,8,5,13
CUATRO CAÑADAS,consulta externa,repetidas en menores de 5 anos,2005-03-01,43,41,43,41,84
CUEVO,consulta externa,repetidas en menores de 5 anos,2005-03-01,18,18,18,18,36
CULPINA,consulta externa,repetidas en menores de 5 anos,2005-03-01,12,8,12,8,20
CURAHUARA DE CARANGAS,consulta externa,repetidas en menores de 5 anos,2005-03-01,0,1,0,1,1
CURVA,consulta externa,repetidas en menores de 5 anos,2005-03-01,1,1,1,1,2
EL ALTO,consulta externa,repetidas en menores de 5 anos,2005-03-01,2242,2027,2242,2027,4269
EL PUENTE(STC),consulta externa,repetidas en menores de 5 anos,2005-03-01,10,7,10,7,17
EL PUENTE(TJA),consulta externa,repetidas en menores de 5 anos,2005-03-01,9,12,9,12,21
EL TORNO,consulta externa,repetidas en menores de 5 anos,2005-03-01,144,124,144,124,268
EL VILLAR,consulta externa,repetidas en menores de 5 anos,2005-03-01,4,2,4,2,6
ENTRE RIOS,consulta externa,repetidas en menores de 5 anos,2005-03-01,27,40,27,40,67
ENTRE RIOS,consulta externa,repetidas en menores de 5 anos,2005-03-01,33,30,33,30,63
EUCALIPTUS,consulta externa,repetidas en menores de 5 anos,2005-03-01,3,8,3,8,11
EXALTACION,consulta externa,repetidas en menores de 5 anos,2005-03-01,8,4,8,4,12
FERNANDEZ ALONSO,consulta externa,repetidas en menores de 5 anos,2005-03-01,39,40,39,40,79
FILADELFIA,consulta externa,repetidas en menores de 5 anos,2005-03-01,4,5,4,5,9
GENERAL SAAVEDRA,consulta externa,repetidas en menores de 5 anos,2005-03-01,28,26,28,26,54
GRAL. J.J. PEREZ (CHARAZANI),consulta externa,repetidas en menores de 5 anos,2005-03-01,5,3,5,3,8
GUANAY,consulta externa,repetidas en menores de 5 anos,2005-03-01,59,40,59,40,99
GUAQUI,consulta externa,repetidas en menores de 5 anos,2005-03-01,2,2,2,2,4
GUAYARAMERIN,consulta externa,repetidas en menores de 5 anos,2005-03-01,122,89,122,89,211
GUTIERREZ,consulta externa,repetidas en menores de 5 anos,2005-03-01,70,88,70,88,158
HUACARETA,consulta externa,repetidas en menores de 5 anos,2005-03-01,34,47,34,47,81
HUACAYA (VILLA DE HUACAYA),consulta externa,repetidas en menores de 5 anos,2005-03-01,4,1,4,1,5
HUACHACALLA,consulta externa,repetidas en menores de 5 anos,2005-03-01,0,1,0,1,1
HUANUNI,consulta externa,repetidas en menores de 5 anos,2005-03-01,146,150,146,150,296
HUARACAJE,consulta externa,repetidas en menores de 5 anos,2005-03-01,15,7,15,7,22
HUAYLLAMARCA,consulta externa,repetidas en menores de 5 anos,2005-03-01,12,13,12,13,25
ICLA,consulta externa,repetidas en menores de 5 anos,2005-03-01,3,5,3,5,8
INCAHUASI,consulta externa,repetidas en menores de 5 anos,2005-03-01,22,16,22,16,38
INGAVI (HUMAITA),consulta externa,repetidas en menores de 5 anos,2005-03-01,4,1,4,1,5
INQUISIVI,consulta externa,repetidas en menores de 5 anos,2005-03-01,5,2,5,2,7
IRUPANA (VILLA DE LANZA),consulta externa,repetidas en menores de 5 anos,2005-03-01,5,2,5,2,7
IXIAMAS,consulta externa,repetidas en menores de 5 anos,2005-03-01,22,12,22,12,34
JESUS DE MACHACA,consulta externa,repetidas en menores de 5 anos,2005-03-01,0,1,0,1,1
LA ASUNTA,consulta externa,repetidas en menores de 5 anos,2005-03-01,5,11,5,11,16
LA GUARDIA,consulta externa,repetidas en menores de 5 anos,2005-03-01,93,117,93,117,210
LA PAZ,consulta externa,repetidas en menores de 5 anos,2005-03-01,4362,4485,4362,4485,8847
LAGUNILLAS,consulta externa,repetidas en menores de 5 anos,2005-03-01,9,5,9,5,14
LAJA,consulta externa,repetidas en menores de 5 anos,2005-03-01,5,3,5,3,8
LAS CARRERAS,consulta externa,repetidas en menores de 5 anos,2005-03-01,5,2,5,2,7
LLALLAGUA,consulta externa,repetidas en menores de 5 anos,2005-03-01,25,21,25,21,46
LLICA,consulta externa,repetidas en menores de 5 anos,2005-03-01,7,2,7,2,9
LORETO,consulta externa,repetidas en menores de 5 anos,2005-03-01,16,9,16,9,25
LURIBAY,consulta externa,repetidas en menores de 5 anos,2005-03-01,0,1,0,1,1
MACHACAMARCA,consulta externa,repetidas en menores de 5 anos,2005-03-01,2,3,2,3,5
MACHARETI,consulta externa,repetidas en menores de 5 anos,2005-03-01,19,11,19,11,30
MAGDALENA,consulta externa,repetidas en menores de 5 anos,2005-03-01,13,20,13,20,33
MAIRANA,consulta externa,repetidas en menores de 5 anos,2005-03-01,17,7,17,7,24
MAPIRI,consulta externa,repetidas en menores de 5 anos,2005-03-01,2,4,2,4,6
MECAPACA,consulta externa,repetidas en menores de 5 anos,2005-03-01,12,21,12,21,33
MINEROS,consulta externa,repetidas en menores de 5 anos,2005-03-01,17,18,17,18,35
MIZQUE,consulta externa,repetidas en menores de 5 anos,2005-03-01,11,12,11,12,23
MOCOMOCO,consulta externa,repetidas en menores de 5 anos,2005-03-01,9,7,9,7,16
MOJINETE,consulta externa,repetidas en menores de 5 anos,2005-03-01,2,4,2,4,6
MOJOCOYA,consulta externa,repetidas en menores de 5 anos,2005-03-01,6,1,6,1,7
MONTEAGUDO,consulta externa,repetidas en menores de 5 anos,2005-03-01,79,70,79,70,149
MONTERO,consulta externa,repetidas en menores de 5 anos,2005-03-01,514,452,514,452,966
MOROCHATA,consulta externa,repetidas en menores de 5 anos,2005-03-01,22,25,22,25,47
NUEVO MANOA (NUEVA ESPERANZA),consulta externa,repetidas en menores de 5 anos,2005-03-01,2,3,2,3,5
OCURI,consulta externa,repetidas en menores de 5 anos,2005-03-01,8,4,8,4,12
OKINAWA,consulta externa,repetidas en menores de 5 anos,2005-03-01,16,15,16,15,31
OMEREQUE,consulta externa,repetidas en menores de 5 anos,2005-03-01,19,14,19,14,33
ORURO,consulta externa,repetidas en menores de 5 anos,2005-03-01,430,445,430,445,875
PADCAYA,consulta externa,repetidas en menores de 5 anos,2005-03-01,15,12,15,12,27
PADILLA,consulta externa,repetidas en menores de 5 anos,2005-03-01,9,3,9,3,12
PAILON,consulta externa,repetidas en menores de 5 anos,2005-03-01,11,8,11,8,19
PALCA,consulta externa,repetidas en menores de 5 anos,2005-03-01,7,6,7,6,13
PALOS BLANCOS,consulta externa,repetidas en menores de 5 anos,2005-03-01,19,11,19,11,30
PAMPA AULLAGAS,consulta externa,repetidas en menores de 5 anos,2005-03-01,2,2,2,2,4
PAMPA GRANDE,consulta externa,repetidas en menores de 5 anos,2005-03-01,73,44,73,44,117
PAPEL PAMPA,consulta externa,repetidas en menores de 5 anos,2005-03-01,2,1,2,1,3
PASORAPA,consulta externa,repetidas en menores de 5 anos,2005-03-01,3,1,3,1,4
PATACAMAYA,consulta externa,repetidas en menores de 5 anos,2005-03-01,17,9,17,9,26
PAZÑA,consulta externa,repetidas en menores de 5 anos,2005-03-01,1,1,1,1,2
PELECHUCO,consulta externa,repetidas en menores de 5 anos,2005-03-01,4,2,4,2,6
POCOATA,consulta externa,repetidas en menores de 5 anos,2005-03-01,10,5,10,5,15
POCONA,consulta externa,repetidas en menores de 5 anos,2005-03-01,4,1,4,1,5
POJO (CBBA),consulta externa,repetidas en menores de 5 anos,2005-03-01,16,29,16,29,45
POOPO,consulta externa,repetidas en menores de 5 anos,2005-03-01,2,1,2,1,3
PORCO,consulta externa,repetidas en menores de 5 anos,2005-03-01,3,1,3,1,4
POROMA,consulta externa,repetidas en menores de 5 anos,2005-03-01,5,2,5,2,7
PORONGO,consulta externa,repetidas en menores de 5 anos,2005-03-01,17,11,17,11,28
PORTACHUELO,consulta externa,repetidas en menores de 5 anos,2005-03-01,77,76,77,76,153
PORVENIR,consulta externa,repetidas en menores de 5 anos,2005-03-01,2,4,2,4,6
POSTRER VALLE,consulta externa,repetidas en menores de 5 anos,2005-03-01,7,6,7,6,13
POTOSI,consulta externa,repetidas en menores de 5 anos,2005-03-01,299,279,299,279,578
PRESTO,consulta externa,repetidas en menores de 5 anos,2005-03-01,3,0,3,0,3
PUCARANI,consulta externa,repetidas en menores de 5 anos,2005-03-01,2,5,2,5,7
PUERTO ACOSTA,consulta externa,repetidas en menores de 5 anos,2005-03-01,3,4,3,4,7
PUERTO CARABUCO,consulta externa,repetidas en menores de 5 anos,2005-03-01,1,2,1,2,3
PUERTO GONZALO MORENO,consulta externa,repetidas en menores de 5 anos,2005-03-01,11,15,11,15,26
PUERTO PEREZ,consulta externa,repetidas en menores de 5 anos,2005-03-01,0,2,0,2,2
PUERTO QUIJARRO,consulta externa,repetidas en menores de 5 anos,2005-03-01,13,20,13,20,33
PUERTO RICO,consulta externa,repetidas en menores de 5 anos,2005-03-01,43,37,43,37,80
PUERTO SILES,consulta externa,repetidas en menores de 5 anos,2005-03-01,4,9,4,9,13
PUERTO SUAREZ,consulta externa,repetidas en menores de 5 anos,2005-03-01,27,29,27,29,56
PUERTO VILLARROEL,consulta externa,repetidas en menores de 5 anos,2005-03-01,106,81,106,81,187
PUNA,consulta externa,repetidas en menores de 5 anos,2005-03-01,13,11,13,11,24
PUNATA,consulta externa,repetidas en menores de 5 anos,2005-03-01,85,71,85,71,156
QUIABAYA,consulta externa,repetidas en menores de 5 anos,2005-03-01,1,0,1,0,1
QUILLACOLLO,consulta externa,repetidas en menores de 5 anos,2005-03-01,204,190,204,190,394
QUIME,consulta externa,repetidas en menores de 5 anos,2005-03-01,2,7,2,7,9
QUIRUSILLAS,consulta externa,repetidas en menores de 5 anos,2005-03-01,1,1,1,1,2
RAVELO,consulta externa,repetidas en menores de 5 anos,2005-03-01,2,1,2,1,3
REYES,consulta externa,repetidas en menores de 5 anos,2005-03-01,10,8,10,8,18
RIBERALTA,consulta externa,repetidas en menores de 5 anos,2005-03-01,495,475,495,475,970
ROBORE,consulta externa,repetidas en menores de 5 anos,2005-03-01,22,24,22,24,46
RURRENABAQUE,consulta externa,repetidas en menores de 5 anos,2005-03-01,64,76,64,76,140
SABAYA,consulta externa,repetidas en menores de 5 anos,2005-03-01,4,4,4,4,8
SACABA,consulta externa,repetidas en menores de 5 anos,2005-03-01,165,134,165,134,299
SACABAMBA,consulta externa,repetidas en menores de 5 anos,2005-03-01,21,1,21,1,22
SAIPINA,consulta externa,repetidas en menores de 5 anos,2005-03-01,16,20,16,20,36
SALINAS DE GARCI MENDOZA,consulta externa,repetidas en menores de 5 anos,2005-03-01,16,14,16,14,30
SAMAIPATA,consulta externa,repetidas en menores de 5 anos,2005-03-01,5,2,5,2,7
SAN AGUSTIN,consulta externa,repetidas en menores de 5 anos,2005-03-01,2,0,2,0,2
SAN ANDRES,consulta externa,repetidas en menores de 5 anos,2005-03-01,14,14,14,14,28
SAN ANDRES DE MACHACA,consulta externa,repetidas en menores de 5 anos,2005-03-01,0,2,0,2,2
SAN ANTONIO DE ESMORUCO,consulta externa,repetidas en menores de 5 anos,2005-03-01,3,2,3,2,5
SAN ANTONIO DE LOMERIO,consulta externa,repetidas en menores de 5 anos,2005-03-01,4,4,4,4,8
SAN BENITO,consulta externa,repetidas en menores de 5 anos,2005-03-01,16,22,16,22,38
SAN BORJA,consulta externa,repetidas en menores de 5 anos,2005-03-01,69,56,69,56,125
SAN BUENA VENTURA,consulta externa,repetidas en menores de 5 anos,2005-03-01,13,7,13,7,20
SAN CARLOS,consulta externa,repetidas en menores de 5 anos,2005-03-01,25,29,25,29,54
SAN IGNACIO,consulta externa,repetidas en menores de 5 anos,2005-03-01,142,133,142,133,275
SAN IGNACIO DE VELASCO,consulta externa,repetidas en menores de 5 anos,2005-03-01,225,170,225,170,395
SAN JAVIER(BNI),consulta externa,repetidas en menores de 5 anos,2005-03-01,11,9,11,9,20
SAN JAVIER(STC),consulta externa,repetidas en menores de 5 anos,2005-03-01,57,61,57,61,118
SAN JOAQUIN,consulta externa,repetidas en menores de 5 anos,2005-03-01,7,11,7,11,18
SAN JOSE DE CHIQUITOS,consulta externa,repetidas en menores de 5 anos,2005-03-01,9,6,9,6,15
SAN JUAN DE YAPACANI,consulta externa,repetidas en menores de 5 anos,2005-03-01,11,9,11,9,20
SAN JULIAN,consulta externa,repetidas en menores de 5 anos,2005-03-01,40,50,40,50,90
SAN LORENZO(PND),consulta externa,repetidas en menores de 5 anos,2005-03-01,12,17,12,17,29
SAN LORENZO(TJA),consulta externa,repetidas en menores de 5 anos,2005-03-01,71,67,71,67,138
SAN LUCAS,consulta externa,repetidas en menores de 5 anos,2005-03-01,11,13,11,13,24
SAN MATIAS,consulta externa,repetidas en menores de 5 anos,2005-03-01,31,25,31,25,56
SAN MIGUEL DE VELASCO,consulta externa,repetidas en menores de 5 anos,2005-03-01,69,47,69,47,116
SAN PABLO DE LIPEZ,consulta externa,repetidas en menores de 5 anos,2005-03-01,4,0,4,0,4
SAN PEDRO,consulta externa,repetidas en menores de 5 anos,2005-03-01,37,25,37,25,62
SAN PEDRO DE BUENA VISTA,consulta externa,repetidas en menores de 5 anos,2005-03-01,1,0,1,0,1
SAN PEDRO DE CURAHUARA,consulta externa,repetidas en menores de 5 anos,2005-03-01,1,1,1,1,2
SAN RAFAEL,consulta externa,repetidas en menores de 5 anos,2005-03-01,14,8,14,8,22
SAN RAMON,consulta externa,repetidas en menores de 5 anos,2005-03-01,5,8,5,8,13
SAN RAMON,consulta externa,repetidas en menores de 5 anos,2005-03-01,11,5,11,5,16
SANTA ANA,consulta externa,repetidas en menores de 5 anos,2005-03-01,32,17,32,17,49
SANTA CRUZ DE LA SIERRA,consulta externa,repetidas en menores de 5 anos,2005-03-01,5265,4944,5265,4944,10209
SANTA ROSA,consulta externa,repetidas en menores de 5 anos,2005-03-01,24,8,24,8,32
SANTA ROSA DEL SARA,consulta externa,repetidas en menores de 5 anos,2005-03-01,19,12,19,12,31
SANTIAGO DE CALLAPA,consulta externa,repetidas en menores de 5 anos,2005-03-01,5,8,5,8,13
SANTIAGO DE HUARI,consulta externa,repetidas en menores de 5 anos,2005-03-01,3,5,3,5,8
SANTIVAÑES,consulta externa,repetidas en menores de 5 anos,2005-03-01,4,5,4,5,9
SANTUARIO DE QUILLACAS,consulta externa,repetidas en menores de 5 anos,2005-03-01,0,1,0,1,1
SAPAHAQUI,consulta externa,repetidas en menores de 5 anos,2005-03-01,5,9,5,9,14
SENA,consulta externa,repetidas en menores de 5 anos,2005-03-01,6,20,6,20,26
SICA SICA (VILLA AROMA),consulta externa,repetidas en menores de 5 anos,2005-03-01,8,9,8,9,17
SIPE SIPE,consulta externa,repetidas en menores de 5 anos,2005-03-01,88,81,88,81,169
SOPACHUY,consulta externa,repetidas en menores de 5 anos,2005-03-01,5,3,5,3,8
SORACACHI,consulta externa,repetidas en menores de 5 anos,2005-03-01,0,1,0,1,1
SORATA,consulta externa,repetidas en menores de 5 anos,2005-03-01,25,20,25,20,45
SUCRE,consulta externa,repetidas en menores de 5 anos,2005-03-01,781,826,781,826,1607
TACACHI,consulta externa,repetidas en menores de 5 anos,2005-03-01,18,11,18,11,29
TACOBAMBA,consulta externa,repetidas en menores de 5 anos,2005-03-01,3,0,3,0,3
TACOPAYA,consulta externa,repetidas en menores de 5 anos,2005-03-01,4,2,4,2,6
TAHUA,consulta externa,repetidas en menores de 5 anos,2005-03-01,0,1,0,1,1
TAPACARI,consulta externa,repetidas en menores de 5 anos,2005-03-01,25,24,25,24,49
TARABUCO,consulta externa,repetidas en menores de 5 anos,2005-03-01,174,190,174,190,364
TARACO,consulta externa,repetidas en menores de 5 anos,2005-03-01,5,1,5,1,6
TARATA,consulta externa,repetidas en menores de 5 anos,2005-03-01,30,27,30,27,57
TARIJA,consulta externa,repetidas en menores de 5 anos,2005-03-01,584,606,584,606,1190
TARVITA,consulta externa,repetidas en menores de 5 anos,2005-03-01,11,11,11,11,22
TIAWANACU,consulta externa,repetidas en menores de 5 anos,2005-03-01,3,0,3,0,3
TINGUIPAYA,consulta externa,repetidas en menores de 5 anos,2005-03-01,0,2,0,2,2
TIPUANI,consulta externa,repetidas en menores de 5 anos,2005-03-01,13,12,13,12,25
TIQUIPAYA,consulta externa,repetidas en menores de 5 anos,2005-03-01,235,222,235,222,457
TIRAQUE (CBBA),consulta externa,repetidas en menores de 5 anos,2005-03-01,84,76,84,76,160
TITO YUPANQUI (PARQUIPUJIO),consulta externa,repetidas en menores de 5 anos,2005-03-01,1,0,1,0,1
TOCO,consulta externa,repetidas en menores de 5 anos,2005-03-01,8,13,8,13,21
TOLATA,consulta externa,repetidas en menores de 5 anos,2005-03-01,1,8,1,8,9
TOLEDO,consulta externa,repetidas en menores de 5 anos,2005-03-01,3,1,3,1,4
TOMAVE,consulta externa,repetidas en menores de 5 anos,2005-03-01,5,6,5,6,11
TOMINA,consulta externa,repetidas en menores de 5 anos,2005-03-01,4,6,4,6,10
TORO TORO,consulta externa,repetidas en menores de 5 anos,2005-03-01,6,2,6,2,8
TOTORA(CBBA),consulta externa,repetidas en menores de 5 anos,2005-03-01,7,7,7,7,14
TOTORA(ORR),consulta externa,repetidas en menores de 5 anos,2005-03-01,1,0,1,0,1
TRIGAL,consulta externa,repetidas en menores de 5 anos,2005-03-01,4,3,4,3,7
TRINIDAD,consulta externa,repetidas en menores de 5 anos,2005-03-01,323,326,323,326,649
TUPIZA,consulta externa,repetidas en menores de 5 anos,2005-03-01,67,68,67,68,135
TURCO,consulta externa,repetidas en menores de 5 anos,2005-03-01,0,2,0,2,2
UNCIA,consulta externa,repetidas en menores de 5 anos,2005-03-01,15,17,15,17,32
URIONDO (A. CONCEPCION),consulta externa,repetidas en menores de 5 anos,2005-03-01,21,27,21,27,48
URUBICHA,consulta externa,repetidas en menores de 5 anos,2005-03-01,2,5,2,5,7
UYUNI,consulta externa,repetidas en menores de 5 anos,2005-03-01,61,59,61,59,120
VACAS,consulta externa,repetidas en menores de 5 anos,2005-03-01,29,32,29,32,61
VALLEGRANDE,consulta externa,repetidas en menores de 5 anos,2005-03-01,19,35,19,35,54
VIACHA,consulta externa,repetidas en menores de 5 anos,2005-03-01,99,57,99,57,156
VILLA MONTES,consulta externa,repetidas en menores de 5 anos,2005-03-01,30,34,30,34,64
VILLA RIVERO,consulta externa,repetidas en menores de 5 anos,2005-03-01,19,14,19,14,33
VILLA SERRANO,consulta externa,repetidas en menores de 5 anos,2005-03-01,13,3,13,3,16
VILLA TUNARI,consulta externa,repetidas en menores de 5 anos,2005-03-01,103,71,103,71,174
VILLA VACA GUZMAN (MUYUPAMPA),consulta externa,repetidas en menores de 5 anos,2005-03-01,82,57,82,57,139
VILLAZON,consulta externa,repetidas en menores de 5 anos,2005-03-01,34,41,34,41,75
VINTO,consulta externa,repetidas en menores de 5 anos,2005-03-01,36,23,36,23,59
VITICHI,consulta externa,repetidas en menores de 5 anos,2005-03-01,2,4,2,4,6
WARNES,consulta externa,repetidas en menores de 5 anos,2005-03-01,124,102,124,102,226
YACO,consulta externa,repetidas en menores de 5 anos,2005-03-01,0,2,0,2,2
YACUIBA,consulta externa,repetidas en menores de 5 anos,2005-03-01,183,183,183,183,366
YAMPARAEZ,consulta externa,repetidas en menores de 5 anos,2005-03-01,6,3,6,3,9
YANACACHI,consulta externa,repetidas en menores de 5 anos,2005-03-01,3,3,3,3,6
YAPACANI,consulta externa,repetidas en menores de 5 anos,2005-03-01,52,43,52,43,95
YOCALLA,consulta externa,repetidas en menores de 5 anos,2005-03-01,3,3,3,3,6
YOTALA,consulta externa,repetidas en menores de 5 anos,2005-03-01,19,13,19,13,32
ZUDAÑEZ,consulta externa,repetidas en menores de 5 anos,2005-03-01,1,2,1,2,3
ACACIO,consulta externa,repetidas en menores de 5 anos,2005-04-01,1,1,1,1,2
ACHACACHI,consulta externa,repetidas en menores de 5 anos,2005-04-01,15,11,15,11,26
ACHOCALLA,consulta externa,repetidas en menores de 5 anos,2005-04-01,23,18,23,18,41
AIQUILE,consulta externa,repetidas en menores de 5 anos,2005-04-01,55,51,55,51,106
ALALAY,consulta externa,repetidas en menores de 5 anos,2005-04-01,0,1,0,1,1
ALCALA,consulta externa,repetidas en menores de 5 anos,2005-04-01,1,0,1,0,1
ANCORAIMES,consulta externa,repetidas en menores de 5 anos,2005-04-01,7,10,7,10,17
ANDAMARCA,consulta externa,repetidas en menores de 5 anos,2005-04-01,5,1,5,1,6
ANTEQUERA,consulta externa,repetidas en menores de 5 anos,2005-04-01,1,0,1,0,1
ANZALDO,consulta externa,repetidas en menores de 5 anos,2005-04-01,5,4,5,4,9
APOLO,consulta externa,repetidas en menores de 5 anos,2005-04-01,14,7,14,7,21
ARAMPAMPA,consulta externa,repetidas en menores de 5 anos,2005-04-01,1,0,1,0,1
ARANI,consulta externa,repetidas en menores de 5 anos,2005-04-01,27,20,27,20,47
ARBIETO,consulta externa,repetidas en menores de 5 anos,2005-04-01,0,3,0,3,3
ARQUE,consulta externa,repetidas en menores de 5 anos,2005-04-01,15,9,15,9,24
ASCENCION DE GUARAYOS,consulta externa,repetidas en menores de 5 anos,2005-04-01,36,49,36,49,85
ATOCHA,consulta externa,repetidas en menores de 5 anos,2005-04-01,44,41,44,41,85
AUCAPATA,consulta externa,repetidas en menores de 5 anos,2005-04-01,1,0,1,0,1
AYATA,consulta externa,repetidas en menores de 5 anos,2005-04-01,13,4,13,4,17
AYO AYO,consulta externa,repetidas en menores de 5 anos,2005-04-01,12,5,12,5,17
AYOPAYA (V. DE INDEPENDENCIA),consulta externa,repetidas en menores de 5 anos,2005-04-01,17,11,17,11,28
AZURDUY,consulta externa,repetidas en menores de 5 anos,2005-04-01,1,0,1,0,1
BATALLAS,consulta externa,repetidas en menores de 5 anos,2005-04-01,2,0,2,0,2
BAURES,consulta externa,repetidas en menores de 5 anos,2005-04-01,15,13,15,13,28
BELEN DE ANDAMARCA,consulta externa,repetidas en menores de 5 anos,2005-04-01,1,0,1,0,1
BELEN DE URMIRI,consulta externa,repetidas en menores de 5 anos,2005-04-01,1,1,1,1,2
BERMEJO,consulta externa,repetidas en menores de 5 anos,2005-04-01,65,48,65,48,113
BETANZOS,consulta externa,repetidas en menores de 5 anos,2005-04-01,33,22,33,22,55
BOLIVAR,consulta externa,repetidas en menores de 5 anos,2005-04-01,13,10,13,10,23
BOLPEBRA,consulta externa,repetidas en menores de 5 anos,2005-04-01,5,6,5,6,11
BOYUIBE,consulta externa,repetidas en menores de 5 anos,2005-04-01,3,8,3,8,11
BUENA VISTA,consulta externa,repetidas en menores de 5 anos,2005-04-01,153,151,153,151,304
CABEZAS,consulta externa,repetidas en menores de 5 anos,2005-04-01,4,3,4,3,7
CAIROMA,consulta externa,repetidas en menores de 5 anos,2005-04-01,1,0,1,0,1
"CAIZA ""D""",consulta externa,repetidas en menores de 5 anos,2005-04-01,4,3,4,3,7
CAJUATA,consulta externa,repetidas en menores de 5 anos,2005-04-01,1,0,1,0,1
CALACOTO,consulta externa,repetidas en menores de 5 anos,2005-04-01,7,0,7,0,7
CALAMARCA,consulta externa,repetidas en menores de 5 anos,2005-04-01,3,10,3,10,13
CAMARGO,consulta externa,repetidas en menores de 5 anos,2005-04-01,11,16,11,16,27
CAMATAQUI (C. VILLA ABECIA),consulta externa,repetidas en menores de 5 anos,2005-04-01,6,5,6,5,11
CAMIRI,consulta externa,repetidas en menores de 5 anos,2005-04-01,152,132,152,132,284
CAPINOTA,consulta externa,repetidas en menores de 5 anos,2005-04-01,49,47,49,47,96
CAQUIAVIRI,consulta externa,repetidas en menores de 5 anos,2005-04-01,1,5,1,5,6
CARACOLLO,consulta externa,repetidas en menores de 5 anos,2005-04-01,4,2,4,2,6
CARANAVI,consulta externa,repetidas en menores de 5 anos,2005-04-01,10,5,10,5,15
CARAPARI,consulta externa,repetidas en menores de 5 anos,2005-04-01,10,2,10,2,12
CHACARILLA,consulta externa,repetidas en menores de 5 anos,2005-04-01,4,13,4,13,17
CHALLAPATA,consulta externa,repetidas en menores de 5 anos,2005-04-01,12,17,12,17,29
CHAQUI,consulta externa,repetidas en menores de 5 anos,2005-04-01,1,2,1,2,3
CHARAGUA,consulta externa,repetidas en menores de 5 anos,2005-04-01,40,71,40,71,111
CHARAÑA,consulta externa,repetidas en menores de 5 anos,2005-04-01,2,0,2,0,2
CHAYANTA,consulta externa,repetidas en menores de 5 anos,2005-04-01,7,12,7,12,19
CHIMORE,consulta externa,repetidas en menores de 5 anos,2005-04-01,64,54,64,54,118
CHIPAYA,consulta externa,repetidas en menores de 5 anos,2005-04-01,5,4,5,4,9
CHOQUE COTA,consulta externa,repetidas en menores de 5 anos,2005-04-01,4,5,4,5,9
CHULUMANI (V. DE LA LIBERTAD),consulta externa,repetidas en menores de 5 anos,2005-04-01,5,3,5,3,8
CHUMA,consulta externa,repetidas en menores de 5 anos,2005-04-01,6,9,6,9,15
CLIZA,consulta externa,repetidas en menores de 5 anos,2005-04-01,13,11,13,11,24
COBIJA,consulta externa,repetidas en menores de 5 anos,2005-04-01,171,202,171,202,373
COCHABAMBA,consulta externa,repetidas en menores de 5 anos,2005-04-01,3832,3088,3832,3088,6920
COLCAPIRHUA,consulta externa,repetidas en menores de 5 anos,2005-04-01,98,86,98,86,184
"COLCHA ""K""",consulta externa,repetidas en menores de 5 anos,2005-04-01,8,6,8,6,14
COLOMI,consulta externa,repetidas en menores de 5 anos,2005-04-01,13,11,13,11,24
COLPA BELGICA,consulta externa,repetidas en menores de 5 anos,2005-04-01,51,31,51,31,82
COLQUECHACA,consulta externa,repetidas en menores de 5 anos,2005-04-01,17,14,17,14,31
COLQUENCHA,consulta externa,repetidas en menores de 5 anos,2005-04-01,2,2,2,2,4
COLQUIRI,consulta externa,repetidas en menores de 5 anos,2005-04-01,29,18,29,18,47
COMANCHE,consulta externa,repetidas en menores de 5 anos,2005-04-01,2,3,2,3,5
COMARAPA,consulta externa,repetidas en menores de 5 anos,2005-04-01,69,49,69,49,118
CONCEPCION,consulta externa,repetidas en menores de 5 anos,2005-04-01,6,0,6,0,6
COPACABANA,consulta externa,repetidas en menores de 5 anos,2005-04-01,3,3,3,3,6
CORIPATA,consulta externa,repetidas en menores de 5 anos,2005-04-01,6,4,6,4,10
CORO CORO,consulta externa,repetidas en menores de 5 anos,2005-04-01,3,6,3,6,9
COROICO,consulta externa,repetidas en menores de 5 anos,2005-04-01,50,24,50,24,74
CORQUE,consulta externa,repetidas en menores de 5 anos,2005-04-01,14,8,14,8,22
COTAGAITA,consulta externa,repetidas en menores de 5 anos,2005-04-01,17,19,17,19,36
COTOCA,consulta externa,repetidas en menores de 5 anos,2005-04-01,9,9,9,9,18
CUATRO CAÑADAS,consulta externa,repetidas en menores de 5 anos,2005-04-01,36,29,36,29,65
CUCHUMUELA (V. G. VILLARROEL),consulta externa,repetidas en menores de 5 anos,2005-04-01,0,1,0,1,1
CUEVO,consulta externa,repetidas en menores de 5 anos,2005-04-01,7,8,7,8,15
CULPINA,consulta externa,repetidas en menores de 5 anos,2005-04-01,20,22,20,22,42
CURVA,consulta externa,repetidas en menores de 5 anos,2005-04-01,1,0,1,0,1
EL ALTO,consulta externa,repetidas en menores de 5 anos,2005-04-01,2411,2448,2411,2448,4859
EL CHORO,consulta externa,repetidas en menores de 5 anos,2005-04-01,0,3,0,3,3
EL PUENTE(STC),consulta externa,repetidas en menores de 5 anos,2005-04-01,1,4,1,4,5
EL PUENTE(TJA),consulta externa,repetidas en menores de 5 anos,2005-04-01,9,6,9,6,15
EL TORNO,consulta externa,repetidas en menores de 5 anos,2005-04-01,155,132,155,132,287
EL VILLAR,consulta externa,repetidas en menores de 5 anos,2005-04-01,5,2,5,2,7
ENTRE RIOS,consulta externa,repetidas en menores de 5 anos,2005-04-01,14,12,14,12,26
ENTRE RIOS,consulta externa,repetidas en menores de 5 anos,2005-04-01,44,45,44,45,89
EUCALIPTUS,consulta externa,repetidas en menores de 5 anos,2005-04-01,11,0,11,0,11
EXALTACION,consulta externa,repetidas en menores de 5 anos,2005-04-01,16,16,16,16,32
FERNANDEZ ALONSO,consulta externa,repetidas en menores de 5 anos,2005-04-01,22,20,22,20,42
FILADELFIA,consulta externa,repetidas en menores de 5 anos,2005-04-01,1,0,1,0,1
GENERAL SAAVEDRA,consulta externa,repetidas en menores de 5 anos,2005-04-01,24,16,24,16,40
GRAL. J.J. PEREZ (CHARAZANI),consulta externa,repetidas en menores de 5 anos,2005-04-01,7,7,7,7,14
GUANAY,consulta externa,repetidas en menores de 5 anos,2005-04-01,6,5,6,5,11
GUAYARAMERIN,consulta externa,repetidas en menores de 5 anos,2005-04-01,90,108,90,108,198
GUTIERREZ,consulta externa,repetidas en menores de 5 anos,2005-04-01,58,54,58,54,112
HUACARETA,consulta externa,repetidas en menores de 5 anos,2005-04-01,65,87,65,87,152
HUACAYA (VILLA DE HUACAYA),consulta externa,repetidas en menores de 5 anos,2005-04-01,0,4,0,4,4
HUACHACALLA,consulta externa,repetidas en menores de 5 anos,2005-04-01,3,2,3,2,5
HUANUNI,consulta externa,repetidas en menores de 5 anos,2005-04-01,36,36,36,36,72
HUARACAJE,consulta externa,repetidas en menores de 5 anos,2005-04-01,15,20,15,20,35
HUAYLLAMARCA,consulta externa,repetidas en menores de 5 anos,2005-04-01,4,9,4,9,13
ICHOCA,consulta externa,repetidas en menores de 5 anos,2005-04-01,2,6,2,6,8
ICLA,consulta externa,repetidas en menores de 5 anos,2005-04-01,1,3,1,3,4
INCAHUASI,consulta externa,repetidas en menores de 5 anos,2005-04-01,10,10,10,10,20
INGAVI (HUMAITA),consulta externa,repetidas en menores de 5 anos,2005-04-01,2,0,2,0,2
INQUISIVI,consulta externa,repetidas en menores de 5 anos,2005-04-01,6,2,6,2,8
IRUPANA (VILLA DE LANZA),consulta externa,repetidas en menores de 5 anos,2005-04-01,2,9,2,9,11
IXIAMAS,consulta externa,repetidas en menores de 5 anos,2005-04-01,19,9,19,9,28
JESUS DE MACHACA,consulta externa,repetidas en menores de 5 anos,2005-04-01,2,0,2,0,2
LA ASUNTA,consulta externa,repetidas en menores de 5 anos,2005-04-01,6,5,6,5,11
LA GUARDIA,consulta externa,repetidas en menores de 5 anos,2005-04-01,129,128,129,128,257
LA PAZ,consulta externa,repetidas en menores de 5 anos,2005-04-01,4698,4771,4698,4771,9469
LA RIVERA,consulta externa,repetidas en menores de 5 anos,2005-04-01,0,1,0,1,1
LAGUNILLAS,consulta externa,repetidas en menores de 5 anos,2005-04-01,7,10,7,10,17
LAJA,consulta externa,repetidas en menores de 5 anos,2005-04-01,2,2,2,2,4
LAS CARRERAS,consulta externa,repetidas en menores de 5 anos,2005-04-01,1,6,1,6,7
LLALLAGUA,consulta externa,repetidas en menores de 5 anos,2005-04-01,47,44,47,44,91
LLICA,consulta externa,repetidas en menores de 5 anos,2005-04-01,4,5,4,5,9
LORETO,consulta externa,repetidas en menores de 5 anos,2005-04-01,13,7,13,7,20
LURIBAY,consulta externa,repetidas en menores de 5 anos,2005-04-01,3,1,3,1,4
MACHACAMARCA,consulta externa,repetidas en menores de 5 anos,2005-04-01,1,1,1,1,2
MACHARETI,consulta externa,repetidas en menores de 5 anos,2005-04-01,11,13,11,13,24
MAGDALENA,consulta externa,repetidas en menores de 5 anos,2005-04-01,20,31,20,31,51
MAIRANA,consulta externa,repetidas en menores de 5 anos,2005-04-01,3,16,3,16,19
MAPIRI,consulta externa,repetidas en menores de 5 anos,2005-04-01,2,3,2,3,5
MECAPACA,consulta externa,repetidas en menores de 5 anos,2005-04-01,31,15,31,15,46
MINEROS,consulta externa,repetidas en menores de 5 anos,2005-04-01,31,13,31,13,44
MIZQUE,consulta externa,repetidas en menores de 5 anos,2005-04-01,22,18,22,18,40
MOCOMOCO,consulta externa,repetidas en menores de 5 anos,2005-04-01,7,2,7,2,9
MOJINETE,consulta externa,repetidas en menores de 5 anos,2005-04-01,10,7,10,7,17
MOJOCOYA,consulta externa,repetidas en menores de 5 anos,2005-04-01,2,1,2,1,3
MONTEAGUDO,consulta externa,repetidas en menores de 5 anos,2005-04-01,57,74,57,74,131
MONTERO,consulta externa,repetidas en menores de 5 anos,2005-04-01,576,483,576,483,1059
MORO MORO,consulta externa,repetidas en menores de 5 anos,2005-04-01,2,0,2,0,2
MOROCHATA,consulta externa,repetidas en menores de 5 anos,2005-04-01,21,23,21,23,44
NAZACARA DE PACAJES,consulta externa,repetidas en menores de 5 anos,2005-04-01,0,1,0,1,1
NUEVO MANOA (NUEVA ESPERANZA),consulta externa,repetidas en menores de 5 anos,2005-04-01,1,3,1,3,4
OCURI,consulta externa,repetidas en menores de 5 anos,2005-04-01,5,1,5,1,6
OKINAWA,consulta externa,repetidas en menores de 5 anos,2005-04-01,12,11,12,11,23
OMEREQUE,consulta externa,repetidas en menores de 5 anos,2005-04-01,11,12,11,12,23
ORURO,consulta externa,repetidas en menores de 5 anos,2005-04-01,523,480,523,480,1003
PADCAYA,consulta externa,repetidas en menores de 5 anos,2005-04-01,15,14,15,14,29
PADILLA,consulta externa,repetidas en menores de 5 anos,2005-04-01,16,9,16,9,25
PAILON,consulta externa,repetidas en menores de 5 anos,2005-04-01,5,9,5,9,14
PALCA,consulta externa,repetidas en menores de 5 anos,2005-04-01,10,10,10,10,20
PALOS BLANCOS,consulta externa,repetidas en menores de 5 anos,2005-04-01,69,33,69,33,102
PAMPA AULLAGAS,consulta externa,repetidas en menores de 5 anos,2005-04-01,4,0,4,0,4
PAMPA GRANDE,consulta externa,repetidas en menores de 5 anos,2005-04-01,38,35,38,35,73
PASORAPA,consulta externa,repetidas en menores de 5 anos,2005-04-01,18,10,18,10,28
PATACAMAYA,consulta externa,repetidas en menores de 5 anos,2005-04-01,11,17,11,17,28
PAZÑA,consulta externa,repetidas en menores de 5 anos,2005-04-01,1,2,1,2,3
PELECHUCO,consulta externa,repetidas en menores de 5 anos,2005-04-01,2,3,2,3,5
POCOATA,consulta externa,repetidas en menores de 5 anos,2005-04-01,7,7,7,7,14
POCONA,consulta externa,repetidas en menores de 5 anos,2005-04-01,7,11,7,11,18
POJO (CBBA),consulta externa,repetidas en menores de 5 anos,2005-04-01,3,4,3,4,7
POOPO,consulta externa,repetidas en menores de 5 anos,2005-04-01,1,0,1,0,1
PORCO,consulta externa,repetidas en menores de 5 anos,2005-04-01,2,4,2,4,6
POROMA,consulta externa,repetidas en menores de 5 anos,2005-04-01,6,0,6,0,6
PORONGO,consulta externa,repetidas en menores de 5 anos,2005-04-01,18,3,18,3,21
PORTACHUELO,consulta externa,repetidas en menores de 5 anos,2005-04-01,91,82,91,82,173
PORVENIR,consulta externa,repetidas en menores de 5 anos,2005-04-01,4,2,4,2,6
POSTRER VALLE,consulta externa,repetidas en menores de 5 anos,2005-04-01,7,2,7,2,9
POTOSI,consulta externa,repetidas en menores de 5 anos,2005-04-01,425,283,425,283,708
PRESTO,consulta externa,repetidas en menores de 5 anos,2005-04-01,3,1,3,1,4
PUCARA,consulta externa,repetidas en menores de 5 anos,2005-04-01,30,26,30,26,56
PUCARANI,consulta externa,repetidas en menores de 5 anos,2005-04-01,3,3,3,3,6
PUERTO ACOSTA,consulta externa,repetidas en menores de 5 anos,2005-04-01,5,13,5,13,18
PUERTO CARABUCO,consulta externa,repetidas en menores de 5 anos,2005-04-01,0,5,0,5,5
PUERTO GONZALO MORENO,consulta externa,repetidas en menores de 5 anos,2005-04-01,5,13,5,13,18
PUERTO QUIJARRO,consulta externa,repetidas en menores de 5 anos,2005-04-01,26,17,26,17,43
PUERTO RICO,consulta externa,repetidas en menores de 5 anos,2005-04-01,9,8,9,8,17
PUERTO SILES,consulta externa,repetidas en menores de 5 anos,2005-04-01,5,8,5,8,13
PUERTO SUAREZ,consulta externa,repetidas en menores de 5 anos,2005-04-01,24,23,24,23,47
PUERTO VILLARROEL,consulta externa,repetidas en menores de 5 anos,2005-04-01,98,109,98,109,207
PUNA,consulta externa,repetidas en menores de 5 anos,2005-04-01,13,15,13,15,28
PUNATA,consulta externa,repetidas en menores de 5 anos,2005-04-01,106,82,106,82,188
QUILLACOLLO,consulta externa,repetidas en menores de 5 anos,2005-04-01,147,79,147,79,226
QUIME,consulta externa,repetidas en menores de 5 anos,2005-04-01,10,7,10,7,17
QUIRUSILLAS,consulta externa,repetidas en menores de 5 anos,2005-04-01,2,7,2,7,9
RAVELO,consulta externa,repetidas en menores de 5 anos,2005-04-01,16,14,16,14,30
REYES,consulta externa,repetidas en menores de 5 anos,2005-04-01,26,18,26,18,44
RIBERALTA,consulta externa,repetidas en menores de 5 anos,2005-04-01,495,497,495,497,992
ROBORE,consulta externa,repetidas en menores de 5 anos,2005-04-01,32,31,32,31,63
RURRENABAQUE,consulta externa,repetidas en menores de 5 anos,2005-04-01,72,46,72,46,118
SABAYA,consulta externa,repetidas en menores de 5 anos,2005-04-01,2,0,2,0,2
SACABA,consulta externa,repetidas en menores de 5 anos,2005-04-01,213,168,213,168,381
SACABAMBA,consulta externa,repetidas en menores de 5 anos,2005-04-01,18,22,18,22,40
SACACA,consulta externa,repetidas en menores de 5 anos,2005-04-01,3,2,3,2,5
SAIPINA,consulta externa,repetidas en menores de 5 anos,2005-04-01,12,14,12,14,26
SALINAS DE GARCI MENDOZA,consulta externa,repetidas en menores de 5 anos,2005-04-01,4,5,4,5,9
SAMAIPATA,consulta externa,repetidas en menores de 5 anos,2005-04-01,4,1,4,1,5
SAN ANDRES,consulta externa,repetidas en menores de 5 anos,2005-04-01,35,46,35,46,81
SAN ANDRES DE MACHACA,consulta externa,repetidas en menores de 5 anos,2005-04-01,0,1,0,1,1
SAN ANTONIO DE ESMORUCO,consulta externa,repetidas en menores de 5 anos,2005-04-01,1,3,1,3,4
SAN ANTONIO DE LOMERIO,consulta externa,repetidas en menores de 5 anos,2005-04-01,3,3,3,3,6
SAN BENITO,consulta externa,repetidas en menores de 5 anos,2005-04-01,19,16,19,16,35
SAN BORJA,consulta externa,repetidas en menores de 5 anos,2005-04-01,50,60,50,60,110
SAN BUENA VENTURA,consulta externa,repetidas en menores de 5 anos,2005-04-01,3,2,3,2,5
SAN CARLOS,consulta externa,repetidas en menores de 5 anos,2005-04-01,40,34,40,34,74
SAN IGNACIO,consulta externa,repetidas en menores de 5 anos,2005-04-01,115,111,115,111,226
SAN IGNACIO DE VELASCO,consulta externa,repetidas en menores de 5 anos,2005-04-01,55,58,55,58,113
SAN JAVIER(BNI),consulta externa,repetidas en menores de 5 anos,2005-04-01,5,16,5,16,21
SAN JAVIER(STC),consulta externa,repetidas en menores de 5 anos,2005-04-01,55,50,55,50,105
SAN JOAQUIN,consulta externa,repetidas en menores de 5 anos,2005-04-01,8,13,8,13,21
SAN JOSE DE CHIQUITOS,consulta externa,repetidas en menores de 5 anos,2005-04-01,3,8,3,8,11
SAN JUAN DE YAPACANI,consulta externa,repetidas en menores de 5 anos,2005-04-01,8,6,8,6,14
SAN JULIAN,consulta externa,repetidas en menores de 5 anos,2005-04-01,55,55,55,55,110
SAN LORENZO(PND),consulta externa,repetidas en menores de 5 anos,2005-04-01,2,1,2,1,3
SAN LORENZO(TJA),consulta externa,repetidas en menores de 5 anos,2005-04-01,91,82,91,82,173
SAN LUCAS,consulta externa,repetidas en menores de 5 anos,2005-04-01,28,36,28,36,64
SAN MATIAS,consulta externa,repetidas en menores de 5 anos,2005-04-01,10,15,10,15,25
SAN MIGUEL DE VELASCO,consulta externa,repetidas en menores de 5 anos,2005-04-01,51,33,51,33,84
SAN PABLO DE LIPEZ,consulta externa,repetidas en menores de 5 anos,2005-04-01,2,3,2,3,5
SAN PEDRO,consulta externa,repetidas en menores de 5 anos,2005-04-01,20,18,20,18,38
SAN PEDRO DE BUENA VISTA,consulta externa,repetidas en menores de 5 anos,2005-04-01,0,3,0,3,3
SAN PEDRO DE QUEMES,consulta externa,repetidas en menores de 5 anos,2005-04-01,0,1,0,1,1
SAN PEDRO DE TIQUINA,consulta externa,repetidas en menores de 5 anos,2005-04-01,1,1,1,1,2
SAN RAFAEL,consulta externa,repetidas en menores de 5 anos,2005-04-01,4,5,4,5,9
SAN RAMON,consulta externa,repetidas en menores de 5 anos,2005-04-01,6,6,6,6,12
SAN RAMON,consulta externa,repetidas en menores de 5 anos,2005-04-01,14,14,14,14,28
SANTA ANA,consulta externa,repetidas en menores de 5 anos,2005-04-01,41,27,41,27,68
SANTA CRUZ DE LA SIERRA,consulta externa,repetidas en menores de 5 anos,2005-04-01,3883,4201,3883,4201,8084
SANTA ROSA,consulta externa,repetidas en menores de 5 anos,2005-04-01,32,15,32,15,47
SANTA ROSA DEL SARA,consulta externa,repetidas en menores de 5 anos,2005-04-01,59,37,59,37,96
SANTIAGO DE CALLAPA,consulta externa,repetidas en menores de 5 anos,2005-04-01,5,9,5,9,14
SANTIAGO DE HUARI,consulta externa,repetidas en menores de 5 anos,2005-04-01,4,5,4,5,9
SANTIAGO DE MACHACA,consulta externa,repetidas en menores de 5 anos,2005-04-01,0,1,0,1,1
SANTIVAÑES,consulta externa,repetidas en menores de 5 anos,2005-04-01,7,6,7,6,13
SANTUARIO DE QUILLACAS,consulta externa,repetidas en menores de 5 anos,2005-04-01,1,1,1,1,2
SAPAHAQUI,consulta externa,repetidas en menores de 5 anos,2005-04-01,11,3,11,3,14
SENA,consulta externa,repetidas en menores de 5 anos,2005-04-01,7,5,7,5,12
SICA SICA (VILLA AROMA),consulta externa,repetidas en menores de 5 anos,2005-04-01,2,4,2,4,6
SICAYA,consulta externa,repetidas en menores de 5 anos,2005-04-01,1,6,1,6,7
SIPE SIPE,consulta externa,repetidas en menores de 5 anos,2005-04-01,173,122,173,122,295
SOPACHUY,consulta externa,repetidas en menores de 5 anos,2005-04-01,1,2,1,2,3
SORACACHI,consulta externa,repetidas en menores de 5 anos,2005-04-01,4,1,4,1,5
SORATA,consulta externa,repetidas en menores de 5 anos,2005-04-01,9,12,9,12,21
SUCRE,consulta externa,repetidas en menores de 5 anos,2005-04-01,932,897,932,897,1829
TACACHI,consulta externa,repetidas en menores de 5 anos,2005-04-01,11,13,11,13,24
TACOBAMBA,consulta externa,repetidas en menores de 5 anos,2005-04-01,0,2,0,2,2
TACOPAYA,consulta externa,repetidas en menores de 5 anos,2005-04-01,30,40,30,40,70
TAPACARI,consulta externa,repetidas en menores de 5 anos,2005-04-01,39,27,39,27,66
TARABUCO,consulta externa,repetidas en menores de 5 anos,2005-04-01,189,175,189,175,364
TARACO,consulta externa,repetidas en menores de 5 anos,2005-04-01,1,0,1,0,1
TARATA,consulta externa,repetidas en menores de 5 anos,2005-04-01,17,28,17,28,45
TARIJA,consulta externa,repetidas en menores de 5 anos,2005-04-01,659,711,659,711,1370
TARVITA,consulta externa,repetidas en menores de 5 anos,2005-04-01,3,3,3,3,6
TEOPONTE,consulta externa,repetidas en menores de 5 anos,2005-04-01,13,10,13,10,23
TIAWANACU,consulta externa,repetidas en menores de 5 anos,2005-04-01,0,6,0,6,6
TINGUIPAYA,consulta externa,repetidas en menores de 5 anos,2005-04-01,1,0,1,0,1
TIPUANI,consulta externa,repetidas en menores de 5 anos,2005-04-01,36,42,36,42,78
TIQUIPAYA,consulta externa,repetidas en menores de 5 anos,2005-04-01,311,235,311,235,546
TIRAQUE (CBBA),consulta externa,repetidas en menores de 5 anos,2005-04-01,132,142,132,142,274
TITO YUPANQUI (PARQUIPUJIO),consulta externa,repetidas en menores de 5 anos,2005-04-01,0,1,0,1,1
TOCO,consulta externa,repetidas en menores de 5 anos,2005-04-01,14,3,14,3,17
TOLATA,consulta externa,repetidas en menores de 5 anos,2005-04-01,6,3,6,3,9
TOLEDO,consulta externa,repetidas en menores de 5 anos,2005-04-01,4,9,4,9,13
TOMAVE,consulta externa,repetidas en menores de 5 anos,2005-04-01,4,2,4,2,6
TOMINA,consulta externa,repetidas en menores de 5 anos,2005-04-01,7,2,7,2,9
TORO TORO,consulta externa,repetidas en menores de 5 anos,2005-04-01,4,5,4,5,9
TOTORA(CBBA),consulta externa,repetidas en menores de 5 anos,2005-04-01,6,8,6,8,14
TRIGAL,consulta externa,repetidas en menores de 5 anos,2005-04-01,17,13,17,13,30
TRINIDAD,consulta externa,repetidas en menores de 5 anos,2005-04-01,263,298,263,298,561
TUPIZA,consulta externa,repetidas en menores de 5 anos,2005-04-01,60,63,60,63,123
TURCO,consulta externa,repetidas en menores de 5 anos,2005-04-01,2,0,2,0,2
UMALA,consulta externa,repetidas en menores de 5 anos,2005-04-01,0,1,0,1,1
UNCIA,consulta externa,repetidas en menores de 5 anos,2005-04-01,24,20,24,20,44
URIONDO (A. CONCEPCION),consulta externa,repetidas en menores de 5 anos,2005-04-01,12,31,12,31,43
URUBICHA,consulta externa,repetidas en menores de 5 anos,2005-04-01,8,12,8,12,20
UYUNI,consulta externa,repetidas en menores de 5 anos,2005-04-01,7,6,7,6,13
VACAS,consulta externa,repetidas en menores de 5 anos,2005-04-01,31,22,31,22,53
VALLEGRANDE,consulta externa,repetidas en menores de 5 anos,2005-04-01,7,23,7,23,30
VIACHA,consulta externa,repetidas en menores de 5 anos,2005-04-01,57,41,57,41,98
VILA VILA,consulta externa,repetidas en menores de 5 anos,2005-04-01,1,2,1,2,3
VILLA MONTES,consulta externa,repetidas en menores de 5 anos,2005-04-01,45,36,45,36,81
VILLA NUEVA (LOMA ALTA),consulta externa,repetidas en menores de 5 anos,2005-04-01,2,1,2,1,3
VILLA RIVERO,consulta externa,repetidas en menores de 5 anos,2005-04-01,14,18,14,18,32
VILLA SERRANO,consulta externa,repetidas en menores de 5 anos,2005-04-01,2,2,2,2,4
VILLA TUNARI,consulta externa,repetidas en menores de 5 anos,2005-04-01,145,129,145,129,274
VILLA VACA GUZMAN (MUYUPAMPA),consulta externa,repetidas en menores de 5 anos,2005-04-01,12,9,12,9,21
VILLAZON,consulta externa,repetidas en menores de 5 anos,2005-04-01,54,54,54,54,108
VINTO,consulta externa,repetidas en menores de 5 anos,2005-04-01,38,25,38,25,63
VITICHI,consulta externa,repetidas en menores de 5 anos,2005-04-01,3,5,3,5,8
WALDO BALLIVIAN,consulta externa,repetidas en menores de 5 anos,2005-04-01,0,2,0,2,2
WARNES,consulta externa,repetidas en menores de 5 anos,2005-04-01,105,104,105,104,209
YACO,consulta externa,repetidas en menores de 5 anos,2005-04-01,0,1,0,1,1
YACUIBA,consulta externa,repetidas en menores de 5 anos,2005-04-01,157,190,157,190,347
YAMPARAEZ,consulta externa,repetidas en menores de 5 anos,2005-04-01,11,12,11,12,23
YANACACHI,consulta externa,repetidas en menores de 5 anos,2005-04-01,10,14,10,14,24
YAPACANI,consulta externa,repetidas en menores de 5 anos,2005-04-01,59,47,59,47,106
YOCALLA,consulta externa,repetidas en menores de 5 anos,2005-04-01,4,1,4,1,5
YOTALA,consulta externa,repetidas en menores de 5 anos,2005-04-01,48,74,48,74,122
ZUDAÑEZ,consulta externa,repetidas en menores de 5 anos,2005-04-01,3,3,3,3,6
ACACIO,consulta externa,repetidas en menores de 5 anos,2005-05-01,8,1,8,1,9
ACHACACHI,consulta externa,repetidas en menores de 5 anos,2005-05-01,24,18,24,18,42
ACHOCALLA,consulta externa,repetidas en menores de 5 anos,2005-05-01,8,12,8,12,20
AIQUILE,consulta externa,repetidas en menores de 5 anos,2005-05-01,134,130,134,130,264
ALALAY,consulta externa,repetidas en menores de 5 anos,2005-05-01,10,17,10,17,27
ALCALA,consulta externa,repetidas en menores de 5 anos,2005-05-01,0,1,0,1,1
ANCORAIMES,consulta externa,repetidas en menores de 5 anos,2005-05-01,17,8,17,8,25
ANDAMARCA,consulta externa,repetidas en menores de 5 anos,2005-05-01,11,4,11,4,15
ANTEQUERA,consulta externa,repetidas en menores de 5 anos,2005-05-01,4,7,4,7,11
ANZALDO,consulta externa,repetidas en menores de 5 anos,2005-05-01,3,9,3,9,12
APOLO,consulta externa,repetidas en menores de 5 anos,2005-05-01,3,6,3,6,9
ARANI,consulta externa,repetidas en menores de 5 anos,2005-05-01,45,31,45,31,76
ARBIETO,consulta externa,repetidas en menores de 5 anos,2005-05-01,6,7,6,7,13
ARQUE,consulta externa,repetidas en menores de 5 anos,2005-05-01,1,4,1,4,5
ASCENCION DE GUARAYOS,consulta externa,repetidas en menores de 5 anos,2005-05-01,22,18,22,18,40
ATOCHA,consulta externa,repetidas en menores de 5 anos,2005-05-01,31,39,31,39,70
AUCAPATA,consulta externa,repetidas en menores de 5 anos,2005-05-01,5,4,5,4,9
AYATA,consulta externa,repetidas en menores de 5 anos,2005-05-01,2,3,2,3,5
AYO AYO,consulta externa,repetidas en menores de 5 anos,2005-05-01,4,8,4,8,12
AYOPAYA (V. DE INDEPENDENCIA),consulta externa,repetidas en menores de 5 anos,2005-05-01,15,11,15,11,26
AZURDUY,consulta externa,repetidas en menores de 5 anos,2005-05-01,3,0,3,0,3
BATALLAS,consulta externa,repetidas en menores de 5 anos,2005-05-01,3,2,3,2,5
BAURES,consulta externa,repetidas en menores de 5 anos,2005-05-01,9,15,9,15,24
BELEN DE ANDAMARCA,consulta externa,repetidas en menores de 5 anos,2005-05-01,3,0,3,0,3
BELEN DE URMIRI,consulta externa,repetidas en menores de 5 anos,2005-05-01,9,3,9,3,12
BERMEJO,consulta externa,repetidas en menores de 5 anos,2005-05-01,30,33,30,33,63
BETANZOS,consulta externa,repetidas en menores de 5 anos,2005-05-01,17,18,17,18,35
BOLIVAR,consulta externa,repetidas en menores de 5 anos,2005-05-01,7,8,7,8,15
BOLPEBRA,consulta externa,repetidas en menores de 5 anos,2005-05-01,4,7,4,7,11
BOYUIBE,consulta externa,repetidas en menores de 5 anos,2005-05-01,19,15,19,15,34
BUENA VISTA,consulta externa,repetidas en menores de 5 anos,2005-05-01,107,89,107,89,196
CABEZAS,consulta externa,repetidas en menores de 5 anos,2005-05-01,8,5,8,5,13
CAIROMA,consulta externa,repetidas en menores de 5 anos,2005-05-01,3,1,3,1,4
"CAIZA ""D""",consulta externa,repetidas en menores de 5 anos,2005-05-01,10,7,10,7,17
CAJUATA,consulta externa,repetidas en menores de 5 anos,2005-05-01,5,0,5,0,5
CALAMARCA,consulta externa,repetidas en menores de 5 anos,2005-05-01,19,16,19,16,35
CAMARGO,consulta externa,repetidas en menores de 5 anos,2005-05-01,7,13,7,13,20
CAMATAQUI (C. VILLA ABECIA),consulta externa,repetidas en menores de 5 anos,2005-05-01,7,3,7,3,10
CAMIRI,consulta externa,repetidas en menores de 5 anos,2005-05-01,167,169,167,169,336
CAPINOTA,consulta externa,repetidas en menores de 5 anos,2005-05-01,34,25,34,25,59
CAQUIAVIRI,consulta externa,repetidas en menores de 5 anos,2005-05-01,2,0,2,0,2
CARACOLLO,consulta externa,repetidas en menores de 5 anos,2005-05-01,8,8,8,8,16
CARANAVI,consulta externa,repetidas en menores de 5 anos,2005-05-01,50,56,50,56,106
CARAPARI,consulta externa,repetidas en menores de 5 anos,2005-05-01,3,4,3,4,7
CARIPUYO,consulta externa,repetidas en menores de 5 anos,2005-05-01,1,1,1,1,2
CARMEN RIVERO TORREZ,consulta externa,repetidas en menores de 5 anos,2005-05-01,1,1,1,1,2
CHACARILLA,consulta externa,repetidas en menores de 5 anos,2005-05-01,12,13,12,13,25
CHALLAPATA,consulta externa,repetidas en menores de 5 anos,2005-05-01,16,18,16,18,34
CHAQUI,consulta externa,repetidas en menores de 5 anos,2005-05-01,0,3,0,3,3
CHARAGUA,consulta externa,repetidas en menores de 5 anos,2005-05-01,42,55,42,55,97
CHARAÑA,consulta externa,repetidas en menores de 5 anos,2005-05-01,5,6,5,6,11
CHAYANTA,consulta externa,repetidas en menores de 5 anos,2005-05-01,14,7,14,7,21
CHIMORE,consulta externa,repetidas en menores de 5 anos,2005-05-01,44,55,44,55,99
CHIPAYA,consulta externa,repetidas en menores de 5 anos,2005-05-01,3,1,3,1,4
CHOQUE COTA,consulta externa,repetidas en menores de 5 anos,2005-05-01,10,10,10,10,20
CHULUMANI (V. DE LA LIBERTAD),consulta externa,repetidas en menores de 5 anos,2005-05-01,6,14,6,14,20
CHUMA,consulta externa,repetidas en menores de 5 anos,2005-05-01,2,7,2,7,9
CLIZA,consulta externa,repetidas en menores de 5 anos,2005-05-01,16,11,16,11,27
COBIJA,consulta externa,repetidas en menores de 5 anos,2005-05-01,182,193,182,193,375
COCHABAMBA,consulta externa,repetidas en menores de 5 anos,2005-05-01,2913,2462,2913,2462,5375
COLCAPIRHUA,consulta externa,repetidas en menores de 5 anos,2005-05-01,128,111,128,111,239
"COLCHA ""K""",consulta externa,repetidas en menores de 5 anos,2005-05-01,12,12,12,12,24
COLLANA,consulta externa,repetidas en menores de 5 anos,2005-05-01,1,0,1,0,1
COLOMI,consulta externa,repetidas en menores de 5 anos,2005-05-01,25,14,25,14,39
COLPA BELGICA,consulta externa,repetidas en menores de 5 anos,2005-05-01,35,25,35,25,60
COLQUECHACA,consulta externa,repetidas en menores de 5 anos,2005-05-01,5,12,5,12,17
COLQUENCHA,consulta externa,repetidas en menores de 5 anos,2005-05-01,4,8,4,8,12
COLQUIRI,consulta externa,repetidas en menores de 5 anos,2005-05-01,41,32,41,32,73
COMANCHE,consulta externa,repetidas en menores de 5 anos,2005-05-01,2,2,2,2,4
COMARAPA,consulta externa,repetidas en menores de 5 anos,2005-05-01,51,61,51,61,112
COMBAYA,consulta externa,repetidas en menores de 5 anos,2005-05-01,1,1,1,1,2
COPACABANA,consulta externa,repetidas en menores de 5 anos,2005-05-01,2,3,2,3,5
CORIPATA,consulta externa,repetidas en menores de 5 anos,2005-05-01,1,7,1,7,8
CORO CORO,consulta externa,repetidas en menores de 5 anos,2005-05-01,1,1,1,1,2
COROICO,consulta externa,repetidas en menores de 5 anos,2005-05-01,40,30,40,30,70
CORQUE,consulta externa,repetidas en menores de 5 anos,2005-05-01,17,16,17,16,33
COTAGAITA,consulta externa,repetidas en menores de 5 anos,2005-05-01,33,11,33,11,44
COTOCA,consulta externa,repetidas en menores de 5 anos,2005-05-01,8,4,8,4,12
CUATRO CAÑADAS,consulta externa,repetidas en menores de 5 anos,2005-05-01,25,29,25,29,54
CUCHUMUELA (V. G. VILLARROEL),consulta externa,repetidas en menores de 5 anos,2005-05-01,2,4,2,4,6
CUEVO,consulta externa,repetidas en menores de 5 anos,2005-05-01,3,5,3,5,8
CULPINA,consulta externa,repetidas en menores de 5 anos,2005-05-01,31,33,31,33,64
CURAHUARA DE CARANGAS,consulta externa,repetidas en menores de 5 anos,2005-05-01,2,1,2,1,3
CURVA,consulta externa,repetidas en menores de 5 anos,2005-05-01,1,2,1,2,3
DESAGUADERO,consulta externa,repetidas en menores de 5 anos,2005-05-01,7,2,7,2,9
EL ALTO,consulta externa,repetidas en menores de 5 anos,2005-05-01,2059,1852,2059,1852,3911
EL CHORO,consulta externa,repetidas en menores de 5 anos,2005-05-01,1,3,1,3,4
EL PUENTE(STC),consulta externa,repetidas en menores de 5 anos,2005-05-01,3,2,3,2,5
EL PUENTE(TJA),consulta externa,repetidas en menores de 5 anos,2005-05-01,5,6,5,6,11
EL TORNO,consulta externa,repetidas en menores de 5 anos,2005-05-01,171,152,171,152,323
EL VILLAR,consulta externa,repetidas en menores de 5 anos,2005-05-01,6,5,6,5,11
ENTRE RIOS,consulta externa,repetidas en menores de 5 anos,2005-05-01,34,26,34,26,60
ENTRE RIOS,consulta externa,repetidas en menores de 5 anos,2005-05-01,18,18,18,18,36
EUCALIPTUS,consulta externa,repetidas en menores de 5 anos,2005-05-01,20,11,20,11,31
EXALTACION,consulta externa,repetidas en menores de 5 anos,2005-05-01,9,18,9,18,27
FERNANDEZ ALONSO,consulta externa,repetidas en menores de 5 anos,2005-05-01,31,30,31,30,61
FILADELFIA,consulta externa,repetidas en menores de 5 anos,2005-05-01,25,28,25,28,53
GENERAL SAAVEDRA,consulta externa,repetidas en menores de 5 anos,2005-05-01,21,17,21,17,38
GRAL. J.J. PEREZ (CHARAZANI),consulta externa,repetidas en menores de 5 anos,2005-05-01,6,4,6,4,10
GUANAY,consulta externa,repetidas en menores de 5 anos,2005-05-01,18,18,18,18,36
GUAQUI,consulta externa,repetidas en menores de 5 anos,2005-05-01,3,0,3,0,3
GUAYARAMERIN,consulta externa,repetidas en menores de 5 anos,2005-05-01,76,117,76,117,193
GUTIERREZ,consulta externa,repetidas en menores de 5 anos,2005-05-01,8,5,8,5,13
HUACARETA,consulta externa,repetidas en menores de 5 anos,2005-05-01,34,38,34,38,72
HUACAYA (VILLA DE HUACAYA),consulta externa,repetidas en menores de 5 anos,2005-05-01,2,2,2,2,4
HUACHACALLA,consulta externa,repetidas en menores de 5 anos,2005-05-01,1,1,1,1,2
HUANUNI,consulta externa,repetidas en menores de 5 anos,2005-05-01,104,86,104,86,190
HUARACAJE,consulta externa,repetidas en menores de 5 anos,2005-05-01,19,7,19,7,26
HUAYLLAMARCA,consulta externa,repetidas en menores de 5 anos,2005-05-01,19,16,19,16,35
ICLA,consulta externa,repetidas en menores de 5 anos,2005-05-01,2,2,2,2,4
INCAHUASI,consulta externa,repetidas en menores de 5 anos,2005-05-01,13,19,13,19,32
INGAVI (HUMAITA),consulta externa,repetidas en menores de 5 anos,2005-05-01,3,7,3,7,10
INQUISIVI,consulta externa,repetidas en menores de 5 anos,2005-05-01,4,2,4,2,6
IRUPANA (VILLA DE LANZA),consulta externa,repetidas en menores de 5 anos,2005-05-01,6,10,6,10,16
IXIAMAS,consulta externa,repetidas en menores de 5 anos,2005-05-01,14,8,14,8,22
JESUS DE MACHACA,consulta externa,repetidas en menores de 5 anos,2005-05-01,3,0,3,0,3
LA ASUNTA,consulta externa,repetidas en menores de 5 anos,2005-05-01,4,6,4,6,10
LA GUARDIA,consulta externa,repetidas en menores de 5 anos,2005-05-01,100,116,100,116,216
LA PAZ,consulta externa,repetidas en menores de 5 anos,2005-05-01,4771,4598,4771,4598,9369
LAGUNILLAS,consulta externa,repetidas en menores de 5 anos,2005-05-01,30,24,30,24,54
LAJA,consulta externa,repetidas en menores de 5 anos,2005-05-01,5,6,5,6,11
LAS CARRERAS,consulta externa,repetidas en menores de 5 anos,2005-05-01,3,1,3,1,4
LICOMA PAMPA,consulta externa,repetidas en menores de 5 anos,2005-05-01,0,1,0,1,1
LLALLAGUA,consulta externa,repetidas en menores de 5 anos,2005-05-01,34,20,34,20,54
LLICA,consulta externa,repetidas en menores de 5 anos,2005-05-01,4,1,4,1,5
LORETO,consulta externa,repetidas en menores de 5 anos,2005-05-01,15,9,15,9,24
LURIBAY,consulta externa,repetidas en menores de 5 anos,2005-05-01,3,1,3,1,4
MACHACAMARCA,consulta externa,repetidas en menores de 5 anos,2005-05-01,7,6,7,6,13
MACHARETI,consulta externa,repetidas en menores de 5 anos,2005-05-01,11,9,11,9,20
MAGDALENA,consulta externa,repetidas en menores de 5 anos,2005-05-01,22,13,22,13,35
MAIRANA,consulta externa,repetidas en menores de 5 anos,2005-05-01,8,6,8,6,14
MALLA,consulta externa,repetidas en menores de 5 anos,2005-05-01,66,46,66,46,112
MAPIRI,consulta externa,repetidas en menores de 5 anos,2005-05-01,1,3,1,3,4
MECAPACA,consulta externa,repetidas en menores de 5 anos,2005-05-01,48,49,48,49,97
MINEROS,consulta externa,repetidas en menores de 5 anos,2005-05-01,11,20,11,20,31
MIZQUE,consulta externa,repetidas en menores de 5 anos,2005-05-01,28,32,28,32,60
MOCOMOCO,consulta externa,repetidas en menores de 5 anos,2005-05-01,1,3,1,3,4
MOJINETE,consulta externa,repetidas en menores de 5 anos,2005-05-01,7,2,7,2,9
MOJOCOYA,consulta externa,repetidas en menores de 5 anos,2005-05-01,1,3,1,3,4
MONTEAGUDO,consulta externa,repetidas en menores de 5 anos,2005-05-01,37,28,37,28,65
MONTERO,consulta externa,repetidas en menores de 5 anos,2005-05-01,490,442,490,442,932
MOROCHATA,consulta externa,repetidas en menores de 5 anos,2005-05-01,19,18,19,18,37
OCURI,consulta externa,repetidas en menores de 5 anos,2005-05-01,2,3,2,3,5
OKINAWA,consulta externa,repetidas en menores de 5 anos,2005-05-01,17,22,17,22,39
OMEREQUE,consulta externa,repetidas en menores de 5 anos,2005-05-01,17,15,17,15,32
ORURO,consulta externa,repetidas en menores de 5 anos,2005-05-01,737,719,737,719,1456
PADCAYA,consulta externa,repetidas en menores de 5 anos,2005-05-01,17,12,17,12,29
PADILLA,consulta externa,repetidas en menores de 5 anos,2005-05-01,11,8,11,8,19
PAILON,consulta externa,repetidas en menores de 5 anos,2005-05-01,14,7,14,7,21
PALCA,consulta externa,repetidas en menores de 5 anos,2005-05-01,3,8,3,8,11
PALOS BLANCOS,consulta externa,repetidas en menores de 5 anos,2005-05-01,122,99,122,99,221
PAMPA AULLAGAS,consulta externa,repetidas en menores de 5 anos,2005-05-01,2,0,2,0,2
PAMPA GRANDE,consulta externa,repetidas en menores de 5 anos,2005-05-01,36,15,36,15,51
PAPEL PAMPA,consulta externa,repetidas en menores de 5 anos,2005-05-01,1,1,1,1,2
PATACAMAYA,consulta externa,repetidas en menores de 5 anos,2005-05-01,9,16,9,16,25
PAZÑA,consulta externa,repetidas en menores de 5 anos,2005-05-01,11,6,11,6,17
PELECHUCO,consulta externa,repetidas en menores de 5 anos,2005-05-01,5,5,5,5,10
POCOATA,consulta externa,repetidas en menores de 5 anos,2005-05-01,7,7,7,7,14
POCONA,consulta externa,repetidas en menores de 5 anos,2005-05-01,6,2,6,2,8
POJO (CBBA),consulta externa,repetidas en menores de 5 anos,2005-05-01,6,5,6,5,11
POOPO,consulta externa,repetidas en menores de 5 anos,2005-05-01,1,2,1,2,3
PORCO,consulta externa,repetidas en menores de 5 anos,2005-05-01,10,6,10,6,16
POROMA,consulta externa,repetidas en menores de 5 anos,2005-05-01,2,5,2,5,7
PORONGO,consulta externa,repetidas en menores de 5 anos,2005-05-01,24,17,24,17,41
PORTACHUELO,consulta externa,repetidas en menores de 5 anos,2005-05-01,32,31,32,31,63
PORVENIR,consulta externa,repetidas en menores de 5 anos,2005-05-01,2,3,2,3,5
POSTRER VALLE,consulta externa,repetidas en menores de 5 anos,2005-05-01,2,2,2,2,4
POTOSI,consulta externa,repetidas en menores de 5 anos,2005-05-01,475,327,475,327,802
PRESTO,consulta externa,repetidas en menores de 5 anos,2005-05-01,3,0,3,0,3
PUCARA,consulta externa,repetidas en menores de 5 anos,2005-05-01,5,4,5,4,9
PUCARANI,consulta externa,repetidas en menores de 5 anos,2005-05-01,3,5,3,5,8
PUERTO ACOSTA,consulta externa,repetidas en menores de 5 anos,2005-05-01,18,15,18,15,33
PUERTO CARABUCO,consulta externa,repetidas en menores de 5 anos,2005-05-01,0,3,0,3,3
PUERTO GONZALO MORENO,consulta externa,repetidas en menores de 5 anos,2005-05-01,6,6,6,6,12
PUERTO PEREZ,consulta externa,repetidas en menores de 5 anos,2005-05-01,1,0,1,0,1
PUERTO QUIJARRO,consulta externa,repetidas en menores de 5 anos,2005-05-01,43,36,43,36,79
PUERTO RICO,consulta externa,repetidas en menores de 5 anos,2005-05-01,5,3,5,3,8
PUERTO SILES,consulta externa,repetidas en menores de 5 anos,2005-05-01,11,4,11,4,15
PUERTO SUAREZ,consulta externa,repetidas en menores de 5 anos,2005-05-01,12,19,12,19,31
PUERTO VILLARROEL,consulta externa,repetidas en menores de 5 anos,2005-05-01,83,86,83,86,169
PUNA,consulta externa,repetidas en menores de 5 anos,2005-05-01,11,9,11,9,20
PUNATA,consulta externa,repetidas en menores de 5 anos,2005-05-01,44,59,44,59,103
QUILLACOLLO,consulta externa,repetidas en menores de 5 anos,2005-05-01,130,131,130,131,261
QUIME,consulta externa,repetidas en menores de 5 anos,2005-05-01,7,5,7,5,12
QUIRUSILLAS,consulta externa,repetidas en menores de 5 anos,2005-05-01,1,2,1,2,3
RAVELO,consulta externa,repetidas en menores de 5 anos,2005-05-01,11,13,11,13,24
REYES,consulta externa,repetidas en menores de 5 anos,2005-05-01,19,10,19,10,29
RIBERALTA,consulta externa,repetidas en menores de 5 anos,2005-05-01,312,309,312,309,621
ROBORE,consulta externa,repetidas en menores de 5 anos,2005-05-01,15,10,15,10,25
RURRENABAQUE,consulta externa,repetidas en menores de 5 anos,2005-05-01,93,68,93,68,161
SABAYA,consulta externa,repetidas en menores de 5 anos,2005-05-01,6,4,6,4,10
SACABA,consulta externa,repetidas en menores de 5 anos,2005-05-01,218,194,218,194,412
SACABAMBA,consulta externa,repetidas en menores de 5 anos,2005-05-01,17,32,17,32,49
SACACA,consulta externa,repetidas en menores de 5 anos,2005-05-01,5,10,5,10,15
SAIPINA,consulta externa,repetidas en menores de 5 anos,2005-05-01,14,11,14,11,25
SALINAS DE GARCI MENDOZA,consulta externa,repetidas en menores de 5 anos,2005-05-01,12,3,12,3,15
SAMAIPATA,consulta externa,repetidas en menores de 5 anos,2005-05-01,2,1,2,1,3
SAN AGUSTIN,consulta externa,repetidas en menores de 5 anos,2005-05-01,0,2,0,2,2
SAN ANDRES,consulta externa,repetidas en menores de 5 anos,2005-05-01,28,18,28,18,46
SAN ANDRES DE MACHACA,consulta externa,repetidas en menores de 5 anos,2005-05-01,1,0,1,0,1
SAN ANTONIO DE ESMORUCO,consulta externa,repetidas en menores de 5 anos,2005-05-01,3,2,3,2,5
SAN ANTONIO DE LOMERIO,consulta externa,repetidas en menores de 5 anos,2005-05-01,0,1,0,1,1
SAN BENITO,consulta externa,repetidas en menores de 5 anos,2005-05-01,26,26,26,26,52
SAN BORJA,consulta externa,repetidas en menores de 5 anos,2005-05-01,82,55,82,55,137
SAN BUENA VENTURA,consulta externa,repetidas en menores de 5 anos,2005-05-01,3,7,3,7,10
SAN CARLOS,consulta externa,repetidas en menores de 5 anos,2005-05-01,15,13,15,13,28
SAN IGNACIO,consulta externa,repetidas en menores de 5 anos,2005-05-01,106,93,106,93,199
SAN IGNACIO DE VELASCO,consulta externa,repetidas en menores de 5 anos,2005-05-01,61,44,61,44,105
SAN JAVIER(BNI),consulta externa,repetidas en menores de 5 anos,2005-05-01,0,3,0,3,3
SAN JAVIER(STC),consulta externa,repetidas en menores de 5 anos,2005-05-01,20,15,20,15,35
SAN JOAQUIN,consulta externa,repetidas en menores de 5 anos,2005-05-01,3,3,3,3,6
SAN JOSE DE CHIQUITOS,consulta externa,repetidas en menores de 5 anos,2005-05-01,2,10,2,10,12
SAN JUAN DE YAPACANI,consulta externa,repetidas en menores de 5 anos,2005-05-01,11,11,11,11,22
SAN JULIAN,consulta externa,repetidas en menores de 5 anos,2005-05-01,42,28,42,28,70
SAN LORENZO(PND),consulta externa,repetidas en menores de 5 anos,2005-05-01,2,4,2,4,6
SAN LORENZO(TJA),consulta externa,repetidas en menores de 5 anos,2005-05-01,48,38,48,38,86
SAN LUCAS,consulta externa,repetidas en menores de 5 anos,2005-05-01,11,8,11,8,19
SAN MATIAS,consulta externa,repetidas en menores de 5 anos,2005-05-01,5,5,5,5,10
SAN MIGUEL DE VELASCO,consulta externa,repetidas en menores de 5 anos,2005-05-01,17,7,17,7,24
SAN PABLO DE LIPEZ,consulta externa,repetidas en menores de 5 anos,2005-05-01,6,6,6,6,12
SAN PEDRO,consulta externa,repetidas en menores de 5 anos,2005-05-01,50,32,50,32,82
SAN PEDRO DE BUENA VISTA,consulta externa,repetidas en menores de 5 anos,2005-05-01,1,5,1,5,6
SAN PEDRO DE CURAHUARA,consulta externa,repetidas en menores de 5 anos,2005-05-01,3,0,3,0,3
SAN PEDRO DE TIQUINA,consulta externa,repetidas en menores de 5 anos,2005-05-01,3,2,3,2,5
SAN PEDRO(PND),consulta externa,repetidas en menores de 5 anos,2005-05-01,2,6,2,6,8
SAN RAFAEL,consulta externa,repetidas en menores de 5 anos,2005-05-01,2,6,2,6,8
SAN RAMON,consulta externa,repetidas en menores de 5 anos,2005-05-01,15,6,15,6,21
SAN RAMON,consulta externa,repetidas en menores de 5 anos,2005-05-01,3,3,3,3,6
SANTA ANA,consulta externa,repetidas en menores de 5 anos,2005-05-01,50,26,50,26,76
SANTA CRUZ DE LA SIERRA,consulta externa,repetidas en menores de 5 anos,2005-05-01,3014,2968,3014,2968,5982
SANTA ROSA,consulta externa,repetidas en menores de 5 anos,2005-05-01,18,16,18,16,34
SANTA ROSA DEL SARA,consulta externa,repetidas en menores de 5 anos,2005-05-01,26,36,26,36,62
SANTIAGO DE HUARI,consulta externa,repetidas en menores de 5 anos,2005-05-01,16,18,16,18,34
SANTIAGO DE MACHACA,consulta externa,repetidas en menores de 5 anos,2005-05-01,2,2,2,2,4
SANTIVAÑES,consulta externa,repetidas en menores de 5 anos,2005-05-01,20,12,20,12,32
SANTUARIO DE QUILLACAS,consulta externa,repetidas en menores de 5 anos,2005-05-01,2,0,2,0,2
SAPAHAQUI,consulta externa,repetidas en menores de 5 anos,2005-05-01,2,6,2,6,8
SENA,consulta externa,repetidas en menores de 5 anos,2005-05-01,1,0,1,0,1
SICA SICA (VILLA AROMA),consulta externa,repetidas en menores de 5 anos,2005-05-01,11,4,11,4,15
SICAYA,consulta externa,repetidas en menores de 5 anos,2005-05-01,1,0,1,0,1
SIPE SIPE,consulta externa,repetidas en menores de 5 anos,2005-05-01,112,98,112,98,210
SOPACHUY,consulta externa,repetidas en menores de 5 anos,2005-05-01,2,3,2,3,5
SORACACHI,consulta externa,repetidas en menores de 5 anos,2005-05-01,6,2,6,2,8
SORATA,consulta externa,repetidas en menores de 5 anos,2005-05-01,3,3,3,3,6
SUCRE,consulta externa,repetidas en menores de 5 anos,2005-05-01,796,847,796,847,1643
TACACHI,consulta externa,repetidas en menores de 5 anos,2005-05-01,22,19,22,19,41
TACACOMA,consulta externa,repetidas en menores de 5 anos,2005-05-01,2,3,2,3,5
TACOBAMBA,consulta externa,repetidas en menores de 5 anos,2005-05-01,2,0,2,0,2
TACOPAYA,consulta externa,repetidas en menores de 5 anos,2005-05-01,5,2,5,2,7
TAPACARI,consulta externa,repetidas en menores de 5 anos,2005-05-01,54,45,54,45,99
TARABUCO,consulta externa,repetidas en menores de 5 anos,2005-05-01,207,230,207,230,437
TARATA,consulta externa,repetidas en menores de 5 anos,2005-05-01,33,21,33,21,54
TARIJA,consulta externa,repetidas en menores de 5 anos,2005-05-01,553,578,553,578,1131
TARVITA,consulta externa,repetidas en menores de 5 anos,2005-05-01,24,25,24,25,49
TEOPONTE,consulta externa,repetidas en menores de 5 anos,2005-05-01,7,1,7,1,8
TIAWANACU,consulta externa,repetidas en menores de 5 anos,2005-05-01,3,1,3,1,4
TINGUIPAYA,consulta externa,repetidas en menores de 5 anos,2005-05-01,1,2,1,2,3
TIPUANI,consulta externa,repetidas en menores de 5 anos,2005-05-01,21,17,21,17,38
TIQUIPAYA,consulta externa,repetidas en menores de 5 anos,2005-05-01,134,98,134,98,232
TIRAQUE (CBBA),consulta externa,repetidas en menores de 5 anos,2005-05-01,137,93,137,93,230
TITO YUPANQUI (PARQUIPUJIO),consulta externa,repetidas en menores de 5 anos,2005-05-01,2,2,2,2,4
TOCO,consulta externa,repetidas en menores de 5 anos,2005-05-01,6,4,6,4,10
TOLATA,consulta externa,repetidas en menores de 5 anos,2005-05-01,10,9,10,9,19
TOLEDO,consulta externa,repetidas en menores de 5 anos,2005-05-01,8,10,8,10,18
TOMAVE,consulta externa,repetidas en menores de 5 anos,2005-05-01,10,7,10,7,17
TOMINA,consulta externa,repetidas en menores de 5 anos,2005-05-01,3,9,3,9,12
TORO TORO,consulta externa,repetidas en menores de 5 anos,2005-05-01,10,7,10,7,17
TOTORA(CBBA),consulta externa,repetidas en menores de 5 anos,2005-05-01,5,4,5,4,9
TOTORA(ORR),consulta externa,repetidas en menores de 5 anos,2005-05-01,2,1,2,1,3
TRIGAL,consulta externa,repetidas en menores de 5 anos,2005-05-01,13,11,13,11,24
TRINIDAD,consulta externa,repetidas en menores de 5 anos,2005-05-01,341,318,341,318,659
TUPIZA,consulta externa,repetidas en menores de 5 anos,2005-05-01,78,91,78,91,169
UMALA,consulta externa,repetidas en menores de 5 anos,2005-05-01,10,5,10,5,15
UNCIA,consulta externa,repetidas en menores de 5 anos,2005-05-01,17,15,17,15,32
URIONDO (A. CONCEPCION),consulta externa,repetidas en menores de 5 anos,2005-05-01,45,40,45,40,85
URUBICHA,consulta externa,repetidas en menores de 5 anos,2005-05-01,1,4,1,4,5
UYUNI,consulta externa,repetidas en menores de 5 anos,2005-05-01,12,17,12,17,29
VACAS,consulta externa,repetidas en menores de 5 anos,2005-05-01,52,28,52,28,80
VALLEGRANDE,consulta externa,repetidas en menores de 5 anos,2005-05-01,11,14,11,14,25
VIACHA,consulta externa,repetidas en menores de 5 anos,2005-05-01,77,95,77,95,172
VILA VILA,consulta externa,repetidas en menores de 5 anos,2005-05-01,7,4,7,4,11
VILLA MONTES,consulta externa,repetidas en menores de 5 anos,2005-05-01,42,32,42,32,74
VILLA NUEVA (LOMA ALTA),consulta externa,repetidas en menores de 5 anos,2005-05-01,9,7,9,7,16
VILLA RIVERO,consulta externa,repetidas en menores de 5 anos,2005-05-01,19,10,19,10,29
VILLA SERRANO,consulta externa,repetidas en menores de 5 anos,2005-05-01,3,4,3,4,7
VILLA TUNARI,consulta externa,repetidas en menores de 5 anos,2005-05-01,107,104,107,104,211
VILLA VACA GUZMAN (MUYUPAMPA),consulta externa,repetidas en menores de 5 anos,2005-05-01,38,42,38,42,80
VILLAZON,consulta externa,repetidas en menores de 5 anos,2005-05-01,54,45,54,45,99
VINTO,consulta externa,repetidas en menores de 5 anos,2005-05-01,30,18,30,18,48
VITICHI,consulta externa,repetidas en menores de 5 anos,2005-05-01,6,5,6,5,11
WALDO BALLIVIAN,consulta externa,repetidas en menores de 5 anos,2005-05-01,3,1,3,1,4
WARNES,consulta externa,repetidas en menores de 5 anos,2005-05-01,116,148,116,148,264
YACO,consulta externa,repetidas en menores de 5 anos,2005-05-01,24,22,24,22,46
YACUIBA,consulta externa,repetidas en menores de 5 anos,2005-05-01,183,145,183,145,328
YAMPARAEZ,consulta externa,repetidas en menores de 5 anos,2005-05-01,15,11,15,11,26
YANACACHI,consulta externa,repetidas en menores de 5 anos,2005-05-01,13,19,13,19,32
YAPACANI,consulta externa,repetidas en menores de 5 anos,2005-05-01,33,20,33,20,53
YOCALLA,consulta externa,repetidas en menores de 5 anos,2005-05-01,3,0,3,0,3
YOTALA,consulta externa,repetidas en menores de 5 anos,2005-05-01,59,61,59,61,120
ZUDAÑEZ,consulta externa,repetidas en menores de 5 anos,2005-05-01,3,3,3,3,6
ACACIO,consulta externa,repetidas en menores de 5 anos,2005-06-01,1,1,1,1,2
ACHACACHI,consulta externa,repetidas en menores de 5 anos,2005-06-01,10,9,10,9,19
ACHOCALLA,consulta externa,repetidas en menores de 5 anos,2005-06-01,2,9,2,9,11
AIQUILE,consulta externa,repetidas en menores de 5 anos,2005-06-01,55,57,55,57,112
ALALAY,consulta externa,repetidas en menores de 5 anos,2005-06-01,1,1,1,1,2
ANCORAIMES,consulta externa,repetidas en menores de 5 anos,2005-06-01,18,16,18,16,34
ANDAMARCA,consulta externa,repetidas en menores de 5 anos,2005-06-01,2,4,2,4,6
ANTEQUERA,consulta externa,repetidas en menores de 5 anos,2005-06-01,1,23,1,23,24
ANZALDO,consulta externa,repetidas en menores de 5 anos,2005-06-01,8,3,8,3,11
APOLO,consulta externa,repetidas en menores de 5 anos,2005-06-01,22,10,22,10,32
ARAMPAMPA,consulta externa,repetidas en menores de 5 anos,2005-06-01,1,0,1,0,1
ARANI,consulta externa,repetidas en menores de 5 anos,2005-06-01,59,52,59,52,111
ARBIETO,consulta externa,repetidas en menores de 5 anos,2005-06-01,4,0,4,0,4
ARQUE,consulta externa,repetidas en menores de 5 anos,2005-06-01,15,11,15,11,26
ASCENCION DE GUARAYOS,consulta externa,repetidas en menores de 5 anos,2005-06-01,36,28,36,28,64
ATOCHA,consulta externa,repetidas en menores de 5 anos,2005-06-01,36,33,36,33,69
AUCAPATA,consulta externa,repetidas en menores de 5 anos,2005-06-01,5,1,5,1,6
AYATA,consulta externa,repetidas en menores de 5 anos,2005-06-01,3,7,3,7,10
AYO AYO,consulta externa,repetidas en menores de 5 anos,2005-06-01,5,21,5,21,26
AYOPAYA (V. DE INDEPENDENCIA),consulta externa,repetidas en menores de 5 anos,2005-06-01,10,17,10,17,27
AZURDUY,consulta externa,repetidas en menores de 5 anos,2005-06-01,0,2,0,2,2
BATALLAS,consulta externa,repetidas en menores de 5 anos,2005-06-01,3,1,3,1,4
BAURES,consulta externa,repetidas en menores de 5 anos,2005-06-01,10,7,10,7,17
BELEN DE ANDAMARCA,consulta externa,repetidas en menores de 5 anos,2005-06-01,3,1,3,1,4
BELEN DE URMIRI,consulta externa,repetidas en menores de 5 anos,2005-06-01,3,1,3,1,4
BERMEJO,consulta externa,repetidas en menores de 5 anos,2005-06-01,72,65,72,65,137
BETANZOS,consulta externa,repetidas en menores de 5 anos,2005-06-01,20,17,20,17,37
BOLIVAR,consulta externa,repetidas en menores de 5 anos,2005-06-01,4,3,4,3,7
BOLPEBRA,consulta externa,repetidas en menores de 5 anos,2005-06-01,3,0,3,0,3
BOYUIBE,consulta externa,repetidas en menores de 5 anos,2005-06-01,10,13,10,13,23
BUENA VISTA,consulta externa,repetidas en menores de 5 anos,2005-06-01,97,82,97,82,179
CABEZAS,consulta externa,repetidas en menores de 5 anos,2005-06-01,7,4,7,4,11
CAIROMA,consulta externa,repetidas en menores de 5 anos,2005-06-01,2,0,2,0,2
"CAIZA ""D""",consulta externa,repetidas en menores de 5 anos,2005-06-01,12,0,12,0,12
CAJUATA,consulta externa,repetidas en menores de 5 anos,2005-06-01,3,3,3,3,6
CALACOTO,consulta externa,repetidas en menores de 5 anos,2005-06-01,2,1,2,1,3
CALAMARCA,consulta externa,repetidas en menores de 5 anos,2005-06-01,11,17,11,17,28
CAMARGO,consulta externa,repetidas en menores de 5 anos,2005-06-01,16,11,16,11,27
CAMATAQUI (C. VILLA ABECIA),consulta externa,repetidas en menores de 5 anos,2005-06-01,0,1,0,1,1
CAMIRI,consulta externa,repetidas en menores de 5 anos,2005-06-01,183,171,183,171,354
CAPINOTA,consulta externa,repetidas en menores de 5 anos,2005-06-01,64,59,64,59,123
CAQUIAVIRI,consulta externa,repetidas en menores de 5 anos,2005-06-01,4,3,4,3,7
CARACOLLO,consulta externa,repetidas en menores de 5 anos,2005-06-01,3,11,3,11,14
CARANAVI,consulta externa,repetidas en menores de 5 anos,2005-06-01,63,75,63,75,138
CARAPARI,consulta externa,repetidas en menores de 5 anos,2005-06-01,15,14,15,14,29
CHACARILLA,consulta externa,repetidas en menores de 5 anos,2005-06-01,8,8,8,8,16
CHALLAPATA,consulta externa,repetidas en menores de 5 anos,2005-06-01,4,20,4,20,24
CHAQUI,consulta externa,repetidas en menores de 5 anos,2005-06-01,4,1,4,1,5
CHARAGUA,consulta externa,repetidas en menores de 5 anos,2005-06-01,48,60,48,60,108
CHARAÑA,consulta externa,repetidas en menores de 5 anos,2005-06-01,0,1,0,1,1
CHAYANTA,consulta externa,repetidas en menores de 5 anos,2005-06-01,6,3,6,3,9
CHIMORE,consulta externa,repetidas en menores de 5 anos,2005-06-01,35,41,35,41,76
CHIPAYA,consulta externa,repetidas en menores de 5 anos,2005-06-01,0,5,0,5,5
CHOQUE COTA,consulta externa,repetidas en menores de 5 anos,2005-06-01,2,9,2,9,11
CHULUMANI (V. DE LA LIBERTAD),consulta externa,repetidas en menores de 5 anos,2005-06-01,11,10,11,10,21
CHUMA,consulta externa,repetidas en menores de 5 anos,2005-06-01,5,2,5,2,7
CLIZA,consulta externa,repetidas en menores de 5 anos,2005-06-01,9,9,9,9,18
COBIJA,consulta externa,repetidas en menores de 5 anos,2005-06-01,172,169,172,169,341
COCHABAMBA,consulta externa,repetidas en menores de 5 anos,2005-06-01,2613,2494,2613,2494,5107
COLCAPIRHUA,consulta externa,repetidas en menores de 5 anos,2005-06-01,113,101,113,101,214
"COLCHA ""K""",consulta externa,repetidas en menores de 5 anos,2005-06-01,11,10,11,10,21
COLLANA,consulta externa,repetidas en menores de 5 anos,2005-06-01,3,0,3,0,3
COLOMI,consulta externa,repetidas en menores de 5 anos,2005-06-01,35,29,35,29,64
COLPA BELGICA,consulta externa,repetidas en menores de 5 anos,2005-06-01,46,25,46,25,71
COLQUECHACA,consulta externa,repetidas en menores de 5 anos,2005-06-01,5,4,5,4,9
COLQUENCHA,consulta externa,repetidas en menores de 5 anos,2005-06-01,6,7,6,7,13
COLQUIRI,consulta externa,repetidas en menores de 5 anos,2005-06-01,21,38,21,38,59
COMANCHE,consulta externa,repetidas en menores de 5 anos,2005-06-01,1,1,1,1,2
COMARAPA,consulta externa,repetidas en menores de 5 anos,2005-06-01,53,47,53,47,100
CONCEPCION,consulta externa,repetidas en menores de 5 anos,2005-06-01,1,5,1,5,6
COPACABANA,consulta externa,repetidas en menores de 5 anos,2005-06-01,0,1,0,1,1
CORIPATA,consulta externa,repetidas en menores de 5 anos,2005-06-01,3,3,3,3,6
CORO CORO,consulta externa,repetidas en menores de 5 anos,2005-06-01,6,2,6,2,8
COROICO,consulta externa,repetidas en menores de 5 anos,2005-06-01,39,43,39,43,82
CORQUE,consulta externa,repetidas en menores de 5 anos,2005-06-01,18,14,18,14,32
COTAGAITA,consulta externa,repetidas en menores de 5 anos,2005-06-01,36,42,36,42,78
COTOCA,consulta externa,repetidas en menores de 5 anos,2005-06-01,13,9,13,9,22
CUATRO CAÑADAS,consulta externa,repetidas en menores de 5 anos,2005-06-01,20,9,20,9,29
CUCHUMUELA (V. G. VILLARROEL),consulta externa,repetidas en menores de 5 anos,2005-06-01,2,0,2,0,2
CUEVO,consulta externa,repetidas en menores de 5 anos,2005-06-01,7,9,7,9,16
CULPINA,consulta externa,repetidas en menores de 5 anos,2005-06-01,22,21,22,21,43
DESAGUADERO,consulta externa,repetidas en menores de 5 anos,2005-06-01,5,2,5,2,7
EL ALTO,consulta externa,repetidas en menores de 5 anos,2005-06-01,2050,1832,2050,1832,3882
EL CHORO,consulta externa,repetidas en menores de 5 anos,2005-06-01,1,1,1,1,2
EL PUENTE(STC),consulta externa,repetidas en menores de 5 anos,2005-06-01,8,5,8,5,13
EL PUENTE(TJA),consulta externa,repetidas en menores de 5 anos,2005-06-01,8,5,8,5,13
EL TORNO,consulta externa,repetidas en menores de 5 anos,2005-06-01,154,125,154,125,279
EL VILLAR,consulta externa,repetidas en menores de 5 anos,2005-06-01,8,14,8,14,22
ENTRE RIOS,consulta externa,repetidas en menores de 5 anos,2005-06-01,11,13,11,13,24
ENTRE RIOS,consulta externa,repetidas en menores de 5 anos,2005-06-01,26,29,26,29,55
ESCARA,consulta externa,repetidas en menores de 5 anos,2005-06-01,0,1,0,1,1
EUCALIPTUS,consulta externa,repetidas en menores de 5 anos,2005-06-01,24,7,24,7,31
EXALTACION,consulta externa,repetidas en menores de 5 anos,2005-06-01,5,12,5,12,17
FERNANDEZ ALONSO,consulta externa,repetidas en menores de 5 anos,2005-06-01,29,23,29,23,52
FILADELFIA,consulta externa,repetidas en menores de 5 anos,2005-06-01,1,2,1,2,3
GENERAL SAAVEDRA,consulta externa,repetidas en menores de 5 anos,2005-06-01,22,18,22,18,40
GRAL. J.J. PEREZ (CHARAZANI),consulta externa,repetidas en menores de 5 anos,2005-06-01,5,4,5,4,9
GUANAY,consulta externa,repetidas en menores de 5 anos,2005-06-01,0,1,0,1,1
GUAQUI,consulta externa,repetidas en menores de 5 anos,2005-06-01,1,2,1,2,3
GUAYARAMERIN,consulta externa,repetidas en menores de 5 anos,2005-06-01,103,160,103,160,263
GUTIERREZ,consulta externa,repetidas en menores de 5 anos,2005-06-01,60,65,60,65,125
HUACARETA,consulta externa,repetidas en menores de 5 anos,2005-06-01,36,47,36,47,83
HUACAYA (VILLA DE HUACAYA),consulta externa,repetidas en menores de 5 anos,2005-06-01,1,1,1,1,2
HUANUNI,consulta externa,repetidas en menores de 5 anos,2005-06-01,59,65,59,65,124
HUARACAJE,consulta externa,repetidas en menores de 5 anos,2005-06-01,21,25,21,25,46
HUAYLLAMARCA,consulta externa,repetidas en menores de 5 anos,2005-06-01,5,10,5,10,15
ICHOCA,consulta externa,repetidas en menores de 5 anos,2005-06-01,0,3,0,3,3
ICLA,consulta externa,repetidas en menores de 5 anos,2005-06-01,1,6,1,6,7
INCAHUASI,consulta externa,repetidas en menores de 5 anos,2005-06-01,14,10,14,10,24
INGAVI (HUMAITA),consulta externa,repetidas en menores de 5 anos,2005-06-01,2,1,2,1,3
INQUISIVI,consulta externa,repetidas en menores de 5 anos,2005-06-01,2,2,2,2,4
IRUPANA (VILLA DE LANZA),consulta externa,repetidas en menores de 5 anos,2005-06-01,15,13,15,13,28
IXIAMAS,consulta externa,repetidas en menores de 5 anos,2005-06-01,30,13,30,13,43
JESUS DE MACHACA,consulta externa,repetidas en menores de 5 anos,2005-06-01,11,2,11,2,13
LA ASUNTA,consulta externa,repetidas en menores de 5 anos,2005-06-01,6,10,6,10,16
LA GUARDIA,consulta externa,repetidas en menores de 5 anos,2005-06-01,112,131,112,131,243
LA PAZ,consulta externa,repetidas en menores de 5 anos,2005-06-01,3454,3495,3454,3495,6949
LAGUNILLAS,consulta externa,repetidas en menores de 5 anos,2005-06-01,26,26,26,26,52
LAJA,consulta externa,repetidas en menores de 5 anos,2005-06-01,13,4,13,4,17
LAS CARRERAS,consulta externa,repetidas en menores de 5 anos,2005-06-01,3,6,3,6,9
LICOMA PAMPA,consulta externa,repetidas en menores de 5 anos,2005-06-01,2,1,2,1,3
LLALLAGUA,consulta externa,repetidas en menores de 5 anos,2005-06-01,25,23,25,23,48
LLICA,consulta externa,repetidas en menores de 5 anos,2005-06-01,2,0,2,0,2
LORETO,consulta externa,repetidas en menores de 5 anos,2005-06-01,14,12,14,12,26
LURIBAY,consulta externa,repetidas en menores de 5 anos,2005-06-01,1,2,1,2,3
MACHACAMARCA,consulta externa,repetidas en menores de 5 anos,2005-06-01,4,3,4,3,7
MACHARETI,consulta externa,repetidas en menores de 5 anos,2005-06-01,12,19,12,19,31
MAGDALENA,consulta externa,repetidas en menores de 5 anos,2005-06-01,17,22,17,22,39
MAIRANA,consulta externa,repetidas en menores de 5 anos,2005-06-01,5,5,5,5,10
MALLA,consulta externa,repetidas en menores de 5 anos,2005-06-01,0,1,0,1,1
MAPIRI,consulta externa,repetidas en menores de 5 anos,2005-06-01,13,16,13,16,29
MECAPACA,consulta externa,repetidas en menores de 5 anos,2005-06-01,18,20,18,20,38
MINEROS,consulta externa,repetidas en menores de 5 anos,2005-06-01,30,17,30,17,47
MIZQUE,consulta externa,repetidas en menores de 5 anos,2005-06-01,18,16,18,16,34
MOCOMOCO,consulta externa,repetidas en menores de 5 anos,2005-06-01,2,0,2,0,2
MOJINETE,consulta externa,repetidas en menores de 5 anos,2005-06-01,8,12,8,12,20
MOJOCOYA,consulta externa,repetidas en menores de 5 anos,2005-06-01,12,4,12,4,16
MONTEAGUDO,consulta externa,repetidas en menores de 5 anos,2005-06-01,55,49,55,49,104
MONTERO,consulta externa,repetidas en menores de 5 anos,2005-06-01,636,585,636,585,1221
MORO MORO,consulta externa,repetidas en menores de 5 anos,2005-06-01,2,1,2,1,3
MOROCHATA,consulta externa,repetidas en menores de 5 anos,2005-06-01,27,29,27,29,56
NACEBE (SANTA ROSA DEL ABUNA),consulta externa,repetidas en menores de 5 anos,2005-06-01,3,2,3,2,5
OCURI,consulta externa,repetidas en menores de 5 anos,2005-06-01,2,1,2,1,3
OKINAWA,consulta externa,repetidas en menores de 5 anos,2005-06-01,26,18,26,18,44
OMEREQUE,consulta externa,repetidas en menores de 5 anos,2005-06-01,15,7,15,7,22
ORURO,consulta externa,repetidas en menores de 5 anos,2005-06-01,582,568,582,568,1150
PADCAYA,consulta externa,repetidas en menores de 5 anos,2005-06-01,19,16,19,16,35
PADILLA,consulta externa,repetidas en menores de 5 anos,2005-06-01,8,8,8,8,16
PAILON,consulta externa,repetidas en menores de 5 anos,2005-06-01,20,23,20,23,43
PALCA,consulta externa,repetidas en menores de 5 anos,2005-06-01,10,2,10,2,12
PALOS BLANCOS,consulta externa,repetidas en menores de 5 anos,2005-06-01,17,10,17,10,27
PAMPA GRANDE,consulta externa,repetidas en menores de 5 anos,2005-06-01,17,9,17,9,26
PAPEL PAMPA,consulta externa,repetidas en menores de 5 anos,2005-06-01,7,4,7,4,11
PASORAPA,consulta externa,repetidas en menores de 5 anos,2005-06-01,26,20,26,20,46
PATACAMAYA,consulta externa,repetidas en menores de 5 anos,2005-06-01,18,9,18,9,27
PAZÑA,consulta externa,repetidas en menores de 5 anos,2005-06-01,6,8,6,8,14
PELECHUCO,consulta externa,repetidas en menores de 5 anos,2005-06-01,3,2,3,2,5
POCOATA,consulta externa,repetidas en menores de 5 anos,2005-06-01,4,3,4,3,7
POCONA,consulta externa,repetidas en menores de 5 anos,2005-06-01,1,1,1,1,2
POJO (CBBA),consulta externa,repetidas en menores de 5 anos,2005-06-01,7,14,7,14,21
POOPO,consulta externa,repetidas en menores de 5 anos,2005-06-01,3,2,3,2,5
PORCO,consulta externa,repetidas en menores de 5 anos,2005-06-01,2,5,2,5,7
POROMA,consulta externa,repetidas en menores de 5 anos,2005-06-01,1,0,1,0,1
PORONGO,consulta externa,repetidas en menores de 5 anos,2005-06-01,25,22,25,22,47
PORTACHUELO,consulta externa,repetidas en menores de 5 anos,2005-06-01,65,66,65,66,131
PORVENIR,consulta externa,repetidas en menores de 5 anos,2005-06-01,5,12,5,12,17
POSTRER VALLE,consulta externa,repetidas en menores de 5 anos,2005-06-01,4,2,4,2,6
POTOSI,consulta externa,repetidas en menores de 5 anos,2005-06-01,516,321,516,321,837
PRESTO,consulta externa,repetidas en menores de 5 anos,2005-06-01,3,7,3,7,10
PUCARA,consulta externa,repetidas en menores de 5 anos,2005-06-01,11,8,11,8,19
PUCARANI,consulta externa,repetidas en menores de 5 anos,2005-06-01,0,3,0,3,3
PUERTO ACOSTA,consulta externa,repetidas en menores de 5 anos,2005-06-01,20,26,20,26,46
PUERTO CARABUCO,consulta externa,repetidas en menores de 5 anos,2005-06-01,6,2,6,2,8
PUERTO GONZALO MORENO,consulta externa,repetidas en menores de 5 anos,2005-06-01,11,11,11,11,22
PUERTO PEREZ,consulta externa,repetidas en menores de 5 anos,2005-06-01,1,0,1,0,1
PUERTO QUIJARRO,consulta externa,repetidas en menores de 5 anos,2005-06-01,26,21,26,21,47
PUERTO RICO,consulta externa,repetidas en menores de 5 anos,2005-06-01,84,120,84,120,204
PUERTO SUAREZ,consulta externa,repetidas en menores de 5 anos,2005-06-01,19,17,19,17,36
PUERTO VILLARROEL,consulta externa,repetidas en menores de 5 anos,2005-06-01,72,61,72,61,133
PUNA,consulta externa,repetidas en menores de 5 anos,2005-06-01,15,13,15,13,28
PUNATA,consulta externa,repetidas en menores de 5 anos,2005-06-01,129,103,129,103,232
QUILLACOLLO,consulta externa,repetidas en menores de 5 anos,2005-06-01,114,231,114,231,345
QUIME,consulta externa,repetidas en menores de 5 anos,2005-06-01,15,4,15,4,19
RAVELO,consulta externa,repetidas en menores de 5 anos,2005-06-01,1,1,1,1,2
REYES,consulta externa,repetidas en menores de 5 anos,2005-06-01,49,50,49,50,99
RIBERALTA,consulta externa,repetidas en menores de 5 anos,2005-06-01,340,299,340,299,639
ROBORE,consulta externa,repetidas en menores de 5 anos,2005-06-01,11,13,11,13,24
RURRENABAQUE,consulta externa,repetidas en menores de 5 anos,2005-06-01,116,125,116,125,241
SABAYA,consulta externa,repetidas en menores de 5 anos,2005-06-01,2,3,2,3,5
SACABA,consulta externa,repetidas en menores de 5 anos,2005-06-01,147,134,147,134,281
SACABAMBA,consulta externa,repetidas en menores de 5 anos,2005-06-01,44,44,44,44,88
SACACA,consulta externa,repetidas en menores de 5 anos,2005-06-01,9,3,9,3,12
SAIPINA,consulta externa,repetidas en menores de 5 anos,2005-06-01,20,9,20,9,29
SALINAS DE GARCI MENDOZA,consulta externa,repetidas en menores de 5 anos,2005-06-01,5,3,5,3,8
SAMAIPATA,consulta externa,repetidas en menores de 5 anos,2005-06-01,3,4,3,4,7
SAN AGUSTIN,consulta externa,repetidas en menores de 5 anos,2005-06-01,3,2,3,2,5
SAN ANDRES,consulta externa,repetidas en menores de 5 anos,2005-06-01,21,9,21,9,30
SAN ANDRES DE MACHACA,consulta externa,repetidas en menores de 5 anos,2005-06-01,3,0,3,0,3
SAN ANTONIO DE ESMORUCO,consulta externa,repetidas en menores de 5 anos,2005-06-01,3,1,3,1,4
SAN ANTONIO DE LOMERIO,consulta externa,repetidas en menores de 5 anos,2005-06-01,2,2,2,2,4
SAN BENITO,consulta externa,repetidas en menores de 5 anos,2005-06-01,13,18,13,18,31
SAN BORJA,consulta externa,repetidas en menores de 5 anos,2005-06-01,87,93,87,93,180
SAN BUENA VENTURA,consulta externa,repetidas en menores de 5 anos,2005-06-01,5,5,5,5,10
SAN CARLOS,consulta externa,repetidas en menores de 5 anos,2005-06-01,26,32,26,32,58
SAN IGNACIO,consulta externa,repetidas en menores de 5 anos,2005-06-01,127,95,127,95,222
SAN IGNACIO DE VELASCO,consulta externa,repetidas en menores de 5 anos,2005-06-01,123,81,123,81,204
SAN JAVIER(BNI),consulta externa,repetidas en menores de 5 anos,2005-06-01,8,6,8,6,14
SAN JAVIER(STC),consulta externa,repetidas en menores de 5 anos,2005-06-01,20,11,20,11,31
SAN JOAQUIN,consulta externa,repetidas en menores de 5 anos,2005-06-01,4,2,4,2,6
SAN JOSE DE CHIQUITOS,consulta externa,repetidas en menores de 5 anos,2005-06-01,16,5,16,5,21
SAN JUAN DE YAPACANI,consulta externa,repetidas en menores de 5 anos,2005-06-01,8,5,8,5,13
SAN JULIAN,consulta externa,repetidas en menores de 5 anos,2005-06-01,42,35,42,35,77
SAN LORENZO(PND),consulta externa,repetidas en menores de 5 anos,2005-06-01,5,5,5,5,10
SAN LORENZO(TJA),consulta externa,repetidas en menores de 5 anos,2005-06-01,86,68,86,68,154
SAN LUCAS,consulta externa,repetidas en menores de 5 anos,2005-06-01,32,28,32,28,60
SAN MATIAS,consulta externa,repetidas en menores de 5 anos,2005-06-01,41,66,41,66,107
SAN MIGUEL DE VELASCO,consulta externa,repetidas en menores de 5 anos,2005-06-01,59,59,59,59,118
SAN PABLO DE LIPEZ,consulta externa,repetidas en menores de 5 anos,2005-06-01,6,9,6,9,15
SAN PEDRO,consulta externa,repetidas en menores de 5 anos,2005-06-01,29,35,29,35,64
SAN PEDRO DE BUENA VISTA,consulta externa,repetidas en menores de 5 anos,2005-06-01,2,0,2,0,2
SAN PEDRO DE CURAHUARA,consulta externa,repetidas en menores de 5 anos,2005-06-01,3,0,3,0,3
SAN PEDRO DE TIQUINA,consulta externa,repetidas en menores de 5 anos,2005-06-01,5,0,5,0,5
SAN PEDRO(PND),consulta externa,repetidas en menores de 5 anos,2005-06-01,0,1,0,1,1
SAN RAFAEL,consulta externa,repetidas en menores de 5 anos,2005-06-01,3,5,3,5,8
SAN RAMON,consulta externa,repetidas en menores de 5 anos,2005-06-01,6,9,6,9,15
SAN RAMON,consulta externa,repetidas en menores de 5 anos,2005-06-01,4,6,4,6,10
SANTA ANA,consulta externa,repetidas en menores de 5 anos,2005-06-01,41,36,41,36,77
SANTA CRUZ DE LA SIERRA,consulta externa,repetidas en menores de 5 anos,2005-06-01,4147,4174,4147,4174,8321
SANTA ROSA,consulta externa,repetidas en menores de 5 anos,2005-06-01,35,32,35,32,67
SANTA ROSA DEL SARA,consulta externa,repetidas en menores de 5 anos,2005-06-01,37,54,37,54,91
SANTIAGO DE CALLAPA,consulta externa,repetidas en menores de 5 anos,2005-06-01,2,0,2,0,2
SANTIAGO DE HUARI,consulta externa,repetidas en menores de 5 anos,2005-06-01,17,21,17,21,38
SANTIAGO DE MACHACA,consulta externa,repetidas en menores de 5 anos,2005-06-01,3,2,3,2,5
SANTIVAÑES,consulta externa,repetidas en menores de 5 anos,2005-06-01,6,8,6,8,14
SANTUARIO DE QUILLACAS,consulta externa,repetidas en menores de 5 anos,2005-06-01,2,0,2,0,2
SAPAHAQUI,consulta externa,repetidas en menores de 5 anos,2005-06-01,5,3,5,3,8
SENA,consulta externa,repetidas en menores de 5 anos,2005-06-01,1,1,1,1,2
SICA SICA (VILLA AROMA),consulta externa,repetidas en menores de 5 anos,2005-06-01,7,4,7,4,11
SIPE SIPE,consulta externa,repetidas en menores de 5 anos,2005-06-01,95,82,95,82,177
SOPACHUY,consulta externa,repetidas en menores de 5 anos,2005-06-01,1,0,1,0,1
SORACACHI,consulta externa,repetidas en menores de 5 anos,2005-06-01,1,1,1,1,2
SORATA,consulta externa,repetidas en menores de 5 anos,2005-06-01,3,1,3,1,4
SUCRE,consulta externa,repetidas en menores de 5 anos,2005-06-01,861,843,861,843,1704
TACACHI,consulta externa,repetidas en menores de 5 anos,2005-06-01,19,12,19,12,31
TACACOMA,consulta externa,repetidas en menores de 5 anos,2005-06-01,6,0,6,0,6
TACOBAMBA,consulta externa,repetidas en menores de 5 anos,2005-06-01,3,0,3,0,3
TACOPAYA,consulta externa,repetidas en menores de 5 anos,2005-06-01,8,3,8,3,11
TAPACARI,consulta externa,repetidas en menores de 5 anos,2005-06-01,25,25,25,25,50
TARABUCO,consulta externa,repetidas en menores de 5 anos,2005-06-01,209,209,209,209,418
TARACO,consulta externa,repetidas en menores de 5 anos,2005-06-01,0,2,0,2,2
TARATA,consulta externa,repetidas en menores de 5 anos,2005-06-01,8,5,8,5,13
TARIJA,consulta externa,repetidas en menores de 5 anos,2005-06-01,742,694,742,694,1436
TARVITA,consulta externa,repetidas en menores de 5 anos,2005-06-01,8,6,8,6,14
TEOPONTE,consulta externa,repetidas en menores de 5 anos,2005-06-01,1,5,1,5,6
TIAWANACU,consulta externa,repetidas en menores de 5 anos,2005-06-01,3,1,3,1,4
TINGUIPAYA,consulta externa,repetidas en menores de 5 anos,2005-06-01,2,4,2,4,6
TIPUANI,consulta externa,repetidas en menores de 5 anos,2005-06-01,14,12,14,12,26
TIQUIPAYA,consulta externa,repetidas en menores de 5 anos,2005-06-01,195,145,195,145,340
TIRAQUE (CBBA),consulta externa,repetidas en menores de 5 anos,2005-06-01,133,94,133,94,227
TITO YUPANQUI (PARQUIPUJIO),consulta externa,repetidas en menores de 5 anos,2005-06-01,3,0,3,0,3
TOCO,consulta externa,repetidas en menores de 5 anos,2005-06-01,4,3,4,3,7
TODOS SANTOS,consulta externa,repetidas en menores de 5 anos,2005-06-01,1,1,1,1,2
TOLATA,consulta externa,repetidas en menores de 5 anos,2005-06-01,1,6,1,6,7
TOLEDO,consulta externa,repetidas en menores de 5 anos,2005-06-01,7,2,7,2,9
TOMAVE,consulta externa,repetidas en menores de 5 anos,2005-06-01,5,4,5,4,9
TOMINA,consulta externa,repetidas en menores de 5 anos,2005-06-01,10,9,10,9,19
TORO TORO,consulta externa,repetidas en menores de 5 anos,2005-06-01,5,0,5,0,5
TOTORA(CBBA),consulta externa,repetidas en menores de 5 anos,2005-06-01,12,16,12,16,28
TOTORA(ORR),consulta externa,repetidas en menores de 5 anos,2005-06-01,4,9,4,9,13
TRIGAL,consulta externa,repetidas en menores de 5 anos,2005-06-01,18,15,18,15,33
TRINIDAD,consulta externa,repetidas en menores de 5 anos,2005-06-01,415,430,415,430,845
TUPIZA,consulta externa,repetidas en menores de 5 anos,2005-06-01,95,88,95,88,183
TURCO,consulta externa,repetidas en menores de 5 anos,2005-06-01,3,6,3,6,9
UMALA,consulta externa,repetidas en menores de 5 anos,2005-06-01,1,1,1,1,2
UNCIA,consulta externa,repetidas en menores de 5 anos,2005-06-01,13,7,13,7,20
URIONDO (A. CONCEPCION),consulta externa,repetidas en menores de 5 anos,2005-06-01,41,55,41,55,96
URUBICHA,consulta externa,repetidas en menores de 5 anos,2005-06-01,6,10,6,10,16
UYUNI,consulta externa,repetidas en menores de 5 anos,2005-06-01,36,39,36,39,75
VACAS,consulta externa,repetidas en menores de 5 anos,2005-06-01,39,30,39,30,69
VALLEGRANDE,consulta externa,repetidas en menores de 5 anos,2005-06-01,12,16,12,16,28
VIACHA,consulta externa,repetidas en menores de 5 anos,2005-06-01,56,55,56,55,111
VILA VILA,consulta externa,repetidas en menores de 5 anos,2005-06-01,1,0,1,0,1
VILLA MONTES,consulta externa,repetidas en menores de 5 anos,2005-06-01,56,52,56,52,108
VILLA NUEVA (LOMA ALTA),consulta externa,repetidas en menores de 5 anos,2005-06-01,0,1,0,1,1
VILLA RIVERO,consulta externa,repetidas en menores de 5 anos,2005-06-01,10,3,10,3,13
VILLA SERRANO,consulta externa,repetidas en menores de 5 anos,2005-06-01,5,1,5,1,6
VILLA TUNARI,consulta externa,repetidas en menores de 5 anos,2005-06-01,89,64,89,64,153
VILLA VACA GUZMAN (MUYUPAMPA),consulta externa,repetidas en menores de 5 anos,2005-06-01,36,36,36,36,72
VILLAZON,consulta externa,repetidas en menores de 5 anos,2005-06-01,49,34,49,34,83
VINTO,consulta externa,repetidas en menores de 5 anos,2005-06-01,29,27,29,27,56
VITICHI,consulta externa,repetidas en menores de 5 anos,2005-06-01,14,9,14,9,23
WARNES,consulta externa,repetidas en menores de 5 anos,2005-06-01,102,54,102,54,156
YACO,consulta externa,repetidas en menores de 5 anos,2005-06-01,3,3,3,3,6
YACUIBA,consulta externa,repetidas en menores de 5 anos,2005-06-01,185,172,185,172,357
YAMPARAEZ,consulta externa,repetidas en menores de 5 anos,2005-06-01,16,15,16,15,31
YANACACHI,consulta externa,repetidas en menores de 5 anos,2005-06-01,14,12,14,12,26
YAPACANI,consulta externa,repetidas en menores de 5 anos,2005-06-01,42,34,42,34,76
YOCALLA,consulta externa,repetidas en menores de 5 anos,2005-06-01,1,6,1,6,7
YOTALA,consulta externa,repetidas en menores de 5 anos,2005-06-01,68,86,68,86,154
YUNCHARA,consulta externa,repetidas en menores de 5 anos,2005-06-01,1,0,1,0,1
ZUDAÑEZ,consulta externa,repetidas en menores de 5 anos,2005-06-01,6,6,6,6,12
ACACIO,consulta externa,repetidas en menores de 5 anos,2005-07-01,1,0,1,0,1
ACHACACHI,consulta externa,repetidas en menores de 5 anos,2005-07-01,9,5,9,5,14
ACHOCALLA,consulta externa,repetidas en menores de 5 anos,2005-07-01,9,7,9,7,16
AIQUILE,consulta externa,repetidas en menores de 5 anos,2005-07-01,139,151,139,151,290
ALALAY,consulta externa,repetidas en menores de 5 anos,2005-07-01,1,2,1,2,3
ALCALA,consulta externa,repetidas en menores de 5 anos,2005-07-01,0,1,0,1,1
ANCORAIMES,consulta externa,repetidas en menores de 5 anos,2005-07-01,8,5,8,5,13
ANDAMARCA,consulta externa,repetidas en menores de 5 anos,2005-07-01,0,6,0,6,6
ANTEQUERA,consulta externa,repetidas en menores de 5 anos,2005-07-01,0,6,0,6,6
ANZALDO,consulta externa,repetidas en menores de 5 anos,2005-07-01,13,8,13,8,21
APOLO,consulta externa,repetidas en menores de 5 anos,2005-07-01,51,28,51,28,79
ARAMPAMPA,consulta externa,repetidas en menores de 5 anos,2005-07-01,3,0,3,0,3
ARANI,consulta externa,repetidas en menores de 5 anos,2005-07-01,53,42,53,42,95
ARBIETO,consulta externa,repetidas en menores de 5 anos,2005-07-01,8,6,8,6,14
ARQUE,consulta externa,repetidas en menores de 5 anos,2005-07-01,2,1,2,1,3
ASCENCION DE GUARAYOS,consulta externa,repetidas en menores de 5 anos,2005-07-01,24,24,24,24,48
ATOCHA,consulta externa,repetidas en menores de 5 anos,2005-07-01,58,43,58,43,101
AUCAPATA,consulta externa,repetidas en menores de 5 anos,2005-07-01,3,4,3,4,7
AYATA,consulta externa,repetidas en menores de 5 anos,2005-07-01,16,9,16,9,25
AYO AYO,consulta externa,repetidas en menores de 5 anos,2005-07-01,4,9,4,9,13
AYOPAYA (V. DE INDEPENDENCIA),consulta externa,repetidas en menores de 5 anos,2005-07-01,18,30,18,30,48
BATALLAS,consulta externa,repetidas en menores de 5 anos,2005-07-01,0,4,0,4,4
BAURES,consulta externa,repetidas en menores de 5 anos,2005-07-01,7,7,7,7,14
BELEN DE ANDAMARCA,consulta externa,repetidas en menores de 5 anos,2005-07-01,1,0,1,0,1
BELEN DE URMIRI,consulta externa,repetidas en menores de 5 anos,2005-07-01,8,0,8,0,8
BERMEJO,consulta externa,repetidas en menores de 5 anos,2005-07-01,62,58,62,58,120
BETANZOS,consulta externa,repetidas en menores de 5 anos,2005-07-01,43,30,43,30,73
BOLIVAR,consulta externa,repetidas en menores de 5 anos,2005-07-01,15,14,15,14,29
BOLPEBRA,consulta externa,repetidas en menores de 5 anos,2005-07-01,6,1,6,1,7
BOYUIBE,consulta externa,repetidas en menores de 5 anos,2005-07-01,14,17,14,17,31
BUENA VISTA,consulta externa,repetidas en menores de 5 anos,2005-07-01,105,94,105,94,199
CABEZAS,consulta externa,repetidas en menores de 5 anos,2005-07-01,7,8,7,8,15
CAIROMA,consulta externa,repetidas en menores de 5 anos,2005-07-01,1,0,1,0,1
"CAIZA ""D""",consulta externa,repetidas en menores de 5 anos,2005-07-01,2,6,2,6,8
CAJUATA,consulta externa,repetidas en menores de 5 anos,2005-07-01,4,1,4,1,5
CALACOTO,consulta externa,repetidas en menores de 5 anos,2005-07-01,0,1,0,1,1
CALAMARCA,consulta externa,repetidas en menores de 5 anos,2005-07-01,16,20,16,20,36
CAMARGO,consulta externa,repetidas en menores de 5 anos,2005-07-01,7,8,7,8,15
CAMATAQUI (C. VILLA ABECIA),consulta externa,repetidas en menores de 5 anos,2005-07-01,6,7,6,7,13
CAMIRI,consulta externa,repetidas en menores de 5 anos,2005-07-01,81,95,81,95,176
CAPINOTA,consulta externa,repetidas en menores de 5 anos,2005-07-01,46,43,46,43,89
CAQUIAVIRI,consulta externa,repetidas en menores de 5 anos,2005-07-01,3,1,3,1,4
CARACOLLO,consulta externa,repetidas en menores de 5 anos,2005-07-01,14,3,14,3,17
CARANAVI,consulta externa,repetidas en menores de 5 anos,2005-07-01,18,15,18,15,33
CARAPARI,consulta externa,repetidas en menores de 5 anos,2005-07-01,8,2,8,2,10
CARMEN RIVERO TORREZ,consulta externa,repetidas en menores de 5 anos,2005-07-01,0,2,0,2,2
CHACARILLA,consulta externa,repetidas en menores de 5 anos,2005-07-01,7,8,7,8,15
CHALLAPATA,consulta externa,repetidas en menores de 5 anos,2005-07-01,7,8,7,8,15
CHAQUI,consulta externa,repetidas en menores de 5 anos,2005-07-01,1,1,1,1,2
CHARAGUA,consulta externa,repetidas en menores de 5 anos,2005-07-01,73,50,73,50,123
CHARAÑA,consulta externa,repetidas en menores de 5 anos,2005-07-01,7,10,7,10,17
CHAYANTA,consulta externa,repetidas en menores de 5 anos,2005-07-01,9,1,9,1,10
CHIMORE,consulta externa,repetidas en menores de 5 anos,2005-07-01,35,31,35,31,66
CHIPAYA,consulta externa,repetidas en menores de 5 anos,2005-07-01,3,1,3,1,4
CHOQUE COTA,consulta externa,repetidas en menores de 5 anos,2005-07-01,16,18,16,18,34
CHULUMANI (V. DE LA LIBERTAD),consulta externa,repetidas en menores de 5 anos,2005-07-01,14,8,14,8,22
CHUMA,consulta externa,repetidas en menores de 5 anos,2005-07-01,0,7,0,7,7
CLIZA,consulta externa,repetidas en menores de 5 anos,2005-07-01,9,9,9,9,18
COBIJA,consulta externa,repetidas en menores de 5 anos,2005-07-01,90,95,90,95,185
COCHABAMBA,consulta externa,repetidas en menores de 5 anos,2005-07-01,2533,2334,2533,2334,4867
COLCAPIRHUA,consulta externa,repetidas en menores de 5 anos,2005-07-01,125,138,125,138,263
"COLCHA ""K""",consulta externa,repetidas en menores de 5 anos,2005-07-01,3,4,3,4,7
COLOMI,consulta externa,repetidas en menores de 5 anos,2005-07-01,16,11,16,11,27
COLPA BELGICA,consulta externa,repetidas en menores de 5 anos,2005-07-01,54,29,54,29,83
COLQUECHACA,consulta externa,repetidas en menores de 5 anos,2005-07-01,28,24,28,24,52
COLQUENCHA,consulta externa,repetidas en menores de 5 anos,2005-07-01,4,6,4,6,10
COLQUIRI,consulta externa,repetidas en menores de 5 anos,2005-07-01,15,22,15,22,37
COMARAPA,consulta externa,repetidas en menores de 5 anos,2005-07-01,71,56,71,56,127
CONCEPCION,consulta externa,repetidas en menores de 5 anos,2005-07-01,5,1,5,1,6
COPACABANA,consulta externa,repetidas en menores de 5 anos,2005-07-01,3,0,3,0,3
CORIPATA,consulta externa,repetidas en menores de 5 anos,2005-07-01,6,3,6,3,9
CORO CORO,consulta externa,repetidas en menores de 5 anos,2005-07-01,1,0,1,0,1
COROICO,consulta externa,repetidas en menores de 5 anos,2005-07-01,20,21,20,21,41
CORQUE,consulta externa,repetidas en menores de 5 anos,2005-07-01,34,18,34,18,52
COTAGAITA,consulta externa,repetidas en menores de 5 anos,2005-07-01,34,27,34,27,61
COTOCA,consulta externa,repetidas en menores de 5 anos,2005-07-01,10,7,10,7,17
CUATRO CAÑADAS,consulta externa,repetidas en menores de 5 anos,2005-07-01,30,27,30,27,57
CUCHUMUELA (V. G. VILLARROEL),consulta externa,repetidas en menores de 5 anos,2005-07-01,1,2,1,2,3
CUEVO,consulta externa,repetidas en menores de 5 anos,2005-07-01,9,11,9,11,20
CULPINA,consulta externa,repetidas en menores de 5 anos,2005-07-01,44,29,44,29,73
CURAHUARA DE CARANGAS,consulta externa,repetidas en menores de 5 anos,2005-07-01,4,1,4,1,5
CURVA,consulta externa,repetidas en menores de 5 anos,2005-07-01,1,0,1,0,1
DESAGUADERO,consulta externa,repetidas en menores de 5 anos,2005-07-01,3,1,3,1,4
EL ALTO,consulta externa,repetidas en menores de 5 anos,2005-07-01,2268,2296,2268,2296,4564
EL CHORO,consulta externa,repetidas en menores de 5 anos,2005-07-01,3,1,3,1,4
EL PUENTE(STC),consulta externa,repetidas en menores de 5 anos,2005-07-01,32,23,32,23,55
EL PUENTE(TJA),consulta externa,repetidas en menores de 5 anos,2005-07-01,27,30,27,30,57
EL TORNO,consulta externa,repetidas en menores de 5 anos,2005-07-01,157,148,157,148,305
EL VILLAR,consulta externa,repetidas en menores de 5 anos,2005-07-01,3,6,3,6,9
ENTRE RIOS,consulta externa,repetidas en menores de 5 anos,2005-07-01,12,6,12,6,18
ENTRE RIOS,consulta externa,repetidas en menores de 5 anos,2005-07-01,52,44,52,44,96
EUCALIPTUS,consulta externa,repetidas en menores de 5 anos,2005-07-01,12,9,12,9,21
EUREKA (SANTOS MERCADO),consulta externa,repetidas en menores de 5 anos,2005-07-01,0,1,0,1,1
EXALTACION,consulta externa,repetidas en menores de 5 anos,2005-07-01,4,12,4,12,16
FERNANDEZ ALONSO,consulta externa,repetidas en menores de 5 anos,2005-07-01,24,26,24,26,50
FILADELFIA,consulta externa,repetidas en menores de 5 anos,2005-07-01,3,2,3,2,5
GENERAL SAAVEDRA,consulta externa,repetidas en menores de 5 anos,2005-07-01,35,32,35,32,67
GRAL. J.J. PEREZ (CHARAZANI),consulta externa,repetidas en menores de 5 anos,2005-07-01,14,9,14,9,23
GUAQUI,consulta externa,repetidas en menores de 5 anos,2005-07-01,1,1,1,1,2
GUAYARAMERIN,consulta externa,repetidas en menores de 5 anos,2005-07-01,107,96,107,96,203
GUTIERREZ,consulta externa,repetidas en menores de 5 anos,2005-07-01,65,60,65,60,125
HUACARETA,consulta externa,repetidas en menores de 5 anos,2005-07-01,40,29,40,29,69
HUACAYA (VILLA DE HUACAYA),consulta externa,repetidas en menores de 5 anos,2005-07-01,1,1,1,1,2
HUACHACALLA,consulta externa,repetidas en menores de 5 anos,2005-07-01,2,0,2,0,2
HUANUNI,consulta externa,repetidas en menores de 5 anos,2005-07-01,98,102,98,102,200
HUARACAJE,consulta externa,repetidas en menores de 5 anos,2005-07-01,6,6,6,6,12
HUAYLLAMARCA,consulta externa,repetidas en menores de 5 anos,2005-07-01,9,18,9,18,27
ICHOCA,consulta externa,repetidas en menores de 5 anos,2005-07-01,1,0,1,0,1
ICLA,consulta externa,repetidas en menores de 5 anos,2005-07-01,16,17,16,17,33
INCAHUASI,consulta externa,repetidas en menores de 5 anos,2005-07-01,13,10,13,10,23
INGAVI (HUMAITA),consulta externa,repetidas en menores de 5 anos,2005-07-01,8,1,8,1,9
INQUISIVI,consulta externa,repetidas en menores de 5 anos,2005-07-01,2,2,2,2,4
IRUPANA (VILLA DE LANZA),consulta externa,repetidas en menores de 5 anos,2005-07-01,20,14,20,14,34
IXIAMAS,consulta externa,repetidas en menores de 5 anos,2005-07-01,27,19,27,19,46
JESUS DE MACHACA,consulta externa,repetidas en menores de 5 anos,2005-07-01,4,1,4,1,5
LA ASUNTA,consulta externa,repetidas en menores de 5 anos,2005-07-01,3,5,3,5,8
LA GUARDIA,consulta externa,repetidas en menores de 5 anos,2005-07-01,182,141,182,141,323
LA PAZ,consulta externa,repetidas en menores de 5 anos,2005-07-01,3902,3954,3902,3954,7856
LAGUNILLAS,consulta externa,repetidas en menores de 5 anos,2005-07-01,27,13,27,13,40
LAJA,consulta externa,repetidas en menores de 5 anos,2005-07-01,8,10,8,10,18
LAS CARRERAS,consulta externa,repetidas en menores de 5 anos,2005-07-01,11,7,11,7,18
LICOMA PAMPA,consulta externa,repetidas en menores de 5 anos,2005-07-01,0,1,0,1,1
LLALLAGUA,consulta externa,repetidas en menores de 5 anos,2005-07-01,49,59,49,59,108
LLICA,consulta externa,repetidas en menores de 5 anos,2005-07-01,1,1,1,1,2
LORETO,consulta externa,repetidas en menores de 5 anos,2005-07-01,10,11,10,11,21
LURIBAY,consulta externa,repetidas en menores de 5 anos,2005-07-01,6,1,6,1,7
MACHACAMARCA,consulta externa,repetidas en menores de 5 anos,2005-07-01,2,7,2,7,9
MACHARETI,consulta externa,repetidas en menores de 5 anos,2005-07-01,10,7,10,7,17
MAGDALENA,consulta externa,repetidas en menores de 5 anos,2005-07-01,8,5,8,5,13
MAIRANA,consulta externa,repetidas en menores de 5 anos,2005-07-01,9,10,9,10,19
MALLA,consulta externa,repetidas en menores de 5 anos,2005-07-01,2,2,2,2,4
MAPIRI,consulta externa,repetidas en menores de 5 anos,2005-07-01,7,10,7,10,17
MECAPACA,consulta externa,repetidas en menores de 5 anos,2005-07-01,13,19,13,19,32
MINEROS,consulta externa,repetidas en menores de 5 anos,2005-07-01,38,30,38,30,68
MIZQUE,consulta externa,repetidas en menores de 5 anos,2005-07-01,48,36,48,36,84
MOCOMOCO,consulta externa,repetidas en menores de 5 anos,2005-07-01,2,3,2,3,5
MOJINETE,consulta externa,repetidas en menores de 5 anos,2005-07-01,11,3,11,3,14
MOJOCOYA,consulta externa,repetidas en menores de 5 anos,2005-07-01,13,12,13,12,25
MONTEAGUDO,consulta externa,repetidas en menores de 5 anos,2005-07-01,68,65,68,65,133
MONTERO,consulta externa,repetidas en menores de 5 anos,2005-07-01,605,620,605,620,1225
MOROCHATA,consulta externa,repetidas en menores de 5 anos,2005-07-01,32,17,32,17,49
OCURI,consulta externa,repetidas en menores de 5 anos,2005-07-01,2,0,2,0,2
OKINAWA,consulta externa,repetidas en menores de 5 anos,2005-07-01,12,18,12,18,30
OMEREQUE,consulta externa,repetidas en menores de 5 anos,2005-07-01,26,30,26,30,56
ORURO,consulta externa,repetidas en menores de 5 anos,2005-07-01,532,471,532,471,1003
PADCAYA,consulta externa,repetidas en menores de 5 anos,2005-07-01,25,13,25,13,38
PADILLA,consulta externa,repetidas en menores de 5 anos,2005-07-01,9,8,9,8,17
PAILON,consulta externa,repetidas en menores de 5 anos,2005-07-01,14,20,14,20,34
PALCA,consulta externa,repetidas en menores de 5 anos,2005-07-01,3,2,3,2,5
PALOS BLANCOS,consulta externa,repetidas en menores de 5 anos,2005-07-01,12,12,12,12,24
PAMPA AULLAGAS,consulta externa,repetidas en menores de 5 anos,2005-07-01,2,0,2,0,2
PAMPA GRANDE,consulta externa,repetidas en menores de 5 anos,2005-07-01,17,10,17,10,27
PAPEL PAMPA,consulta externa,repetidas en menores de 5 anos,2005-07-01,11,3,11,3,14
PATACAMAYA,consulta externa,repetidas en menores de 5 anos,2005-07-01,2,6,2,6,8
PAZÑA,consulta externa,repetidas en menores de 5 anos,2005-07-01,6,3,6,3,9
PELECHUCO,consulta externa,repetidas en menores de 5 anos,2005-07-01,3,1,3,1,4
POCOATA,consulta externa,repetidas en menores de 5 anos,2005-07-01,8,1,8,1,9
POCONA,consulta externa,repetidas en menores de 5 anos,2005-07-01,27,22,27,22,49
POJO (CBBA),consulta externa,repetidas en menores de 5 anos,2005-07-01,28,21,28,21,49
POOPO,consulta externa,repetidas en menores de 5 anos,2005-07-01,2,4,2,4,6
PORCO,consulta externa,repetidas en menores de 5 anos,2005-07-01,9,16,9,16,25
POROMA,consulta externa,repetidas en menores de 5 anos,2005-07-01,7,3,7,3,10
PORONGO,consulta externa,repetidas en menores de 5 anos,2005-07-01,29,25,29,25,54
PORTACHUELO,consulta externa,repetidas en menores de 5 anos,2005-07-01,104,70,104,70,174
PORVENIR,consulta externa,repetidas en menores de 5 anos,2005-07-01,6,7,6,7,13
POSTRER VALLE,consulta externa,repetidas en menores de 5 anos,2005-07-01,3,3,3,3,6
POTOSI,consulta externa,repetidas en menores de 5 anos,2005-07-01,427,436,427,436,863
PRESTO,consulta externa,repetidas en menores de 5 anos,2005-07-01,32,27,32,27,59
PUCARA,consulta externa,repetidas en menores de 5 anos,2005-07-01,5,0,5,0,5
PUCARANI,consulta externa,repetidas en menores de 5 anos,2005-07-01,7,7,7,7,14
PUERTO ACOSTA,consulta externa,repetidas en menores de 5 anos,2005-07-01,42,40,42,40,82
PUERTO CARABUCO,consulta externa,repetidas en menores de 5 anos,2005-07-01,1,0,1,0,1
PUERTO GONZALO MORENO,consulta externa,repetidas en menores de 5 anos,2005-07-01,9,9,9,9,18
PUERTO PEREZ,consulta externa,repetidas en menores de 5 anos,2005-07-01,3,1,3,1,4
PUERTO QUIJARRO,consulta externa,repetidas en menores de 5 anos,2005-07-01,23,25,23,25,48
PUERTO RICO,consulta externa,repetidas en menores de 5 anos,2005-07-01,4,1,4,1,5
PUERTO SUAREZ,consulta externa,repetidas en menores de 5 anos,2005-07-01,7,12,7,12,19
PUERTO VILLARROEL,consulta externa,repetidas en menores de 5 anos,2005-07-01,79,75,79,75,154
PUNA,consulta externa,repetidas en menores de 5 anos,2005-07-01,30,18,30,18,48
PUNATA,consulta externa,repetidas en menores de 5 anos,2005-07-01,76,58,76,58,134
QUILLACOLLO,consulta externa,repetidas en menores de 5 anos,2005-07-01,135,137,135,137,272
QUIME,consulta externa,repetidas en menores de 5 anos,2005-07-01,8,2,8,2,10
QUIRUSILLAS,consulta externa,repetidas en menores de 5 anos,2005-07-01,5,1,5,1,6
RAVELO,consulta externa,repetidas en menores de 5 anos,2005-07-01,2,1,2,1,3
REYES,consulta externa,repetidas en menores de 5 anos,2005-07-01,9,15,9,15,24
RIBERALTA,consulta externa,repetidas en menores de 5 anos,2005-07-01,352,342,352,342,694
ROBORE,consulta externa,repetidas en menores de 5 anos,2005-07-01,9,24,9,24,33
RURRENABAQUE,consulta externa,repetidas en menores de 5 anos,2005-07-01,122,100,122,100,222
SABAYA,consulta externa,repetidas en menores de 5 anos,2005-07-01,1,1,1,1,2
SACABA,consulta externa,repetidas en menores de 5 anos,2005-07-01,145,139,145,139,284
SACABAMBA,consulta externa,repetidas en menores de 5 anos,2005-07-01,30,35,30,35,65
SACACA,consulta externa,repetidas en menores de 5 anos,2005-07-01,0,1,0,1,1
SAIPINA,consulta externa,repetidas en menores de 5 anos,2005-07-01,19,17,19,17,36
SALINAS DE GARCI MENDOZA,consulta externa,repetidas en menores de 5 anos,2005-07-01,5,3,5,3,8
SAMAIPATA,consulta externa,repetidas en menores de 5 anos,2005-07-01,9,2,9,2,11
SAN ANDRES,consulta externa,repetidas en menores de 5 anos,2005-07-01,28,31,28,31,59
SAN ANDRES DE MACHACA,consulta externa,repetidas en menores de 5 anos,2005-07-01,3,0,3,0,3
SAN ANTONIO DE ESMORUCO,consulta externa,repetidas en menores de 5 anos,2005-07-01,6,5,6,5,11
SAN ANTONIO DE LOMERIO,consulta externa,repetidas en menores de 5 anos,2005-07-01,5,0,5,0,5
SAN BENITO,consulta externa,repetidas en menores de 5 anos,2005-07-01,17,23,17,23,40
SAN BORJA,consulta externa,repetidas en menores de 5 anos,2005-07-01,149,107,149,107,256
SAN BUENA VENTURA,consulta externa,repetidas en menores de 5 anos,2005-07-01,28,32,28,32,60
SAN CARLOS,consulta externa,repetidas en menores de 5 anos,2005-07-01,24,32,24,32,56
SAN IGNACIO,consulta externa,repetidas en menores de 5 anos,2005-07-01,130,89,130,89,219
SAN IGNACIO DE VELASCO,consulta externa,repetidas en menores de 5 anos,2005-07-01,29,20,29,20,49
SAN JAVIER(BNI),consulta externa,repetidas en menores de 5 anos,2005-07-01,7,6,7,6,13
SAN JAVIER(STC),consulta externa,repetidas en menores de 5 anos,2005-07-01,29,27,29,27,56
SAN JOAQUIN,consulta externa,repetidas en menores de 5 anos,2005-07-01,3,3,3,3,6
SAN JOSE DE CHIQUITOS,consulta externa,repetidas en menores de 5 anos,2005-07-01,4,10,4,10,14
SAN JUAN DE YAPACANI,consulta externa,repetidas en menores de 5 anos,2005-07-01,13,13,13,13,26
SAN JULIAN,consulta externa,repetidas en menores de 5 anos,2005-07-01,64,52,64,52,116
SAN LORENZO(PND),consulta externa,repetidas en menores de 5 anos,2005-07-01,15,14,15,14,29
SAN LORENZO(TJA),consulta externa,repetidas en menores de 5 anos,2005-07-01,90,64,90,64,154
SAN LUCAS,consulta externa,repetidas en menores de 5 anos,2005-07-01,26,24,26,24,50
SAN MATIAS,consulta externa,repetidas en menores de 5 anos,2005-07-01,9,8,9,8,17
SAN MIGUEL DE VELASCO,consulta externa,repetidas en menores de 5 anos,2005-07-01,38,42,38,42,80
SAN PABLO DE LIPEZ,consulta externa,repetidas en menores de 5 anos,2005-07-01,12,20,12,20,32
SAN PEDRO,consulta externa,repetidas en menores de 5 anos,2005-07-01,64,72,64,72,136
SAN PEDRO DE BUENA VISTA,consulta externa,repetidas en menores de 5 anos,2005-07-01,1,2,1,2,3
SAN PEDRO DE CURAHUARA,consulta externa,repetidas en menores de 5 anos,2005-07-01,1,1,1,1,2
SAN PEDRO DE TIQUINA,consulta externa,repetidas en menores de 5 anos,2005-07-01,0,2,0,2,2
SAN PEDRO(PND),consulta externa,repetidas en menores de 5 anos,2005-07-01,1,0,1,0,1
SAN RAFAEL,consulta externa,repetidas en menores de 5 anos,2005-07-01,6,9,6,9,15
SAN RAMON,consulta externa,repetidas en menores de 5 anos,2005-07-01,8,9,8,9,17
SAN RAMON,consulta externa,repetidas en menores de 5 anos,2005-07-01,4,2,4,2,6
SANTA ANA,consulta externa,repetidas en menores de 5 anos,2005-07-01,29,17,29,17,46
SANTA CRUZ DE LA SIERRA,consulta externa,repetidas en menores de 5 anos,2005-07-01,4134,4280,4134,4280,8414
SANTA ROSA,consulta externa,repetidas en menores de 5 anos,2005-07-01,73,63,73,63,136
SANTA ROSA DEL SARA,consulta externa,repetidas en menores de 5 anos,2005-07-01,23,63,23,63,86
SANTIAGO DE HUARI,consulta externa,repetidas en menores de 5 anos,2005-07-01,9,8,9,8,17
SANTIAGO DE MACHACA,consulta externa,repetidas en menores de 5 anos,2005-07-01,1,0,1,0,1
SANTIVAÑES,consulta externa,repetidas en menores de 5 anos,2005-07-01,10,11,10,11,21
SAPAHAQUI,consulta externa,repetidas en menores de 5 anos,2005-07-01,8,0,8,0,8
SENA,consulta externa,repetidas en menores de 5 anos,2005-07-01,3,2,3,2,5
SICA SICA (VILLA AROMA),consulta externa,repetidas en menores de 5 anos,2005-07-01,50,43,50,43,93
SICAYA,consulta externa,repetidas en menores de 5 anos,2005-07-01,5,8,5,8,13
SIPE SIPE,consulta externa,repetidas en menores de 5 anos,2005-07-01,136,96,136,96,232
SOPACHUY,consulta externa,repetidas en menores de 5 anos,2005-07-01,9,6,9,6,15
SORACACHI,consulta externa,repetidas en menores de 5 anos,2005-07-01,3,5,3,5,8
SORATA,consulta externa,repetidas en menores de 5 anos,2005-07-01,5,5,5,5,10
SUCRE,consulta externa,repetidas en menores de 5 anos,2005-07-01,814,839,814,839,1653
TACACHI,consulta externa,repetidas en menores de 5 anos,2005-07-01,13,12,13,12,25
TACACOMA,consulta externa,repetidas en menores de 5 anos,2005-07-01,3,2,3,2,5
TACOBAMBA,consulta externa,repetidas en menores de 5 anos,2005-07-01,3,0,3,0,3
TACOPAYA,consulta externa,repetidas en menores de 5 anos,2005-07-01,5,7,5,7,12
TAHUA,consulta externa,repetidas en menores de 5 anos,2005-07-01,0,1,0,1,1
TAPACARI,consulta externa,repetidas en menores de 5 anos,2005-07-01,32,33,32,33,65
TARABUCO,consulta externa,repetidas en menores de 5 anos,2005-07-01,208,246,208,246,454
TARACO,consulta externa,repetidas en menores de 5 anos,2005-07-01,3,0,3,0,3
TARATA,consulta externa,repetidas en menores de 5 anos,2005-07-01,14,20,14,20,34
TARIJA,consulta externa,repetidas en menores de 5 anos,2005-07-01,560,561,560,561,1121
TARVITA,consulta externa,repetidas en menores de 5 anos,2005-07-01,15,7,15,7,22
TEOPONTE,consulta externa,repetidas en menores de 5 anos,2005-07-01,9,13,9,13,22
TINGUIPAYA,consulta externa,repetidas en menores de 5 anos,2005-07-01,1,0,1,0,1
TIPUANI,consulta externa,repetidas en menores de 5 anos,2005-07-01,13,17,13,17,30
TIQUIPAYA,consulta externa,repetidas en menores de 5 anos,2005-07-01,155,151,155,151,306
TIRAQUE (CBBA),consulta externa,repetidas en menores de 5 anos,2005-07-01,164,187,164,187,351
TITO YUPANQUI (PARQUIPUJIO),consulta externa,repetidas en menores de 5 anos,2005-07-01,1,0,1,0,1
TOCO,consulta externa,repetidas en menores de 5 anos,2005-07-01,3,1,3,1,4
TODOS SANTOS,consulta externa,repetidas en menores de 5 anos,2005-07-01,1,0,1,0,1
TOLATA,consulta externa,repetidas en menores de 5 anos,2005-07-01,7,5,7,5,12
TOLEDO,consulta externa,repetidas en menores de 5 anos,2005-07-01,5,5,5,5,10
TOMAVE,consulta externa,repetidas en menores de 5 anos,2005-07-01,8,10,8,10,18
TOMINA,consulta externa,repetidas en menores de 5 anos,2005-07-01,9,7,9,7,16
TORO TORO,consulta externa,repetidas en menores de 5 anos,2005-07-01,3,4,3,4,7
TOTORA(CBBA),consulta externa,repetidas en menores de 5 anos,2005-07-01,6,4,6,4,10
TOTORA(ORR),consulta externa,repetidas en menores de 5 anos,2005-07-01,14,18,14,18,32
TRIGAL,consulta externa,repetidas en menores de 5 anos,2005-07-01,7,7,7,7,14
TRINIDAD,consulta externa,repetidas en menores de 5 anos,2005-07-01,380,380,380,380,760
TUPIZA,consulta externa,repetidas en menores de 5 anos,2005-07-01,84,91,84,91,175
TURCO,consulta externa,repetidas en menores de 5 anos,2005-07-01,0,1,0,1,1
UMALA,consulta externa,repetidas en menores de 5 anos,2005-07-01,9,4,9,4,13
UNCIA,consulta externa,repetidas en menores de 5 anos,2005-07-01,25,17,25,17,42
URIONDO (A. CONCEPCION),consulta externa,repetidas en menores de 5 anos,2005-07-01,47,48,47,48,95
URUBICHA,consulta externa,repetidas en menores de 5 anos,2005-07-01,8,8,8,8,16
UYUNI,consulta externa,repetidas en menores de 5 anos,2005-07-01,13,19,13,19,32
VACAS,consulta externa,repetidas en menores de 5 anos,2005-07-01,37,29,37,29,66
VALLEGRANDE,consulta externa,repetidas en menores de 5 anos,2005-07-01,11,9,11,9,20
VIACHA,consulta externa,repetidas en menores de 5 anos,2005-07-01,93,66,93,66,159
VILA VILA,consulta externa,repetidas en menores de 5 anos,2005-07-01,1,0,1,0,1
VILLA MONTES,consulta externa,repetidas en menores de 5 anos,2005-07-01,43,24,43,24,67
VILLA RIVERO,consulta externa,repetidas en menores de 5 anos,2005-07-01,10,4,10,4,14
VILLA SERRANO,consulta externa,repetidas en menores de 5 anos,2005-07-01,4,2,4,2,6
VILLA TUNARI,consulta externa,repetidas en menores de 5 anos,2005-07-01,107,99,107,99,206
VILLA VACA GUZMAN (MUYUPAMPA),consulta externa,repetidas en menores de 5 anos,2005-07-01,21,19,21,19,40
VILLAZON,consulta externa,repetidas en menores de 5 anos,2005-07-01,58,58,58,58,116
VINTO,consulta externa,repetidas en menores de 5 anos,2005-07-01,13,9,13,9,22
VITICHI,consulta externa,repetidas en menores de 5 anos,2005-07-01,6,7,6,7,13
WARNES,consulta externa,repetidas en menores de 5 anos,2005-07-01,93,93,93,93,186
YACO,consulta externa,repetidas en menores de 5 anos,2005-07-01,0,1,0,1,1
YACUIBA,consulta externa,repetidas en menores de 5 anos,2005-07-01,209,182,209,182,391
YAMPARAEZ,consulta externa,repetidas en menores de 5 anos,2005-07-01,22,27,22,27,49
YANACACHI,consulta externa,repetidas en menores de 5 anos,2005-07-01,10,3,10,3,13
YAPACANI,consulta externa,repetidas en menores de 5 anos,2005-07-01,62,67,62,67,129
YOCALLA,consulta externa,repetidas en menores de 5 anos,2005-07-01,6,3,6,3,9
YOTALA,consulta externa,repetidas en menores de 5 anos,2005-07-01,66,76,66,76,142
YUNCHARA,consulta externa,repetidas en menores de 5 anos,2005-07-01,4,8,4,8,12
ZUDAÑEZ,consulta externa,repetidas en menores de 5 anos,2005-07-01,4,7,4,7,11
ACACIO,consulta externa,repetidas en menores de 5 anos,2005-08-01,3,2,3,2,5
ACHACACHI,consulta externa,repetidas en menores de 5 anos,2005-08-01,12,4,12,4,16
ACHOCALLA,consulta externa,repetidas en menores de 5 anos,2005-08-01,4,8,4,8,12
AIQUILE,consulta externa,repetidas en menores de 5 anos,2005-08-01,46,58,46,58,104
ALCALA,consulta externa,repetidas en menores de 5 anos,2005-08-01,1,0,1,0,1
ANCORAIMES,consulta externa,repetidas en menores de 5 anos,2005-08-01,8,6,8,6,14
ANDAMARCA,consulta externa,repetidas en menores de 5 anos,2005-08-01,7,3,7,3,10
ANTEQUERA,consulta externa,repetidas en menores de 5 anos,2005-08-01,9,2,9,2,11
ANZALDO,consulta externa,repetidas en menores de 5 anos,2005-08-01,10,16,10,16,26
APOLO,consulta externa,repetidas en menores de 5 anos,2005-08-01,21,17,21,17,38
ARAMPAMPA,consulta externa,repetidas en menores de 5 anos,2005-08-01,1,0,1,0,1
ARANI,consulta externa,repetidas en menores de 5 anos,2005-08-01,48,28,48,28,76
ARBIETO,consulta externa,repetidas en menores de 5 anos,2005-08-01,14,31,14,31,45
ARQUE,consulta externa,repetidas en menores de 5 anos,2005-08-01,10,6,10,6,16
ASCENCION DE GUARAYOS,consulta externa,repetidas en menores de 5 anos,2005-08-01,87,70,87,70,157
ATOCHA,consulta externa,repetidas en menores de 5 anos,2005-08-01,64,44,64,44,108
AUCAPATA,consulta externa,repetidas en menores de 5 anos,2005-08-01,3,1,3,1,4
AYATA,consulta externa,repetidas en menores de 5 anos,2005-08-01,30,23,30,23,53
AYO AYO,consulta externa,repetidas en menores de 5 anos,2005-08-01,3,7,3,7,10
AYOPAYA (V. DE INDEPENDENCIA),consulta externa,repetidas en menores de 5 anos,2005-08-01,6,13,6,13,19
AZURDUY,consulta externa,repetidas en menores de 5 anos,2005-08-01,4,3,4,3,7
BATALLAS,consulta externa,repetidas en menores de 5 anos,2005-08-01,1,3,1,3,4
BAURES,consulta externa,repetidas en menores de 5 anos,2005-08-01,11,18,11,18,29
BELEN DE ANDAMARCA,consulta externa,repetidas en menores de 5 anos,2005-08-01,4,5,4,5,9
BELEN DE URMIRI,consulta externa,repetidas en menores de 5 anos,2005-08-01,6,0,6,0,6
BELLA FLOR,consulta externa,repetidas en menores de 5 anos,2005-08-01,0,2,0,2,2
BERMEJO,consulta externa,repetidas en menores de 5 anos,2005-08-01,84,79,84,79,163
BETANZOS,consulta externa,repetidas en menores de 5 anos,2005-08-01,38,34,38,34,72
BOLIVAR,consulta externa,repetidas en menores de 5 anos,2005-08-01,9,13,9,13,22
BOLPEBRA,consulta externa,repetidas en menores de 5 anos,2005-08-01,0,1,0,1,1
BOYUIBE,consulta externa,repetidas en menores de 5 anos,2005-08-01,9,11,9,11,20
BUENA VISTA,consulta externa,repetidas en menores de 5 anos,2005-08-01,91,104,91,104,195
CABEZAS,consulta externa,repetidas en menores de 5 anos,2005-08-01,17,11,17,11,28
CAIROMA,consulta externa,repetidas en menores de 5 anos,2005-08-01,1,4,1,4,5
"CAIZA ""D""",consulta externa,repetidas en menores de 5 anos,2005-08-01,5,4,5,4,9
CAJUATA,consulta externa,repetidas en menores de 5 anos,2005-08-01,3,3,3,3,6
CALAMARCA,consulta externa,repetidas en menores de 5 anos,2005-08-01,14,9,14,9,23
CAMARGO,consulta externa,repetidas en menores de 5 anos,2005-08-01,23,18,23,18,41
CAMATAQUI (C. VILLA ABECIA),consulta externa,repetidas en menores de 5 anos,2005-08-01,8,8,8,8,16
CAMIRI,consulta externa,repetidas en menores de 5 anos,2005-08-01,104,204,104,204,308
CAPINOTA,consulta externa,repetidas en menores de 5 anos,2005-08-01,40,37,40,37,77
CAQUIAVIRI,consulta externa,repetidas en menores de 5 anos,2005-08-01,3,0,3,0,3
CARACOLLO,consulta externa,repetidas en menores de 5 anos,2005-08-01,4,8,4,8,12
CARANAVI,consulta externa,repetidas en menores de 5 anos,2005-08-01,20,30,20,30,50
CARAPARI,consulta externa,repetidas en menores de 5 anos,2005-08-01,0,1,0,1,1
CARIPUYO,consulta externa,repetidas en menores de 5 anos,2005-08-01,29,40,29,40,69
CARMEN RIVERO TORREZ,consulta externa,repetidas en menores de 5 anos,2005-08-01,1,0,1,0,1
CHALLAPATA,consulta externa,repetidas en menores de 5 anos,2005-08-01,29,18,29,18,47
CHAQUI,consulta externa,repetidas en menores de 5 anos,2005-08-01,0,4,0,4,4
CHARAGUA,consulta externa,repetidas en menores de 5 anos,2005-08-01,72,71,72,71,143
CHARAÑA,consulta externa,repetidas en menores de 5 anos,2005-08-01,0,3,0,3,3
CHAYANTA,consulta externa,repetidas en menores de 5 anos,2005-08-01,11,11,11,11,22
CHIMORE,consulta externa,repetidas en menores de 5 anos,2005-08-01,28,27,28,27,55
CHIPAYA,consulta externa,repetidas en menores de 5 anos,2005-08-01,1,0,1,0,1
CHOQUE COTA,consulta externa,repetidas en menores de 5 anos,2005-08-01,4,2,4,2,6
CHULUMANI (V. DE LA LIBERTAD),consulta externa,repetidas en menores de 5 anos,2005-08-01,14,9,14,9,23
CHUMA,consulta externa,repetidas en menores de 5 anos,2005-08-01,4,2,4,2,6
CLIZA,consulta externa,repetidas en menores de 5 anos,2005-08-01,8,16,8,16,24
COBIJA,consulta externa,repetidas en menores de 5 anos,2005-08-01,243,280,243,280,523
COCHABAMBA,consulta externa,repetidas en menores de 5 anos,2005-08-01,2574,2356,2574,2356,4930
COLCAPIRHUA,consulta externa,repetidas en menores de 5 anos,2005-08-01,150,139,150,139,289
"COLCHA ""K""",consulta externa,repetidas en menores de 5 anos,2005-08-01,9,8,9,8,17
COLOMI,consulta externa,repetidas en menores de 5 anos,2005-08-01,5,8,5,8,13
COLPA BELGICA,consulta externa,repetidas en menores de 5 anos,2005-08-01,32,20,32,20,52
COLQUECHACA,consulta externa,repetidas en menores de 5 anos,2005-08-01,3,7,3,7,10
COLQUENCHA,consulta externa,repetidas en menores de 5 anos,2005-08-01,4,5,4,5,9
COLQUIRI,consulta externa,repetidas en menores de 5 anos,2005-08-01,27,11,27,11,38
COMANCHE,consulta externa,repetidas en menores de 5 anos,2005-08-01,0,2,0,2,2
COMARAPA,consulta externa,repetidas en menores de 5 anos,2005-08-01,79,78,79,78,157
COMBAYA,consulta externa,repetidas en menores de 5 anos,2005-08-01,2,0,2,0,2
CONCEPCION,consulta externa,repetidas en menores de 5 anos,2005-08-01,3,2,3,2,5
COPACABANA,consulta externa,repetidas en menores de 5 anos,2005-08-01,0,2,0,2,2
CORIPATA,consulta externa,repetidas en menores de 5 anos,2005-08-01,11,3,11,3,14
CORO CORO,consulta externa,repetidas en menores de 5 anos,2005-08-01,1,1,1,1,2
COROICO,consulta externa,repetidas en menores de 5 anos,2005-08-01,20,39,20,39,59
CORQUE,consulta externa,repetidas en menores de 5 anos,2005-08-01,18,12,18,12,30
COTAGAITA,consulta externa,repetidas en menores de 5 anos,2005-08-01,20,20,20,20,40
COTOCA,consulta externa,repetidas en menores de 5 anos,2005-08-01,13,6,13,6,19
CUATRO CAÑADAS,consulta externa,repetidas en menores de 5 anos,2005-08-01,19,18,19,18,37
CUCHUMUELA (V. G. VILLARROEL),consulta externa,repetidas en menores de 5 anos,2005-08-01,2,0,2,0,2
CUEVO,consulta externa,repetidas en menores de 5 anos,2005-08-01,5,4,5,4,9
CULPINA,consulta externa,repetidas en menores de 5 anos,2005-08-01,67,47,67,47,114
CURAHUARA DE CARANGAS,consulta externa,repetidas en menores de 5 anos,2005-08-01,1,4,1,4,5
CURVA,consulta externa,repetidas en menores de 5 anos,2005-08-01,5,4,5,4,9
DESAGUADERO,consulta externa,repetidas en menores de 5 anos,2005-08-01,0,2,0,2,2
EL ALTO,consulta externa,repetidas en menores de 5 anos,2005-08-01,2447,2254,2447,2254,4701
EL CHORO,consulta externa,repetidas en menores de 5 anos,2005-08-01,1,0,1,0,1
EL PUENTE(STC),consulta externa,repetidas en menores de 5 anos,2005-08-01,5,6,5,6,11
EL PUENTE(TJA),consulta externa,repetidas en menores de 5 anos,2005-08-01,30,29,30,29,59
EL TORNO,consulta externa,repetidas en menores de 5 anos,2005-08-01,103,120,103,120,223
EL VILLAR,consulta externa,repetidas en menores de 5 anos,2005-08-01,6,4,6,4,10
ENTRE RIOS,consulta externa,repetidas en menores de 5 anos,2005-08-01,4,6,4,6,10
ENTRE RIOS,consulta externa,repetidas en menores de 5 anos,2005-08-01,57,48,57,48,105
EUCALIPTUS,consulta externa,repetidas en menores de 5 anos,2005-08-01,13,1,13,1,14
EXALTACION,consulta externa,repetidas en menores de 5 anos,2005-08-01,9,4,9,4,13
FERNANDEZ ALONSO,consulta externa,repetidas en menores de 5 anos,2005-08-01,9,15,9,15,24
FILADELFIA,consulta externa,repetidas en menores de 5 anos,2005-08-01,2,3,2,3,5
GENERAL SAAVEDRA,consulta externa,repetidas en menores de 5 anos,2005-08-01,17,20,17,20,37
GRAL. J.J. PEREZ (CHARAZANI),consulta externa,repetidas en menores de 5 anos,2005-08-01,5,3,5,3,8
GUANAY,consulta externa,repetidas en menores de 5 anos,2005-08-01,1,0,1,0,1
GUAQUI,consulta externa,repetidas en menores de 5 anos,2005-08-01,1,0,1,0,1
GUAYARAMERIN,consulta externa,repetidas en menores de 5 anos,2005-08-01,105,92,105,92,197
GUTIERREZ,consulta externa,repetidas en menores de 5 anos,2005-08-01,125,117,125,117,242
HUACARETA,consulta externa,repetidas en menores de 5 anos,2005-08-01,17,29,17,29,46
HUACAYA (VILLA DE HUACAYA),consulta externa,repetidas en menores de 5 anos,2005-08-01,1,3,1,3,4
HUANUNI,consulta externa,repetidas en menores de 5 anos,2005-08-01,84,84,84,84,168
HUARACAJE,consulta externa,repetidas en menores de 5 anos,2005-08-01,11,8,11,8,19
HUAYLLAMARCA,consulta externa,repetidas en menores de 5 anos,2005-08-01,3,8,3,8,11
ICHOCA,consulta externa,repetidas en menores de 5 anos,2005-08-01,3,0,3,0,3
ICLA,consulta externa,repetidas en menores de 5 anos,2005-08-01,6,10,6,10,16
INCAHUASI,consulta externa,repetidas en menores de 5 anos,2005-08-01,11,25,11,25,36
INGAVI (HUMAITA),consulta externa,repetidas en menores de 5 anos,2005-08-01,4,2,4,2,6
INQUISIVI,consulta externa,repetidas en menores de 5 anos,2005-08-01,2,2,2,2,4
IRUPANA (VILLA DE LANZA),consulta externa,repetidas en menores de 5 anos,2005-08-01,7,6,7,6,13
IXIAMAS,consulta externa,repetidas en menores de 5 anos,2005-08-01,14,11,14,11,25
JESUS DE MACHACA,consulta externa,repetidas en menores de 5 anos,2005-08-01,2,4,2,4,6
LA ASUNTA,consulta externa,repetidas en menores de 5 anos,2005-08-01,7,3,7,3,10
LA GUARDIA,consulta externa,repetidas en menores de 5 anos,2005-08-01,157,133,157,133,290
LA PAZ,consulta externa,repetidas en menores de 5 anos,2005-08-01,4338,4463,4338,4463,8801
LAGUNILLAS,consulta externa,repetidas en menores de 5 anos,2005-08-01,28,22,28,22,50
LAJA,consulta externa,repetidas en menores de 5 anos,2005-08-01,1,4,1,4,5
LAS CARRERAS,consulta externa,repetidas en menores de 5 anos,2005-08-01,4,61,4,61,65
LICOMA PAMPA,consulta externa,repetidas en menores de 5 anos,2005-08-01,1,1,1,1,2
LLALLAGUA,consulta externa,repetidas en menores de 5 anos,2005-08-01,55,54,55,54,109
LLICA,consulta externa,repetidas en menores de 5 anos,2005-08-01,0,1,0,1,1
LORETO,consulta externa,repetidas en menores de 5 anos,2005-08-01,9,9,9,9,18
LURIBAY,consulta externa,repetidas en menores de 5 anos,2005-08-01,1,0,1,0,1
MACHACAMARCA,consulta externa,repetidas en menores de 5 anos,2005-08-01,1,1,1,1,2
MACHARETI,consulta externa,repetidas en menores de 5 anos,2005-08-01,7,5,7,5,12
MAGDALENA,consulta externa,repetidas en menores de 5 anos,2005-08-01,18,25,18,25,43
MAIRANA,consulta externa,repetidas en menores de 5 anos,2005-08-01,7,5,7,5,12
MALLA,consulta externa,repetidas en menores de 5 anos,2005-08-01,6,4,6,4,10
MAPIRI,consulta externa,repetidas en menores de 5 anos,2005-08-01,6,3,6,3,9
MECAPACA,consulta externa,repetidas en menores de 5 anos,2005-08-01,19,19,19,19,38
MINEROS,consulta externa,repetidas en menores de 5 anos,2005-08-01,10,16,10,16,26
MIZQUE,consulta externa,repetidas en menores de 5 anos,2005-08-01,47,39,47,39,86
MOCOMOCO,consulta externa,repetidas en menores de 5 anos,2005-08-01,1,3,1,3,4
MOJINETE,consulta externa,repetidas en menores de 5 anos,2005-08-01,13,13,13,13,26
MOJOCOYA,consulta externa,repetidas en menores de 5 anos,2005-08-01,16,10,16,10,26
MONTEAGUDO,consulta externa,repetidas en menores de 5 anos,2005-08-01,91,66,91,66,157
MONTERO,consulta externa,repetidas en menores de 5 anos,2005-08-01,519,488,519,488,1007
MORO MORO,consulta externa,repetidas en menores de 5 anos,2005-08-01,0,1,0,1,1
MOROCHATA,consulta externa,repetidas en menores de 5 anos,2005-08-01,120,112,120,112,232
NACEBE (SANTA ROSA DEL ABUNA),consulta externa,repetidas en menores de 5 anos,2005-08-01,2,1,2,1,3
NUEVO MANOA (NUEVA ESPERANZA),consulta externa,repetidas en menores de 5 anos,2005-08-01,1,0,1,0,1
OCURI,consulta externa,repetidas en menores de 5 anos,2005-08-01,5,6,5,6,11
OKINAWA,consulta externa,repetidas en menores de 5 anos,2005-08-01,13,14,13,14,27
OMEREQUE,consulta externa,repetidas en menores de 5 anos,2005-08-01,40,21,40,21,61
ORURO,consulta externa,repetidas en menores de 5 anos,2005-08-01,493,437,493,437,930
PADCAYA,consulta externa,repetidas en menores de 5 anos,2005-08-01,21,25,21,25,46
PADILLA,consulta externa,repetidas en menores de 5 anos,2005-08-01,6,7,6,7,13
PAILON,consulta externa,repetidas en menores de 5 anos,2005-08-01,25,8,25,8,33
PALCA,consulta externa,repetidas en menores de 5 anos,2005-08-01,6,4,6,4,10
PALOS BLANCOS,consulta externa,repetidas en menores de 5 anos,2005-08-01,19,15,19,15,34
PAMPA AULLAGAS,consulta externa,repetidas en menores de 5 anos,2005-08-01,0,1,0,1,1
PAMPA GRANDE,consulta externa,repetidas en menores de 5 anos,2005-08-01,28,14,28,14,42
PAPEL PAMPA,consulta externa,repetidas en menores de 5 anos,2005-08-01,0,3,0,3,3
PASORAPA,consulta externa,repetidas en menores de 5 anos,2005-08-01,27,21,27,21,48
PATACAMAYA,consulta externa,repetidas en menores de 5 anos,2005-08-01,4,4,4,4,8
PAZÑA,consulta externa,repetidas en menores de 5 anos,2005-08-01,1,1,1,1,2
PELECHUCO,consulta externa,repetidas en menores de 5 anos,2005-08-01,1,3,1,3,4
POCOATA,consulta externa,repetidas en menores de 5 anos,2005-08-01,2,1,2,1,3
POCONA,consulta externa,repetidas en menores de 5 anos,2005-08-01,11,16,11,16,27
POJO (CBBA),consulta externa,repetidas en menores de 5 anos,2005-08-01,12,8,12,8,20
POOPO,consulta externa,repetidas en menores de 5 anos,2005-08-01,1,2,1,2,3
PORCO,consulta externa,repetidas en menores de 5 anos,2005-08-01,8,8,8,8,16
POROMA,consulta externa,repetidas en menores de 5 anos,2005-08-01,11,5,11,5,16
PORONGO,consulta externa,repetidas en menores de 5 anos,2005-08-01,11,9,11,9,20
PORTACHUELO,consulta externa,repetidas en menores de 5 anos,2005-08-01,50,58,50,58,108
PORVENIR,consulta externa,repetidas en menores de 5 anos,2005-08-01,2,2,2,2,4
POSTRER VALLE,consulta externa,repetidas en menores de 5 anos,2005-08-01,4,2,4,2,6
POTOSI,consulta externa,repetidas en menores de 5 anos,2005-08-01,377,341,377,341,718
PRESTO,consulta externa,repetidas en menores de 5 anos,2005-08-01,6,7,6,7,13
PUCARA,consulta externa,repetidas en menores de 5 anos,2005-08-01,2,0,2,0,2
PUCARANI,consulta externa,repetidas en menores de 5 anos,2005-08-01,10,1,10,1,11
PUERTO ACOSTA,consulta externa,repetidas en menores de 5 anos,2005-08-01,25,34,25,34,59
PUERTO CARABUCO,consulta externa,repetidas en menores de 5 anos,2005-08-01,5,2,5,2,7
PUERTO GONZALO MORENO,consulta externa,repetidas en menores de 5 anos,2005-08-01,4,13,4,13,17
PUERTO PEREZ,consulta externa,repetidas en menores de 5 anos,2005-08-01,3,2,3,2,5
PUERTO QUIJARRO,consulta externa,repetidas en menores de 5 anos,2005-08-01,14,12,14,12,26
PUERTO RICO,consulta externa,repetidas en menores de 5 anos,2005-08-01,15,10,15,10,25
PUERTO SUAREZ,consulta externa,repetidas en menores de 5 anos,2005-08-01,18,15,18,15,33
PUERTO VILLARROEL,consulta externa,repetidas en menores de 5 anos,2005-08-01,69,46,69,46,115
PUNA,consulta externa,repetidas en menores de 5 anos,2005-08-01,24,16,24,16,40
PUNATA,consulta externa,repetidas en menores de 5 anos,2005-08-01,39,43,39,43,82
QUILLACOLLO,consulta externa,repetidas en menores de 5 anos,2005-08-01,188,190,188,190,378
QUIME,consulta externa,repetidas en menores de 5 anos,2005-08-01,9,8,9,8,17
RAVELO,consulta externa,repetidas en menores de 5 anos,2005-08-01,1,2,1,2,3
REYES,consulta externa,repetidas en menores de 5 anos,2005-08-01,26,24,26,24,50
RIBERALTA,consulta externa,repetidas en menores de 5 anos,2005-08-01,374,390,374,390,764
ROBORE,consulta externa,repetidas en menores de 5 anos,2005-08-01,13,14,13,14,27
RURRENABAQUE,consulta externa,repetidas en menores de 5 anos,2005-08-01,134,106,134,106,240
SABAYA,consulta externa,repetidas en menores de 5 anos,2005-08-01,1,1,1,1,2
SACABA,consulta externa,repetidas en menores de 5 anos,2005-08-01,162,146,162,146,308
SACABAMBA,consulta externa,repetidas en menores de 5 anos,2005-08-01,42,42,42,42,84
SACACA,consulta externa,repetidas en menores de 5 anos,2005-08-01,12,9,12,9,21
SAIPINA,consulta externa,repetidas en menores de 5 anos,2005-08-01,16,21,16,21,37
SALINAS DE GARCI MENDOZA,consulta externa,repetidas en menores de 5 anos,2005-08-01,3,4,3,4,7
SAMAIPATA,consulta externa,repetidas en menores de 5 anos,2005-08-01,3,1,3,1,4
SAN AGUSTIN,consulta externa,repetidas en menores de 5 anos,2005-08-01,5,3,5,3,8
SAN ANDRES,consulta externa,repetidas en menores de 5 anos,2005-08-01,15,16,15,16,31
SAN ANDRES DE MACHACA,consulta externa,repetidas en menores de 5 anos,2005-08-01,1,1,1,1,2
SAN ANTONIO DE ESMORUCO,consulta externa,repetidas en menores de 5 anos,2005-08-01,3,4,3,4,7
SAN ANTONIO DE LOMERIO,consulta externa,repetidas en menores de 5 anos,2005-08-01,2,0,2,0,2
SAN BENITO,consulta externa,repetidas en menores de 5 anos,2005-08-01,44,45,44,45,89
SAN BORJA,consulta externa,repetidas en menores de 5 anos,2005-08-01,99,65,99,65,164
SAN BUENA VENTURA,consulta externa,repetidas en menores de 5 anos,2005-08-01,15,24,15,24,39
SAN CARLOS,consulta externa,repetidas en menores de 5 anos,2005-08-01,15,13,15,13,28
SAN IGNACIO,consulta externa,repetidas en menores de 5 anos,2005-08-01,110,99,110,99,209
SAN IGNACIO DE VELASCO,consulta externa,repetidas en menores de 5 anos,2005-08-01,147,141,147,141,288
SAN JAVIER(BNI),consulta externa,repetidas en menores de 5 anos,2005-08-01,6,8,6,8,14
SAN JAVIER(STC),consulta externa,repetidas en menores de 5 anos,2005-08-01,16,24,16,24,40
SAN JOAQUIN,consulta externa,repetidas en menores de 5 anos,2005-08-01,1,1,1,1,2
SAN JOSE DE CHIQUITOS,consulta externa,repetidas en menores de 5 anos,2005-08-01,20,30,20,30,50
SAN JUAN DE YAPACANI,consulta externa,repetidas en menores de 5 anos,2005-08-01,20,17,20,17,37
SAN JULIAN,consulta externa,repetidas en menores de 5 anos,2005-08-01,65,70,65,70,135
SAN LORENZO(PND),consulta externa,repetidas en menores de 5 anos,2005-08-01,8,7,8,7,15
SAN LORENZO(TJA),consulta externa,repetidas en menores de 5 anos,2005-08-01,54,40,54,40,94
SAN LUCAS,consulta externa,repetidas en menores de 5 anos,2005-08-01,25,24,25,24,49
SAN MATIAS,consulta externa,repetidas en menores de 5 anos,2005-08-01,20,18,20,18,38
SAN MIGUEL DE VELASCO,consulta externa,repetidas en menores de 5 anos,2005-08-01,45,32,45,32,77
SAN PABLO DE LIPEZ,consulta externa,repetidas en menores de 5 anos,2005-08-01,8,7,8,7,15
SAN PEDRO,consulta externa,repetidas en menores de 5 anos,2005-08-01,76,65,76,65,141
SAN PEDRO DE BUENA VISTA,consulta externa,repetidas en menores de 5 anos,2005-08-01,3,5,3,5,8
SAN PEDRO DE CURAHUARA,consulta externa,repetidas en menores de 5 anos,2005-08-01,7,3,7,3,10
SAN PEDRO DE TIQUINA,consulta externa,repetidas en menores de 5 anos,2005-08-01,0,3,0,3,3
SAN PEDRO(PND),consulta externa,repetidas en menores de 5 anos,2005-08-01,5,5,5,5,10
SAN RAFAEL,consulta externa,repetidas en menores de 5 anos,2005-08-01,4,7,4,7,11
SAN RAMON,consulta externa,repetidas en menores de 5 anos,2005-08-01,7,8,7,8,15
SAN RAMON,consulta externa,repetidas en menores de 5 anos,2005-08-01,12,12,12,12,24
SANTA ANA,consulta externa,repetidas en menores de 5 anos,2005-08-01,36,24,36,24,60
SANTA CRUZ DE LA SIERRA,consulta externa,repetidas en menores de 5 anos,2005-08-01,4092,3884,4092,3884,7976
SANTA ROSA,consulta externa,repetidas en menores de 5 anos,2005-08-01,40,41,40,41,81
SANTA ROSA DEL SARA,consulta externa,repetidas en menores de 5 anos,2005-08-01,23,25,23,25,48
SANTIAGO DE CALLAPA,consulta externa,repetidas en menores de 5 anos,2005-08-01,1,1,1,1,2
SANTIAGO DE HUARI,consulta externa,repetidas en menores de 5 anos,2005-08-01,16,15,16,15,31
SANTIAGO DE MACHACA,consulta externa,repetidas en menores de 5 anos,2005-08-01,1,1,1,1,2
SANTIVAÑES,consulta externa,repetidas en menores de 5 anos,2005-08-01,7,17,7,17,24
SANTUARIO DE QUILLACAS,consulta externa,repetidas en menores de 5 anos,2005-08-01,4,2,4,2,6
SENA,consulta externa,repetidas en menores de 5 anos,2005-08-01,6,4,6,4,10
SICA SICA (VILLA AROMA),consulta externa,repetidas en menores de 5 anos,2005-08-01,19,10,19,10,29
SICAYA,consulta externa,repetidas en menores de 5 anos,2005-08-01,1,2,1,2,3
SIPE SIPE,consulta externa,repetidas en menores de 5 anos,2005-08-01,105,99,105,99,204
SOPACHUY,consulta externa,repetidas en menores de 5 anos,2005-08-01,7,6,7,6,13
SORACACHI,consulta externa,repetidas en menores de 5 anos,2005-08-01,1,4,1,4,5
SORATA,consulta externa,repetidas en menores de 5 anos,2005-08-01,2,1,2,1,3
SUCRE,consulta externa,repetidas en menores de 5 anos,2005-08-01,890,862,890,862,1752
TACACHI,consulta externa,repetidas en menores de 5 anos,2005-08-01,12,17,12,17,29
TACACOMA,consulta externa,repetidas en menores de 5 anos,2005-08-01,2,2,2,2,4
TACOBAMBA,consulta externa,repetidas en menores de 5 anos,2005-08-01,2,2,2,2,4
TACOPAYA,consulta externa,repetidas en menores de 5 anos,2005-08-01,32,24,32,24,56
TAHUA,consulta externa,repetidas en menores de 5 anos,2005-08-01,3,0,3,0,3
TAPACARI,consulta externa,repetidas en menores de 5 anos,2005-08-01,30,28,30,28,58
TARABUCO,consulta externa,repetidas en menores de 5 anos,2005-08-01,211,230,211,230,441
TARATA,consulta externa,repetidas en menores de 5 anos,2005-08-01,9,10,9,10,19
TARIJA,consulta externa,repetidas en menores de 5 anos,2005-08-01,704,633,704,633,1337
TARVITA,consulta externa,repetidas en menores de 5 anos,2005-08-01,52,34,52,34,86
TEOPONTE,consulta externa,repetidas en menores de 5 anos,2005-08-01,10,7,10,7,17
TIAWANACU,consulta externa,repetidas en menores de 5 anos,2005-08-01,4,5,4,5,9
TINGUIPAYA,consulta externa,repetidas en menores de 5 anos,2005-08-01,7,0,7,0,7
TIPUANI,consulta externa,repetidas en menores de 5 anos,2005-08-01,8,3,8,3,11
TIQUIPAYA,consulta externa,repetidas en menores de 5 anos,2005-08-01,313,253,313,253,566
TIRAQUE (CBBA),consulta externa,repetidas en menores de 5 anos,2005-08-01,103,72,103,72,175
TITO YUPANQUI (PARQUIPUJIO),consulta externa,repetidas en menores de 5 anos,2005-08-01,0,1,0,1,1
TOCO,consulta externa,repetidas en menores de 5 anos,2005-08-01,5,3,5,3,8
TOLATA,consulta externa,repetidas en menores de 5 anos,2005-08-01,6,10,6,10,16
TOLEDO,consulta externa,repetidas en menores de 5 anos,2005-08-01,3,5,3,5,8
TOMAVE,consulta externa,repetidas en menores de 5 anos,2005-08-01,8,8,8,8,16
TOMINA,consulta externa,repetidas en menores de 5 anos,2005-08-01,19,24,19,24,43
TORO TORO,consulta externa,repetidas en menores de 5 anos,2005-08-01,17,10,17,10,27
TOTORA(CBBA),consulta externa,repetidas en menores de 5 anos,2005-08-01,7,12,7,12,19
TOTORA(ORR),consulta externa,repetidas en menores de 5 anos,2005-08-01,6,10,6,10,16
TRIGAL,consulta externa,repetidas en menores de 5 anos,2005-08-01,4,1,4,1,5
TRINIDAD,consulta externa,repetidas en menores de 5 anos,2005-08-01,424,350,424,350,774
TUPIZA,consulta externa,repetidas en menores de 5 anos,2005-08-01,98,100,98,100,198
TURCO,consulta externa,repetidas en menores de 5 anos,2005-08-01,4,2,4,2,6
UMALA,consulta externa,repetidas en menores de 5 anos,2005-08-01,4,1,4,1,5
UNCIA,consulta externa,repetidas en menores de 5 anos,2005-08-01,48,57,48,57,105
URIONDO (A. CONCEPCION),consulta externa,repetidas en menores de 5 anos,2005-08-01,35,20,35,20,55
URUBICHA,consulta externa,repetidas en menores de 5 anos,2005-08-01,7,13,7,13,20
UYUNI,consulta externa,repetidas en menores de 5 anos,2005-08-01,15,16,15,16,31
VACAS,consulta externa,repetidas en menores de 5 anos,2005-08-01,60,51,60,51,111
VALLEGRANDE,consulta externa,repetidas en menores de 5 anos,2005-08-01,22,24,22,24,46
VIACHA,consulta externa,repetidas en menores de 5 anos,2005-08-01,74,53,74,53,127
VILA VILA,consulta externa,repetidas en menores de 5 anos,2005-08-01,1,0,1,0,1
VILLA MONTES,consulta externa,repetidas en menores de 5 anos,2005-08-01,16,9,16,9,25
VILLA NUEVA (LOMA ALTA),consulta externa,repetidas en menores de 5 anos,2005-08-01,1,1,1,1,2
VILLA RIVERO,consulta externa,repetidas en menores de 5 anos,2005-08-01,8,4,8,4,12
VILLA SERRANO,consulta externa,repetidas en menores de 5 anos,2005-08-01,8,6,8,6,14
VILLA TUNARI,consulta externa,repetidas en menores de 5 anos,2005-08-01,109,74,109,74,183
VILLA VACA GUZMAN (MUYUPAMPA),consulta externa,repetidas en menores de 5 anos,2005-08-01,15,19,15,19,34
VILLAZON,consulta externa,repetidas en menores de 5 anos,2005-08-01,97,56,97,56,153
VINTO,consulta externa,repetidas en menores de 5 anos,2005-08-01,36,32,36,32,68
VITICHI,consulta externa,repetidas en menores de 5 anos,2005-08-01,4,8,4,8,12
WALDO BALLIVIAN,consulta externa,repetidas en menores de 5 anos,2005-08-01,0,6,0,6,6
WARNES,consulta externa,repetidas en menores de 5 anos,2005-08-01,59,62,59,62,121
YACO,consulta externa,repetidas en menores de 5 anos,2005-08-01,0,1,0,1,1
YACUIBA,consulta externa,repetidas en menores de 5 anos,2005-08-01,159,174,159,174,333
YAMPARAEZ,consulta externa,repetidas en menores de 5 anos,2005-08-01,41,40,41,40,81
YANACACHI,consulta externa,repetidas en menores de 5 anos,2005-08-01,0,6,0,6,6
YAPACANI,consulta externa,repetidas en menores de 5 anos,2005-08-01,63,50,63,50,113
YOCALLA,consulta externa,repetidas en menores de 5 anos,2005-08-01,9,5,9,5,14
YOTALA,consulta externa,repetidas en menores de 5 anos,2005-08-01,72,51,72,51,123
YUNCHARA,consulta externa,repetidas en menores de 5 anos,2005-08-01,4,4,4,4,8
ZUDAÑEZ,consulta externa,repetidas en menores de 5 anos,2005-08-01,7,8,7,8,15
ACACIO,consulta externa,repetidas en menores de 5 anos,2005-09-01,2,1,2,1,3
ACHACACHI,consulta externa,repetidas en menores de 5 anos,2005-09-01,11,4,11,4,15
ACHOCALLA,consulta externa,repetidas en menores de 5 anos,2005-09-01,6,5,6,5,11
AIQUILE,consulta externa,repetidas en menores de 5 anos,2005-09-01,150,142,150,142,292
ALALAY,consulta externa,repetidas en menores de 5 anos,2005-09-01,1,1,1,1,2
ALCALA,consulta externa,repetidas en menores de 5 anos,2005-09-01,0,2,0,2,2
ANCORAIMES,consulta externa,repetidas en menores de 5 anos,2005-09-01,10,8,10,8,18
ANDAMARCA,consulta externa,repetidas en menores de 5 anos,2005-09-01,3,3,3,3,6
ANTEQUERA,consulta externa,repetidas en menores de 5 anos,2005-09-01,7,18,7,18,25
ANZALDO,consulta externa,repetidas en menores de 5 anos,2005-09-01,21,19,21,19,40
APOLO,consulta externa,repetidas en menores de 5 anos,2005-09-01,20,22,20,22,42
ARANI,consulta externa,repetidas en menores de 5 anos,2005-09-01,50,45,50,45,95
ARBIETO,consulta externa,repetidas en menores de 5 anos,2005-09-01,6,8,6,8,14
ARQUE,consulta externa,repetidas en menores de 5 anos,2005-09-01,0,2,0,2,2
ASCENCION DE GUARAYOS,consulta externa,repetidas en menores de 5 anos,2005-09-01,29,25,29,25,54
ATOCHA,consulta externa,repetidas en menores de 5 anos,2005-09-01,45,36,45,36,81
AUCAPATA,consulta externa,repetidas en menores de 5 anos,2005-09-01,1,1,1,1,2
AYATA,consulta externa,repetidas en menores de 5 anos,2005-09-01,15,20,15,20,35
AYO AYO,consulta externa,repetidas en menores de 5 anos,2005-09-01,5,4,5,4,9
AYOPAYA (V. DE INDEPENDENCIA),consulta externa,repetidas en menores de 5 anos,2005-09-01,25,25,25,25,50
AZURDUY,consulta externa,repetidas en menores de 5 anos,2005-09-01,3,4,3,4,7
BATALLAS,consulta externa,repetidas en menores de 5 anos,2005-09-01,15,6,15,6,21
BAURES,consulta externa,repetidas en menores de 5 anos,2005-09-01,14,5,14,5,19
BELEN DE ANDAMARCA,consulta externa,repetidas en menores de 5 anos,2005-09-01,4,2,4,2,6
BELEN DE URMIRI,consulta externa,repetidas en menores de 5 anos,2005-09-01,4,3,4,3,7
BERMEJO,consulta externa,repetidas en menores de 5 anos,2005-09-01,56,67,56,67,123
BETANZOS,consulta externa,repetidas en menores de 5 anos,2005-09-01,38,26,38,26,64
BOLIVAR,consulta externa,repetidas en menores de 5 anos,2005-09-01,27,21,27,21,48
BOLPEBRA,consulta externa,repetidas en menores de 5 anos,2005-09-01,2,1,2,1,3
BOYUIBE,consulta externa,repetidas en menores de 5 anos,2005-09-01,13,16,13,16,29
BUENA VISTA,consulta externa,repetidas en menores de 5 anos,2005-09-01,105,106,105,106,211
CABEZAS,consulta externa,repetidas en menores de 5 anos,2005-09-01,29,17,29,17,46
CAIROMA,consulta externa,repetidas en menores de 5 anos,2005-09-01,3,5,3,5,8
"CAIZA ""D""",consulta externa,repetidas en menores de 5 anos,2005-09-01,1,1,1,1,2
CAJUATA,consulta externa,repetidas en menores de 5 anos,2005-09-01,9,0,9,0,9
CALAMARCA,consulta externa,repetidas en menores de 5 anos,2005-09-01,5,3,5,3,8
CAMARGO,consulta externa,repetidas en menores de 5 anos,2005-09-01,7,6,7,6,13
CAMATAQUI (C. VILLA ABECIA),consulta externa,repetidas en menores de 5 anos,2005-09-01,3,3,3,3,6
CAMIRI,consulta externa,repetidas en menores de 5 anos,2005-09-01,143,164,143,164,307
CAPINOTA,consulta externa,repetidas en menores de 5 anos,2005-09-01,53,49,53,49,102
CARACOLLO,consulta externa,repetidas en menores de 5 anos,2005-09-01,7,1,7,1,8
CARANAVI,consulta externa,repetidas en menores de 5 anos,2005-09-01,21,18,21,18,39
CARAPARI,consulta externa,repetidas en menores de 5 anos,2005-09-01,2,0,2,0,2
CARIPUYO,consulta externa,repetidas en menores de 5 anos,2005-09-01,1,2,1,2,3
CARMEN RIVERO TORREZ,consulta externa,repetidas en menores de 5 anos,2005-09-01,1,1,1,1,2
CHALLAPATA,consulta externa,repetidas en menores de 5 anos,2005-09-01,12,14,12,14,26
CHAQUI,consulta externa,repetidas en menores de 5 anos,2005-09-01,4,5,4,5,9
CHARAGUA,consulta externa,repetidas en menores de 5 anos,2005-09-01,83,48,83,48,131
CHARAÑA,consulta externa,repetidas en menores de 5 anos,2005-09-01,6,15,6,15,21
CHAYANTA,consulta externa,repetidas en menores de 5 anos,2005-09-01,7,6,7,6,13
CHIMORE,consulta externa,repetidas en menores de 5 anos,2005-09-01,35,36,35,36,71
CHIPAYA,consulta externa,repetidas en menores de 5 anos,2005-09-01,2,2,2,2,4
CHOQUE COTA,consulta externa,repetidas en menores de 5 anos,2005-09-01,2,1,2,1,3
CHULUMANI (V. DE LA LIBERTAD),consulta externa,repetidas en menores de 5 anos,2005-09-01,13,18,13,18,31
CHUMA,consulta externa,repetidas en menores de 5 anos,2005-09-01,4,4,4,4,8
CLIZA,consulta externa,repetidas en menores de 5 anos,2005-09-01,18,14,18,14,32
COBIJA,consulta externa,repetidas en menores de 5 anos,2005-09-01,146,174,146,174,320
COCHABAMBA,consulta externa,repetidas en menores de 5 anos,2005-09-01,3018,2560,3018,2560,5578
COLCAPIRHUA,consulta externa,repetidas en menores de 5 anos,2005-09-01,168,154,168,154,322
"COLCHA ""K""",consulta externa,repetidas en menores de 5 anos,2005-09-01,6,10,6,10,16
COLLANA,consulta externa,repetidas en menores de 5 anos,2005-09-01,1,0,1,0,1
COLOMI,consulta externa,repetidas en menores de 5 anos,2005-09-01,12,10,12,10,22
COLPA BELGICA,consulta externa,repetidas en menores de 5 anos,2005-09-01,15,10,15,10,25
COLQUECHACA,consulta externa,repetidas en menores de 5 anos,2005-09-01,7,4,7,4,11
COLQUENCHA,consulta externa,repetidas en menores de 5 anos,2005-09-01,5,3,5,3,8
COLQUIRI,consulta externa,repetidas en menores de 5 anos,2005-09-01,47,31,47,31,78
COMANCHE,consulta externa,repetidas en menores de 5 anos,2005-09-01,1,4,1,4,5
COMARAPA,consulta externa,repetidas en menores de 5 anos,2005-09-01,32,37,32,37,69
CONCEPCION,consulta externa,repetidas en menores de 5 anos,2005-09-01,16,10,16,10,26
COPACABANA,consulta externa,repetidas en menores de 5 anos,2005-09-01,0,1,0,1,1
CORIPATA,consulta externa,repetidas en menores de 5 anos,2005-09-01,9,5,9,5,14
CORO CORO,consulta externa,repetidas en menores de 5 anos,2005-09-01,3,1,3,1,4
COROICO,consulta externa,repetidas en menores de 5 anos,2005-09-01,44,57,44,57,101
CORQUE,consulta externa,repetidas en menores de 5 anos,2005-09-01,26,26,26,26,52
COTAGAITA,consulta externa,repetidas en menores de 5 anos,2005-09-01,27,23,27,23,50
COTOCA,consulta externa,repetidas en menores de 5 anos,2005-09-01,12,7,12,7,19
CUATRO CAÑADAS,consulta externa,repetidas en menores de 5 anos,2005-09-01,27,30,27,30,57
CUCHUMUELA (V. G. VILLARROEL),consulta externa,repetidas en menores de 5 anos,2005-09-01,5,2,5,2,7
CUEVO,consulta externa,repetidas en menores de 5 anos,2005-09-01,10,14,10,14,24
CULPINA,consulta externa,repetidas en menores de 5 anos,2005-09-01,50,41,50,41,91
CURAHUARA DE CARANGAS,consulta externa,repetidas en menores de 5 anos,2005-09-01,2,4,2,4,6
DESAGUADERO,consulta externa,repetidas en menores de 5 anos,2005-09-01,7,2,7,2,9
EL ALTO,consulta externa,repetidas en menores de 5 anos,2005-09-01,2302,2216,2302,2216,4518
EL CHORO,consulta externa,repetidas en menores de 5 anos,2005-09-01,1,2,1,2,3
EL PUENTE(STC),consulta externa,repetidas en menores de 5 anos,2005-09-01,6,5,6,5,11
EL PUENTE(TJA),consulta externa,repetidas en menores de 5 anos,2005-09-01,106,92,106,92,198
EL TORNO,consulta externa,repetidas en menores de 5 anos,2005-09-01,102,116,102,116,218
EL VILLAR,consulta externa,repetidas en menores de 5 anos,2005-09-01,2,3,2,3,5
ENTRE RIOS,consulta externa,repetidas en menores de 5 anos,2005-09-01,6,8,6,8,14
ENTRE RIOS,consulta externa,repetidas en menores de 5 anos,2005-09-01,83,67,83,67,150
EUCALIPTUS,consulta externa,repetidas en menores de 5 anos,2005-09-01,16,5,16,5,21
EUREKA (SANTOS MERCADO),consulta externa,repetidas en menores de 5 anos,2005-09-01,1,1,1,1,2
EXALTACION,consulta externa,repetidas en menores de 5 anos,2005-09-01,6,5,6,5,11
FERNANDEZ ALONSO,consulta externa,repetidas en menores de 5 anos,2005-09-01,19,14,19,14,33
FILADELFIA,consulta externa,repetidas en menores de 5 anos,2005-09-01,5,3,5,3,8
GENERAL SAAVEDRA,consulta externa,repetidas en menores de 5 anos,2005-09-01,40,30,40,30,70
GRAL. J.J. PEREZ (CHARAZANI),consulta externa,repetidas en menores de 5 anos,2005-09-01,6,1,6,1,7
GUANAY,consulta externa,repetidas en menores de 5 anos,2005-09-01,7,7,7,7,14
GUAQUI,consulta externa,repetidas en menores de 5 anos,2005-09-01,5,2,5,2,7
GUAYARAMERIN,consulta externa,repetidas en menores de 5 anos,2005-09-01,66,81,66,81,147
GUTIERREZ,consulta externa,repetidas en menores de 5 anos,2005-09-01,34,38,34,38,72
HUACARETA,consulta externa,repetidas en menores de 5 anos,2005-09-01,64,71,64,71,135
HUACAYA (VILLA DE HUACAYA),consulta externa,repetidas en menores de 5 anos,2005-09-01,9,8,9,8,17
HUACHACALLA,consulta externa,repetidas en menores de 5 anos,2005-09-01,2,1,2,1,3
HUANUNI,consulta externa,repetidas en menores de 5 anos,2005-09-01,95,101,95,101,196
HUARACAJE,consulta externa,repetidas en menores de 5 anos,2005-09-01,9,13,9,13,22
HUAYLLAMARCA,consulta externa,repetidas en menores de 5 anos,2005-09-01,1,3,1,3,4
ICHOCA,consulta externa,repetidas en menores de 5 anos,2005-09-01,2,1,2,1,3
ICLA,consulta externa,repetidas en menores de 5 anos,2005-09-01,8,3,8,3,11
INCAHUASI,consulta externa,repetidas en menores de 5 anos,2005-09-01,2,12,2,12,14
INGAVI (HUMAITA),consulta externa,repetidas en menores de 5 anos,2005-09-01,5,3,5,3,8
INQUISIVI,consulta externa,repetidas en menores de 5 anos,2005-09-01,2,0,2,0,2
IRUPANA (VILLA DE LANZA),consulta externa,repetidas en menores de 5 anos,2005-09-01,13,3,13,3,16
IXIAMAS,consulta externa,repetidas en menores de 5 anos,2005-09-01,23,9,23,9,32
JESUS DE MACHACA,consulta externa,repetidas en menores de 5 anos,2005-09-01,4,6,4,6,10
LA ASUNTA,consulta externa,repetidas en menores de 5 anos,2005-09-01,4,5,4,5,9
LA GUARDIA,consulta externa,repetidas en menores de 5 anos,2005-09-01,108,121,108,121,229
LA PAZ,consulta externa,repetidas en menores de 5 anos,2005-09-01,4542,4501,4542,4501,9043
LAGUNILLAS,consulta externa,repetidas en menores de 5 anos,2005-09-01,10,8,10,8,18
LAJA,consulta externa,repetidas en menores de 5 anos,2005-09-01,14,7,14,7,21
LAS CARRERAS,consulta externa,repetidas en menores de 5 anos,2005-09-01,4,7,4,7,11
LLALLAGUA,consulta externa,repetidas en menores de 5 anos,2005-09-01,40,34,40,34,74
LLICA,consulta externa,repetidas en menores de 5 anos,2005-09-01,6,3,6,3,9
LORETO,consulta externa,repetidas en menores de 5 anos,2005-09-01,9,8,9,8,17
LURIBAY,consulta externa,repetidas en menores de 5 anos,2005-09-01,2,2,2,2,4
MACHACAMARCA,consulta externa,repetidas en menores de 5 anos,2005-09-01,0,3,0,3,3
MACHARETI,consulta externa,repetidas en menores de 5 anos,2005-09-01,10,6,10,6,16
MAGDALENA,consulta externa,repetidas en menores de 5 anos,2005-09-01,19,33,19,33,52
MAIRANA,consulta externa,repetidas en menores de 5 anos,2005-09-01,6,6,6,6,12
MALLA,consulta externa,repetidas en menores de 5 anos,2005-09-01,2,2,2,2,4
MAPIRI,consulta externa,repetidas en menores de 5 anos,2005-09-01,13,17,13,17,30
MECAPACA,consulta externa,repetidas en menores de 5 anos,2005-09-01,24,23,24,23,47
MINEROS,consulta externa,repetidas en menores de 5 anos,2005-09-01,14,17,14,17,31
MIZQUE,consulta externa,repetidas en menores de 5 anos,2005-09-01,13,11,13,11,24
MOCOMOCO,consulta externa,repetidas en menores de 5 anos,2005-09-01,4,7,4,7,11
MOJINETE,consulta externa,repetidas en menores de 5 anos,2005-09-01,5,6,5,6,11
MOJOCOYA,consulta externa,repetidas en menores de 5 anos,2005-09-01,2,0,2,0,2
MONTEAGUDO,consulta externa,repetidas en menores de 5 anos,2005-09-01,83,57,83,57,140
MONTERO,consulta externa,repetidas en menores de 5 anos,2005-09-01,451,405,451,405,856
MOROCHATA,consulta externa,repetidas en menores de 5 anos,2005-09-01,59,55,59,55,114
OCURI,consulta externa,repetidas en menores de 5 anos,2005-09-01,2,4,2,4,6
OKINAWA,consulta externa,repetidas en menores de 5 anos,2005-09-01,12,11,12,11,23
OMEREQUE,consulta externa,repetidas en menores de 5 anos,2005-09-01,25,14,25,14,39
ORURO,consulta externa,repetidas en menores de 5 anos,2005-09-01,587,659,587,659,1246
PADCAYA,consulta externa,repetidas en menores de 5 anos,2005-09-01,28,22,28,22,50
PADILLA,consulta externa,repetidas en menores de 5 anos,2005-09-01,5,5,5,5,10
PAILON,consulta externa,repetidas en menores de 5 anos,2005-09-01,29,13,29,13,42
PALCA,consulta externa,repetidas en menores de 5 anos,2005-09-01,1,8,1,8,9
PALOS BLANCOS,consulta externa,repetidas en menores de 5 anos,2005-09-01,41,30,41,30,71
PAMPA AULLAGAS,consulta externa,repetidas en menores de 5 anos,2005-09-01,3,3,3,3,6
PAMPA GRANDE,consulta externa,repetidas en menores de 5 anos,2005-09-01,10,9,10,9,19
PAPEL PAMPA,consulta externa,repetidas en menores de 5 anos,2005-09-01,1,9,1,9,10
PASORAPA,consulta externa,repetidas en menores de 5 anos,2005-09-01,9,4,9,4,13
PATACAMAYA,consulta externa,repetidas en menores de 5 anos,2005-09-01,20,5,20,5,25
PAZÑA,consulta externa,repetidas en menores de 5 anos,2005-09-01,3,4,3,4,7
PELECHUCO,consulta externa,repetidas en menores de 5 anos,2005-09-01,1,1,1,1,2
POCOATA,consulta externa,repetidas en menores de 5 anos,2005-09-01,4,2,4,2,6
POCONA,consulta externa,repetidas en menores de 5 anos,2005-09-01,11,6,11,6,17
POJO (CBBA),consulta externa,repetidas en menores de 5 anos,2005-09-01,7,4,7,4,11
POOPO,consulta externa,repetidas en menores de 5 anos,2005-09-01,2,0,2,0,2
PORCO,consulta externa,repetidas en menores de 5 anos,2005-09-01,2,9,2,9,11
POROMA,consulta externa,repetidas en menores de 5 anos,2005-09-01,5,3,5,3,8
PORONGO,consulta externa,repetidas en menores de 5 anos,2005-09-01,17,8,17,8,25
PORTACHUELO,consulta externa,repetidas en menores de 5 anos,2005-09-01,44,24,44,24,68
PORVENIR,consulta externa,repetidas en menores de 5 anos,2005-09-01,1,2,1,2,3
POSTRER VALLE,consulta externa,repetidas en menores de 5 anos,2005-09-01,2,1,2,1,3
POTOSI,consulta externa,repetidas en menores de 5 anos,2005-09-01,474,430,474,430,904
PRESTO,consulta externa,repetidas en menores de 5 anos,2005-09-01,3,1,3,1,4
PUCARA,consulta externa,repetidas en menores de 5 anos,2005-09-01,9,4,9,4,13
PUCARANI,consulta externa,repetidas en menores de 5 anos,2005-09-01,9,7,9,7,16
PUERTO ACOSTA,consulta externa,repetidas en menores de 5 anos,2005-09-01,30,31,30,31,61
PUERTO CARABUCO,consulta externa,repetidas en menores de 5 anos,2005-09-01,1,1,1,1,2
PUERTO GONZALO MORENO,consulta externa,repetidas en menores de 5 anos,2005-09-01,9,10,9,10,19
PUERTO PEREZ,consulta externa,repetidas en menores de 5 anos,2005-09-01,1,0,1,0,1
PUERTO QUIJARRO,consulta externa,repetidas en menores de 5 anos,2005-09-01,46,35,46,35,81
PUERTO RICO,consulta externa,repetidas en menores de 5 anos,2005-09-01,5,6,5,6,11
PUERTO SILES,consulta externa,repetidas en menores de 5 anos,2005-09-01,3,3,3,3,6
PUERTO SUAREZ,consulta externa,repetidas en menores de 5 anos,2005-09-01,16,20,16,20,36
PUERTO VILLARROEL,consulta externa,repetidas en menores de 5 anos,2005-09-01,89,99,89,99,188
PUNA,consulta externa,repetidas en menores de 5 anos,2005-09-01,25,16,25,16,41
PUNATA,consulta externa,repetidas en menores de 5 anos,2005-09-01,59,53,59,53,112
QUILLACOLLO,consulta externa,repetidas en menores de 5 anos,2005-09-01,116,107,116,107,223
QUIME,consulta externa,repetidas en menores de 5 anos,2005-09-01,7,2,7,2,9
QUIRUSILLAS,consulta externa,repetidas en menores de 5 anos,2005-09-01,0,3,0,3,3
RAVELO,consulta externa,repetidas en menores de 5 anos,2005-09-01,2,3,2,3,5
REYES,consulta externa,repetidas en menores de 5 anos,2005-09-01,7,13,7,13,20
RIBERALTA,consulta externa,repetidas en menores de 5 anos,2005-09-01,377,311,377,311,688
ROBORE,consulta externa,repetidas en menores de 5 anos,2005-09-01,8,13,8,13,21
RURRENABAQUE,consulta externa,repetidas en menores de 5 anos,2005-09-01,108,111,108,111,219
SABAYA,consulta externa,repetidas en menores de 5 anos,2005-09-01,3,2,3,2,5
SACABA,consulta externa,repetidas en menores de 5 anos,2005-09-01,223,198,223,198,421
SACABAMBA,consulta externa,repetidas en menores de 5 anos,2005-09-01,29,26,29,26,55
SACACA,consulta externa,repetidas en menores de 5 anos,2005-09-01,8,5,8,5,13
SAIPINA,consulta externa,repetidas en menores de 5 anos,2005-09-01,11,11,11,11,22
SALINAS DE GARCI MENDOZA,consulta externa,repetidas en menores de 5 anos,2005-09-01,4,5,4,5,9
SAMAIPATA,consulta externa,repetidas en menores de 5 anos,2005-09-01,6,4,6,4,10
SAN AGUSTIN,consulta externa,repetidas en menores de 5 anos,2005-09-01,3,1,3,1,4
SAN ANDRES,consulta externa,repetidas en menores de 5 anos,2005-09-01,21,16,21,16,37
SAN ANDRES DE MACHACA,consulta externa,repetidas en menores de 5 anos,2005-09-01,3,4,3,4,7
SAN ANTONIO DE ESMORUCO,consulta externa,repetidas en menores de 5 anos,2005-09-01,0,3,0,3,3
SAN ANTONIO DE LOMERIO,consulta externa,repetidas en menores de 5 anos,2005-09-01,1,1,1,1,2
SAN BENITO,consulta externa,repetidas en menores de 5 anos,2005-09-01,25,31,25,31,56
SAN BORJA,consulta externa,repetidas en menores de 5 anos,2005-09-01,75,52,75,52,127
SAN BUENA VENTURA,consulta externa,repetidas en menores de 5 anos,2005-09-01,18,24,18,24,42
SAN CARLOS,consulta externa,repetidas en menores de 5 anos,2005-09-01,12,7,12,7,19
SAN IGNACIO,consulta externa,repetidas en menores de 5 anos,2005-09-01,105,120,105,120,225
SAN IGNACIO DE VELASCO,consulta externa,repetidas en menores de 5 anos,2005-09-01,84,57,84,57,141
SAN JAVIER(BNI),consulta externa,repetidas en menores de 5 anos,2005-09-01,27,16,27,16,43
SAN JAVIER(STC),consulta externa,repetidas en menores de 5 anos,2005-09-01,12,15,12,15,27
SAN JOAQUIN,consulta externa,repetidas en menores de 5 anos,2005-09-01,2,2,2,2,4
SAN JOSE DE CHIQUITOS,consulta externa,repetidas en menores de 5 anos,2005-09-01,5,10,5,10,15
SAN JUAN DE YAPACANI,consulta externa,repetidas en menores de 5 anos,2005-09-01,32,24,32,24,56
SAN JULIAN,consulta externa,repetidas en menores de 5 anos,2005-09-01,45,41,45,41,86
SAN LORENZO(PND),consulta externa,repetidas en menores de 5 anos,2005-09-01,7,4,7,4,11
SAN LORENZO(TJA),consulta externa,repetidas en menores de 5 anos,2005-09-01,57,32,57,32,89
SAN LUCAS,consulta externa,repetidas en menores de 5 anos,2005-09-01,19,16,19,16,35
SAN MATIAS,consulta externa,repetidas en menores de 5 anos,2005-09-01,9,9,9,9,18
SAN MIGUEL DE VELASCO,consulta externa,repetidas en menores de 5 anos,2005-09-01,42,22,42,22,64
SAN PABLO DE LIPEZ,consulta externa,repetidas en menores de 5 anos,2005-09-01,1,7,1,7,8
SAN PEDRO,consulta externa,repetidas en menores de 5 anos,2005-09-01,71,57,71,57,128
SAN PEDRO DE BUENA VISTA,consulta externa,repetidas en menores de 5 anos,2005-09-01,2,2,2,2,4
SAN PEDRO DE CURAHUARA,consulta externa,repetidas en menores de 5 anos,2005-09-01,1,0,1,0,1
SAN PEDRO DE QUEMES,consulta externa,repetidas en menores de 5 anos,2005-09-01,1,1,1,1,2
SAN PEDRO DE TIQUINA,consulta externa,repetidas en menores de 5 anos,2005-09-01,5,2,5,2,7
SAN RAFAEL,consulta externa,repetidas en menores de 5 anos,2005-09-01,5,2,5,2,7
SAN RAMON,consulta externa,repetidas en menores de 5 anos,2005-09-01,13,6,13,6,19
SAN RAMON,consulta externa,repetidas en menores de 5 anos,2005-09-01,5,1,5,1,6
SANTA ANA,consulta externa,repetidas en menores de 5 anos,2005-09-01,53,37,53,37,90
SANTA CRUZ DE LA SIERRA,consulta externa,repetidas en menores de 5 anos,2005-09-01,3192,3475,3192,3475,6667
SANTA ROSA,consulta externa,repetidas en menores de 5 anos,2005-09-01,31,24,31,24,55
SANTA ROSA DEL SARA,consulta externa,repetidas en menores de 5 anos,2005-09-01,43,34,43,34,77
SANTIAGO DE CALLAPA,consulta externa,repetidas en menores de 5 anos,2005-09-01,1,0,1,0,1
SANTIAGO DE HUARI,consulta externa,repetidas en menores de 5 anos,2005-09-01,8,10,8,10,18
SANTIAGO DE MACHACA,consulta externa,repetidas en menores de 5 anos,2005-09-01,2,0,2,0,2
SANTIVAÑES,consulta externa,repetidas en menores de 5 anos,2005-09-01,6,6,6,6,12
SANTUARIO DE QUILLACAS,consulta externa,repetidas en menores de 5 anos,2005-09-01,4,7,4,7,11
SAPAHAQUI,consulta externa,repetidas en menores de 5 anos,2005-09-01,2,0,2,0,2
SENA,consulta externa,repetidas en menores de 5 anos,2005-09-01,4,7,4,7,11
SICA SICA (VILLA AROMA),consulta externa,repetidas en menores de 5 anos,2005-09-01,8,10,8,10,18
SICAYA,consulta externa,repetidas en menores de 5 anos,2005-09-01,5,8,5,8,13
SIPE SIPE,consulta externa,repetidas en menores de 5 anos,2005-09-01,126,127,126,127,253
SOPACHUY,consulta externa,repetidas en menores de 5 anos,2005-09-01,5,5,5,5,10
SORACACHI,consulta externa,repetidas en menores de 5 anos,2005-09-01,1,7,1,7,8
SORATA,consulta externa,repetidas en menores de 5 anos,2005-09-01,1,1,1,1,2
SUCRE,consulta externa,repetidas en menores de 5 anos,2005-09-01,793,792,793,792,1585
TACACHI,consulta externa,repetidas en menores de 5 anos,2005-09-01,13,15,13,15,28
TACACOMA,consulta externa,repetidas en menores de 5 anos,2005-09-01,1,0,1,0,1
TACOBAMBA,consulta externa,repetidas en menores de 5 anos,2005-09-01,2,0,2,0,2
TACOPAYA,consulta externa,repetidas en menores de 5 anos,2005-09-01,8,5,8,5,13
TAHUA,consulta externa,repetidas en menores de 5 anos,2005-09-01,1,1,1,1,2
TAPACARI,consulta externa,repetidas en menores de 5 anos,2005-09-01,42,29,42,29,71
TARABUCO,consulta externa,repetidas en menores de 5 anos,2005-09-01,171,175,171,175,346
TARACO,consulta externa,repetidas en menores de 5 anos,2005-09-01,2,2,2,2,4
TARATA,consulta externa,repetidas en menores de 5 anos,2005-09-01,8,3,8,3,11
TARIJA,consulta externa,repetidas en menores de 5 anos,2005-09-01,826,791,826,791,1617
TARVITA,consulta externa,repetidas en menores de 5 anos,2005-09-01,35,29,35,29,64
TEOPONTE,consulta externa,repetidas en menores de 5 anos,2005-09-01,6,3,6,3,9
TIAWANACU,consulta externa,repetidas en menores de 5 anos,2005-09-01,0,6,0,6,6
TINGUIPAYA,consulta externa,repetidas en menores de 5 anos,2005-09-01,6,2,6,2,8
TIPUANI,consulta externa,repetidas en menores de 5 anos,2005-09-01,3,4,3,4,7
TIQUIPAYA,consulta externa,repetidas en menores de 5 anos,2005-09-01,183,162,183,162,345
TIRAQUE (CBBA),consulta externa,repetidas en menores de 5 anos,2005-09-01,140,140,140,140,280
TITO YUPANQUI (PARQUIPUJIO),consulta externa,repetidas en menores de 5 anos,2005-09-01,1,0,1,0,1
TOCO,consulta externa,repetidas en menores de 5 anos,2005-09-01,10,7,10,7,17
TODOS SANTOS,consulta externa,repetidas en menores de 5 anos,2005-09-01,0,2,0,2,2
TOLATA,consulta externa,repetidas en menores de 5 anos,2005-09-01,13,7,13,7,20
TOLEDO,consulta externa,repetidas en menores de 5 anos,2005-09-01,4,4,4,4,8
TOMAVE,consulta externa,repetidas en menores de 5 anos,2005-09-01,4,4,4,4,8
TOMINA,consulta externa,repetidas en menores de 5 anos,2005-09-01,6,12,6,12,18
TORO TORO,consulta externa,repetidas en menores de 5 anos,2005-09-01,11,11,11,11,22
TOTORA(CBBA),consulta externa,repetidas en menores de 5 anos,2005-09-01,2,2,2,2,4
TOTORA(ORR),consulta externa,repetidas en menores de 5 anos,2005-09-01,3,2,3,2,5
TRIGAL,consulta externa,repetidas en menores de 5 anos,2005-09-01,4,3,4,3,7
TRINIDAD,consulta externa,repetidas en menores de 5 anos,2005-09-01,302,311,302,311,613
TUPIZA,consulta externa,repetidas en menores de 5 anos,2005-09-01,100,108,100,108,208
TURCO,consulta externa,repetidas en menores de 5 anos,2005-09-01,4,7,4,7,11
UNCIA,consulta externa,repetidas en menores de 5 anos,2005-09-01,48,43,48,43,91
URIONDO (A. CONCEPCION),consulta externa,repetidas en menores de 5 anos,2005-09-01,59,46,59,46,105
URUBICHA,consulta externa,repetidas en menores de 5 anos,2005-09-01,3,3,3,3,6
UYUNI,consulta externa,repetidas en menores de 5 anos,2005-09-01,11,10,11,10,21
VACAS,consulta externa,repetidas en menores de 5 anos,2005-09-01,45,38,45,38,83
VALLEGRANDE,consulta externa,repetidas en menores de 5 anos,2005-09-01,15,16,15,16,31
VIACHA,consulta externa,repetidas en menores de 5 anos,2005-09-01,85,94,85,94,179
VILLA MONTES,consulta externa,repetidas en menores de 5 anos,2005-09-01,89,86,89,86,175
VILLA NUEVA (LOMA ALTA),consulta externa,repetidas en menores de 5 anos,2005-09-01,3,0,3,0,3
VILLA RIVERO,consulta externa,repetidas en menores de 5 anos,2005-09-01,16,25,16,25,41
VILLA SERRANO,consulta externa,repetidas en menores de 5 anos,2005-09-01,5,1,5,1,6
VILLA TUNARI,consulta externa,repetidas en menores de 5 anos,2005-09-01,96,69,96,69,165
VILLA VACA GUZMAN (MUYUPAMPA),consulta externa,repetidas en menores de 5 anos,2005-09-01,12,11,12,11,23
VILLAZON,consulta externa,repetidas en menores de 5 anos,2005-09-01,79,66,79,66,145
VINTO,consulta externa,repetidas en menores de 5 anos,2005-09-01,80,55,80,55,135
VITICHI,consulta externa,repetidas en menores de 5 anos,2005-09-01,3,4,3,4,7
WALDO BALLIVIAN,consulta externa,repetidas en menores de 5 anos,2005-09-01,0,1,0,1,1
WARNES,consulta externa,repetidas en menores de 5 anos,2005-09-01,55,50,55,50,105
YACO,consulta externa,repetidas en menores de 5 anos,2005-09-01,3,2,3,2,5
YACUIBA,consulta externa,repetidas en menores de 5 anos,2005-09-01,227,218,227,218,445
YAMPARAEZ,consulta externa,repetidas en menores de 5 anos,2005-09-01,16,23,16,23,39
YANACACHI,consulta externa,repetidas en menores de 5 anos,2005-09-01,1,3,1,3,4
YAPACANI,consulta externa,repetidas en menores de 5 anos,2005-09-01,40,34,40,34,74
YOCALLA,consulta externa,repetidas en menores de 5 anos,2005-09-01,21,19,21,19,40
YOTALA,consulta externa,repetidas en menores de 5 anos,2005-09-01,31,20,31,20,51
YUNCHARA,consulta externa,repetidas en menores de 5 anos,2005-09-01,4,9,4,9,13
ZUDAÑEZ,consulta externa,repetidas en menores de 5 anos,2005-09-01,6,7,6,7,13
ACACIO,consulta externa,repetidas en menores de 5 anos,2005-10-01,0,2,0,2,2
ACHACACHI,consulta externa,repetidas en menores de 5 anos,2005-10-01,16,17,16,17,33
ACHOCALLA,consulta externa,repetidas en menores de 5 anos,2005-10-01,4,6,4,6,10
AIQUILE,consulta externa,repetidas en menores de 5 anos,2005-10-01,61,22,61,22,83
ALALAY,consulta externa,repetidas en menores de 5 anos,2005-10-01,2,0,2,0,2
ANCORAIMES,consulta externa,repetidas en menores de 5 anos,2005-10-01,15,9,15,9,24
ANDAMARCA,consulta externa,repetidas en menores de 5 anos,2005-10-01,9,1,9,1,10
ANTEQUERA,consulta externa,repetidas en menores de 5 anos,2005-10-01,1,4,1,4,5
ANZALDO,consulta externa,repetidas en menores de 5 anos,2005-10-01,26,28,26,28,54
APOLO,consulta externa,repetidas en menores de 5 anos,2005-10-01,1,9,1,9,10
ARAMPAMPA,consulta externa,repetidas en menores de 5 anos,2005-10-01,3,0,3,0,3
ARANI,consulta externa,repetidas en menores de 5 anos,2005-10-01,48,43,48,43,91
ARBIETO,consulta externa,repetidas en menores de 5 anos,2005-10-01,18,14,18,14,32
ARQUE,consulta externa,repetidas en menores de 5 anos,2005-10-01,1,1,1,1,2
ASCENCION DE GUARAYOS,consulta externa,repetidas en menores de 5 anos,2005-10-01,10,8,10,8,18
ATOCHA,consulta externa,repetidas en menores de 5 anos,2005-10-01,77,53,77,53,130
AUCAPATA,consulta externa,repetidas en menores de 5 anos,2005-10-01,2,2,2,2,4
AYATA,consulta externa,repetidas en menores de 5 anos,2005-10-01,10,17,10,17,27
AYO AYO,consulta externa,repetidas en menores de 5 anos,2005-10-01,6,4,6,4,10
AYOPAYA (V. DE INDEPENDENCIA),consulta externa,repetidas en menores de 5 anos,2005-10-01,14,12,14,12,26
BATALLAS,consulta externa,repetidas en menores de 5 anos,2005-10-01,4,3,4,3,7
BAURES,consulta externa,repetidas en menores de 5 anos,2005-10-01,8,5,8,5,13
BELEN DE ANDAMARCA,consulta externa,repetidas en menores de 5 anos,2005-10-01,1,1,1,1,2
BELEN DE URMIRI,consulta externa,repetidas en menores de 5 anos,2005-10-01,4,2,4,2,6
BERMEJO,consulta externa,repetidas en menores de 5 anos,2005-10-01,102,91,102,91,193
BETANZOS,consulta externa,repetidas en menores de 5 anos,2005-10-01,50,38,50,38,88
BOLIVAR,consulta externa,repetidas en menores de 5 anos,2005-10-01,10,9,10,9,19
BOYUIBE,consulta externa,repetidas en menores de 5 anos,2005-10-01,18,20,18,20,38
BUENA VISTA,consulta externa,repetidas en menores de 5 anos,2005-10-01,117,108,117,108,225
CABEZAS,consulta externa,repetidas en menores de 5 anos,2005-10-01,12,12,12,12,24
CAIROMA,consulta externa,repetidas en menores de 5 anos,2005-10-01,0,2,0,2,2
"CAIZA ""D""",consulta externa,repetidas en menores de 5 anos,2005-10-01,5,4,5,4,9
CAJUATA,consulta externa,repetidas en menores de 5 anos,2005-10-01,2,3,2,3,5
CALACOTO,consulta externa,repetidas en menores de 5 anos,2005-10-01,0,1,0,1,1
CALAMARCA,consulta externa,repetidas en menores de 5 anos,2005-10-01,12,10,12,10,22
CAMARGO,consulta externa,repetidas en menores de 5 anos,2005-10-01,13,12,13,12,25
CAMATAQUI (C. VILLA ABECIA),consulta externa,repetidas en menores de 5 anos,2005-10-01,2,2,2,2,4
CAMIRI,consulta externa,repetidas en menores de 5 anos,2005-10-01,87,90,87,90,177
CAPINOTA,consulta externa,repetidas en menores de 5 anos,2005-10-01,21,23,21,23,44
CAQUIAVIRI,consulta externa,repetidas en menores de 5 anos,2005-10-01,1,2,1,2,3
CARACOLLO,consulta externa,repetidas en menores de 5 anos,2005-10-01,5,5,5,5,10
CARANAVI,consulta externa,repetidas en menores de 5 anos,2005-10-01,41,47,41,47,88
CARAPARI,consulta externa,repetidas en menores de 5 anos,2005-10-01,4,3,4,3,7
CARIPUYO,consulta externa,repetidas en menores de 5 anos,2005-10-01,3,2,3,2,5
CARMEN RIVERO TORREZ,consulta externa,repetidas en menores de 5 anos,2005-10-01,2,3,2,3,5
CHALLAPATA,consulta externa,repetidas en menores de 5 anos,2005-10-01,10,12,10,12,22
CHAQUI,consulta externa,repetidas en menores de 5 anos,2005-10-01,1,1,1,1,2
CHARAGUA,consulta externa,repetidas en menores de 5 anos,2005-10-01,66,66,66,66,132
CHARAÑA,consulta externa,repetidas en menores de 5 anos,2005-10-01,1,2,1,2,3
CHAYANTA,consulta externa,repetidas en menores de 5 anos,2005-10-01,2,5,2,5,7
CHIMORE,consulta externa,repetidas en menores de 5 anos,2005-10-01,59,44,59,44,103
CHIPAYA,consulta externa,repetidas en menores de 5 anos,2005-10-01,2,3,2,3,5
CHOQUE COTA,consulta externa,repetidas en menores de 5 anos,2005-10-01,8,5,8,5,13
CHULUMANI (V. DE LA LIBERTAD),consulta externa,repetidas en menores de 5 anos,2005-10-01,22,16,22,16,38
CHUMA,consulta externa,repetidas en menores de 5 anos,2005-10-01,4,2,4,2,6
CLIZA,consulta externa,repetidas en menores de 5 anos,2005-10-01,36,24,36,24,60
COBIJA,consulta externa,repetidas en menores de 5 anos,2005-10-01,89,89,89,89,178
COCHABAMBA,consulta externa,repetidas en menores de 5 anos,2005-10-01,3318,2917,3318,2917,6235
COLCAPIRHUA,consulta externa,repetidas en menores de 5 anos,2005-10-01,145,184,145,184,329
"COLCHA ""K""",consulta externa,repetidas en menores de 5 anos,2005-10-01,0,7,0,7,7
COLLANA,consulta externa,repetidas en menores de 5 anos,2005-10-01,4,1,4,1,5
COLOMI,consulta externa,repetidas en menores de 5 anos,2005-10-01,19,18,19,18,37
COLPA BELGICA,consulta externa,repetidas en menores de 5 anos,2005-10-01,33,25,33,25,58
COLQUECHACA,consulta externa,repetidas en menores de 5 anos,2005-10-01,6,4,6,4,10
COLQUENCHA,consulta externa,repetidas en menores de 5 anos,2005-10-01,6,6,6,6,12
COLQUIRI,consulta externa,repetidas en menores de 5 anos,2005-10-01,32,43,32,43,75
COMANCHE,consulta externa,repetidas en menores de 5 anos,2005-10-01,7,4,7,4,11
COMARAPA,consulta externa,repetidas en menores de 5 anos,2005-10-01,40,38,40,38,78
CONCEPCION,consulta externa,repetidas en menores de 5 anos,2005-10-01,2,1,2,1,3
COPACABANA,consulta externa,repetidas en menores de 5 anos,2005-10-01,1,0,1,0,1
CORIPATA,consulta externa,repetidas en menores de 5 anos,2005-10-01,3,4,3,4,7
CORO CORO,consulta externa,repetidas en menores de 5 anos,2005-10-01,0,1,0,1,1
COROICO,consulta externa,repetidas en menores de 5 anos,2005-10-01,55,36,55,36,91
CORQUE,consulta externa,repetidas en menores de 5 anos,2005-10-01,18,23,18,23,41
COTAGAITA,consulta externa,repetidas en menores de 5 anos,2005-10-01,30,22,30,22,52
COTOCA,consulta externa,repetidas en menores de 5 anos,2005-10-01,10,8,10,8,18
CUATRO CAÑADAS,consulta externa,repetidas en menores de 5 anos,2005-10-01,40,34,40,34,74
CUCHUMUELA (V. G. VILLARROEL),consulta externa,repetidas en menores de 5 anos,2005-10-01,6,2,6,2,8
CUEVO,consulta externa,repetidas en menores de 5 anos,2005-10-01,17,14,17,14,31
CULPINA,consulta externa,repetidas en menores de 5 anos,2005-10-01,40,33,40,33,73
CURAHUARA DE CARANGAS,consulta externa,repetidas en menores de 5 anos,2005-10-01,2,6,2,6,8
DESAGUADERO,consulta externa,repetidas en menores de 5 anos,2005-10-01,5,6,5,6,11
EL ALTO,consulta externa,repetidas en menores de 5 anos,2005-10-01,2343,2570,2343,2570,4913
EL CHORO,consulta externa,repetidas en menores de 5 anos,2005-10-01,3,5,3,5,8
EL PUENTE(STC),consulta externa,repetidas en menores de 5 anos,2005-10-01,15,7,15,7,22
EL PUENTE(TJA),consulta externa,repetidas en menores de 5 anos,2005-10-01,72,76,72,76,148
EL TORNO,consulta externa,repetidas en menores de 5 anos,2005-10-01,81,74,81,74,155
EL VILLAR,consulta externa,repetidas en menores de 5 anos,2005-10-01,2,7,2,7,9
ENTRE RIOS,consulta externa,repetidas en menores de 5 anos,2005-10-01,9,10,9,10,19
ENTRE RIOS,consulta externa,repetidas en menores de 5 anos,2005-10-01,90,82,90,82,172
EUCALIPTUS,consulta externa,repetidas en menores de 5 anos,2005-10-01,31,15,31,15,46
EXALTACION,consulta externa,repetidas en menores de 5 anos,2005-10-01,5,11,5,11,16
FERNANDEZ ALONSO,consulta externa,repetidas en menores de 5 anos,2005-10-01,12,14,12,14,26
FILADELFIA,consulta externa,repetidas en menores de 5 anos,2005-10-01,9,4,9,4,13
GENERAL SAAVEDRA,consulta externa,repetidas en menores de 5 anos,2005-10-01,22,12,22,12,34
GRAL. J.J. PEREZ (CHARAZANI),consulta externa,repetidas en menores de 5 anos,2005-10-01,15,8,15,8,23
GUANAY,consulta externa,repetidas en menores de 5 anos,2005-10-01,4,1,4,1,5
GUAQUI,consulta externa,repetidas en menores de 5 anos,2005-10-01,7,6,7,6,13
GUAYARAMERIN,consulta externa,repetidas en menores de 5 anos,2005-10-01,128,93,128,93,221
GUTIERREZ,consulta externa,repetidas en menores de 5 anos,2005-10-01,133,147,133,147,280
HUACARETA,consulta externa,repetidas en menores de 5 anos,2005-10-01,40,34,40,34,74
HUACAYA (VILLA DE HUACAYA),consulta externa,repetidas en menores de 5 anos,2005-10-01,5,0,5,0,5
HUACHACALLA,consulta externa,repetidas en menores de 5 anos,2005-10-01,6,1,6,1,7
HUANUNI,consulta externa,repetidas en menores de 5 anos,2005-10-01,97,68,97,68,165
HUARACAJE,consulta externa,repetidas en menores de 5 anos,2005-10-01,20,10,20,10,30
HUAYLLAMARCA,consulta externa,repetidas en menores de 5 anos,2005-10-01,1,2,1,2,3
ICHOCA,consulta externa,repetidas en menores de 5 anos,2005-10-01,3,0,3,0,3
ICLA,consulta externa,repetidas en menores de 5 anos,2005-10-01,3,5,3,5,8
INCAHUASI,consulta externa,repetidas en menores de 5 anos,2005-10-01,5,9,5,9,14
INGAVI (HUMAITA),consulta externa,repetidas en menores de 5 anos,2005-10-01,2,0,2,0,2
INQUISIVI,consulta externa,repetidas en menores de 5 anos,2005-10-01,0,2,0,2,2
IRUPANA (VILLA DE LANZA),consulta externa,repetidas en menores de 5 anos,2005-10-01,5,4,5,4,9
IXIAMAS,consulta externa,repetidas en menores de 5 anos,2005-10-01,13,4,13,4,17
JESUS DE MACHACA,consulta externa,repetidas en menores de 5 anos,2005-10-01,3,12,3,12,15
LA ASUNTA,consulta externa,repetidas en menores de 5 anos,2005-10-01,7,6,7,6,13
LA GUARDIA,consulta externa,repetidas en menores de 5 anos,2005-10-01,137,118,137,118,255
LA PAZ,consulta externa,repetidas en menores de 5 anos,2005-10-01,4246,4415,4246,4415,8661
LA RIVERA,consulta externa,repetidas en menores de 5 anos,2005-10-01,1,0,1,0,1
LAGUNILLAS,consulta externa,repetidas en menores de 5 anos,2005-10-01,16,30,16,30,46
LAJA,consulta externa,repetidas en menores de 5 anos,2005-10-01,7,7,7,7,14
LAS CARRERAS,consulta externa,repetidas en menores de 5 anos,2005-10-01,5,4,5,4,9
LLALLAGUA,consulta externa,repetidas en menores de 5 anos,2005-10-01,49,44,49,44,93
LLICA,consulta externa,repetidas en menores de 5 anos,2005-10-01,4,2,4,2,6
LORETO,consulta externa,repetidas en menores de 5 anos,2005-10-01,29,25,29,25,54
LURIBAY,consulta externa,repetidas en menores de 5 anos,2005-10-01,0,2,0,2,2
MACHACAMARCA,consulta externa,repetidas en menores de 5 anos,2005-10-01,0,10,0,10,10
MACHARETI,consulta externa,repetidas en menores de 5 anos,2005-10-01,9,14,9,14,23
MAGDALENA,consulta externa,repetidas en menores de 5 anos,2005-10-01,21,31,21,31,52
MAIRANA,consulta externa,repetidas en menores de 5 anos,2005-10-01,8,7,8,7,15
MALLA,consulta externa,repetidas en menores de 5 anos,2005-10-01,7,5,7,5,12
MAPIRI,consulta externa,repetidas en menores de 5 anos,2005-10-01,7,5,7,5,12
MECAPACA,consulta externa,repetidas en menores de 5 anos,2005-10-01,24,21,24,21,45
MINEROS,consulta externa,repetidas en menores de 5 anos,2005-10-01,18,7,18,7,25
MIZQUE,consulta externa,repetidas en menores de 5 anos,2005-10-01,12,11,12,11,23
MOCOMOCO,consulta externa,repetidas en menores de 5 anos,2005-10-01,6,3,6,3,9
MOJINETE,consulta externa,repetidas en menores de 5 anos,2005-10-01,14,10,14,10,24
MOJOCOYA,consulta externa,repetidas en menores de 5 anos,2005-10-01,5,5,5,5,10
MONTEAGUDO,consulta externa,repetidas en menores de 5 anos,2005-10-01,69,63,69,63,132
MONTERO,consulta externa,repetidas en menores de 5 anos,2005-10-01,616,448,616,448,1064
MORO MORO,consulta externa,repetidas en menores de 5 anos,2005-10-01,1,0,1,0,1
MOROCHATA,consulta externa,repetidas en menores de 5 anos,2005-10-01,86,72,86,72,158
NACEBE (SANTA ROSA DEL ABUNA),consulta externa,repetidas en menores de 5 anos,2005-10-01,1,1,1,1,2
OCURI,consulta externa,repetidas en menores de 5 anos,2005-10-01,1,1,1,1,2
OKINAWA,consulta externa,repetidas en menores de 5 anos,2005-10-01,13,14,13,14,27
OMEREQUE,consulta externa,repetidas en menores de 5 anos,2005-10-01,19,12,19,12,31
ORURO,consulta externa,repetidas en menores de 5 anos,2005-10-01,653,650,653,650,1303
PADCAYA,consulta externa,repetidas en menores de 5 anos,2005-10-01,16,16,16,16,32
PADILLA,consulta externa,repetidas en menores de 5 anos,2005-10-01,2,3,2,3,5
PAILON,consulta externa,repetidas en menores de 5 anos,2005-10-01,12,14,12,14,26
PALCA,consulta externa,repetidas en menores de 5 anos,2005-10-01,2,2,2,2,4
PALOS BLANCOS,consulta externa,repetidas en menores de 5 anos,2005-10-01,57,52,57,52,109
PAMPA AULLAGAS,consulta externa,repetidas en menores de 5 anos,2005-10-01,2,1,2,1,3
PAMPA GRANDE,consulta externa,repetidas en menores de 5 anos,2005-10-01,6,11,6,11,17
PAPEL PAMPA,consulta externa,repetidas en menores de 5 anos,2005-10-01,3,7,3,7,10
PASORAPA,consulta externa,repetidas en menores de 5 anos,2005-10-01,1,0,1,0,1
PATACAMAYA,consulta externa,repetidas en menores de 5 anos,2005-10-01,9,10,9,10,19
PAZÑA,consulta externa,repetidas en menores de 5 anos,2005-10-01,13,6,13,6,19
PELECHUCO,consulta externa,repetidas en menores de 5 anos,2005-10-01,1,4,1,4,5
POCOATA,consulta externa,repetidas en menores de 5 anos,2005-10-01,6,9,6,9,15
POCONA,consulta externa,repetidas en menores de 5 anos,2005-10-01,15,18,15,18,33
POJO (CBBA),consulta externa,repetidas en menores de 5 anos,2005-10-01,7,7,7,7,14
PORCO,consulta externa,repetidas en menores de 5 anos,2005-10-01,7,5,7,5,12
POROMA,consulta externa,repetidas en menores de 5 anos,2005-10-01,3,3,3,3,6
PORONGO,consulta externa,repetidas en menores de 5 anos,2005-10-01,14,10,14,10,24
PORTACHUELO,consulta externa,repetidas en menores de 5 anos,2005-10-01,39,50,39,50,89
POSTRER VALLE,consulta externa,repetidas en menores de 5 anos,2005-10-01,2,1,2,1,3
POTOSI,consulta externa,repetidas en menores de 5 anos,2005-10-01,485,503,485,503,988
PRESTO,consulta externa,repetidas en menores de 5 anos,2005-10-01,2,4,2,4,6
PUCARA,consulta externa,repetidas en menores de 5 anos,2005-10-01,6,1,6,1,7
PUCARANI,consulta externa,repetidas en menores de 5 anos,2005-10-01,5,1,5,1,6
PUERTO ACOSTA,consulta externa,repetidas en menores de 5 anos,2005-10-01,40,49,40,49,89
PUERTO CARABUCO,consulta externa,repetidas en menores de 5 anos,2005-10-01,2,0,2,0,2
PUERTO GONZALO MORENO,consulta externa,repetidas en menores de 5 anos,2005-10-01,32,25,32,25,57
PUERTO PEREZ,consulta externa,repetidas en menores de 5 anos,2005-10-01,0,3,0,3,3
PUERTO QUIJARRO,consulta externa,repetidas en menores de 5 anos,2005-10-01,31,26,31,26,57
PUERTO RICO,consulta externa,repetidas en menores de 5 anos,2005-10-01,2,2,2,2,4
PUERTO SILES,consulta externa,repetidas en menores de 5 anos,2005-10-01,4,0,4,0,4
PUERTO SUAREZ,consulta externa,repetidas en menores de 5 anos,2005-10-01,20,16,20,16,36
PUERTO VILLARROEL,consulta externa,repetidas en menores de 5 anos,2005-10-01,93,89,93,89,182
PUNA,consulta externa,repetidas en menores de 5 anos,2005-10-01,17,19,17,19,36
PUNATA,consulta externa,repetidas en menores de 5 anos,2005-10-01,81,91,81,91,172
QUILLACOLLO,consulta externa,repetidas en menores de 5 anos,2005-10-01,330,268,330,268,598
QUIME,consulta externa,repetidas en menores de 5 anos,2005-10-01,14,5,14,5,19
QUIRUSILLAS,consulta externa,repetidas en menores de 5 anos,2005-10-01,0,2,0,2,2
RAVELO,consulta externa,repetidas en menores de 5 anos,2005-10-01,2,2,2,2,4
REYES,consulta externa,repetidas en menores de 5 anos,2005-10-01,8,16,8,16,24
RIBERALTA,consulta externa,repetidas en menores de 5 anos,2005-10-01,384,339,384,339,723
ROBORE,consulta externa,repetidas en menores de 5 anos,2005-10-01,10,13,10,13,23
RURRENABAQUE,consulta externa,repetidas en menores de 5 anos,2005-10-01,100,110,100,110,210
SABAYA,consulta externa,repetidas en menores de 5 anos,2005-10-01,7,7,7,7,14
SACABA,consulta externa,repetidas en menores de 5 anos,2005-10-01,258,299,258,299,557
SACABAMBA,consulta externa,repetidas en menores de 5 anos,2005-10-01,38,35,38,35,73
SACACA,consulta externa,repetidas en menores de 5 anos,2005-10-01,3,7,3,7,10
SAIPINA,consulta externa,repetidas en menores de 5 anos,2005-10-01,7,4,7,4,11
SALINAS DE GARCI MENDOZA,consulta externa,repetidas en menores de 5 anos,2005-10-01,8,12,8,12,20
SAMAIPATA,consulta externa,repetidas en menores de 5 anos,2005-10-01,7,4,7,4,11
SAN AGUSTIN,consulta externa,repetidas en menores de 5 anos,2005-10-01,1,1,1,1,2
SAN ANDRES,consulta externa,repetidas en menores de 5 anos,2005-10-01,34,22,34,22,56
SAN ANTONIO DE ESMORUCO,consulta externa,repetidas en menores de 5 anos,2005-10-01,0,6,0,6,6
SAN ANTONIO DE LOMERIO,consulta externa,repetidas en menores de 5 anos,2005-10-01,2,1,2,1,3
SAN BENITO,consulta externa,repetidas en menores de 5 anos,2005-10-01,37,49,37,49,86
SAN BORJA,consulta externa,repetidas en menores de 5 anos,2005-10-01,95,78,95,78,173
SAN BUENA VENTURA,consulta externa,repetidas en menores de 5 anos,2005-10-01,8,5,8,5,13
SAN CARLOS,consulta externa,repetidas en menores de 5 anos,2005-10-01,20,16,20,16,36
SAN IGNACIO,consulta externa,repetidas en menores de 5 anos,2005-10-01,104,69,104,69,173
SAN IGNACIO DE VELASCO,consulta externa,repetidas en menores de 5 anos,2005-10-01,155,117,155,117,272
SAN JAVIER(BNI),consulta externa,repetidas en menores de 5 anos,2005-10-01,3,4,3,4,7
SAN JAVIER(STC),consulta externa,repetidas en menores de 5 anos,2005-10-01,11,5,11,5,16
SAN JOAQUIN,consulta externa,repetidas en menores de 5 anos,2005-10-01,1,1,1,1,2
SAN JOSE DE CHIQUITOS,consulta externa,repetidas en menores de 5 anos,2005-10-01,6,5,6,5,11
SAN JUAN DE YAPACANI,consulta externa,repetidas en menores de 5 anos,2005-10-01,43,34,43,34,77
SAN JULIAN,consulta externa,repetidas en menores de 5 anos,2005-10-01,52,39,52,39,91
SAN LORENZO(PND),consulta externa,repetidas en menores de 5 anos,2005-10-01,7,2,7,2,9
SAN LORENZO(TJA),consulta externa,repetidas en menores de 5 anos,2005-10-01,29,20,29,20,49
SAN LUCAS,consulta externa,repetidas en menores de 5 anos,2005-10-01,19,15,19,15,34
SAN MATIAS,consulta externa,repetidas en menores de 5 anos,2005-10-01,15,12,15,12,27
SAN MIGUEL DE VELASCO,consulta externa,repetidas en menores de 5 anos,2005-10-01,53,47,53,47,100
SAN PABLO DE LIPEZ,consulta externa,repetidas en menores de 5 anos,2005-10-01,7,10,7,10,17
SAN PEDRO,consulta externa,repetidas en menores de 5 anos,2005-10-01,85,85,85,85,170
SAN PEDRO DE BUENA VISTA,consulta externa,repetidas en menores de 5 anos,2005-10-01,1,2,1,2,3
SAN PEDRO DE CURAHUARA,consulta externa,repetidas en menores de 5 anos,2005-10-01,13,2,13,2,15
SAN PEDRO DE QUEMES,consulta externa,repetidas en menores de 5 anos,2005-10-01,0,1,0,1,1
SAN PEDRO DE TIQUINA,consulta externa,repetidas en menores de 5 anos,2005-10-01,0,1,0,1,1
SAN PEDRO(PND),consulta externa,repetidas en menores de 5 anos,2005-10-01,1,1,1,1,2
SAN RAFAEL,consulta externa,repetidas en menores de 5 anos,2005-10-01,7,7,7,7,14
SAN RAMON,consulta externa,repetidas en menores de 5 anos,2005-10-01,4,3,4,3,7
SAN RAMON,consulta externa,repetidas en menores de 5 anos,2005-10-01,7,10,7,10,17
SANTA ANA,consulta externa,repetidas en menores de 5 anos,2005-10-01,13,9,13,9,22
SANTA CRUZ DE LA SIERRA,consulta externa,repetidas en menores de 5 anos,2005-10-01,3373,3351,3373,3351,6724
SANTA ROSA,consulta externa,repetidas en menores de 5 anos,2005-10-01,64,60,64,60,124
SANTA ROSA DEL SARA,consulta externa,repetidas en menores de 5 anos,2005-10-01,30,36,30,36,66
SANTIAGO DE CALLAPA,consulta externa,repetidas en menores de 5 anos,2005-10-01,1,0,1,0,1
SANTIAGO DE HUARI,consulta externa,repetidas en menores de 5 anos,2005-10-01,22,8,22,8,30
SANTIAGO DE MACHACA,consulta externa,repetidas en menores de 5 anos,2005-10-01,3,5,3,5,8
SANTIVAÑES,consulta externa,repetidas en menores de 5 anos,2005-10-01,28,36,28,36,64
SANTUARIO DE QUILLACAS,consulta externa,repetidas en menores de 5 anos,2005-10-01,3,3,3,3,6
SAPAHAQUI,consulta externa,repetidas en menores de 5 anos,2005-10-01,4,6,4,6,10
SENA,consulta externa,repetidas en menores de 5 anos,2005-10-01,2,2,2,2,4
SICA SICA (VILLA AROMA),consulta externa,repetidas en menores de 5 anos,2005-10-01,3,9,3,9,12
SICAYA,consulta externa,repetidas en menores de 5 anos,2005-10-01,3,0,3,0,3
SIPE SIPE,consulta externa,repetidas en menores de 5 anos,2005-10-01,199,158,199,158,357
SOPACHUY,consulta externa,repetidas en menores de 5 anos,2005-10-01,3,2,3,2,5
SORACACHI,consulta externa,repetidas en menores de 5 anos,2005-10-01,7,5,7,5,12
SORATA,consulta externa,repetidas en menores de 5 anos,2005-10-01,17,17,17,17,34
SUCRE,consulta externa,repetidas en menores de 5 anos,2005-10-01,924,830,924,830,1754
TACACHI,consulta externa,repetidas en menores de 5 anos,2005-10-01,19,11,19,11,30
TACOBAMBA,consulta externa,repetidas en menores de 5 anos,2005-10-01,2,1,2,1,3
TACOPAYA,consulta externa,repetidas en menores de 5 anos,2005-10-01,36,40,36,40,76
TAHUA,consulta externa,repetidas en menores de 5 anos,2005-10-01,0,1,0,1,1
TAPACARI,consulta externa,repetidas en menores de 5 anos,2005-10-01,27,26,27,26,53
TARABUCO,consulta externa,repetidas en menores de 5 anos,2005-10-01,188,202,188,202,390
TARATA,consulta externa,repetidas en menores de 5 anos,2005-10-01,15,17,15,17,32
TARIJA,consulta externa,repetidas en menores de 5 anos,2005-10-01,897,1042,897,1042,1939
TARVITA,consulta externa,repetidas en menores de 5 anos,2005-10-01,22,33,22,33,55
TEOPONTE,consulta externa,repetidas en menores de 5 anos,2005-10-01,6,6,6,6,12
TIAWANACU,consulta externa,repetidas en menores de 5 anos,2005-10-01,2,0,2,0,2
TINGUIPAYA,consulta externa,repetidas en menores de 5 anos,2005-10-01,2,0,2,0,2
TIPUANI,consulta externa,repetidas en menores de 5 anos,2005-10-01,34,36,34,36,70
TIQUIPAYA,consulta externa,repetidas en menores de 5 anos,2005-10-01,212,202,212,202,414
TIRAQUE (CBBA),consulta externa,repetidas en menores de 5 anos,2005-10-01,125,112,125,112,237
TITO YUPANQUI (PARQUIPUJIO),consulta externa,repetidas en menores de 5 anos,2005-10-01,4,0,4,0,4
TOCO,consulta externa,repetidas en menores de 5 anos,2005-10-01,3,9,3,9,12
TODOS SANTOS,consulta externa,repetidas en menores de 5 anos,2005-10-01,1,0,1,0,1
TOLATA,consulta externa,repetidas en menores de 5 anos,2005-10-01,16,18,16,18,34
TOLEDO,consulta externa,repetidas en menores de 5 anos,2005-10-01,6,12,6,12,18
TOMAVE,consulta externa,repetidas en menores de 5 anos,2005-10-01,2,2,2,2,4
TOMINA,consulta externa,repetidas en menores de 5 anos,2005-10-01,5,14,5,14,19
TORO TORO,consulta externa,repetidas en menores de 5 anos,2005-10-01,16,7,16,7,23
TOTORA(CBBA),consulta externa,repetidas en menores de 5 anos,2005-10-01,21,17,21,17,38
TOTORA(ORR),consulta externa,repetidas en menores de 5 anos,2005-10-01,2,5,2,5,7
TRIGAL,consulta externa,repetidas en menores de 5 anos,2005-10-01,2,2,2,2,4
TRINIDAD,consulta externa,repetidas en menores de 5 anos,2005-10-01,316,303,316,303,619
TUPIZA,consulta externa,repetidas en menores de 5 anos,2005-10-01,77,76,77,76,153
TURCO,consulta externa,repetidas en menores de 5 anos,2005-10-01,1,1,1,1,2
UNCIA,consulta externa,repetidas en menores de 5 anos,2005-10-01,32,28,32,28,60
URIONDO (A. CONCEPCION),consulta externa,repetidas en menores de 5 anos,2005-10-01,36,42,36,42,78
URUBICHA,consulta externa,repetidas en menores de 5 anos,2005-10-01,7,3,7,3,10
UYUNI,consulta externa,repetidas en menores de 5 anos,2005-10-01,9,4,9,4,13
VACAS,consulta externa,repetidas en menores de 5 anos,2005-10-01,80,54,80,54,134
VALLEGRANDE,consulta externa,repetidas en menores de 5 anos,2005-10-01,11,12,11,12,23
VIACHA,consulta externa,repetidas en menores de 5 anos,2005-10-01,78,80,78,80,158
VILA VILA,consulta externa,repetidas en menores de 5 anos,2005-10-01,2,2,2,2,4
VILLA MONTES,consulta externa,repetidas en menores de 5 anos,2005-10-01,38,20,38,20,58
VILLA NUEVA (LOMA ALTA),consulta externa,repetidas en menores de 5 anos,2005-10-01,5,5,5,5,10
VILLA RIVERO,consulta externa,repetidas en menores de 5 anos,2005-10-01,39,30,39,30,69
VILLA SERRANO,consulta externa,repetidas en menores de 5 anos,2005-10-01,11,10,11,10,21
VILLA TUNARI,consulta externa,repetidas en menores de 5 anos,2005-10-01,109,104,109,104,213
VILLA VACA GUZMAN (MUYUPAMPA),consulta externa,repetidas en menores de 5 anos,2005-10-01,29,18,29,18,47
VILLAZON,consulta externa,repetidas en menores de 5 anos,2005-10-01,35,53,35,53,88
VINTO,consulta externa,repetidas en menores de 5 anos,2005-10-01,187,149,187,149,336
VITICHI,consulta externa,repetidas en menores de 5 anos,2005-10-01,8,5,8,5,13
WALDO BALLIVIAN,consulta externa,repetidas en menores de 5 anos,2005-10-01,0,1,0,1,1
WARNES,consulta externa,repetidas en menores de 5 anos,2005-10-01,101,65,101,65,166
YACO,consulta externa,repetidas en menores de 5 anos,2005-10-01,3,1,3,1,4
YACUIBA,consulta externa,repetidas en menores de 5 anos,2005-10-01,254,245,254,245,499
YAMPARAEZ,consulta externa,repetidas en menores de 5 anos,2005-10-01,17,17,17,17,34
YANACACHI,consulta externa,repetidas en menores de 5 anos,2005-10-01,1,2,1,2,3
YAPACANI,consulta externa,repetidas en menores de 5 anos,2005-10-01,21,30,21,30,51
YOCALLA,consulta externa,repetidas en menores de 5 anos,2005-10-01,8,11,8,11,19
YOTALA,consulta externa,repetidas en menores de 5 anos,2005-10-01,32,31,32,31,63
YUNCHARA,consulta externa,repetidas en menores de 5 anos,2005-10-01,4,8,4,8,12
ZUDAÑEZ,consulta externa,repetidas en menores de 5 anos,2005-10-01,12,8,12,8,20
ACACIO,consulta externa,repetidas en menores de 5 anos,2005-11-01,0,1,0,1,1
ACHACACHI,consulta externa,repetidas en menores de 5 anos,2005-11-01,13,11,13,11,24
ACHOCALLA,consulta externa,repetidas en menores de 5 anos,2005-11-01,2,4,2,4,6
AIQUILE,consulta externa,repetidas en menores de 5 anos,2005-11-01,124,114,124,114,238
ALALAY,consulta externa,repetidas en menores de 5 anos,2005-11-01,2,0,2,0,2
ANCORAIMES,consulta externa,repetidas en menores de 5 anos,2005-11-01,11,2,11,2,13
ANDAMARCA,consulta externa,repetidas en menores de 5 anos,2005-11-01,2,2,2,2,4
ANTEQUERA,consulta externa,repetidas en menores de 5 anos,2005-11-01,6,3,6,3,9
ANZALDO,consulta externa,repetidas en menores de 5 anos,2005-11-01,21,20,21,20,41
APOLO,consulta externa,repetidas en menores de 5 anos,2005-11-01,15,13,15,13,28
ARANI,consulta externa,repetidas en menores de 5 anos,2005-11-01,31,27,31,27,58
ARBIETO,consulta externa,repetidas en menores de 5 anos,2005-11-01,16,22,16,22,38
ARQUE,consulta externa,repetidas en menores de 5 anos,2005-11-01,40,40,40,40,80
ASCENCION DE GUARAYOS,consulta externa,repetidas en menores de 5 anos,2005-11-01,42,28,42,28,70
ATOCHA,consulta externa,repetidas en menores de 5 anos,2005-11-01,46,34,46,34,80
AUCAPATA,consulta externa,repetidas en menores de 5 anos,2005-11-01,0,1,0,1,1
AYATA,consulta externa,repetidas en menores de 5 anos,2005-11-01,5,4,5,4,9
AYO AYO,consulta externa,repetidas en menores de 5 anos,2005-11-01,7,9,7,9,16
AYOPAYA (V. DE INDEPENDENCIA),consulta externa,repetidas en menores de 5 anos,2005-11-01,12,13,12,13,25
AZURDUY,consulta externa,repetidas en menores de 5 anos,2005-11-01,5,6,5,6,11
BATALLAS,consulta externa,repetidas en menores de 5 anos,2005-11-01,0,3,0,3,3
BAURES,consulta externa,repetidas en menores de 5 anos,2005-11-01,6,3,6,3,9
BELEN DE ANDAMARCA,consulta externa,repetidas en menores de 5 anos,2005-11-01,6,2,6,2,8
BELEN DE URMIRI,consulta externa,repetidas en menores de 5 anos,2005-11-01,4,3,4,3,7
BELLA FLOR,consulta externa,repetidas en menores de 5 anos,2005-11-01,14,9,14,9,23
BERMEJO,consulta externa,repetidas en menores de 5 anos,2005-11-01,57,60,57,60,117
BETANZOS,consulta externa,repetidas en menores de 5 anos,2005-11-01,22,24,22,24,46
BOLIVAR,consulta externa,repetidas en menores de 5 anos,2005-11-01,24,22,24,22,46
BOLPEBRA,consulta externa,repetidas en menores de 5 anos,2005-11-01,9,2,9,2,11
BOYUIBE,consulta externa,repetidas en menores de 5 anos,2005-11-01,4,8,4,8,12
BUENA VISTA,consulta externa,repetidas en menores de 5 anos,2005-11-01,122,86,122,86,208
CABEZAS,consulta externa,repetidas en menores de 5 anos,2005-11-01,26,18,26,18,44
CAIROMA,consulta externa,repetidas en menores de 5 anos,2005-11-01,4,5,4,5,9
"CAIZA ""D""",consulta externa,repetidas en menores de 5 anos,2005-11-01,6,2,6,2,8
CAJUATA,consulta externa,repetidas en menores de 5 anos,2005-11-01,5,2,5,2,7
CALACOTO,consulta externa,repetidas en menores de 5 anos,2005-11-01,1,0,1,0,1
CALAMARCA,consulta externa,repetidas en menores de 5 anos,2005-11-01,7,11,7,11,18
CAMARGO,consulta externa,repetidas en menores de 5 anos,2005-11-01,17,10,17,10,27
CAMATAQUI (C. VILLA ABECIA),consulta externa,repetidas en menores de 5 anos,2005-11-01,4,1,4,1,5
CAMIRI,consulta externa,repetidas en menores de 5 anos,2005-11-01,207,202,207,202,409
CAPINOTA,consulta externa,repetidas en menores de 5 anos,2005-11-01,68,61,68,61,129
CAQUIAVIRI,consulta externa,repetidas en menores de 5 anos,2005-11-01,4,1,4,1,5
CARACOLLO,consulta externa,repetidas en menores de 5 anos,2005-11-01,4,3,4,3,7
CARANAVI,consulta externa,repetidas en menores de 5 anos,2005-11-01,55,32,55,32,87
CARANGAS,consulta externa,repetidas en menores de 5 anos,2005-11-01,0,1,0,1,1
CARAPARI,consulta externa,repetidas en menores de 5 anos,2005-11-01,9,5,9,5,14
CARIPUYO,consulta externa,repetidas en menores de 5 anos,2005-11-01,5,4,5,4,9
CHACARILLA,consulta externa,repetidas en menores de 5 anos,2005-11-01,1,0,1,0,1
CHALLAPATA,consulta externa,repetidas en menores de 5 anos,2005-11-01,7,11,7,11,18
CHAQUI,consulta externa,repetidas en menores de 5 anos,2005-11-01,1,0,1,0,1
CHARAGUA,consulta externa,repetidas en menores de 5 anos,2005-11-01,56,69,56,69,125
CHARAÑA,consulta externa,repetidas en menores de 5 anos,2005-11-01,2,3,2,3,5
CHAYANTA,consulta externa,repetidas en menores de 5 anos,2005-11-01,5,7,5,7,12
CHIMORE,consulta externa,repetidas en menores de 5 anos,2005-11-01,42,45,42,45,87
CHIPAYA,consulta externa,repetidas en menores de 5 anos,2005-11-01,9,7,9,7,16
CHOQUE COTA,consulta externa,repetidas en menores de 5 anos,2005-11-01,0,3,0,3,3
CHULUMANI (V. DE LA LIBERTAD),consulta externa,repetidas en menores de 5 anos,2005-11-01,13,20,13,20,33
CHUMA,consulta externa,repetidas en menores de 5 anos,2005-11-01,4,4,4,4,8
CLIZA,consulta externa,repetidas en menores de 5 anos,2005-11-01,34,22,34,22,56
COBIJA,consulta externa,repetidas en menores de 5 anos,2005-11-01,116,104,116,104,220
COCHABAMBA,consulta externa,repetidas en menores de 5 anos,2005-11-01,3246,3009,3246,3009,6255
COLCAPIRHUA,consulta externa,repetidas en menores de 5 anos,2005-11-01,123,117,123,117,240
"COLCHA ""K""",consulta externa,repetidas en menores de 5 anos,2005-11-01,10,8,10,8,18
COLLANA,consulta externa,repetidas en menores de 5 anos,2005-11-01,4,3,4,3,7
COLOMI,consulta externa,repetidas en menores de 5 anos,2005-11-01,22,21,22,21,43
COLPA BELGICA,consulta externa,repetidas en menores de 5 anos,2005-11-01,12,15,12,15,27
COLQUECHACA,consulta externa,repetidas en menores de 5 anos,2005-11-01,4,4,4,4,8
COLQUENCHA,consulta externa,repetidas en menores de 5 anos,2005-11-01,4,5,4,5,9
COLQUIRI,consulta externa,repetidas en menores de 5 anos,2005-11-01,37,36,37,36,73
COMANCHE,consulta externa,repetidas en menores de 5 anos,2005-11-01,5,5,5,5,10
COMARAPA,consulta externa,repetidas en menores de 5 anos,2005-11-01,29,43,29,43,72
COMBAYA,consulta externa,repetidas en menores de 5 anos,2005-11-01,1,2,1,2,3
CORIPATA,consulta externa,repetidas en menores de 5 anos,2005-11-01,3,2,3,2,5
CORO CORO,consulta externa,repetidas en menores de 5 anos,2005-11-01,3,5,3,5,8
COROICO,consulta externa,repetidas en menores de 5 anos,2005-11-01,28,26,28,26,54
CORQUE,consulta externa,repetidas en menores de 5 anos,2005-11-01,12,16,12,16,28
COTAGAITA,consulta externa,repetidas en menores de 5 anos,2005-11-01,20,12,20,12,32
COTOCA,consulta externa,repetidas en menores de 5 anos,2005-11-01,12,15,12,15,27
CUATRO CAÑADAS,consulta externa,repetidas en menores de 5 anos,2005-11-01,20,27,20,27,47
CUCHUMUELA (V. G. VILLARROEL),consulta externa,repetidas en menores de 5 anos,2005-11-01,5,3,5,3,8
CUEVO,consulta externa,repetidas en menores de 5 anos,2005-11-01,14,24,14,24,38
CULPINA,consulta externa,repetidas en menores de 5 anos,2005-11-01,42,46,42,46,88
CURAHUARA DE CARANGAS,consulta externa,repetidas en menores de 5 anos,2005-11-01,2,5,2,5,7
CURVA,consulta externa,repetidas en menores de 5 anos,2005-11-01,1,0,1,0,1
EL ALTO,consulta externa,repetidas en menores de 5 anos,2005-11-01,2125,1878,2125,1878,4003
EL CHORO,consulta externa,repetidas en menores de 5 anos,2005-11-01,3,5,3,5,8
EL PUENTE(STC),consulta externa,repetidas en menores de 5 anos,2005-11-01,4,7,4,7,11
EL PUENTE(TJA),consulta externa,repetidas en menores de 5 anos,2005-11-01,129,139,129,139,268
EL TORNO,consulta externa,repetidas en menores de 5 anos,2005-11-01,67,61,67,61,128
EL VILLAR,consulta externa,repetidas en menores de 5 anos,2005-11-01,2,0,2,0,2
ENTRE RIOS,consulta externa,repetidas en menores de 5 anos,2005-11-01,9,3,9,3,12
ENTRE RIOS,consulta externa,repetidas en menores de 5 anos,2005-11-01,161,742,161,742,903
EUCALIPTUS,consulta externa,repetidas en menores de 5 anos,2005-11-01,11,2,11,2,13
EUREKA (SANTOS MERCADO),consulta externa,repetidas en menores de 5 anos,2005-11-01,1,1,1,1,2
EXALTACION,consulta externa,repetidas en menores de 5 anos,2005-11-01,12,8,12,8,20
FERNANDEZ ALONSO,consulta externa,repetidas en menores de 5 anos,2005-11-01,33,25,33,25,58
FILADELFIA,consulta externa,repetidas en menores de 5 anos,2005-11-01,3,3,3,3,6
GENERAL SAAVEDRA,consulta externa,repetidas en menores de 5 anos,2005-11-01,37,61,37,61,98
GRAL. J.J. PEREZ (CHARAZANI),consulta externa,repetidas en menores de 5 anos,2005-11-01,8,3,8,3,11
GUANAY,consulta externa,repetidas en menores de 5 anos,2005-11-01,2,1,2,1,3
GUAQUI,consulta externa,repetidas en menores de 5 anos,2005-11-01,2,3,2,3,5
GUAYARAMERIN,consulta externa,repetidas en menores de 5 anos,2005-11-01,67,63,67,63,130
GUTIERREZ,consulta externa,repetidas en menores de 5 anos,2005-11-01,27,46,27,46,73
HUACARETA,consulta externa,repetidas en menores de 5 anos,2005-11-01,72,65,72,65,137
HUACHACALLA,consulta externa,repetidas en menores de 5 anos,2005-11-01,7,1,7,1,8
HUANUNI,consulta externa,repetidas en menores de 5 anos,2005-11-01,115,105,115,105,220
HUARACAJE,consulta externa,repetidas en menores de 5 anos,2005-11-01,22,27,22,27,49
HUAYLLAMARCA,consulta externa,repetidas en menores de 5 anos,2005-11-01,1,2,1,2,3
ICHOCA,consulta externa,repetidas en menores de 5 anos,2005-11-01,1,2,1,2,3
ICLA,consulta externa,repetidas en menores de 5 anos,2005-11-01,7,10,7,10,17
INCAHUASI,consulta externa,repetidas en menores de 5 anos,2005-11-01,3,3,3,3,6
INGAVI (HUMAITA),consulta externa,repetidas en menores de 5 anos,2005-11-01,8,3,8,3,11
INQUISIVI,consulta externa,repetidas en menores de 5 anos,2005-11-01,5,8,5,8,13
IRUPANA (VILLA DE LANZA),consulta externa,repetidas en menores de 5 anos,2005-11-01,8,6,8,6,14
IXIAMAS,consulta externa,repetidas en menores de 5 anos,2005-11-01,14,9,14,9,23
JESUS DE MACHACA,consulta externa,repetidas en menores de 5 anos,2005-11-01,6,8,6,8,14
LA ASUNTA,consulta externa,repetidas en menores de 5 anos,2005-11-01,3,3,3,3,6
LA GUARDIA,consulta externa,repetidas en menores de 5 anos,2005-11-01,71,96,71,96,167
LA PAZ,consulta externa,repetidas en menores de 5 anos,2005-11-01,4494,4441,4494,4441,8935
LA RIVERA,consulta externa,repetidas en menores de 5 anos,2005-11-01,0,1,0,1,1
LAGUNILLAS,consulta externa,repetidas en menores de 5 anos,2005-11-01,8,7,8,7,15
LAJA,consulta externa,repetidas en menores de 5 anos,2005-11-01,2,7,2,7,9
LAS CARRERAS,consulta externa,repetidas en menores de 5 anos,2005-11-01,3,4,3,4,7
LICOMA PAMPA,consulta externa,repetidas en menores de 5 anos,2005-11-01,0,2,0,2,2
LLALLAGUA,consulta externa,repetidas en menores de 5 anos,2005-11-01,52,36,52,36,88
LLICA,consulta externa,repetidas en menores de 5 anos,2005-11-01,1,5,1,5,6
LORETO,consulta externa,repetidas en menores de 5 anos,2005-11-01,9,10,9,10,19
LURIBAY,consulta externa,repetidas en menores de 5 anos,2005-11-01,4,0,4,0,4
MACHACAMARCA,consulta externa,repetidas en menores de 5 anos,2005-11-01,0,1,0,1,1
MACHARETI,consulta externa,repetidas en menores de 5 anos,2005-11-01,13,5,13,5,18
MAGDALENA,consulta externa,repetidas en menores de 5 anos,2005-11-01,27,36,27,36,63
MAIRANA,consulta externa,repetidas en menores de 5 anos,2005-11-01,7,6,7,6,13
MALLA,consulta externa,repetidas en menores de 5 anos,2005-11-01,1,3,1,3,4
MAPIRI,consulta externa,repetidas en menores de 5 anos,2005-11-01,8,8,8,8,16
MECAPACA,consulta externa,repetidas en menores de 5 anos,2005-11-01,14,11,14,11,25
MINEROS,consulta externa,repetidas en menores de 5 anos,2005-11-01,24,9,24,9,33
MIZQUE,consulta externa,repetidas en menores de 5 anos,2005-11-01,15,10,15,10,25
MOCOMOCO,consulta externa,repetidas en menores de 5 anos,2005-11-01,5,8,5,8,13
MOJINETE,consulta externa,repetidas en menores de 5 anos,2005-11-01,4,1,4,1,5
MOJOCOYA,consulta externa,repetidas en menores de 5 anos,2005-11-01,4,1,4,1,5
MONTEAGUDO,consulta externa,repetidas en menores de 5 anos,2005-11-01,60,59,60,59,119
MONTERO,consulta externa,repetidas en menores de 5 anos,2005-11-01,519,573,519,573,1092
MORO MORO,consulta externa,repetidas en menores de 5 anos,2005-11-01,2,0,2,0,2
MOROCHATA,consulta externa,repetidas en menores de 5 anos,2005-11-01,125,115,125,115,240
NUEVO MANOA (NUEVA ESPERANZA),consulta externa,repetidas en menores de 5 anos,2005-11-01,2,0,2,0,2
OCURI,consulta externa,repetidas en menores de 5 anos,2005-11-01,4,1,4,1,5
OKINAWA,consulta externa,repetidas en menores de 5 anos,2005-11-01,17,20,17,20,37
OMEREQUE,consulta externa,repetidas en menores de 5 anos,2005-11-01,18,12,18,12,30
ORURO,consulta externa,repetidas en menores de 5 anos,2005-11-01,613,487,613,487,1100
PADCAYA,consulta externa,repetidas en menores de 5 anos,2005-11-01,20,26,20,26,46
PADILLA,consulta externa,repetidas en menores de 5 anos,2005-11-01,11,2,11,2,13
PAILON,consulta externa,repetidas en menores de 5 anos,2005-11-01,17,28,17,28,45
PALCA,consulta externa,repetidas en menores de 5 anos,2005-11-01,3,4,3,4,7
PALOS BLANCOS,consulta externa,repetidas en menores de 5 anos,2005-11-01,65,42,65,42,107
PAMPA GRANDE,consulta externa,repetidas en menores de 5 anos,2005-11-01,4,8,4,8,12
PAPEL PAMPA,consulta externa,repetidas en menores de 5 anos,2005-11-01,2,3,2,3,5
PASORAPA,consulta externa,repetidas en menores de 5 anos,2005-11-01,2,0,2,0,2
PATACAMAYA,consulta externa,repetidas en menores de 5 anos,2005-11-01,10,7,10,7,17
PAZÑA,consulta externa,repetidas en menores de 5 anos,2005-11-01,6,7,6,7,13
PELECHUCO,consulta externa,repetidas en menores de 5 anos,2005-11-01,3,6,3,6,9
POCOATA,consulta externa,repetidas en menores de 5 anos,2005-11-01,5,5,5,5,10
POCONA,consulta externa,repetidas en menores de 5 anos,2005-11-01,7,4,7,4,11
POJO (CBBA),consulta externa,repetidas en menores de 5 anos,2005-11-01,9,20,9,20,29
PORCO,consulta externa,repetidas en menores de 5 anos,2005-11-01,9,1,9,1,10
POROMA,consulta externa,repetidas en menores de 5 anos,2005-11-01,4,3,4,3,7
PORONGO,consulta externa,repetidas en menores de 5 anos,2005-11-01,37,20,37,20,57
PORTACHUELO,consulta externa,repetidas en menores de 5 anos,2005-11-01,73,46,73,46,119
PORVENIR,consulta externa,repetidas en menores de 5 anos,2005-11-01,1,0,1,0,1
POSTRER VALLE,consulta externa,repetidas en menores de 5 anos,2005-11-01,0,1,0,1,1
POTOSI,consulta externa,repetidas en menores de 5 anos,2005-11-01,496,545,496,545,1041
PRESTO,consulta externa,repetidas en menores de 5 anos,2005-11-01,6,4,6,4,10
PUCARA,consulta externa,repetidas en menores de 5 anos,2005-11-01,3,0,3,0,3
PUCARANI,consulta externa,repetidas en menores de 5 anos,2005-11-01,5,4,5,4,9
PUERTO ACOSTA,consulta externa,repetidas en menores de 5 anos,2005-11-01,45,74,45,74,119
PUERTO CARABUCO,consulta externa,repetidas en menores de 5 anos,2005-11-01,5,5,5,5,10
PUERTO GONZALO MORENO,consulta externa,repetidas en menores de 5 anos,2005-11-01,12,12,12,12,24
PUERTO PEREZ,consulta externa,repetidas en menores de 5 anos,2005-11-01,1,3,1,3,4
PUERTO QUIJARRO,consulta externa,repetidas en menores de 5 anos,2005-11-01,13,20,13,20,33
PUERTO RICO,consulta externa,repetidas en menores de 5 anos,2005-11-01,10,4,10,4,14
PUERTO SILES,consulta externa,repetidas en menores de 5 anos,2005-11-01,2,0,2,0,2
PUERTO SUAREZ,consulta externa,repetidas en menores de 5 anos,2005-11-01,24,12,24,12,36
PUERTO VILLARROEL,consulta externa,repetidas en menores de 5 anos,2005-11-01,93,59,93,59,152
PUNA,consulta externa,repetidas en menores de 5 anos,2005-11-01,18,17,18,17,35
PUNATA,consulta externa,repetidas en menores de 5 anos,2005-11-01,91,66,91,66,157
QUILLACOLLO,consulta externa,repetidas en menores de 5 anos,2005-11-01,537,365,537,365,902
QUIME,consulta externa,repetidas en menores de 5 anos,2005-11-01,1,2,1,2,3
QUIRUSILLAS,consulta externa,repetidas en menores de 5 anos,2005-11-01,2,0,2,0,2
RAVELO,consulta externa,repetidas en menores de 5 anos,2005-11-01,1,2,1,2,3
REYES,consulta externa,repetidas en menores de 5 anos,2005-11-01,23,20,23,20,43
RIBERALTA,consulta externa,repetidas en menores de 5 anos,2005-11-01,329,316,329,316,645
ROBORE,consulta externa,repetidas en menores de 5 anos,2005-11-01,12,7,12,7,19
RURRENABAQUE,consulta externa,repetidas en menores de 5 anos,2005-11-01,90,86,90,86,176
SABAYA,consulta externa,repetidas en menores de 5 anos,2005-11-01,8,3,8,3,11
SACABA,consulta externa,repetidas en menores de 5 anos,2005-11-01,240,221,240,221,461
SACABAMBA,consulta externa,repetidas en menores de 5 anos,2005-11-01,27,29,27,29,56
SACACA,consulta externa,repetidas en menores de 5 anos,2005-11-01,1,4,1,4,5
SAIPINA,consulta externa,repetidas en menores de 5 anos,2005-11-01,25,50,25,50,75
SALINAS DE GARCI MENDOZA,consulta externa,repetidas en menores de 5 anos,2005-11-01,5,4,5,4,9
SAMAIPATA,consulta externa,repetidas en menores de 5 anos,2005-11-01,4,1,4,1,5
SAN ANDRES,consulta externa,repetidas en menores de 5 anos,2005-11-01,14,15,14,15,29
SAN ANDRES DE MACHACA,consulta externa,repetidas en menores de 5 anos,2005-11-01,0,2,0,2,2
SAN ANTONIO DE ESMORUCO,consulta externa,repetidas en menores de 5 anos,2005-11-01,7,0,7,0,7
SAN ANTONIO DE LOMERIO,consulta externa,repetidas en menores de 5 anos,2005-11-01,2,2,2,2,4
SAN BENITO,consulta externa,repetidas en menores de 5 anos,2005-11-01,42,37,42,37,79
SAN BORJA,consulta externa,repetidas en menores de 5 anos,2005-11-01,94,76,94,76,170
SAN BUENA VENTURA,consulta externa,repetidas en menores de 5 anos,2005-11-01,11,4,11,4,15
SAN CARLOS,consulta externa,repetidas en menores de 5 anos,2005-11-01,18,8,18,8,26
SAN IGNACIO,consulta externa,repetidas en menores de 5 anos,2005-11-01,107,105,107,105,212
SAN IGNACIO DE VELASCO,consulta externa,repetidas en menores de 5 anos,2005-11-01,39,33,39,33,72
SAN JAVIER(BNI),consulta externa,repetidas en menores de 5 anos,2005-11-01,9,16,9,16,25
SAN JAVIER(STC),consulta externa,repetidas en menores de 5 anos,2005-11-01,17,13,17,13,30
SAN JOAQUIN,consulta externa,repetidas en menores de 5 anos,2005-11-01,2,2,2,2,4
SAN JOSE DE CHIQUITOS,consulta externa,repetidas en menores de 5 anos,2005-11-01,8,3,8,3,11
SAN JUAN DE YAPACANI,consulta externa,repetidas en menores de 5 anos,2005-11-01,50,40,50,40,90
SAN JULIAN,consulta externa,repetidas en menores de 5 anos,2005-11-01,66,54,66,54,120
SAN LORENZO(PND),consulta externa,repetidas en menores de 5 anos,2005-11-01,2,3,2,3,5
SAN LORENZO(TJA),consulta externa,repetidas en menores de 5 anos,2005-11-01,11,9,11,9,20
SAN LUCAS,consulta externa,repetidas en menores de 5 anos,2005-11-01,16,18,16,18,34
SAN MATIAS,consulta externa,repetidas en menores de 5 anos,2005-11-01,20,6,20,6,26
SAN MIGUEL DE VELASCO,consulta externa,repetidas en menores de 5 anos,2005-11-01,57,39,57,39,96
SAN PABLO DE LIPEZ,consulta externa,repetidas en menores de 5 anos,2005-11-01,8,6,8,6,14
SAN PEDRO,consulta externa,repetidas en menores de 5 anos,2005-11-01,71,63,71,63,134
SAN PEDRO DE BUENA VISTA,consulta externa,repetidas en menores de 5 anos,2005-11-01,4,0,4,0,4
SAN PEDRO DE CURAHUARA,consulta externa,repetidas en menores de 5 anos,2005-11-01,2,2,2,2,4
SAN PEDRO DE QUEMES,consulta externa,repetidas en menores de 5 anos,2005-11-01,0,1,0,1,1
SAN PEDRO DE TIQUINA,consulta externa,repetidas en menores de 5 anos,2005-11-01,3,0,3,0,3
SAN PEDRO(PND),consulta externa,repetidas en menores de 5 anos,2005-11-01,0,7,0,7,7
SAN RAFAEL,consulta externa,repetidas en menores de 5 anos,2005-11-01,6,11,6,11,17
SAN RAMON,consulta externa,repetidas en menores de 5 anos,2005-11-01,3,6,3,6,9
SAN RAMON,consulta externa,repetidas en menores de 5 anos,2005-11-01,6,3,6,3,9
SANTA ANA,consulta externa,repetidas en menores de 5 anos,2005-11-01,18,11,18,11,29
SANTA CRUZ DE LA SIERRA,consulta externa,repetidas en menores de 5 anos,2005-11-01,3976,3595,3976,3595,7571
SANTA ROSA,consulta externa,repetidas en menores de 5 anos,2005-11-01,24,19,24,19,43
SANTA ROSA DEL SARA,consulta externa,repetidas en menores de 5 anos,2005-11-01,48,45,48,45,93
SANTIAGO DE CALLAPA,consulta externa,repetidas en menores de 5 anos,2005-11-01,1,0,1,0,1
SANTIAGO DE HUARI,consulta externa,repetidas en menores de 5 anos,2005-11-01,12,17,12,17,29
SANTIVAÑES,consulta externa,repetidas en menores de 5 anos,2005-11-01,1,10,1,10,11
SANTUARIO DE QUILLACAS,consulta externa,repetidas en menores de 5 anos,2005-11-01,2,1,2,1,3
SAPAHAQUI,consulta externa,repetidas en menores de 5 anos,2005-11-01,3,1,3,1,4
SENA,consulta externa,repetidas en menores de 5 anos,2005-11-01,2,2,2,2,4
SICA SICA (VILLA AROMA),consulta externa,repetidas en menores de 5 anos,2005-11-01,0,5,0,5,5
SICAYA,consulta externa,repetidas en menores de 5 anos,2005-11-01,5,0,5,0,5
SIPE SIPE,consulta externa,repetidas en menores de 5 anos,2005-11-01,151,116,151,116,267
SOPACHUY,consulta externa,repetidas en menores de 5 anos,2005-11-01,2,1,2,1,3
SORACACHI,consulta externa,repetidas en menores de 5 anos,2005-11-01,8,0,8,0,8
SORATA,consulta externa,repetidas en menores de 5 anos,2005-11-01,6,4,6,4,10
SUCRE,consulta externa,repetidas en menores de 5 anos,2005-11-01,737,792,737,792,1529
TACACHI,consulta externa,repetidas en menores de 5 anos,2005-11-01,13,17,13,17,30
TACOBAMBA,consulta externa,repetidas en menores de 5 anos,2005-11-01,0,2,0,2,2
TACOPAYA,consulta externa,repetidas en menores de 5 anos,2005-11-01,10,7,10,7,17
TAPACARI,consulta externa,repetidas en menores de 5 anos,2005-11-01,73,80,73,80,153
TARABUCO,consulta externa,repetidas en menores de 5 anos,2005-11-01,228,267,228,267,495
TARACO,consulta externa,repetidas en menores de 5 anos,2005-11-01,0,1,0,1,1
TARATA,consulta externa,repetidas en menores de 5 anos,2005-11-01,18,13,18,13,31
TARIJA,consulta externa,repetidas en menores de 5 anos,2005-11-01,751,678,751,678,1429
TARVITA,consulta externa,repetidas en menores de 5 anos,2005-11-01,19,38,19,38,57
TEOPONTE,consulta externa,repetidas en menores de 5 anos,2005-11-01,3,2,3,2,5
TIAWANACU,consulta externa,repetidas en menores de 5 anos,2005-11-01,4,3,4,3,7
TINGUIPAYA,consulta externa,repetidas en menores de 5 anos,2005-11-01,3,1,3,1,4
TIPUANI,consulta externa,repetidas en menores de 5 anos,2005-11-01,13,10,13,10,23
TIQUIPAYA,consulta externa,repetidas en menores de 5 anos,2005-11-01,180,179,180,179,359
TIRAQUE (CBBA),consulta externa,repetidas en menores de 5 anos,2005-11-01,156,135,156,135,291
TITO YUPANQUI (PARQUIPUJIO),consulta externa,repetidas en menores de 5 anos,2005-11-01,2,1,2,1,3
TOCO,consulta externa,repetidas en menores de 5 anos,2005-11-01,25,11,25,11,36
TOLATA,consulta externa,repetidas en menores de 5 anos,2005-11-01,12,10,12,10,22
TOLEDO,consulta externa,repetidas en menores de 5 anos,2005-11-01,9,10,9,10,19
TOMAVE,consulta externa,repetidas en menores de 5 anos,2005-11-01,9,2,9,2,11
TOMINA,consulta externa,repetidas en menores de 5 anos,2005-11-01,1,2,1,2,3
TORO TORO,consulta externa,repetidas en menores de 5 anos,2005-11-01,8,4,8,4,12
TOTORA(CBBA),consulta externa,repetidas en menores de 5 anos,2005-11-01,15,9,15,9,24
TOTORA(ORR),consulta externa,repetidas en menores de 5 anos,2005-11-01,15,33,15,33,48
TRIGAL,consulta externa,repetidas en menores de 5 anos,2005-11-01,22,10,22,10,32
TRINIDAD,consulta externa,repetidas en menores de 5 anos,2005-11-01,355,308,355,308,663
TUPIZA,consulta externa,repetidas en menores de 5 anos,2005-11-01,78,87,78,87,165
TURCO,consulta externa,repetidas en menores de 5 anos,2005-11-01,4,3,4,3,7
UNCIA,consulta externa,repetidas en menores de 5 anos,2005-11-01,18,30,18,30,48
URIONDO (A. CONCEPCION),consulta externa,repetidas en menores de 5 anos,2005-11-01,18,25,18,25,43
URUBICHA,consulta externa,repetidas en menores de 5 anos,2005-11-01,3,1,3,1,4
UYUNI,consulta externa,repetidas en menores de 5 anos,2005-11-01,13,8,13,8,21
VACAS,consulta externa,repetidas en menores de 5 anos,2005-11-01,57,44,57,44,101
VALLEGRANDE,consulta externa,repetidas en menores de 5 anos,2005-11-01,28,45,28,45,73
VIACHA,consulta externa,repetidas en menores de 5 anos,2005-11-01,66,60,66,60,126
VILA VILA,consulta externa,repetidas en menores de 5 anos,2005-11-01,1,0,1,0,1
VILLA MONTES,consulta externa,repetidas en menores de 5 anos,2005-11-01,14,15,14,15,29
VILLA RIVERO,consulta externa,repetidas en menores de 5 anos,2005-11-01,17,15,17,15,32
VILLA SERRANO,consulta externa,repetidas en menores de 5 anos,2005-11-01,5,9,5,9,14
VILLA TUNARI,consulta externa,repetidas en menores de 5 anos,2005-11-01,132,140,132,140,272
VILLA VACA GUZMAN (MUYUPAMPA),consulta externa,repetidas en menores de 5 anos,2005-11-01,21,16,21,16,37
VILLAZON,consulta externa,repetidas en menores de 5 anos,2005-11-01,48,48,48,48,96
VINTO,consulta externa,repetidas en menores de 5 anos,2005-11-01,124,110,124,110,234
VITICHI,consulta externa,repetidas en menores de 5 anos,2005-11-01,3,6,3,6,9
WALDO BALLIVIAN,consulta externa,repetidas en menores de 5 anos,2005-11-01,1,1,1,1,2
WARNES,consulta externa,repetidas en menores de 5 anos,2005-11-01,92,109,92,109,201
YACO,consulta externa,repetidas en menores de 5 anos,2005-11-01,10,6,10,6,16
YACUIBA,consulta externa,repetidas en menores de 5 anos,2005-11-01,200,188,200,188,388
YAMPARAEZ,consulta externa,repetidas en menores de 5 anos,2005-11-01,9,7,9,7,16
YANACACHI,consulta externa,repetidas en menores de 5 anos,2005-11-01,2,3,2,3,5
YAPACANI,consulta externa,repetidas en menores de 5 anos,2005-11-01,34,37,34,37,71
YOCALLA,consulta externa,repetidas en menores de 5 anos,2005-11-01,12,17,12,17,29
YOTALA,consulta externa,repetidas en menores de 5 anos,2005-11-01,27,24,27,24,51
YUNCHARA,consulta externa,repetidas en menores de 5 anos,2005-11-01,26,22,26,22,48
ZUDAÑEZ,consulta externa,repetidas en menores de 5 anos,2005-11-01,2,4,2,4,6
ACHACACHI,consulta externa,repetidas en menores de 5 anos,2005-12-01,19,3,19,3,22
ACHOCALLA,consulta externa,repetidas en menores de 5 anos,2005-12-01,1,1,1,1,2
AIQUILE,consulta externa,repetidas en menores de 5 anos,2005-12-01,51,35,51,35,86
ANCORAIMES,consulta externa,repetidas en menores de 5 anos,2005-12-01,11,6,11,6,17
ANDAMARCA,consulta externa,repetidas en menores de 5 anos,2005-12-01,1,3,1,3,4
ANTEQUERA,consulta externa,repetidas en menores de 5 anos,2005-12-01,6,3,6,3,9
ANZALDO,consulta externa,repetidas en menores de 5 anos,2005-12-01,3,2,3,2,5
APOLO,consulta externa,repetidas en menores de 5 anos,2005-12-01,6,5,6,5,11
ARANI,consulta externa,repetidas en menores de 5 anos,2005-12-01,17,39,17,39,56
ARBIETO,consulta externa,repetidas en menores de 5 anos,2005-12-01,19,15,19,15,34
ARQUE,consulta externa,repetidas en menores de 5 anos,2005-12-01,31,17,31,17,48
ASCENCION DE GUARAYOS,consulta externa,repetidas en menores de 5 anos,2005-12-01,38,39,38,39,77
ATOCHA,consulta externa,repetidas en menores de 5 anos,2005-12-01,51,47,51,47,98
AUCAPATA,consulta externa,repetidas en menores de 5 anos,2005-12-01,1,4,1,4,5
AYATA,consulta externa,repetidas en menores de 5 anos,2005-12-01,816,4,816,4,820
AYO AYO,consulta externa,repetidas en menores de 5 anos,2005-12-01,1,5,1,5,6
AYOPAYA (V. DE INDEPENDENCIA),consulta externa,repetidas en menores de 5 anos,2005-12-01,19,21,19,21,40
BATALLAS,consulta externa,repetidas en menores de 5 anos,2005-12-01,1,2,1,2,3
BAURES,consulta externa,repetidas en menores de 5 anos,2005-12-01,12,10,12,10,22
BELEN DE ANDAMARCA,consulta externa,repetidas en menores de 5 anos,2005-12-01,1,2,1,2,3
BELEN DE URMIRI,consulta externa,repetidas en menores de 5 anos,2005-12-01,8,2,8,2,10
BELLA FLOR,consulta externa,repetidas en menores de 5 anos,2005-12-01,5,11,5,11,16
BERMEJO,consulta externa,repetidas en menores de 5 anos,2005-12-01,52,36,52,36,88
BETANZOS,consulta externa,repetidas en menores de 5 anos,2005-12-01,24,26,24,26,50
BOLIVAR,consulta externa,repetidas en menores de 5 anos,2005-12-01,5,9,5,9,14
BOLPEBRA,consulta externa,repetidas en menores de 5 anos,2005-12-01,6,5,6,5,11
BOYUIBE,consulta externa,repetidas en menores de 5 anos,2005-12-01,9,14,9,14,23
BUENA VISTA,consulta externa,repetidas en menores de 5 anos,2005-12-01,97,82,97,82,179
CABEZAS,consulta externa,repetidas en menores de 5 anos,2005-12-01,9,3,9,3,12
CAIROMA,consulta externa,repetidas en menores de 5 anos,2005-12-01,0,1,0,1,1
"CAIZA ""D""",consulta externa,repetidas en menores de 5 anos,2005-12-01,5,1,5,1,6
CAJUATA,consulta externa,repetidas en menores de 5 anos,2005-12-01,10,4,10,4,14
CALACOTO,consulta externa,repetidas en menores de 5 anos,2005-12-01,0,2,0,2,2
CALAMARCA,consulta externa,repetidas en menores de 5 anos,2005-12-01,10,2,10,2,12
CAMARGO,consulta externa,repetidas en menores de 5 anos,2005-12-01,16,9,16,9,25
CAMATAQUI (C. VILLA ABECIA),consulta externa,repetidas en menores de 5 anos,2005-12-01,3,5,3,5,8
CAMIRI,consulta externa,repetidas en menores de 5 anos,2005-12-01,62,64,62,64,126
CAPINOTA,consulta externa,repetidas en menores de 5 anos,2005-12-01,126,103,126,103,229
CARACOLLO,consulta externa,repetidas en menores de 5 anos,2005-12-01,1,1,1,1,2
CARANAVI,consulta externa,repetidas en menores de 5 anos,2005-12-01,34,41,34,41,75
CARAPARI,consulta externa,repetidas en menores de 5 anos,2005-12-01,3,3,3,3,6
CARIPUYO,consulta externa,repetidas en menores de 5 anos,2005-12-01,1,1,1,1,2
CARMEN RIVERO TORREZ,consulta externa,repetidas en menores de 5 anos,2005-12-01,2,3,2,3,5
CHACARILLA,consulta externa,repetidas en menores de 5 anos,2005-12-01,1,0,1,0,1
CHALLAPATA,consulta externa,repetidas en menores de 5 anos,2005-12-01,3,8,3,8,11
CHAQUI,consulta externa,repetidas en menores de 5 anos,2005-12-01,4,2,4,2,6
CHARAGUA,consulta externa,repetidas en menores de 5 anos,2005-12-01,61,43,61,43,104
CHARAÑA,consulta externa,repetidas en menores de 5 anos,2005-12-01,1,1,1,1,2
CHAYANTA,consulta externa,repetidas en menores de 5 anos,2005-12-01,0,3,0,3,3
CHIMORE,consulta externa,repetidas en menores de 5 anos,2005-12-01,28,45,28,45,73
CHIPAYA,consulta externa,repetidas en menores de 5 anos,2005-12-01,1,4,1,4,5
CHOQUE COTA,consulta externa,repetidas en menores de 5 anos,2005-12-01,3,1,3,1,4
CHULUMANI (V. DE LA LIBERTAD),consulta externa,repetidas en menores de 5 anos,2005-12-01,8,4,8,4,12
CHUMA,consulta externa,repetidas en menores de 5 anos,2005-12-01,3,6,3,6,9
CLIZA,consulta externa,repetidas en menores de 5 anos,2005-12-01,38,22,38,22,60
COBIJA,consulta externa,repetidas en menores de 5 anos,2005-12-01,148,148,148,148,296
COCHABAMBA,consulta externa,repetidas en menores de 5 anos,2005-12-01,2758,2810,2758,2810,5568
COLCAPIRHUA,consulta externa,repetidas en menores de 5 anos,2005-12-01,108,94,108,94,202
"COLCHA ""K""",consulta externa,repetidas en menores de 5 anos,2005-12-01,8,5,8,5,13
COLLANA,consulta externa,repetidas en menores de 5 anos,2005-12-01,1,1,1,1,2
COLOMI,consulta externa,repetidas en menores de 5 anos,2005-12-01,7,8,7,8,15
COLPA BELGICA,consulta externa,repetidas en menores de 5 anos,2005-12-01,22,15,22,15,37
COLQUECHACA,consulta externa,repetidas en menores de 5 anos,2005-12-01,6,3,6,3,9
COLQUENCHA,consulta externa,repetidas en menores de 5 anos,2005-12-01,1,1,1,1,2
COLQUIRI,consulta externa,repetidas en menores de 5 anos,2005-12-01,28,41,28,41,69
COMANCHE,consulta externa,repetidas en menores de 5 anos,2005-12-01,8,6,8,6,14
COMARAPA,consulta externa,repetidas en menores de 5 anos,2005-12-01,31,25,31,25,56
COMBAYA,consulta externa,repetidas en menores de 5 anos,2005-12-01,1,2,1,2,3
CONCEPCION,consulta externa,repetidas en menores de 5 anos,2005-12-01,2,2,2,2,4
COPACABANA,consulta externa,repetidas en menores de 5 anos,2005-12-01,1,2,1,2,3
CORIPATA,consulta externa,repetidas en menores de 5 anos,2005-12-01,5,1,5,1,6
CORO CORO,consulta externa,repetidas en menores de 5 anos,2005-12-01,5,1,5,1,6
COROICO,consulta externa,repetidas en menores de 5 anos,2005-12-01,33,20,33,20,53
CORQUE,consulta externa,repetidas en menores de 5 anos,2005-12-01,7,9,7,9,16
COTAGAITA,consulta externa,repetidas en menores de 5 anos,2005-12-01,20,16,20,16,36
COTOCA,consulta externa,repetidas en menores de 5 anos,2005-12-01,9,8,9,8,17
CUATRO CAÑADAS,consulta externa,repetidas en menores de 5 anos,2005-12-01,20,10,20,10,30
CUCHUMUELA (V. G. VILLARROEL),consulta externa,repetidas en menores de 5 anos,2005-12-01,3,0,3,0,3
CUEVO,consulta externa,repetidas en menores de 5 anos,2005-12-01,5,7,5,7,12
CULPINA,consulta externa,repetidas en menores de 5 anos,2005-12-01,10,12,10,12,22
CURAHUARA DE CARANGAS,consulta externa,repetidas en menores de 5 anos,2005-12-01,0,3,0,3,3
CURVA,consulta externa,repetidas en menores de 5 anos,2005-12-01,1,0,1,0,1
DESAGUADERO,consulta externa,repetidas en menores de 5 anos,2005-12-01,0,2,0,2,2
EL ALTO,consulta externa,repetidas en menores de 5 anos,2005-12-01,1985,1746,1985,1746,3731
EL CHORO,consulta externa,repetidas en menores de 5 anos,2005-12-01,0,1,0,1,1
EL PUENTE(STC),consulta externa,repetidas en menores de 5 anos,2005-12-01,8,10,8,10,18
EL PUENTE(TJA),consulta externa,repetidas en menores de 5 anos,2005-12-01,55,49,55,49,104
EL TORNO,consulta externa,repetidas en menores de 5 anos,2005-12-01,33,33,33,33,66
EL VILLAR,consulta externa,repetidas en menores de 5 anos,2005-12-01,2,1,2,1,3
ENTRE RIOS,consulta externa,repetidas en menores de 5 anos,2005-12-01,2,6,2,6,8
ENTRE RIOS,consulta externa,repetidas en menores de 5 anos,2005-12-01,90,74,90,74,164
EUCALIPTUS,consulta externa,repetidas en menores de 5 anos,2005-12-01,5,1,5,1,6
EUREKA (SANTOS MERCADO),consulta externa,repetidas en menores de 5 anos,2005-12-01,1,1,1,1,2
EXALTACION,consulta externa,repetidas en menores de 5 anos,2005-12-01,4,8,4,8,12
FERNANDEZ ALONSO,consulta externa,repetidas en menores de 5 anos,2005-12-01,35,41,35,41,76
FILADELFIA,consulta externa,repetidas en menores de 5 anos,2005-12-01,2,5,2,5,7
GENERAL SAAVEDRA,consulta externa,repetidas en menores de 5 anos,2005-12-01,21,23,21,23,44
GRAL. J.J. PEREZ (CHARAZANI),consulta externa,repetidas en menores de 5 anos,2005-12-01,10,8,10,8,18
GUAQUI,consulta externa,repetidas en menores de 5 anos,2005-12-01,7,5,7,5,12
GUAYARAMERIN,consulta externa,repetidas en menores de 5 anos,2005-12-01,84,69,84,69,153
GUTIERREZ,consulta externa,repetidas en menores de 5 anos,2005-12-01,48,55,48,55,103
HUACARETA,consulta externa,repetidas en menores de 5 anos,2005-12-01,69,61,69,61,130
HUACHACALLA,consulta externa,repetidas en menores de 5 anos,2005-12-01,2,3,2,3,5
HUANUNI,consulta externa,repetidas en menores de 5 anos,2005-12-01,57,73,57,73,130
HUARACAJE,consulta externa,repetidas en menores de 5 anos,2005-12-01,4,5,4,5,9
HUAYLLAMARCA,consulta externa,repetidas en menores de 5 anos,2005-12-01,0,2,0,2,2
ICLA,consulta externa,repetidas en menores de 5 anos,2005-12-01,31,36,31,36,67
INCAHUASI,consulta externa,repetidas en menores de 5 anos,2005-12-01,2,6,2,6,8
INQUISIVI,consulta externa,repetidas en menores de 5 anos,2005-12-01,1,10,1,10,11
IRUPANA (VILLA DE LANZA),consulta externa,repetidas en menores de 5 anos,2005-12-01,13,3,13,3,16
IXIAMAS,consulta externa,repetidas en menores de 5 anos,2005-12-01,15,6,15,6,21
JESUS DE MACHACA,consulta externa,repetidas en menores de 5 anos,2005-12-01,3,14,3,14,17
LA ASUNTA,consulta externa,repetidas en menores de 5 anos,2005-12-01,3,2,3,2,5
LA GUARDIA,consulta externa,repetidas en menores de 5 anos,2005-12-01,65,63,65,63,128
LA PAZ,consulta externa,repetidas en menores de 5 anos,2005-12-01,3586,4079,3586,4079,7665
LAGUNILLAS,consulta externa,repetidas en menores de 5 anos,2005-12-01,5,7,5,7,12
LAJA,consulta externa,repetidas en menores de 5 anos,2005-12-01,7,7,7,7,14
LAS CARRERAS,consulta externa,repetidas en menores de 5 anos,2005-12-01,4,3,4,3,7
LLALLAGUA,consulta externa,repetidas en menores de 5 anos,2005-12-01,21,25,21,25,46
LLICA,consulta externa,repetidas en menores de 5 anos,2005-12-01,9,19,9,19,28
LORETO,consulta externa,repetidas en menores de 5 anos,2005-12-01,14,12,14,12,26
LURIBAY,consulta externa,repetidas en menores de 5 anos,2005-12-01,6,0,6,0,6
MACHARETI,consulta externa,repetidas en menores de 5 anos,2005-12-01,9,8,9,8,17
MAGDALENA,consulta externa,repetidas en menores de 5 anos,2005-12-01,6,18,6,18,24
MAIRANA,consulta externa,repetidas en menores de 5 anos,2005-12-01,10,5,10,5,15
MALLA,consulta externa,repetidas en menores de 5 anos,2005-12-01,1,7,1,7,8
MAPIRI,consulta externa,repetidas en menores de 5 anos,2005-12-01,2,1,2,1,3
MECAPACA,consulta externa,repetidas en menores de 5 anos,2005-12-01,14,14,14,14,28
MINEROS,consulta externa,repetidas en menores de 5 anos,2005-12-01,17,21,17,21,38
MIZQUE,consulta externa,repetidas en menores de 5 anos,2005-12-01,29,18,29,18,47
MOCOMOCO,consulta externa,repetidas en menores de 5 anos,2005-12-01,5,2,5,2,7
MOJINETE,consulta externa,repetidas en menores de 5 anos,2005-12-01,11,8,11,8,19
MOJOCOYA,consulta externa,repetidas en menores de 5 anos,2005-12-01,3,0,3,0,3
MONTEAGUDO,consulta externa,repetidas en menores de 5 anos,2005-12-01,40,40,40,40,80
MONTERO,consulta externa,repetidas en menores de 5 anos,2005-12-01,508,509,508,509,1017
MORO MORO,consulta externa,repetidas en menores de 5 anos,2005-12-01,2,2,2,2,4
MOROCHATA,consulta externa,repetidas en menores de 5 anos,2005-12-01,115,135,115,135,250
OCURI,consulta externa,repetidas en menores de 5 anos,2005-12-01,2,1,2,1,3
OKINAWA,consulta externa,repetidas en menores de 5 anos,2005-12-01,5,3,5,3,8
OMEREQUE,consulta externa,repetidas en menores de 5 anos,2005-12-01,8,7,8,7,15
ORURO,consulta externa,repetidas en menores de 5 anos,2005-12-01,501,505,501,505,1006
PADCAYA,consulta externa,repetidas en menores de 5 anos,2005-12-01,9,6,9,6,15
PADILLA,consulta externa,repetidas en menores de 5 anos,2005-12-01,9,8,9,8,17
PAILON,consulta externa,repetidas en menores de 5 anos,2005-12-01,39,13,39,13,52
PALCA,consulta externa,repetidas en menores de 5 anos,2005-12-01,1,4,1,4,5
PALOS BLANCOS,consulta externa,repetidas en menores de 5 anos,2005-12-01,57,53,57,53,110
PAMPA AULLAGAS,consulta externa,repetidas en menores de 5 anos,2005-12-01,2,0,2,0,2
PAMPA GRANDE,consulta externa,repetidas en menores de 5 anos,2005-12-01,9,10,9,10,19
PAPEL PAMPA,consulta externa,repetidas en menores de 5 anos,2005-12-01,0,1,0,1,1
PATACAMAYA,consulta externa,repetidas en menores de 5 anos,2005-12-01,1,1,1,1,2
PAZÑA,consulta externa,repetidas en menores de 5 anos,2005-12-01,4,6,4,6,10
PELECHUCO,consulta externa,repetidas en menores de 5 anos,2005-12-01,0,3,0,3,3
POCOATA,consulta externa,repetidas en menores de 5 anos,2005-12-01,5,8,5,8,13
POCONA,consulta externa,repetidas en menores de 5 anos,2005-12-01,14,32,14,32,46
POJO (CBBA),consulta externa,repetidas en menores de 5 anos,2005-12-01,12,4,12,4,16
POOPO,consulta externa,repetidas en menores de 5 anos,2005-12-01,1,0,1,0,1
PORCO,consulta externa,repetidas en menores de 5 anos,2005-12-01,7,2,7,2,9
POROMA,consulta externa,repetidas en menores de 5 anos,2005-12-01,0,1,0,1,1
PORONGO,consulta externa,repetidas en menores de 5 anos,2005-12-01,30,24,30,24,54
PORTACHUELO,consulta externa,repetidas en menores de 5 anos,2005-12-01,56,22,56,22,78
POTOSI,consulta externa,repetidas en menores de 5 anos,2005-12-01,358,382,358,382,740
PRESTO,consulta externa,repetidas en menores de 5 anos,2005-12-01,1,1,1,1,2
PUCARANI,consulta externa,repetidas en menores de 5 anos,2005-12-01,2,5,2,5,7
PUERTO ACOSTA,consulta externa,repetidas en menores de 5 anos,2005-12-01,15,22,15,22,37
PUERTO CARABUCO,consulta externa,repetidas en menores de 5 anos,2005-12-01,5,3,5,3,8
PUERTO GONZALO MORENO,consulta externa,repetidas en menores de 5 anos,2005-12-01,10,11,10,11,21
PUERTO PEREZ,consulta externa,repetidas en menores de 5 anos,2005-12-01,1,0,1,0,1
PUERTO QUIJARRO,consulta externa,repetidas en menores de 5 anos,2005-12-01,19,16,19,16,35
PUERTO RICO,consulta externa,repetidas en menores de 5 anos,2005-12-01,0,1,0,1,1
PUERTO SUAREZ,consulta externa,repetidas en menores de 5 anos,2005-12-01,12,13,12,13,25
PUERTO VILLARROEL,consulta externa,repetidas en menores de 5 anos,2005-12-01,81,85,81,85,166
PUNA,consulta externa,repetidas en menores de 5 anos,2005-12-01,16,16,16,16,32
PUNATA,consulta externa,repetidas en menores de 5 anos,2005-12-01,91,85,91,85,176
QUILLACOLLO,consulta externa,repetidas en menores de 5 anos,2005-12-01,284,194,284,194,478
QUIME,consulta externa,repetidas en menores de 5 anos,2005-12-01,4,4,4,4,8
QUIRUSILLAS,consulta externa,repetidas en menores de 5 anos,2005-12-01,1,2,1,2,3
RAVELO,consulta externa,repetidas en menores de 5 anos,2005-12-01,2,2,2,2,4
REYES,consulta externa,repetidas en menores de 5 anos,2005-12-01,4,7,4,7,11
RIBERALTA,consulta externa,repetidas en menores de 5 anos,2005-12-01,271,251,271,251,522
ROBORE,consulta externa,repetidas en menores de 5 anos,2005-12-01,11,9,11,9,20
RURRENABAQUE,consulta externa,repetidas en menores de 5 anos,2005-12-01,39,38,39,38,77
SABAYA,consulta externa,repetidas en menores de 5 anos,2005-12-01,1,2,1,2,3
SACABA,consulta externa,repetidas en menores de 5 anos,2005-12-01,249,227,249,227,476
SACABAMBA,consulta externa,repetidas en menores de 5 anos,2005-12-01,5,11,5,11,16
SACACA,consulta externa,repetidas en menores de 5 anos,2005-12-01,1,6,1,6,7
SAIPINA,consulta externa,repetidas en menores de 5 anos,2005-12-01,19,16,19,16,35
SALINAS DE GARCI MENDOZA,consulta externa,repetidas en menores de 5 anos,2005-12-01,3,4,3,4,7
SAMAIPATA,consulta externa,repetidas en menores de 5 anos,2005-12-01,8,4,8,4,12
SAN ANDRES,consulta externa,repetidas en menores de 5 anos,2005-12-01,16,6,16,6,22
SAN ANDRES DE MACHACA,consulta externa,repetidas en menores de 5 anos,2005-12-01,2,1,2,1,3
SAN ANTONIO DE LOMERIO,consulta externa,repetidas en menores de 5 anos,2005-12-01,1,0,1,0,1
SAN BENITO,consulta externa,repetidas en menores de 5 anos,2005-12-01,29,36,29,36,65
SAN BORJA,consulta externa,repetidas en menores de 5 anos,2005-12-01,69,59,69,59,128
SAN BUENA VENTURA,consulta externa,repetidas en menores de 5 anos,2005-12-01,8,7,8,7,15
SAN CARLOS,consulta externa,repetidas en menores de 5 anos,2005-12-01,6,9,6,9,15
SAN IGNACIO,consulta externa,repetidas en menores de 5 anos,2005-12-01,57,46,57,46,103
SAN IGNACIO DE VELASCO,consulta externa,repetidas en menores de 5 anos,2005-12-01,126,122,126,122,248
SAN JAVIER(BNI),consulta externa,repetidas en menores de 5 anos,2005-12-01,13,18,13,18,31
SAN JAVIER(STC),consulta externa,repetidas en menores de 5 anos,2005-12-01,16,13,16,13,29
SAN JOAQUIN,consulta externa,repetidas en menores de 5 anos,2005-12-01,1,1,1,1,2
SAN JOSE DE CHIQUITOS,consulta externa,repetidas en menores de 5 anos,2005-12-01,4,4,4,4,8
SAN JUAN DE YAPACANI,consulta externa,repetidas en menores de 5 anos,2005-12-01,22,24,22,24,46
SAN JULIAN,consulta externa,repetidas en menores de 5 anos,2005-12-01,38,25,38,25,63
SAN LORENZO(PND),consulta externa,repetidas en menores de 5 anos,2005-12-01,5,1,5,1,6
SAN LORENZO(TJA),consulta externa,repetidas en menores de 5 anos,2005-12-01,30,37,30,37,67
SAN LUCAS,consulta externa,repetidas en menores de 5 anos,2005-12-01,7,11,7,11,18
SAN MATIAS,consulta externa,repetidas en menores de 5 anos,2005-12-01,25,27,25,27,52
SAN MIGUEL DE VELASCO,consulta externa,repetidas en menores de 5 anos,2005-12-01,26,29,26,29,55
SAN PABLO DE LIPEZ,consulta externa,repetidas en menores de 5 anos,2005-12-01,7,12,7,12,19
SAN PEDRO,consulta externa,repetidas en menores de 5 anos,2005-12-01,61,68,61,68,129
SAN PEDRO DE BUENA VISTA,consulta externa,repetidas en menores de 5 anos,2005-12-01,1,2,1,2,3
SAN PEDRO DE QUEMES,consulta externa,repetidas en menores de 5 anos,2005-12-01,1,2,1,2,3
SAN PEDRO DE TIQUINA,consulta externa,repetidas en menores de 5 anos,2005-12-01,0,1,0,1,1
SAN RAFAEL,consulta externa,repetidas en menores de 5 anos,2005-12-01,10,8,10,8,18
SAN RAMON,consulta externa,repetidas en menores de 5 anos,2005-12-01,3,5,3,5,8
SAN RAMON,consulta externa,repetidas en menores de 5 anos,2005-12-01,12,6,12,6,18
SANTA ANA,consulta externa,repetidas en menores de 5 anos,2005-12-01,11,7,11,7,18
SANTA CRUZ DE LA SIERRA,consulta externa,repetidas en menores de 5 anos,2005-12-01,3525,3770,3525,3770,7295
SANTA ROSA,consulta externa,repetidas en menores de 5 anos,2005-12-01,43,26,43,26,69
SANTA ROSA DEL SARA,consulta externa,repetidas en menores de 5 anos,2005-12-01,40,43,40,43,83
SANTIAGO DE HUARI,consulta externa,repetidas en menores de 5 anos,2005-12-01,9,9,9,9,18
SANTIAGO DE MACHACA,consulta externa,repetidas en menores de 5 anos,2005-12-01,1,1,1,1,2
SANTIVAÑES,consulta externa,repetidas en menores de 5 anos,2005-12-01,6,8,6,8,14
SAPAHAQUI,consulta externa,repetidas en menores de 5 anos,2005-12-01,2,2,2,2,4
SICA SICA (VILLA AROMA),consulta externa,repetidas en menores de 5 anos,2005-12-01,1,3,1,3,4
SICAYA,consulta externa,repetidas en menores de 5 anos,2005-12-01,25,9,25,9,34
SIPE SIPE,consulta externa,repetidas en menores de 5 anos,2005-12-01,106,84,106,84,190
SOPACHUY,consulta externa,repetidas en menores de 5 anos,2005-12-01,1,1,1,1,2
SORACACHI,consulta externa,repetidas en menores de 5 anos,2005-12-01,29,19,29,19,48
SORATA,consulta externa,repetidas en menores de 5 anos,2005-12-01,12,4,12,4,16
SUCRE,consulta externa,repetidas en menores de 5 anos,2005-12-01,697,695,697,695,1392
TACACHI,consulta externa,repetidas en menores de 5 anos,2005-12-01,11,12,11,12,23
TACOBAMBA,consulta externa,repetidas en menores de 5 anos,2005-12-01,0,1,0,1,1
TACOPAYA,consulta externa,repetidas en menores de 5 anos,2005-12-01,14,46,14,46,60
TAHUA,consulta externa,repetidas en menores de 5 anos,2005-12-01,2,0,2,0,2
TAPACARI,consulta externa,repetidas en menores de 5 anos,2005-12-01,20,21,20,21,41
TARABUCO,consulta externa,repetidas en menores de 5 anos,2005-12-01,233,245,233,245,478
TARATA,consulta externa,repetidas en menores de 5 anos,2005-12-01,33,18,33,18,51
TARIJA,consulta externa,repetidas en menores de 5 anos,2005-12-01,632,633,632,633,1265
TARVITA,consulta externa,repetidas en menores de 5 anos,2005-12-01,8,10,8,10,18
TIAWANACU,consulta externa,repetidas en menores de 5 anos,2005-12-01,5,1,5,1,6
TIPUANI,consulta externa,repetidas en menores de 5 anos,2005-12-01,9,11,9,11,20
TIQUIPAYA,consulta externa,repetidas en menores de 5 anos,2005-12-01,115,85,115,85,200
TIRAQUE (CBBA),consulta externa,repetidas en menores de 5 anos,2005-12-01,150,140,150,140,290
TOCO,consulta externa,repetidas en menores de 5 anos,2005-12-01,3,2,3,2,5
TOLATA,consulta externa,repetidas en menores de 5 anos,2005-12-01,5,6,5,6,11
TOLEDO,consulta externa,repetidas en menores de 5 anos,2005-12-01,10,4,10,4,14
TOMAVE,consulta externa,repetidas en menores de 5 anos,2005-12-01,5,5,5,5,10
TOMINA,consulta externa,repetidas en menores de 5 anos,2005-12-01,3,6,3,6,9
TORO TORO,consulta externa,repetidas en menores de 5 anos,2005-12-01,1,2,1,2,3
TOTORA(CBBA),consulta externa,repetidas en menores de 5 anos,2005-12-01,5,2,5,2,7
TOTORA(ORR),consulta externa,repetidas en menores de 5 anos,2005-12-01,7,8,7,8,15
TRIGAL,consulta externa,repetidas en menores de 5 anos,2005-12-01,2,5,2,5,7
TRINIDAD,consulta externa,repetidas en menores de 5 anos,2005-12-01,327,366,327,366,693
TUPIZA,consulta externa,repetidas en menores de 5 anos,2005-12-01,79,104,79,104,183
TURCO,consulta externa,repetidas en menores de 5 anos,2005-12-01,1,0,1,0,1
UNCIA,consulta externa,repetidas en menores de 5 anos,2005-12-01,16,17,16,17,33
URIONDO (A. CONCEPCION),consulta externa,repetidas en menores de 5 anos,2005-12-01,13,16,13,16,29
URUBICHA,consulta externa,repetidas en menores de 5 anos,2005-12-01,5,3,5,3,8
UYUNI,consulta externa,repetidas en menores de 5 anos,2005-12-01,6,10,6,10,16
VACAS,consulta externa,repetidas en menores de 5 anos,2005-12-01,46,55,46,55,101
VALLEGRANDE,consulta externa,repetidas en menores de 5 anos,2005-12-01,41,33,41,33,74
VIACHA,consulta externa,repetidas en menores de 5 anos,2005-12-01,60,72,60,72,132
VILA VILA,consulta externa,repetidas en menores de 5 anos,2005-12-01,2,0,2,0,2
VILLA MONTES,consulta externa,repetidas en menores de 5 anos,2005-12-01,37,20,37,20,57
VILLA RIVERO,consulta externa,repetidas en menores de 5 anos,2005-12-01,2,4,2,4,6
VILLA SERRANO,consulta externa,repetidas en menores de 5 anos,2005-12-01,0,1,0,1,1
VILLA TUNARI,consulta externa,repetidas en menores de 5 anos,2005-12-01,171,142,171,142,313
VILLA VACA GUZMAN (MUYUPAMPA),consulta externa,repetidas en menores de 5 anos,2005-12-01,6,3,6,3,9
VILLAZON,consulta externa,repetidas en menores de 5 anos,2005-12-01,57,48,57,48,105
VINTO,consulta externa,repetidas en menores de 5 anos,2005-12-01,148,147,148,147,295
VITICHI,consulta externa,repetidas en menores de 5 anos,2005-12-01,5,0,5,0,5
WALDO BALLIVIAN,consulta externa,repetidas en menores de 5 anos,2005-12-01,1,0,1,0,1
WARNES,consulta externa,repetidas en menores de 5 anos,2005-12-01,66,64,66,64,130
YACO,consulta externa,repetidas en menores de 5 anos,2005-12-01,26,23,26,23,49
YACUIBA,consulta externa,repetidas en menores de 5 anos,2005-12-01,194,179,194,179,373
YAMPARAEZ,consulta externa,repetidas en menores de 5 anos,2005-12-01,12,11,12,11,23
YANACACHI,consulta externa,repetidas en menores de 5 anos,2005-12-01,0,1,0,1,1
YAPACANI,consulta externa,repetidas en menores de 5 anos,2005-12-01,24,27,24,27,51
YOCALLA,consulta externa,repetidas en menores de 5 anos,2005-12-01,9,17,9,17,26
YOTALA,consulta externa,repetidas en menores de 5 anos,2005-12-01,12,10,12,10,22
YUNCHARA,consulta externa,repetidas en menores de 5 anos,2005-12-01,5,2,5,2,7
ZUDAÑEZ,consulta externa,repetidas en menores de 5 anos,2005-12-01,3,1,3,1,4
