municipality,group,variable,month,Repetidas en personas de 15 a 59 años -Hombre,Repetidas en personas de 15 a 59 años -Mujer,TOTAL-H,TOTAL-M,TOTAL
ACACIO,consulta externa,repetidas en personas de 15 a 59 anos,2005-01-01,3,1,3,1,4
ACHACACHI,consulta externa,repetidas en personas de 15 a 59 anos,2005-01-01,42,37,42,37,79
ACHOCALLA,consulta externa,repetidas en personas de 15 a 59 anos,2005-01-01,14,19,14,19,33
AIQUILE,consulta externa,repetidas en personas de 15 a 59 anos,2005-01-01,49,228,49,228,277
ALCALA,consulta externa,repetidas en personas de 15 a 59 anos,2005-01-01,0,1,0,1,1
ANCORAIMES,consulta externa,repetidas en personas de 15 a 59 anos,2005-01-01,3,11,3,11,14
ANDAMARCA,consulta externa,repetidas en personas de 15 a 59 anos,2005-01-01,0,4,0,4,4
ANTEQUERA,consulta externa,repetidas en personas de 15 a 59 anos,2005-01-01,1,0,1,0,1
ANZALDO,consulta externa,repetidas en personas de 15 a 59 anos,2005-01-01,1,7,1,7,8
APOLO,consulta externa,repetidas en personas de 15 a 59 anos,2005-01-01,6,8,6,8,14
ARANI,consulta externa,repetidas en personas de 15 a 59 anos,2005-01-01,1,4,1,4,5
ARBIETO,consulta externa,repetidas en personas de 15 a 59 anos,2005-01-01,2,3,2,3,5
ARQUE,consulta externa,repetidas en personas de 15 a 59 anos,2005-01-01,3,3,3,3,6
ATOCHA,consulta externa,repetidas en personas de 15 a 59 anos,2005-01-01,138,159,138,159,297
AUCAPATA,consulta externa,repetidas en personas de 15 a 59 anos,2005-01-01,3,7,3,7,10
AYATA,consulta externa,repetidas en personas de 15 a 59 anos,2005-01-01,1,1,1,1,2
AYO AYO,consulta externa,repetidas en personas de 15 a 59 anos,2005-01-01,1,2,1,2,3
AYOPAYA (V. DE INDEPENDENCIA),consulta externa,repetidas en personas de 15 a 59 anos,2005-01-01,6,9,6,9,15
AZURDUY,consulta externa,repetidas en personas de 15 a 59 anos,2005-01-01,0,3,0,3,3
BATALLAS,consulta externa,repetidas en personas de 15 a 59 anos,2005-01-01,13,5,13,5,18
BAURES,consulta externa,repetidas en personas de 15 a 59 anos,2005-01-01,5,7,5,7,12
BELEN DE URMIRI,consulta externa,repetidas en personas de 15 a 59 anos,2005-01-01,5,3,5,3,8
BERMEJO,consulta externa,repetidas en personas de 15 a 59 anos,2005-01-01,88,121,88,121,209
BETANZOS,consulta externa,repetidas en personas de 15 a 59 anos,2005-01-01,24,30,24,30,54
BOLIVAR,consulta externa,repetidas en personas de 15 a 59 anos,2005-01-01,2,0,2,0,2
BOLPEBRA,consulta externa,repetidas en personas de 15 a 59 anos,2005-01-01,3,2,3,2,5
BOYUIBE,consulta externa,repetidas en personas de 15 a 59 anos,2005-01-01,4,7,4,7,11
BUENA VISTA,consulta externa,repetidas en personas de 15 a 59 anos,2005-01-01,41,79,41,79,120
CABEZAS,consulta externa,repetidas en personas de 15 a 59 anos,2005-01-01,0,2,0,2,2
CAIROMA,consulta externa,repetidas en personas de 15 a 59 anos,2005-01-01,0,1,0,1,1
"CAIZA ""D""",consulta externa,repetidas en personas de 15 a 59 anos,2005-01-01,0,9,0,9,9
CAJUATA,consulta externa,repetidas en personas de 15 a 59 anos,2005-01-01,1,1,1,1,2
CALACOTO,consulta externa,repetidas en personas de 15 a 59 anos,2005-01-01,0,3,0,3,3
CALAMARCA,consulta externa,repetidas en personas de 15 a 59 anos,2005-01-01,7,10,7,10,17
CAMARGO,consulta externa,repetidas en personas de 15 a 59 anos,2005-01-01,9,42,9,42,51
CAMATAQUI (C. VILLA ABECIA),consulta externa,repetidas en personas de 15 a 59 anos,2005-01-01,0,4,0,4,4
CAMIRI,consulta externa,repetidas en personas de 15 a 59 anos,2005-01-01,103,249,103,249,352
CAPINOTA,consulta externa,repetidas en personas de 15 a 59 anos,2005-01-01,19,40,19,40,59
CAQUIAVIRI,consulta externa,repetidas en personas de 15 a 59 anos,2005-01-01,2,4,2,4,6
CARACOLLO,consulta externa,repetidas en personas de 15 a 59 anos,2005-01-01,9,30,9,30,39
CARANAVI,consulta externa,repetidas en personas de 15 a 59 anos,2005-01-01,18,23,18,23,41
CARAPARI,consulta externa,repetidas en personas de 15 a 59 anos,2005-01-01,4,7,4,7,11
CATACORA,consulta externa,repetidas en personas de 15 a 59 anos,2005-01-01,0,1,0,1,1
CHACARILLA,consulta externa,repetidas en personas de 15 a 59 anos,2005-01-01,0,1,0,1,1
CHALLAPATA,consulta externa,repetidas en personas de 15 a 59 anos,2005-01-01,12,16,12,16,28
CHAQUI,consulta externa,repetidas en personas de 15 a 59 anos,2005-01-01,3,5,3,5,8
CHARAGUA,consulta externa,repetidas en personas de 15 a 59 anos,2005-01-01,8,20,8,20,28
CHARAÑA,consulta externa,repetidas en personas de 15 a 59 anos,2005-01-01,0,2,0,2,2
CHAYANTA,consulta externa,repetidas en personas de 15 a 59 anos,2005-01-01,16,24,16,24,40
CHIMORE,consulta externa,repetidas en personas de 15 a 59 anos,2005-01-01,25,117,25,117,142
CHULUMANI (V. DE LA LIBERTAD),consulta externa,repetidas en personas de 15 a 59 anos,2005-01-01,63,32,63,32,95
CHUMA,consulta externa,repetidas en personas de 15 a 59 anos,2005-01-01,22,27,22,27,49
CLIZA,consulta externa,repetidas en personas de 15 a 59 anos,2005-01-01,0,1,0,1,1
COBIJA,consulta externa,repetidas en personas de 15 a 59 anos,2005-01-01,118,452,118,452,570
COCHABAMBA,consulta externa,repetidas en personas de 15 a 59 anos,2005-01-01,6580,17890,6580,17890,24470
COLCAPIRHUA,consulta externa,repetidas en personas de 15 a 59 anos,2005-01-01,79,227,79,227,306
"COLCHA ""K""",consulta externa,repetidas en personas de 15 a 59 anos,2005-01-01,3,6,3,6,9
COLLANA,consulta externa,repetidas en personas de 15 a 59 anos,2005-01-01,0,1,0,1,1
COLOMI,consulta externa,repetidas en personas de 15 a 59 anos,2005-01-01,14,8,14,8,22
COLPA BELGICA,consulta externa,repetidas en personas de 15 a 59 anos,2005-01-01,96,46,96,46,142
COLQUECHACA,consulta externa,repetidas en personas de 15 a 59 anos,2005-01-01,7,21,7,21,28
COLQUENCHA,consulta externa,repetidas en personas de 15 a 59 anos,2005-01-01,7,6,7,6,13
COLQUIRI,consulta externa,repetidas en personas de 15 a 59 anos,2005-01-01,11,23,11,23,34
COMANCHE,consulta externa,repetidas en personas de 15 a 59 anos,2005-01-01,0,2,0,2,2
COMARAPA,consulta externa,repetidas en personas de 15 a 59 anos,2005-01-01,29,56,29,56,85
COMBAYA,consulta externa,repetidas en personas de 15 a 59 anos,2005-01-01,2,3,2,3,5
CONCEPCION,consulta externa,repetidas en personas de 15 a 59 anos,2005-01-01,6,12,6,12,18
COPACABANA,consulta externa,repetidas en personas de 15 a 59 anos,2005-01-01,5,10,5,10,15
CORIPATA,consulta externa,repetidas en personas de 15 a 59 anos,2005-01-01,6,8,6,8,14
CORO CORO,consulta externa,repetidas en personas de 15 a 59 anos,2005-01-01,1,2,1,2,3
COROICO,consulta externa,repetidas en personas de 15 a 59 anos,2005-01-01,32,50,32,50,82
CORQUE,consulta externa,repetidas en personas de 15 a 59 anos,2005-01-01,23,2,23,2,25
COTAGAITA,consulta externa,repetidas en personas de 15 a 59 anos,2005-01-01,83,126,83,126,209
COTOCA,consulta externa,repetidas en personas de 15 a 59 anos,2005-01-01,6,13,6,13,19
CUATRO CAÑADAS,consulta externa,repetidas en personas de 15 a 59 anos,2005-01-01,16,129,16,129,145
CUCHUMUELA (V. G. VILLARROEL),consulta externa,repetidas en personas de 15 a 59 anos,2005-01-01,2,4,2,4,6
CUEVO,consulta externa,repetidas en personas de 15 a 59 anos,2005-01-01,2,10,2,10,12
CULPINA,consulta externa,repetidas en personas de 15 a 59 anos,2005-01-01,5,17,5,17,22
CURAHUARA DE CARANGAS,consulta externa,repetidas en personas de 15 a 59 anos,2005-01-01,1,1,1,1,2
CURVA,consulta externa,repetidas en personas de 15 a 59 anos,2005-01-01,1,2,1,2,3
DESAGUADERO,consulta externa,repetidas en personas de 15 a 59 anos,2005-01-01,0,1,0,1,1
EL ALTO,consulta externa,repetidas en personas de 15 a 59 anos,2005-01-01,1979,3268,1979,3268,5247
EL CHORO,consulta externa,repetidas en personas de 15 a 59 anos,2005-01-01,6,8,6,8,14
EL PUENTE(STC),consulta externa,repetidas en personas de 15 a 59 anos,2005-01-01,9,4,9,4,13
EL PUENTE(TJA),consulta externa,repetidas en personas de 15 a 59 anos,2005-01-01,7,3,7,3,10
EL TORNO,consulta externa,repetidas en personas de 15 a 59 anos,2005-01-01,95,223,95,223,318
EL VILLAR,consulta externa,repetidas en personas de 15 a 59 anos,2005-01-01,3,6,3,6,9
ENTRE RIOS,consulta externa,repetidas en personas de 15 a 59 anos,2005-01-01,10,10,10,10,20
ENTRE RIOS,consulta externa,repetidas en personas de 15 a 59 anos,2005-01-01,23,36,23,36,59
EUCALIPTUS,consulta externa,repetidas en personas de 15 a 59 anos,2005-01-01,2,8,2,8,10
EUREKA (SANTOS MERCADO),consulta externa,repetidas en personas de 15 a 59 anos,2005-01-01,2,1,2,1,3
EXALTACION,consulta externa,repetidas en personas de 15 a 59 anos,2005-01-01,1,4,1,4,5
FERNANDEZ ALONSO,consulta externa,repetidas en personas de 15 a 59 anos,2005-01-01,16,35,16,35,51
GENERAL SAAVEDRA,consulta externa,repetidas en personas de 15 a 59 anos,2005-01-01,6,11,6,11,17
GUANAY,consulta externa,repetidas en personas de 15 a 59 anos,2005-01-01,11,4,11,4,15
GUAQUI,consulta externa,repetidas en personas de 15 a 59 anos,2005-01-01,3,4,3,4,7
GUAYARAMERIN,consulta externa,repetidas en personas de 15 a 59 anos,2005-01-01,325,411,325,411,736
GUTIERREZ,consulta externa,repetidas en personas de 15 a 59 anos,2005-01-01,34,39,34,39,73
HUACARETA,consulta externa,repetidas en personas de 15 a 59 anos,2005-01-01,3,9,3,9,12
HUACAYA (VILLA DE HUACAYA),consulta externa,repetidas en personas de 15 a 59 anos,2005-01-01,0,1,0,1,1
HUANUNI,consulta externa,repetidas en personas de 15 a 59 anos,2005-01-01,87,97,87,97,184
HUARACAJE,consulta externa,repetidas en personas de 15 a 59 anos,2005-01-01,3,5,3,5,8
ICHOCA,consulta externa,repetidas en personas de 15 a 59 anos,2005-01-01,1,0,1,0,1
ICLA,consulta externa,repetidas en personas de 15 a 59 anos,2005-01-01,6,12,6,12,18
INCAHUASI,consulta externa,repetidas en personas de 15 a 59 anos,2005-01-01,0,4,0,4,4
INGAVI (HUMAITA),consulta externa,repetidas en personas de 15 a 59 anos,2005-01-01,3,2,3,2,5
INQUISIVI,consulta externa,repetidas en personas de 15 a 59 anos,2005-01-01,1,3,1,3,4
IRUPANA (VILLA DE LANZA),consulta externa,repetidas en personas de 15 a 59 anos,2005-01-01,23,14,23,14,37
IXIAMAS,consulta externa,repetidas en personas de 15 a 59 anos,2005-01-01,5,19,5,19,24
JESUS DE MACHACA,consulta externa,repetidas en personas de 15 a 59 anos,2005-01-01,1,14,1,14,15
LA ASUNTA,consulta externa,repetidas en personas de 15 a 59 anos,2005-01-01,2,9,2,9,11
LA GUARDIA,consulta externa,repetidas en personas de 15 a 59 anos,2005-01-01,17,129,17,129,146
LA PAZ,consulta externa,repetidas en personas de 15 a 59 anos,2005-01-01,10038,25406,10038,25406,35444
LAGUNILLAS,consulta externa,repetidas en personas de 15 a 59 anos,2005-01-01,0,5,0,5,5
LAJA,consulta externa,repetidas en personas de 15 a 59 anos,2005-01-01,6,7,6,7,13
LAS CARRERAS,consulta externa,repetidas en personas de 15 a 59 anos,2005-01-01,5,19,5,19,24
LLALLAGUA,consulta externa,repetidas en personas de 15 a 59 anos,2005-01-01,113,110,113,110,223
LLICA,consulta externa,repetidas en personas de 15 a 59 anos,2005-01-01,2,12,2,12,14
LORETO,consulta externa,repetidas en personas de 15 a 59 anos,2005-01-01,1,5,1,5,6
LURIBAY,consulta externa,repetidas en personas de 15 a 59 anos,2005-01-01,3,4,3,4,7
MACHACAMARCA,consulta externa,repetidas en personas de 15 a 59 anos,2005-01-01,18,25,18,25,43
MACHARETI,consulta externa,repetidas en personas de 15 a 59 anos,2005-01-01,8,10,8,10,18
MAGDALENA,consulta externa,repetidas en personas de 15 a 59 anos,2005-01-01,38,92,38,92,130
MAIRANA,consulta externa,repetidas en personas de 15 a 59 anos,2005-01-01,1,11,1,11,12
MAPIRI,consulta externa,repetidas en personas de 15 a 59 anos,2005-01-01,4,7,4,7,11
MECAPACA,consulta externa,repetidas en personas de 15 a 59 anos,2005-01-01,14,9,14,9,23
MINEROS,consulta externa,repetidas en personas de 15 a 59 anos,2005-01-01,8,37,8,37,45
MIZQUE,consulta externa,repetidas en personas de 15 a 59 anos,2005-01-01,4,7,4,7,11
MOCOMOCO,consulta externa,repetidas en personas de 15 a 59 anos,2005-01-01,9,7,9,7,16
MOJINETE,consulta externa,repetidas en personas de 15 a 59 anos,2005-01-01,2,21,2,21,23
MOJOCOYA,consulta externa,repetidas en personas de 15 a 59 anos,2005-01-01,2,3,2,3,5
MONTEAGUDO,consulta externa,repetidas en personas de 15 a 59 anos,2005-01-01,61,292,61,292,353
MONTERO,consulta externa,repetidas en personas de 15 a 59 anos,2005-01-01,650,1263,650,1263,1913
MORO MORO,consulta externa,repetidas en personas de 15 a 59 anos,2005-01-01,1,4,1,4,5
MOROCHATA,consulta externa,repetidas en personas de 15 a 59 anos,2005-01-01,4,47,4,47,51
OCURI,consulta externa,repetidas en personas de 15 a 59 anos,2005-01-01,1,13,1,13,14
OKINAWA,consulta externa,repetidas en personas de 15 a 59 anos,2005-01-01,15,29,15,29,44
OMEREQUE,consulta externa,repetidas en personas de 15 a 59 anos,2005-01-01,2,6,2,6,8
ORURO,consulta externa,repetidas en personas de 15 a 59 anos,2005-01-01,1586,3596,1586,3596,5182
PADCAYA,consulta externa,repetidas en personas de 15 a 59 anos,2005-01-01,6,13,6,13,19
PADILLA,consulta externa,repetidas en personas de 15 a 59 anos,2005-01-01,18,23,18,23,41
PAILON,consulta externa,repetidas en personas de 15 a 59 anos,2005-01-01,0,115,0,115,115
PALCA,consulta externa,repetidas en personas de 15 a 59 anos,2005-01-01,5,15,5,15,20
PALOS BLANCOS,consulta externa,repetidas en personas de 15 a 59 anos,2005-01-01,40,63,40,63,103
PAMPA AULLAGAS,consulta externa,repetidas en personas de 15 a 59 anos,2005-01-01,1,2,1,2,3
PAMPA GRANDE,consulta externa,repetidas en personas de 15 a 59 anos,2005-01-01,9,19,9,19,28
PAPEL PAMPA,consulta externa,repetidas en personas de 15 a 59 anos,2005-01-01,0,1,0,1,1
PATACAMAYA,consulta externa,repetidas en personas de 15 a 59 anos,2005-01-01,5,4,5,4,9
PAZÑA,consulta externa,repetidas en personas de 15 a 59 anos,2005-01-01,21,17,21,17,38
PELECHUCO,consulta externa,repetidas en personas de 15 a 59 anos,2005-01-01,8,6,8,6,14
POCOATA,consulta externa,repetidas en personas de 15 a 59 anos,2005-01-01,4,3,4,3,7
POCONA,consulta externa,repetidas en personas de 15 a 59 anos,2005-01-01,4,0,4,0,4
POJO (CBBA),consulta externa,repetidas en personas de 15 a 59 anos,2005-01-01,4,1,4,1,5
POOPO,consulta externa,repetidas en personas de 15 a 59 anos,2005-01-01,7,8,7,8,15
PORCO,consulta externa,repetidas en personas de 15 a 59 anos,2005-01-01,3,4,3,4,7
POROMA,consulta externa,repetidas en personas de 15 a 59 anos,2005-01-01,1,10,1,10,11
PORONGO,consulta externa,repetidas en personas de 15 a 59 anos,2005-01-01,18,22,18,22,40
PORTACHUELO,consulta externa,repetidas en personas de 15 a 59 anos,2005-01-01,44,71,44,71,115
PORVENIR,consulta externa,repetidas en personas de 15 a 59 anos,2005-01-01,1,1,1,1,2
POSTRER VALLE,consulta externa,repetidas en personas de 15 a 59 anos,2005-01-01,6,9,6,9,15
POTOSI,consulta externa,repetidas en personas de 15 a 59 anos,2005-01-01,2651,3308,2651,3308,5959
PRESTO,consulta externa,repetidas en personas de 15 a 59 anos,2005-01-01,1,2,1,2,3
PUERTO ACOSTA,consulta externa,repetidas en personas de 15 a 59 anos,2005-01-01,28,41,28,41,69
PUERTO CARABUCO,consulta externa,repetidas en personas de 15 a 59 anos,2005-01-01,3,13,3,13,16
PUERTO GONZALO MORENO,consulta externa,repetidas en personas de 15 a 59 anos,2005-01-01,2,13,2,13,15
PUERTO PEREZ,consulta externa,repetidas en personas de 15 a 59 anos,2005-01-01,6,1,6,1,7
PUERTO QUIJARRO,consulta externa,repetidas en personas de 15 a 59 anos,2005-01-01,143,82,143,82,225
PUERTO RICO,consulta externa,repetidas en personas de 15 a 59 anos,2005-01-01,8,22,8,22,30
PUERTO SILES,consulta externa,repetidas en personas de 15 a 59 anos,2005-01-01,8,2,8,2,10
PUERTO SUAREZ,consulta externa,repetidas en personas de 15 a 59 anos,2005-01-01,15,42,15,42,57
PUERTO VILLARROEL,consulta externa,repetidas en personas de 15 a 59 anos,2005-01-01,55,34,55,34,89
PUNA,consulta externa,repetidas en personas de 15 a 59 anos,2005-01-01,6,13,6,13,19
PUNATA,consulta externa,repetidas en personas de 15 a 59 anos,2005-01-01,72,178,72,178,250
QUIABAYA,consulta externa,repetidas en personas de 15 a 59 anos,2005-01-01,4,10,4,10,14
QUILLACOLLO,consulta externa,repetidas en personas de 15 a 59 anos,2005-01-01,239,702,239,702,941
QUIME,consulta externa,repetidas en personas de 15 a 59 anos,2005-01-01,13,12,13,12,25
QUIRUSILLAS,consulta externa,repetidas en personas de 15 a 59 anos,2005-01-01,1,0,1,0,1
RAVELO,consulta externa,repetidas en personas de 15 a 59 anos,2005-01-01,0,1,0,1,1
REYES,consulta externa,repetidas en personas de 15 a 59 anos,2005-01-01,36,64,36,64,100
RIBERALTA,consulta externa,repetidas en personas de 15 a 59 anos,2005-01-01,426,959,426,959,1385
ROBORE,consulta externa,repetidas en personas de 15 a 59 anos,2005-01-01,25,64,25,64,89
RURRENABAQUE,consulta externa,repetidas en personas de 15 a 59 anos,2005-01-01,35,40,35,40,75
SABAYA,consulta externa,repetidas en personas de 15 a 59 anos,2005-01-01,3,5,3,5,8
SACABA,consulta externa,repetidas en personas de 15 a 59 anos,2005-01-01,155,387,155,387,542
SACABAMBA,consulta externa,repetidas en personas de 15 a 59 anos,2005-01-01,2,0,2,0,2
SACACA,consulta externa,repetidas en personas de 15 a 59 anos,2005-01-01,1,1,1,1,2
SAIPINA,consulta externa,repetidas en personas de 15 a 59 anos,2005-01-01,10,32,10,32,42
SALINAS DE GARCI MENDOZA,consulta externa,repetidas en personas de 15 a 59 anos,2005-01-01,3,13,3,13,16
SAMAIPATA,consulta externa,repetidas en personas de 15 a 59 anos,2005-01-01,0,2,0,2,2
SAN ANDRES,consulta externa,repetidas en personas de 15 a 59 anos,2005-01-01,13,21,13,21,34
SAN ANDRES DE MACHACA,consulta externa,repetidas en personas de 15 a 59 anos,2005-01-01,1,3,1,3,4
SAN ANTONIO DE ESMORUCO,consulta externa,repetidas en personas de 15 a 59 anos,2005-01-01,0,6,0,6,6
SAN ANTONIO DE LOMERIO,consulta externa,repetidas en personas de 15 a 59 anos,2005-01-01,0,2,0,2,2
SAN BENITO,consulta externa,repetidas en personas de 15 a 59 anos,2005-01-01,7,13,7,13,20
SAN BORJA,consulta externa,repetidas en personas de 15 a 59 anos,2005-01-01,29,92,29,92,121
SAN BUENA VENTURA,consulta externa,repetidas en personas de 15 a 59 anos,2005-01-01,6,4,6,4,10
SAN CARLOS,consulta externa,repetidas en personas de 15 a 59 anos,2005-01-01,8,132,8,132,140
SAN IGNACIO,consulta externa,repetidas en personas de 15 a 59 anos,2005-01-01,24,67,24,67,91
SAN IGNACIO DE VELASCO,consulta externa,repetidas en personas de 15 a 59 anos,2005-01-01,78,175,78,175,253
SAN JAVIER(BNI),consulta externa,repetidas en personas de 15 a 59 anos,2005-01-01,1,6,1,6,7
SAN JAVIER(STC),consulta externa,repetidas en personas de 15 a 59 anos,2005-01-01,1,27,1,27,28
SAN JOAQUIN,consulta externa,repetidas en personas de 15 a 59 anos,2005-01-01,9,55,9,55,64
SAN JOSE DE CHIQUITOS,consulta externa,repetidas en personas de 15 a 59 anos,2005-01-01,8,20,8,20,28
SAN JUAN DE YAPACANI,consulta externa,repetidas en personas de 15 a 59 anos,2005-01-01,4,16,4,16,20
SAN JULIAN,consulta externa,repetidas en personas de 15 a 59 anos,2005-01-01,20,313,20,313,333
SAN LORENZO(PND),consulta externa,repetidas en personas de 15 a 59 anos,2005-01-01,1,1,1,1,2
SAN LORENZO(TJA),consulta externa,repetidas en personas de 15 a 59 anos,2005-01-01,16,26,16,26,42
SAN LUCAS,consulta externa,repetidas en personas de 15 a 59 anos,2005-01-01,5,24,5,24,29
SAN MATIAS,consulta externa,repetidas en personas de 15 a 59 anos,2005-01-01,12,21,12,21,33
SAN MIGUEL DE VELASCO,consulta externa,repetidas en personas de 15 a 59 anos,2005-01-01,26,61,26,61,87
SAN PABLO DE LIPEZ,consulta externa,repetidas en personas de 15 a 59 anos,2005-01-01,5,14,5,14,19
SAN PEDRO,consulta externa,repetidas en personas de 15 a 59 anos,2005-01-01,50,52,50,52,102
SAN PEDRO DE BUENA VISTA,consulta externa,repetidas en personas de 15 a 59 anos,2005-01-01,1,0,1,0,1
SAN PEDRO DE CURAHUARA,consulta externa,repetidas en personas de 15 a 59 anos,2005-01-01,1,4,1,4,5
SAN PEDRO DE QUEMES,consulta externa,repetidas en personas de 15 a 59 anos,2005-01-01,1,0,1,0,1
SAN PEDRO DE TIQUINA,consulta externa,repetidas en personas de 15 a 59 anos,2005-01-01,5,4,5,4,9
SAN RAFAEL,consulta externa,repetidas en personas de 15 a 59 anos,2005-01-01,3,13,3,13,16
SAN RAMON,consulta externa,repetidas en personas de 15 a 59 anos,2005-01-01,5,52,5,52,57
SAN RAMON,consulta externa,repetidas en personas de 15 a 59 anos,2005-01-01,5,38,5,38,43
SANTA ANA,consulta externa,repetidas en personas de 15 a 59 anos,2005-01-01,31,96,31,96,127
SANTA CRUZ DE LA SIERRA,consulta externa,repetidas en personas de 15 a 59 anos,2005-01-01,4999,11472,4999,11472,16471
SANTA ROSA DEL SARA,consulta externa,repetidas en personas de 15 a 59 anos,2005-01-01,19,15,19,15,34
SANTIAGO DE CALLAPA,consulta externa,repetidas en personas de 15 a 59 anos,2005-01-01,3,14,3,14,17
SANTIAGO DE HUARI,consulta externa,repetidas en personas de 15 a 59 anos,2005-01-01,13,4,13,4,17
SANTIAGO DE MACHACA,consulta externa,repetidas en personas de 15 a 59 anos,2005-01-01,1,0,1,0,1
SANTIVAÑES,consulta externa,repetidas en personas de 15 a 59 anos,2005-01-01,1,6,1,6,7
SAPAHAQUI,consulta externa,repetidas en personas de 15 a 59 anos,2005-01-01,1,1,1,1,2
SICA SICA (VILLA AROMA),consulta externa,repetidas en personas de 15 a 59 anos,2005-01-01,3,11,3,11,14
SIPE SIPE,consulta externa,repetidas en personas de 15 a 59 anos,2005-01-01,16,215,16,215,231
SOPACHUY,consulta externa,repetidas en personas de 15 a 59 anos,2005-01-01,2,5,2,5,7
SORACACHI,consulta externa,repetidas en personas de 15 a 59 anos,2005-01-01,3,6,3,6,9
SORATA,consulta externa,repetidas en personas de 15 a 59 anos,2005-01-01,4,4,4,4,8
SUCRE,consulta externa,repetidas en personas de 15 a 59 anos,2005-01-01,2036,5926,2036,5926,7962
TACACHI,consulta externa,repetidas en personas de 15 a 59 anos,2005-01-01,8,30,8,30,38
TACACOMA,consulta externa,repetidas en personas de 15 a 59 anos,2005-01-01,1,0,1,0,1
TACOBAMBA,consulta externa,repetidas en personas de 15 a 59 anos,2005-01-01,1,3,1,3,4
TACOPAYA,consulta externa,repetidas en personas de 15 a 59 anos,2005-01-01,0,7,0,7,7
TAHUA,consulta externa,repetidas en personas de 15 a 59 anos,2005-01-01,0,1,0,1,1
TAPACARI,consulta externa,repetidas en personas de 15 a 59 anos,2005-01-01,6,21,6,21,27
TARABUCO,consulta externa,repetidas en personas de 15 a 59 anos,2005-01-01,16,20,16,20,36
TARACO,consulta externa,repetidas en personas de 15 a 59 anos,2005-01-01,1,0,1,0,1
TARATA,consulta externa,repetidas en personas de 15 a 59 anos,2005-01-01,15,8,15,8,23
TARIJA,consulta externa,repetidas en personas de 15 a 59 anos,2005-01-01,1497,4472,1497,4472,5969
TARVITA,consulta externa,repetidas en personas de 15 a 59 anos,2005-01-01,10,15,10,15,25
TEOPONTE,consulta externa,repetidas en personas de 15 a 59 anos,2005-01-01,0,1,0,1,1
TIAWANACU,consulta externa,repetidas en personas de 15 a 59 anos,2005-01-01,5,11,5,11,16
TINGUIPAYA,consulta externa,repetidas en personas de 15 a 59 anos,2005-01-01,2,2,2,2,4
TIPUANI,consulta externa,repetidas en personas de 15 a 59 anos,2005-01-01,4,0,4,0,4
TIQUIPAYA,consulta externa,repetidas en personas de 15 a 59 anos,2005-01-01,31,317,31,317,348
TIRAQUE (CBBA),consulta externa,repetidas en personas de 15 a 59 anos,2005-01-01,28,179,28,179,207
TITO YUPANQUI (PARQUIPUJIO),consulta externa,repetidas en personas de 15 a 59 anos,2005-01-01,2,2,2,2,4
TOLATA,consulta externa,repetidas en personas de 15 a 59 anos,2005-01-01,1,1,1,1,2
TOLEDO,consulta externa,repetidas en personas de 15 a 59 anos,2005-01-01,3,10,3,10,13
TOMAVE,consulta externa,repetidas en personas de 15 a 59 anos,2005-01-01,5,3,5,3,8
TOMINA,consulta externa,repetidas en personas de 15 a 59 anos,2005-01-01,6,9,6,9,15
TORO TORO,consulta externa,repetidas en personas de 15 a 59 anos,2005-01-01,5,3,5,3,8
TOTORA(CBBA),consulta externa,repetidas en personas de 15 a 59 anos,2005-01-01,4,1,4,1,5
TRIGAL,consulta externa,repetidas en personas de 15 a 59 anos,2005-01-01,1,1,1,1,2
TRINIDAD,consulta externa,repetidas en personas de 15 a 59 anos,2005-01-01,370,822,370,822,1192
TUPIZA,consulta externa,repetidas en personas de 15 a 59 anos,2005-01-01,85,210,85,210,295
TURCO,consulta externa,repetidas en personas de 15 a 59 anos,2005-01-01,0,2,0,2,2
UMALA,consulta externa,repetidas en personas de 15 a 59 anos,2005-01-01,0,1,0,1,1
UNCIA,consulta externa,repetidas en personas de 15 a 59 anos,2005-01-01,85,120,85,120,205
URIONDO (A. CONCEPCION),consulta externa,repetidas en personas de 15 a 59 anos,2005-01-01,2,18,2,18,20
URUBICHA,consulta externa,repetidas en personas de 15 a 59 anos,2005-01-01,0,147,0,147,147
UYUNI,consulta externa,repetidas en personas de 15 a 59 anos,2005-01-01,34,121,34,121,155
VACAS,consulta externa,repetidas en personas de 15 a 59 anos,2005-01-01,19,19,19,19,38
VALLEGRANDE,consulta externa,repetidas en personas de 15 a 59 anos,2005-01-01,57,144,57,144,201
VIACHA,consulta externa,repetidas en personas de 15 a 59 anos,2005-01-01,110,195,110,195,305
VILA VILA,consulta externa,repetidas en personas de 15 a 59 anos,2005-01-01,5,2,5,2,7
VILLA MONTES,consulta externa,repetidas en personas de 15 a 59 anos,2005-01-01,59,92,59,92,151
VILLA NUEVA (LOMA ALTA),consulta externa,repetidas en personas de 15 a 59 anos,2005-01-01,0,1,0,1,1
VILLA RIVERO,consulta externa,repetidas en personas de 15 a 59 anos,2005-01-01,5,33,5,33,38
VILLA SERRANO,consulta externa,repetidas en personas de 15 a 59 anos,2005-01-01,4,5,4,5,9
VILLA TUNARI,consulta externa,repetidas en personas de 15 a 59 anos,2005-01-01,61,84,61,84,145
VILLA VACA GUZMAN (MUYUPAMPA),consulta externa,repetidas en personas de 15 a 59 anos,2005-01-01,8,17,8,17,25
VILLAZON,consulta externa,repetidas en personas de 15 a 59 anos,2005-01-01,46,174,46,174,220
VINTO,consulta externa,repetidas en personas de 15 a 59 anos,2005-01-01,1,6,1,6,7
VITICHI,consulta externa,repetidas en personas de 15 a 59 anos,2005-01-01,20,28,20,28,48
WALDO BALLIVIAN,consulta externa,repetidas en personas de 15 a 59 anos,2005-01-01,2,0,2,0,2
WARNES,consulta externa,repetidas en personas de 15 a 59 anos,2005-01-01,7,5,7,5,12
YACO,consulta externa,repetidas en personas de 15 a 59 anos,2005-01-01,0,1,0,1,1
YACUIBA,consulta externa,repetidas en personas de 15 a 59 anos,2005-01-01,253,917,253,917,1170
YAMPARAEZ,consulta externa,repetidas en personas de 15 a 59 anos,2005-01-01,16,15,16,15,31
YANACACHI,consulta externa,repetidas en personas de 15 a 59 anos,2005-01-01,5,5,5,5,10
YAPACANI,consulta externa,repetidas en personas de 15 a 59 anos,2005-01-01,24,321,24,321,345
YOCALLA,consulta externa,repetidas en personas de 15 a 59 anos,2005-01-01,2,23,2,23,25
YOTALA,consulta externa,repetidas en personas de 15 a 59 anos,2005-01-01,28,60,28,60,88
YUNCHARA,consulta externa,repetidas en personas de 15 a 59 anos,2005-01-01,1,1,1,1,2
ZUDAÑEZ,consulta externa,repetidas en personas de 15 a 59 anos,2005-01-01,5,7,5,7,12
ACACIO,consulta externa,repetidas en personas de 15 a 59 anos,2005-02-01,3,0,3,0,3
ACHACACHI,consulta externa,repetidas en personas de 15 a 59 anos,2005-02-01,43,52,43,52,95
ACHOCALLA,consulta externa,repetidas en personas de 15 a 59 anos,2005-02-01,6,7,6,7,13
AIQUILE,consulta externa,repetidas en personas de 15 a 59 anos,2005-02-01,33,195,33,195,228
ALALAY,consulta externa,repetidas en personas de 15 a 59 anos,2005-02-01,0,2,0,2,2
ALCALA,consulta externa,repetidas en personas de 15 a 59 anos,2005-02-01,0,1,0,1,1
ANCORAIMES,consulta externa,repetidas en personas de 15 a 59 anos,2005-02-01,9,6,9,6,15
ANZALDO,consulta externa,repetidas en personas de 15 a 59 anos,2005-02-01,2,12,2,12,14
APOLO,consulta externa,repetidas en personas de 15 a 59 anos,2005-02-01,11,9,11,9,20
ARAMPAMPA,consulta externa,repetidas en personas de 15 a 59 anos,2005-02-01,3,0,3,0,3
ARANI,consulta externa,repetidas en personas de 15 a 59 anos,2005-02-01,4,6,4,6,10
ARBIETO,consulta externa,repetidas en personas de 15 a 59 anos,2005-02-01,1,7,1,7,8
ATOCHA,consulta externa,repetidas en personas de 15 a 59 anos,2005-02-01,146,165,146,165,311
AUCAPATA,consulta externa,repetidas en personas de 15 a 59 anos,2005-02-01,0,1,0,1,1
AYATA,consulta externa,repetidas en personas de 15 a 59 anos,2005-02-01,1,1,1,1,2
AYO AYO,consulta externa,repetidas en personas de 15 a 59 anos,2005-02-01,1,1,1,1,2
AYOPAYA (V. DE INDEPENDENCIA),consulta externa,repetidas en personas de 15 a 59 anos,2005-02-01,10,13,10,13,23
AZURDUY,consulta externa,repetidas en personas de 15 a 59 anos,2005-02-01,2,5,2,5,7
BATALLAS,consulta externa,repetidas en personas de 15 a 59 anos,2005-02-01,5,8,5,8,13
BAURES,consulta externa,repetidas en personas de 15 a 59 anos,2005-02-01,3,15,3,15,18
BELEN DE ANDAMARCA,consulta externa,repetidas en personas de 15 a 59 anos,2005-02-01,0,1,0,1,1
BELEN DE URMIRI,consulta externa,repetidas en personas de 15 a 59 anos,2005-02-01,3,3,3,3,6
BERMEJO,consulta externa,repetidas en personas de 15 a 59 anos,2005-02-01,152,246,152,246,398
BETANZOS,consulta externa,repetidas en personas de 15 a 59 anos,2005-02-01,20,47,20,47,67
BOLIVAR,consulta externa,repetidas en personas de 15 a 59 anos,2005-02-01,3,2,3,2,5
BOLPEBRA,consulta externa,repetidas en personas de 15 a 59 anos,2005-02-01,0,1,0,1,1
BOYUIBE,consulta externa,repetidas en personas de 15 a 59 anos,2005-02-01,4,13,4,13,17
BUENA VISTA,consulta externa,repetidas en personas de 15 a 59 anos,2005-02-01,37,54,37,54,91
CABEZAS,consulta externa,repetidas en personas de 15 a 59 anos,2005-02-01,0,1,0,1,1
CAIROMA,consulta externa,repetidas en personas de 15 a 59 anos,2005-02-01,0,1,0,1,1
"CAIZA ""D""",consulta externa,repetidas en personas de 15 a 59 anos,2005-02-01,1,3,1,3,4
CAJUATA,consulta externa,repetidas en personas de 15 a 59 anos,2005-02-01,0,2,0,2,2
CALACOTO,consulta externa,repetidas en personas de 15 a 59 anos,2005-02-01,1,1,1,1,2
CALAMARCA,consulta externa,repetidas en personas de 15 a 59 anos,2005-02-01,15,15,15,15,30
CAMARGO,consulta externa,repetidas en personas de 15 a 59 anos,2005-02-01,13,22,13,22,35
CAMATAQUI (C. VILLA ABECIA),consulta externa,repetidas en personas de 15 a 59 anos,2005-02-01,3,4,3,4,7
CAMIRI,consulta externa,repetidas en personas de 15 a 59 anos,2005-02-01,88,180,88,180,268
CAPINOTA,consulta externa,repetidas en personas de 15 a 59 anos,2005-02-01,20,15,20,15,35
CAQUIAVIRI,consulta externa,repetidas en personas de 15 a 59 anos,2005-02-01,3,4,3,4,7
CARACOLLO,consulta externa,repetidas en personas de 15 a 59 anos,2005-02-01,7,15,7,15,22
CARANAVI,consulta externa,repetidas en personas de 15 a 59 anos,2005-02-01,18,18,18,18,36
CARAPARI,consulta externa,repetidas en personas de 15 a 59 anos,2005-02-01,8,7,8,7,15
CARIPUYO,consulta externa,repetidas en personas de 15 a 59 anos,2005-02-01,0,1,0,1,1
CARMEN RIVERO TORREZ,consulta externa,repetidas en personas de 15 a 59 anos,2005-02-01,2,4,2,4,6
CATACORA,consulta externa,repetidas en personas de 15 a 59 anos,2005-02-01,1,1,1,1,2
CHACARILLA,consulta externa,repetidas en personas de 15 a 59 anos,2005-02-01,1,0,1,0,1
CHALLAPATA,consulta externa,repetidas en personas de 15 a 59 anos,2005-02-01,25,29,25,29,54
CHAQUI,consulta externa,repetidas en personas de 15 a 59 anos,2005-02-01,4,6,4,6,10
CHARAGUA,consulta externa,repetidas en personas de 15 a 59 anos,2005-02-01,9,31,9,31,40
CHARAÑA,consulta externa,repetidas en personas de 15 a 59 anos,2005-02-01,4,0,4,0,4
CHAYANTA,consulta externa,repetidas en personas de 15 a 59 anos,2005-02-01,9,14,9,14,23
CHIMORE,consulta externa,repetidas en personas de 15 a 59 anos,2005-02-01,14,101,14,101,115
CHOQUE COTA,consulta externa,repetidas en personas de 15 a 59 anos,2005-02-01,0,1,0,1,1
CHULUMANI (V. DE LA LIBERTAD),consulta externa,repetidas en personas de 15 a 59 anos,2005-02-01,65,40,65,40,105
CHUMA,consulta externa,repetidas en personas de 15 a 59 anos,2005-02-01,32,28,32,28,60
CLIZA,consulta externa,repetidas en personas de 15 a 59 anos,2005-02-01,2,14,2,14,16
COBIJA,consulta externa,repetidas en personas de 15 a 59 anos,2005-02-01,90,388,90,388,478
COCHABAMBA,consulta externa,repetidas en personas de 15 a 59 anos,2005-02-01,5563,14721,5563,14721,20284
COLCAPIRHUA,consulta externa,repetidas en personas de 15 a 59 anos,2005-02-01,84,298,84,298,382
"COLCHA ""K""",consulta externa,repetidas en personas de 15 a 59 anos,2005-02-01,5,16,5,16,21
COLLANA,consulta externa,repetidas en personas de 15 a 59 anos,2005-02-01,1,0,1,0,1
COLOMI,consulta externa,repetidas en personas de 15 a 59 anos,2005-02-01,2,8,2,8,10
COLPA BELGICA,consulta externa,repetidas en personas de 15 a 59 anos,2005-02-01,60,63,60,63,123
COLQUECHACA,consulta externa,repetidas en personas de 15 a 59 anos,2005-02-01,4,5,4,5,9
COLQUENCHA,consulta externa,repetidas en personas de 15 a 59 anos,2005-02-01,0,1,0,1,1
COLQUIRI,consulta externa,repetidas en personas de 15 a 59 anos,2005-02-01,21,10,21,10,31
COMANCHE,consulta externa,repetidas en personas de 15 a 59 anos,2005-02-01,2,3,2,3,5
COMARAPA,consulta externa,repetidas en personas de 15 a 59 anos,2005-02-01,23,48,23,48,71
COMBAYA,consulta externa,repetidas en personas de 15 a 59 anos,2005-02-01,3,3,3,3,6
COPACABANA,consulta externa,repetidas en personas de 15 a 59 anos,2005-02-01,0,4,0,4,4
CORIPATA,consulta externa,repetidas en personas de 15 a 59 anos,2005-02-01,1,1,1,1,2
CORO CORO,consulta externa,repetidas en personas de 15 a 59 anos,2005-02-01,1,1,1,1,2
COROICO,consulta externa,repetidas en personas de 15 a 59 anos,2005-02-01,62,66,62,66,128
CORQUE,consulta externa,repetidas en personas de 15 a 59 anos,2005-02-01,12,8,12,8,20
COTAGAITA,consulta externa,repetidas en personas de 15 a 59 anos,2005-02-01,55,68,55,68,123
COTOCA,consulta externa,repetidas en personas de 15 a 59 anos,2005-02-01,9,53,9,53,62
CUATRO CAÑADAS,consulta externa,repetidas en personas de 15 a 59 anos,2005-02-01,18,141,18,141,159
CUCHUMUELA (V. G. VILLARROEL),consulta externa,repetidas en personas de 15 a 59 anos,2005-02-01,0,3,0,3,3
CUEVO,consulta externa,repetidas en personas de 15 a 59 anos,2005-02-01,6,14,6,14,20
CULPINA,consulta externa,repetidas en personas de 15 a 59 anos,2005-02-01,4,7,4,7,11
CURAHUARA DE CARANGAS,consulta externa,repetidas en personas de 15 a 59 anos,2005-02-01,0,3,0,3,3
CURVA,consulta externa,repetidas en personas de 15 a 59 anos,2005-02-01,1,2,1,2,3
DESAGUADERO,consulta externa,repetidas en personas de 15 a 59 anos,2005-02-01,1,0,1,0,1
EL ALTO,consulta externa,repetidas en personas de 15 a 59 anos,2005-02-01,1767,3222,1767,3222,4989
EL CHORO,consulta externa,repetidas en personas de 15 a 59 anos,2005-02-01,3,0,3,0,3
EL PUENTE(STC),consulta externa,repetidas en personas de 15 a 59 anos,2005-02-01,2,8,2,8,10
EL PUENTE(TJA),consulta externa,repetidas en personas de 15 a 59 anos,2005-02-01,2,4,2,4,6
EL TORNO,consulta externa,repetidas en personas de 15 a 59 anos,2005-02-01,100,145,100,145,245
EL VILLAR,consulta externa,repetidas en personas de 15 a 59 anos,2005-02-01,5,8,5,8,13
ENTRE RIOS,consulta externa,repetidas en personas de 15 a 59 anos,2005-02-01,6,11,6,11,17
ENTRE RIOS,consulta externa,repetidas en personas de 15 a 59 anos,2005-02-01,17,16,17,16,33
EUCALIPTUS,consulta externa,repetidas en personas de 15 a 59 anos,2005-02-01,1,1,1,1,2
EXALTACION,consulta externa,repetidas en personas de 15 a 59 anos,2005-02-01,1,1,1,1,2
FERNANDEZ ALONSO,consulta externa,repetidas en personas de 15 a 59 anos,2005-02-01,8,16,8,16,24
FILADELFIA,consulta externa,repetidas en personas de 15 a 59 anos,2005-02-01,14,45,14,45,59
GENERAL SAAVEDRA,consulta externa,repetidas en personas de 15 a 59 anos,2005-02-01,2,10,2,10,12
GRAL. J.J. PEREZ (CHARAZANI),consulta externa,repetidas en personas de 15 a 59 anos,2005-02-01,1,2,1,2,3
GUANAY,consulta externa,repetidas en personas de 15 a 59 anos,2005-02-01,4,6,4,6,10
GUAQUI,consulta externa,repetidas en personas de 15 a 59 anos,2005-02-01,3,1,3,1,4
GUAYARAMERIN,consulta externa,repetidas en personas de 15 a 59 anos,2005-02-01,100,284,100,284,384
GUTIERREZ,consulta externa,repetidas en personas de 15 a 59 anos,2005-02-01,10,21,10,21,31
HUACARETA,consulta externa,repetidas en personas de 15 a 59 anos,2005-02-01,9,8,9,8,17
HUACAYA (VILLA DE HUACAYA),consulta externa,repetidas en personas de 15 a 59 anos,2005-02-01,1,0,1,0,1
HUANUNI,consulta externa,repetidas en personas de 15 a 59 anos,2005-02-01,356,372,356,372,728
HUARACAJE,consulta externa,repetidas en personas de 15 a 59 anos,2005-02-01,9,5,9,5,14
HUAYLLAMARCA,consulta externa,repetidas en personas de 15 a 59 anos,2005-02-01,1,0,1,0,1
ICHOCA,consulta externa,repetidas en personas de 15 a 59 anos,2005-02-01,3,2,3,2,5
ICLA,consulta externa,repetidas en personas de 15 a 59 anos,2005-02-01,5,7,5,7,12
INCAHUASI,consulta externa,repetidas en personas de 15 a 59 anos,2005-02-01,4,5,4,5,9
INGAVI (HUMAITA),consulta externa,repetidas en personas de 15 a 59 anos,2005-02-01,4,2,4,2,6
INQUISIVI,consulta externa,repetidas en personas de 15 a 59 anos,2005-02-01,3,2,3,2,5
IRUPANA (VILLA DE LANZA),consulta externa,repetidas en personas de 15 a 59 anos,2005-02-01,20,15,20,15,35
IXIAMAS,consulta externa,repetidas en personas de 15 a 59 anos,2005-02-01,9,15,9,15,24
JESUS DE MACHACA,consulta externa,repetidas en personas de 15 a 59 anos,2005-02-01,44,7,44,7,51
LA ASUNTA,consulta externa,repetidas en personas de 15 a 59 anos,2005-02-01,1,2,1,2,3
LA GUARDIA,consulta externa,repetidas en personas de 15 a 59 anos,2005-02-01,20,97,20,97,117
LA PAZ,consulta externa,repetidas en personas de 15 a 59 anos,2005-02-01,9820,25570,9820,25570,35390
LAGUNILLAS,consulta externa,repetidas en personas de 15 a 59 anos,2005-02-01,0,2,0,2,2
LAJA,consulta externa,repetidas en personas de 15 a 59 anos,2005-02-01,6,10,6,10,16
LAS CARRERAS,consulta externa,repetidas en personas de 15 a 59 anos,2005-02-01,5,22,5,22,27
LLALLAGUA,consulta externa,repetidas en personas de 15 a 59 anos,2005-02-01,99,139,99,139,238
LLICA,consulta externa,repetidas en personas de 15 a 59 anos,2005-02-01,0,2,0,2,2
LORETO,consulta externa,repetidas en personas de 15 a 59 anos,2005-02-01,3,5,3,5,8
LURIBAY,consulta externa,repetidas en personas de 15 a 59 anos,2005-02-01,0,6,0,6,6
MACHACAMARCA,consulta externa,repetidas en personas de 15 a 59 anos,2005-02-01,5,21,5,21,26
MACHARETI,consulta externa,repetidas en personas de 15 a 59 anos,2005-02-01,5,16,5,16,21
MAGDALENA,consulta externa,repetidas en personas de 15 a 59 anos,2005-02-01,36,82,36,82,118
MAIRANA,consulta externa,repetidas en personas de 15 a 59 anos,2005-02-01,4,7,4,7,11
MAPIRI,consulta externa,repetidas en personas de 15 a 59 anos,2005-02-01,1,3,1,3,4
MECAPACA,consulta externa,repetidas en personas de 15 a 59 anos,2005-02-01,19,29,19,29,48
MINEROS,consulta externa,repetidas en personas de 15 a 59 anos,2005-02-01,6,36,6,36,42
MIZQUE,consulta externa,repetidas en personas de 15 a 59 anos,2005-02-01,3,1,3,1,4
MOCOMOCO,consulta externa,repetidas en personas de 15 a 59 anos,2005-02-01,10,3,10,3,13
MOJINETE,consulta externa,repetidas en personas de 15 a 59 anos,2005-02-01,3,3,3,3,6
MOJOCOYA,consulta externa,repetidas en personas de 15 a 59 anos,2005-02-01,1,8,1,8,9
MONTEAGUDO,consulta externa,repetidas en personas de 15 a 59 anos,2005-02-01,46,350,46,350,396
MONTERO,consulta externa,repetidas en personas de 15 a 59 anos,2005-02-01,648,1115,648,1115,1763
MORO MORO,consulta externa,repetidas en personas de 15 a 59 anos,2005-02-01,2,7,2,7,9
MOROCHATA,consulta externa,repetidas en personas de 15 a 59 anos,2005-02-01,5,41,5,41,46
NUEVO MANOA (NUEVA ESPERANZA),consulta externa,repetidas en personas de 15 a 59 anos,2005-02-01,2,2,2,2,4
OCURI,consulta externa,repetidas en personas de 15 a 59 anos,2005-02-01,2,6,2,6,8
OKINAWA,consulta externa,repetidas en personas de 15 a 59 anos,2005-02-01,29,33,29,33,62
OMEREQUE,consulta externa,repetidas en personas de 15 a 59 anos,2005-02-01,1,2,1,2,3
ORURO,consulta externa,repetidas en personas de 15 a 59 anos,2005-02-01,1239,2921,1239,2921,4160
PADCAYA,consulta externa,repetidas en personas de 15 a 59 anos,2005-02-01,2,7,2,7,9
PADILLA,consulta externa,repetidas en personas de 15 a 59 anos,2005-02-01,7,28,7,28,35
PAILON,consulta externa,repetidas en personas de 15 a 59 anos,2005-02-01,0,80,0,80,80
PALCA,consulta externa,repetidas en personas de 15 a 59 anos,2005-02-01,2,10,2,10,12
PALOS BLANCOS,consulta externa,repetidas en personas de 15 a 59 anos,2005-02-01,62,115,62,115,177
PAMPA AULLAGAS,consulta externa,repetidas en personas de 15 a 59 anos,2005-02-01,1,2,1,2,3
PAMPA GRANDE,consulta externa,repetidas en personas de 15 a 59 anos,2005-02-01,5,15,5,15,20
PAPEL PAMPA,consulta externa,repetidas en personas de 15 a 59 anos,2005-02-01,1,1,1,1,2
PASORAPA,consulta externa,repetidas en personas de 15 a 59 anos,2005-02-01,0,1,0,1,1
PATACAMAYA,consulta externa,repetidas en personas de 15 a 59 anos,2005-02-01,0,1,0,1,1
PAZÑA,consulta externa,repetidas en personas de 15 a 59 anos,2005-02-01,15,17,15,17,32
PELECHUCO,consulta externa,repetidas en personas de 15 a 59 anos,2005-02-01,67,75,67,75,142
POCOATA,consulta externa,repetidas en personas de 15 a 59 anos,2005-02-01,2,7,2,7,9
POCONA,consulta externa,repetidas en personas de 15 a 59 anos,2005-02-01,6,4,6,4,10
POJO (CBBA),consulta externa,repetidas en personas de 15 a 59 anos,2005-02-01,3,1,3,1,4
POOPO,consulta externa,repetidas en personas de 15 a 59 anos,2005-02-01,7,8,7,8,15
PORCO,consulta externa,repetidas en personas de 15 a 59 anos,2005-02-01,3,6,3,6,9
POROMA,consulta externa,repetidas en personas de 15 a 59 anos,2005-02-01,2,12,2,12,14
PORONGO,consulta externa,repetidas en personas de 15 a 59 anos,2005-02-01,7,14,7,14,21
PORTACHUELO,consulta externa,repetidas en personas de 15 a 59 anos,2005-02-01,25,69,25,69,94
PORVENIR,consulta externa,repetidas en personas de 15 a 59 anos,2005-02-01,2,1,2,1,3
POSTRER VALLE,consulta externa,repetidas en personas de 15 a 59 anos,2005-02-01,1,3,1,3,4
POTOSI,consulta externa,repetidas en personas de 15 a 59 anos,2005-02-01,2371,3281,2371,3281,5652
PRESTO,consulta externa,repetidas en personas de 15 a 59 anos,2005-02-01,2,0,2,0,2
PUCARANI,consulta externa,repetidas en personas de 15 a 59 anos,2005-02-01,8,0,8,0,8
PUERTO ACOSTA,consulta externa,repetidas en personas de 15 a 59 anos,2005-02-01,34,54,34,54,88
PUERTO CARABUCO,consulta externa,repetidas en personas de 15 a 59 anos,2005-02-01,4,8,4,8,12
PUERTO GONZALO MORENO,consulta externa,repetidas en personas de 15 a 59 anos,2005-02-01,6,16,6,16,22
PUERTO PEREZ,consulta externa,repetidas en personas de 15 a 59 anos,2005-02-01,0,3,0,3,3
PUERTO QUIJARRO,consulta externa,repetidas en personas de 15 a 59 anos,2005-02-01,28,75,28,75,103
PUERTO RICO,consulta externa,repetidas en personas de 15 a 59 anos,2005-02-01,2,6,2,6,8
PUERTO SILES,consulta externa,repetidas en personas de 15 a 59 anos,2005-02-01,2,5,2,5,7
PUERTO SUAREZ,consulta externa,repetidas en personas de 15 a 59 anos,2005-02-01,8,32,8,32,40
PUERTO VILLARROEL,consulta externa,repetidas en personas de 15 a 59 anos,2005-02-01,29,56,29,56,85
PUNA,consulta externa,repetidas en personas de 15 a 59 anos,2005-02-01,4,20,4,20,24
PUNATA,consulta externa,repetidas en personas de 15 a 59 anos,2005-02-01,93,151,93,151,244
QUIABAYA,consulta externa,repetidas en personas de 15 a 59 anos,2005-02-01,3,8,3,8,11
QUILLACOLLO,consulta externa,repetidas en personas de 15 a 59 anos,2005-02-01,192,697,192,697,889
QUIME,consulta externa,repetidas en personas de 15 a 59 anos,2005-02-01,5,10,5,10,15
QUIRUSILLAS,consulta externa,repetidas en personas de 15 a 59 anos,2005-02-01,1,1,1,1,2
RAVELO,consulta externa,repetidas en personas de 15 a 59 anos,2005-02-01,13,11,13,11,24
REYES,consulta externa,repetidas en personas de 15 a 59 anos,2005-02-01,22,53,22,53,75
RIBERALTA,consulta externa,repetidas en personas de 15 a 59 anos,2005-02-01,322,571,322,571,893
ROBORE,consulta externa,repetidas en personas de 15 a 59 anos,2005-02-01,25,49,25,49,74
RURRENABAQUE,consulta externa,repetidas en personas de 15 a 59 anos,2005-02-01,24,19,24,19,43
SABAYA,consulta externa,repetidas en personas de 15 a 59 anos,2005-02-01,1,1,1,1,2
SACABA,consulta externa,repetidas en personas de 15 a 59 anos,2005-02-01,127,303,127,303,430
SACABAMBA,consulta externa,repetidas en personas de 15 a 59 anos,2005-02-01,3,4,3,4,7
SACACA,consulta externa,repetidas en personas de 15 a 59 anos,2005-02-01,1,3,1,3,4
SAIPINA,consulta externa,repetidas en personas de 15 a 59 anos,2005-02-01,8,20,8,20,28
SALINAS DE GARCI MENDOZA,consulta externa,repetidas en personas de 15 a 59 anos,2005-02-01,3,16,3,16,19
SAMAIPATA,consulta externa,repetidas en personas de 15 a 59 anos,2005-02-01,2,2,2,2,4
SAN AGUSTIN,consulta externa,repetidas en personas de 15 a 59 anos,2005-02-01,1,0,1,0,1
SAN ANDRES,consulta externa,repetidas en personas de 15 a 59 anos,2005-02-01,5,11,5,11,16
SAN ANDRES DE MACHACA,consulta externa,repetidas en personas de 15 a 59 anos,2005-02-01,1,3,1,3,4
SAN ANTONIO DE ESMORUCO,consulta externa,repetidas en personas de 15 a 59 anos,2005-02-01,1,5,1,5,6
SAN ANTONIO DE LOMERIO,consulta externa,repetidas en personas de 15 a 59 anos,2005-02-01,3,1,3,1,4
SAN BENITO,consulta externa,repetidas en personas de 15 a 59 anos,2005-02-01,14,19,14,19,33
SAN BORJA,consulta externa,repetidas en personas de 15 a 59 anos,2005-02-01,24,108,24,108,132
SAN BUENA VENTURA,consulta externa,repetidas en personas de 15 a 59 anos,2005-02-01,12,10,12,10,22
SAN CARLOS,consulta externa,repetidas en personas de 15 a 59 anos,2005-02-01,30,94,30,94,124
SAN IGNACIO,consulta externa,repetidas en personas de 15 a 59 anos,2005-02-01,28,77,28,77,105
SAN IGNACIO DE VELASCO,consulta externa,repetidas en personas de 15 a 59 anos,2005-02-01,56,157,56,157,213
SAN JAVIER(BNI),consulta externa,repetidas en personas de 15 a 59 anos,2005-02-01,1,1,1,1,2
SAN JAVIER(STC),consulta externa,repetidas en personas de 15 a 59 anos,2005-02-01,13,38,13,38,51
SAN JOAQUIN,consulta externa,repetidas en personas de 15 a 59 anos,2005-02-01,10,46,10,46,56
SAN JOSE DE CHIQUITOS,consulta externa,repetidas en personas de 15 a 59 anos,2005-02-01,4,5,4,5,9
SAN JUAN DE YAPACANI,consulta externa,repetidas en personas de 15 a 59 anos,2005-02-01,10,19,10,19,29
SAN JULIAN,consulta externa,repetidas en personas de 15 a 59 anos,2005-02-01,36,380,36,380,416
SAN LORENZO(PND),consulta externa,repetidas en personas de 15 a 59 anos,2005-02-01,0,2,0,2,2
SAN LORENZO(TJA),consulta externa,repetidas en personas de 15 a 59 anos,2005-02-01,14,14,14,14,28
SAN LUCAS,consulta externa,repetidas en personas de 15 a 59 anos,2005-02-01,6,25,6,25,31
SAN MIGUEL DE VELASCO,consulta externa,repetidas en personas de 15 a 59 anos,2005-02-01,20,58,20,58,78
SAN PABLO DE LIPEZ,consulta externa,repetidas en personas de 15 a 59 anos,2005-02-01,5,8,5,8,13
SAN PEDRO,consulta externa,repetidas en personas de 15 a 59 anos,2005-02-01,25,29,25,29,54
SAN PEDRO DE BUENA VISTA,consulta externa,repetidas en personas de 15 a 59 anos,2005-02-01,3,3,3,3,6
SAN PEDRO DE CURAHUARA,consulta externa,repetidas en personas de 15 a 59 anos,2005-02-01,1,2,1,2,3
SAN PEDRO DE TIQUINA,consulta externa,repetidas en personas de 15 a 59 anos,2005-02-01,7,11,7,11,18
SAN RAFAEL,consulta externa,repetidas en personas de 15 a 59 anos,2005-02-01,3,3,3,3,6
SAN RAMON,consulta externa,repetidas en personas de 15 a 59 anos,2005-02-01,4,57,4,57,61
SAN RAMON,consulta externa,repetidas en personas de 15 a 59 anos,2005-02-01,1,20,1,20,21
SANTA ANA,consulta externa,repetidas en personas de 15 a 59 anos,2005-02-01,21,88,21,88,109
SANTA CRUZ DE LA SIERRA,consulta externa,repetidas en personas de 15 a 59 anos,2005-02-01,4314,11862,4314,11862,16176
SANTA ROSA,consulta externa,repetidas en personas de 15 a 59 anos,2005-02-01,6,31,6,31,37
SANTA ROSA DEL SARA,consulta externa,repetidas en personas de 15 a 59 anos,2005-02-01,5,6,5,6,11
SANTIAGO DE CALLAPA,consulta externa,repetidas en personas de 15 a 59 anos,2005-02-01,3,8,3,8,11
SANTIAGO DE HUARI,consulta externa,repetidas en personas de 15 a 59 anos,2005-02-01,19,12,19,12,31
SANTIAGO DE MACHACA,consulta externa,repetidas en personas de 15 a 59 anos,2005-02-01,0,3,0,3,3
SANTIVAÑES,consulta externa,repetidas en personas de 15 a 59 anos,2005-02-01,1,6,1,6,7
SAPAHAQUI,consulta externa,repetidas en personas de 15 a 59 anos,2005-02-01,1,1,1,1,2
SENA,consulta externa,repetidas en personas de 15 a 59 anos,2005-02-01,1,0,1,0,1
SICA SICA (VILLA AROMA),consulta externa,repetidas en personas de 15 a 59 anos,2005-02-01,2,10,2,10,12
SIPE SIPE,consulta externa,repetidas en personas de 15 a 59 anos,2005-02-01,10,207,10,207,217
SOPACHUY,consulta externa,repetidas en personas de 15 a 59 anos,2005-02-01,4,12,4,12,16
SORACACHI,consulta externa,repetidas en personas de 15 a 59 anos,2005-02-01,7,15,7,15,22
SORATA,consulta externa,repetidas en personas de 15 a 59 anos,2005-02-01,14,25,14,25,39
SUCRE,consulta externa,repetidas en personas de 15 a 59 anos,2005-02-01,2060,5565,2060,5565,7625
TACACHI,consulta externa,repetidas en personas de 15 a 59 anos,2005-02-01,5,21,5,21,26
TACOBAMBA,consulta externa,repetidas en personas de 15 a 59 anos,2005-02-01,1,1,1,1,2
TACOPAYA,consulta externa,repetidas en personas de 15 a 59 anos,2005-02-01,6,20,6,20,26
TAHUA,consulta externa,repetidas en personas de 15 a 59 anos,2005-02-01,0,2,0,2,2
TAPACARI,consulta externa,repetidas en personas de 15 a 59 anos,2005-02-01,2,19,2,19,21
TARABUCO,consulta externa,repetidas en personas de 15 a 59 anos,2005-02-01,24,21,24,21,45
TARACO,consulta externa,repetidas en personas de 15 a 59 anos,2005-02-01,1,0,1,0,1
TARATA,consulta externa,repetidas en personas de 15 a 59 anos,2005-02-01,5,13,5,13,18
TARIJA,consulta externa,repetidas en personas de 15 a 59 anos,2005-02-01,1241,4061,1241,4061,5302
TARVITA,consulta externa,repetidas en personas de 15 a 59 anos,2005-02-01,5,13,5,13,18
TEOPONTE,consulta externa,repetidas en personas de 15 a 59 anos,2005-02-01,1,2,1,2,3
TIAWANACU,consulta externa,repetidas en personas de 15 a 59 anos,2005-02-01,2,4,2,4,6
TINGUIPAYA,consulta externa,repetidas en personas de 15 a 59 anos,2005-02-01,1,1,1,1,2
TIPUANI,consulta externa,repetidas en personas de 15 a 59 anos,2005-02-01,3,6,3,6,9
TIQUIPAYA,consulta externa,repetidas en personas de 15 a 59 anos,2005-02-01,15,56,15,56,71
TIRAQUE (CBBA),consulta externa,repetidas en personas de 15 a 59 anos,2005-02-01,20,161,20,161,181
TITO YUPANQUI (PARQUIPUJIO),consulta externa,repetidas en personas de 15 a 59 anos,2005-02-01,2,4,2,4,6
TOCO,consulta externa,repetidas en personas de 15 a 59 anos,2005-02-01,1,0,1,0,1
TODOS SANTOS,consulta externa,repetidas en personas de 15 a 59 anos,2005-02-01,3,1,3,1,4
TOLATA,consulta externa,repetidas en personas de 15 a 59 anos,2005-02-01,0,5,0,5,5
TOLEDO,consulta externa,repetidas en personas de 15 a 59 anos,2005-02-01,7,5,7,5,12
TOMAVE,consulta externa,repetidas en personas de 15 a 59 anos,2005-02-01,9,11,9,11,20
TOMINA,consulta externa,repetidas en personas de 15 a 59 anos,2005-02-01,1,4,1,4,5
TORO TORO,consulta externa,repetidas en personas de 15 a 59 anos,2005-02-01,6,27,6,27,33
TOTORA(CBBA),consulta externa,repetidas en personas de 15 a 59 anos,2005-02-01,2,3,2,3,5
TOTORA(ORR),consulta externa,repetidas en personas de 15 a 59 anos,2005-02-01,1,6,1,6,7
TRIGAL,consulta externa,repetidas en personas de 15 a 59 anos,2005-02-01,1,1,1,1,2
TRINIDAD,consulta externa,repetidas en personas de 15 a 59 anos,2005-02-01,277,468,277,468,745
TUPIZA,consulta externa,repetidas en personas de 15 a 59 anos,2005-02-01,166,219,166,219,385
TURCO,consulta externa,repetidas en personas de 15 a 59 anos,2005-02-01,2,2,2,2,4
UNCIA,consulta externa,repetidas en personas de 15 a 59 anos,2005-02-01,68,144,68,144,212
URIONDO (A. CONCEPCION),consulta externa,repetidas en personas de 15 a 59 anos,2005-02-01,4,8,4,8,12
URUBICHA,consulta externa,repetidas en personas de 15 a 59 anos,2005-02-01,0,158,0,158,158
UYUNI,consulta externa,repetidas en personas de 15 a 59 anos,2005-02-01,37,113,37,113,150
VACAS,consulta externa,repetidas en personas de 15 a 59 anos,2005-02-01,19,15,19,15,34
VALLEGRANDE,consulta externa,repetidas en personas de 15 a 59 anos,2005-02-01,49,139,49,139,188
VIACHA,consulta externa,repetidas en personas de 15 a 59 anos,2005-02-01,64,201,64,201,265
VILA VILA,consulta externa,repetidas en personas de 15 a 59 anos,2005-02-01,1,3,1,3,4
VILLA MONTES,consulta externa,repetidas en personas de 15 a 59 anos,2005-02-01,105,170,105,170,275
VILLA RIVERO,consulta externa,repetidas en personas de 15 a 59 anos,2005-02-01,2,19,2,19,21
VILLA SERRANO,consulta externa,repetidas en personas de 15 a 59 anos,2005-02-01,3,8,3,8,11
VILLA TUNARI,consulta externa,repetidas en personas de 15 a 59 anos,2005-02-01,82,70,82,70,152
VILLA VACA GUZMAN (MUYUPAMPA),consulta externa,repetidas en personas de 15 a 59 anos,2005-02-01,10,59,10,59,69
VILLAZON,consulta externa,repetidas en personas de 15 a 59 anos,2005-02-01,50,104,50,104,154
VINTO,consulta externa,repetidas en personas de 15 a 59 anos,2005-02-01,4,75,4,75,79
VITICHI,consulta externa,repetidas en personas de 15 a 59 anos,2005-02-01,9,22,9,22,31
WALDO BALLIVIAN,consulta externa,repetidas en personas de 15 a 59 anos,2005-02-01,1,0,1,0,1
WARNES,consulta externa,repetidas en personas de 15 a 59 anos,2005-02-01,33,53,33,53,86
YACO,consulta externa,repetidas en personas de 15 a 59 anos,2005-02-01,1,7,1,7,8
YACUIBA,consulta externa,repetidas en personas de 15 a 59 anos,2005-02-01,236,801,236,801,1037
YAMPARAEZ,consulta externa,repetidas en personas de 15 a 59 anos,2005-02-01,5,26,5,26,31
YANACACHI,consulta externa,repetidas en personas de 15 a 59 anos,2005-02-01,3,4,3,4,7
YAPACANI,consulta externa,repetidas en personas de 15 a 59 anos,2005-02-01,28,246,28,246,274
YOCALLA,consulta externa,repetidas en personas de 15 a 59 anos,2005-02-01,2,2,2,2,4
YOTALA,consulta externa,repetidas en personas de 15 a 59 anos,2005-02-01,25,39,25,39,64
YUNCHARA,consulta externa,repetidas en personas de 15 a 59 anos,2005-02-01,2,1,2,1,3
ZUDAÑEZ,consulta externa,repetidas en personas de 15 a 59 anos,2005-02-01,1,6,1,6,7
ACACIO,consulta externa,repetidas en personas de 15 a 59 anos,2005-03-01,4,9,4,9,13
ACHACACHI,consulta externa,repetidas en personas de 15 a 59 anos,2005-03-01,50,54,50,54,104
ACHOCALLA,consulta externa,repetidas en personas de 15 a 59 anos,2005-03-01,20,18,20,18,38
AIQUILE,consulta externa,repetidas en personas de 15 a 59 anos,2005-03-01,32,222,32,222,254
ANCORAIMES,consulta externa,repetidas en personas de 15 a 59 anos,2005-03-01,5,11,5,11,16
ANDAMARCA,consulta externa,repetidas en personas de 15 a 59 anos,2005-03-01,1,1,1,1,2
ANTEQUERA,consulta externa,repetidas en personas de 15 a 59 anos,2005-03-01,0,1,0,1,1
ANZALDO,consulta externa,repetidas en personas de 15 a 59 anos,2005-03-01,3,14,3,14,17
APOLO,consulta externa,repetidas en personas de 15 a 59 anos,2005-03-01,8,4,8,4,12
ARAMPAMPA,consulta externa,repetidas en personas de 15 a 59 anos,2005-03-01,1,0,1,0,1
ARANI,consulta externa,repetidas en personas de 15 a 59 anos,2005-03-01,2,4,2,4,6
ARBIETO,consulta externa,repetidas en personas de 15 a 59 anos,2005-03-01,3,4,3,4,7
ARQUE,consulta externa,repetidas en personas de 15 a 59 anos,2005-03-01,0,2,0,2,2
ASCENCION DE GUARAYOS,consulta externa,repetidas en personas de 15 a 59 anos,2005-03-01,0,1,0,1,1
ATOCHA,consulta externa,repetidas en personas de 15 a 59 anos,2005-03-01,237,255,237,255,492
AUCAPATA,consulta externa,repetidas en personas de 15 a 59 anos,2005-03-01,3,8,3,8,11
AYATA,consulta externa,repetidas en personas de 15 a 59 anos,2005-03-01,4,0,4,0,4
AYO AYO,consulta externa,repetidas en personas de 15 a 59 anos,2005-03-01,8,2,8,2,10
AYOPAYA (V. DE INDEPENDENCIA),consulta externa,repetidas en personas de 15 a 59 anos,2005-03-01,4,15,4,15,19
AZURDUY,consulta externa,repetidas en personas de 15 a 59 anos,2005-03-01,3,1,3,1,4
BATALLAS,consulta externa,repetidas en personas de 15 a 59 anos,2005-03-01,6,11,6,11,17
BAURES,consulta externa,repetidas en personas de 15 a 59 anos,2005-03-01,2,18,2,18,20
BELEN DE ANDAMARCA,consulta externa,repetidas en personas de 15 a 59 anos,2005-03-01,0,1,0,1,1
BELEN DE URMIRI,consulta externa,repetidas en personas de 15 a 59 anos,2005-03-01,1,3,1,3,4
BELLA FLOR,consulta externa,repetidas en personas de 15 a 59 anos,2005-03-01,0,1,0,1,1
BERMEJO,consulta externa,repetidas en personas de 15 a 59 anos,2005-03-01,149,252,149,252,401
BETANZOS,consulta externa,repetidas en personas de 15 a 59 anos,2005-03-01,20,42,20,42,62
BOLIVAR,consulta externa,repetidas en personas de 15 a 59 anos,2005-03-01,1,5,1,5,6
BOLPEBRA,consulta externa,repetidas en personas de 15 a 59 anos,2005-03-01,6,2,6,2,8
BOYUIBE,consulta externa,repetidas en personas de 15 a 59 anos,2005-03-01,3,9,3,9,12
BUENA VISTA,consulta externa,repetidas en personas de 15 a 59 anos,2005-03-01,24,65,24,65,89
CABEZAS,consulta externa,repetidas en personas de 15 a 59 anos,2005-03-01,2,0,2,0,2
CAIROMA,consulta externa,repetidas en personas de 15 a 59 anos,2005-03-01,1,0,1,0,1
"CAIZA ""D""",consulta externa,repetidas en personas de 15 a 59 anos,2005-03-01,2,10,2,10,12
CAJUATA,consulta externa,repetidas en personas de 15 a 59 anos,2005-03-01,1,4,1,4,5
CALACOTO,consulta externa,repetidas en personas de 15 a 59 anos,2005-03-01,0,1,0,1,1
CALAMARCA,consulta externa,repetidas en personas de 15 a 59 anos,2005-03-01,9,18,9,18,27
CAMARGO,consulta externa,repetidas en personas de 15 a 59 anos,2005-03-01,17,52,17,52,69
CAMATAQUI (C. VILLA ABECIA),consulta externa,repetidas en personas de 15 a 59 anos,2005-03-01,4,10,4,10,14
CAMIRI,consulta externa,repetidas en personas de 15 a 59 anos,2005-03-01,80,179,80,179,259
CAPINOTA,consulta externa,repetidas en personas de 15 a 59 anos,2005-03-01,12,12,12,12,24
CAQUIAVIRI,consulta externa,repetidas en personas de 15 a 59 anos,2005-03-01,2,11,2,11,13
CARACOLLO,consulta externa,repetidas en personas de 15 a 59 anos,2005-03-01,3,19,3,19,22
CARANAVI,consulta externa,repetidas en personas de 15 a 59 anos,2005-03-01,21,38,21,38,59
CARAPARI,consulta externa,repetidas en personas de 15 a 59 anos,2005-03-01,8,4,8,4,12
CARIPUYO,consulta externa,repetidas en personas de 15 a 59 anos,2005-03-01,15,20,15,20,35
CARMEN RIVERO TORREZ,consulta externa,repetidas en personas de 15 a 59 anos,2005-03-01,1,2,1,2,3
CHACARILLA,consulta externa,repetidas en personas de 15 a 59 anos,2005-03-01,1,0,1,0,1
CHALLAPATA,consulta externa,repetidas en personas de 15 a 59 anos,2005-03-01,43,24,43,24,67
CHAQUI,consulta externa,repetidas en personas de 15 a 59 anos,2005-03-01,5,5,5,5,10
CHARAGUA,consulta externa,repetidas en personas de 15 a 59 anos,2005-03-01,8,36,8,36,44
CHARAÑA,consulta externa,repetidas en personas de 15 a 59 anos,2005-03-01,2,3,2,3,5
CHAYANTA,consulta externa,repetidas en personas de 15 a 59 anos,2005-03-01,21,14,21,14,35
CHIMORE,consulta externa,repetidas en personas de 15 a 59 anos,2005-03-01,17,80,17,80,97
CHOQUE COTA,consulta externa,repetidas en personas de 15 a 59 anos,2005-03-01,4,21,4,21,25
CHULUMANI (V. DE LA LIBERTAD),consulta externa,repetidas en personas de 15 a 59 anos,2005-03-01,62,34,62,34,96
CHUMA,consulta externa,repetidas en personas de 15 a 59 anos,2005-03-01,19,36,19,36,55
CLIZA,consulta externa,repetidas en personas de 15 a 59 anos,2005-03-01,2,6,2,6,8
COBIJA,consulta externa,repetidas en personas de 15 a 59 anos,2005-03-01,92,358,92,358,450
COCHABAMBA,consulta externa,repetidas en personas de 15 a 59 anos,2005-03-01,7429,19221,7429,19221,26650
COLCAPIRHUA,consulta externa,repetidas en personas de 15 a 59 anos,2005-03-01,136,422,136,422,558
"COLCHA ""K""",consulta externa,repetidas en personas de 15 a 59 anos,2005-03-01,1,7,1,7,8
COLLANA,consulta externa,repetidas en personas de 15 a 59 anos,2005-03-01,1,3,1,3,4
COLOMI,consulta externa,repetidas en personas de 15 a 59 anos,2005-03-01,1,3,1,3,4
COLPA BELGICA,consulta externa,repetidas en personas de 15 a 59 anos,2005-03-01,1,17,1,17,18
COLQUECHACA,consulta externa,repetidas en personas de 15 a 59 anos,2005-03-01,13,12,13,12,25
COLQUENCHA,consulta externa,repetidas en personas de 15 a 59 anos,2005-03-01,1,2,1,2,3
COLQUIRI,consulta externa,repetidas en personas de 15 a 59 anos,2005-03-01,8,15,8,15,23
COMANCHE,consulta externa,repetidas en personas de 15 a 59 anos,2005-03-01,3,1,3,1,4
COMARAPA,consulta externa,repetidas en personas de 15 a 59 anos,2005-03-01,47,55,47,55,102
COMBAYA,consulta externa,repetidas en personas de 15 a 59 anos,2005-03-01,4,5,4,5,9
CONCEPCION,consulta externa,repetidas en personas de 15 a 59 anos,2005-03-01,3,7,3,7,10
COPACABANA,consulta externa,repetidas en personas de 15 a 59 anos,2005-03-01,4,2,4,2,6
CORIPATA,consulta externa,repetidas en personas de 15 a 59 anos,2005-03-01,1,0,1,0,1
CORO CORO,consulta externa,repetidas en personas de 15 a 59 anos,2005-03-01,4,2,4,2,6
COROICO,consulta externa,repetidas en personas de 15 a 59 anos,2005-03-01,91,129,91,129,220
CORQUE,consulta externa,repetidas en personas de 15 a 59 anos,2005-03-01,25,27,25,27,52
COTAGAITA,consulta externa,repetidas en personas de 15 a 59 anos,2005-03-01,116,105,116,105,221
COTOCA,consulta externa,repetidas en personas de 15 a 59 anos,2005-03-01,0,5,0,5,5
CUATRO CAÑADAS,consulta externa,repetidas en personas de 15 a 59 anos,2005-03-01,18,128,18,128,146
CUCHUMUELA (V. G. VILLARROEL),consulta externa,repetidas en personas de 15 a 59 anos,2005-03-01,0,1,0,1,1
CUEVO,consulta externa,repetidas en personas de 15 a 59 anos,2005-03-01,5,9,5,9,14
CULPINA,consulta externa,repetidas en personas de 15 a 59 anos,2005-03-01,5,5,5,5,10
CURAHUARA DE CARANGAS,consulta externa,repetidas en personas de 15 a 59 anos,2005-03-01,1,2,1,2,3
CURVA,consulta externa,repetidas en personas de 15 a 59 anos,2005-03-01,1,0,1,0,1
EL ALTO,consulta externa,repetidas en personas de 15 a 59 anos,2005-03-01,3693,6482,3693,6482,10175
EL CHORO,consulta externa,repetidas en personas de 15 a 59 anos,2005-03-01,1,0,1,0,1
EL PUENTE(STC),consulta externa,repetidas en personas de 15 a 59 anos,2005-03-01,1,1,1,1,2
EL PUENTE(TJA),consulta externa,repetidas en personas de 15 a 59 anos,2005-03-01,1,3,1,3,4
EL TORNO,consulta externa,repetidas en personas de 15 a 59 anos,2005-03-01,122,205,122,205,327
EL VILLAR,consulta externa,repetidas en personas de 15 a 59 anos,2005-03-01,3,3,3,3,6
ENTRE RIOS,consulta externa,repetidas en personas de 15 a 59 anos,2005-03-01,21,74,21,74,95
ENTRE RIOS,consulta externa,repetidas en personas de 15 a 59 anos,2005-03-01,10,14,10,14,24
EUCALIPTUS,consulta externa,repetidas en personas de 15 a 59 anos,2005-03-01,0,1,0,1,1
EXALTACION,consulta externa,repetidas en personas de 15 a 59 anos,2005-03-01,1,5,1,5,6
FERNANDEZ ALONSO,consulta externa,repetidas en personas de 15 a 59 anos,2005-03-01,10,35,10,35,45
FILADELFIA,consulta externa,repetidas en personas de 15 a 59 anos,2005-03-01,2,1,2,1,3
GENERAL SAAVEDRA,consulta externa,repetidas en personas de 15 a 59 anos,2005-03-01,5,13,5,13,18
GRAL. J.J. PEREZ (CHARAZANI),consulta externa,repetidas en personas de 15 a 59 anos,2005-03-01,3,4,3,4,7
GUANAY,consulta externa,repetidas en personas de 15 a 59 anos,2005-03-01,2,1,2,1,3
GUAQUI,consulta externa,repetidas en personas de 15 a 59 anos,2005-03-01,0,2,0,2,2
GUAYARAMERIN,consulta externa,repetidas en personas de 15 a 59 anos,2005-03-01,200,219,200,219,419
GUTIERREZ,consulta externa,repetidas en personas de 15 a 59 anos,2005-03-01,7,22,7,22,29
HUACARETA,consulta externa,repetidas en personas de 15 a 59 anos,2005-03-01,19,13,19,13,32
HUACHACALLA,consulta externa,repetidas en personas de 15 a 59 anos,2005-03-01,2,1,2,1,3
HUANUNI,consulta externa,repetidas en personas de 15 a 59 anos,2005-03-01,429,426,429,426,855
HUARACAJE,consulta externa,repetidas en personas de 15 a 59 anos,2005-03-01,4,13,4,13,17
HUAYLLAMARCA,consulta externa,repetidas en personas de 15 a 59 anos,2005-03-01,5,16,5,16,21
ICLA,consulta externa,repetidas en personas de 15 a 59 anos,2005-03-01,8,4,8,4,12
INCAHUASI,consulta externa,repetidas en personas de 15 a 59 anos,2005-03-01,7,17,7,17,24
INGAVI (HUMAITA),consulta externa,repetidas en personas de 15 a 59 anos,2005-03-01,3,3,3,3,6
INQUISIVI,consulta externa,repetidas en personas de 15 a 59 anos,2005-03-01,4,7,4,7,11
IRUPANA (VILLA DE LANZA),consulta externa,repetidas en personas de 15 a 59 anos,2005-03-01,12,10,12,10,22
IXIAMAS,consulta externa,repetidas en personas de 15 a 59 anos,2005-03-01,11,18,11,18,29
JESUS DE MACHACA,consulta externa,repetidas en personas de 15 a 59 anos,2005-03-01,3,6,3,6,9
LA ASUNTA,consulta externa,repetidas en personas de 15 a 59 anos,2005-03-01,20,19,20,19,39
LA GUARDIA,consulta externa,repetidas en personas de 15 a 59 anos,2005-03-01,17,108,17,108,125
LA PAZ,consulta externa,repetidas en personas de 15 a 59 anos,2005-03-01,13469,30507,13469,30507,43976
LAJA,consulta externa,repetidas en personas de 15 a 59 anos,2005-03-01,13,7,13,7,20
LAS CARRERAS,consulta externa,repetidas en personas de 15 a 59 anos,2005-03-01,20,19,20,19,39
LLALLAGUA,consulta externa,repetidas en personas de 15 a 59 anos,2005-03-01,80,109,80,109,189
LLICA,consulta externa,repetidas en personas de 15 a 59 anos,2005-03-01,9,14,9,14,23
LORETO,consulta externa,repetidas en personas de 15 a 59 anos,2005-03-01,2,7,2,7,9
LURIBAY,consulta externa,repetidas en personas de 15 a 59 anos,2005-03-01,3,1,3,1,4
MACHACAMARCA,consulta externa,repetidas en personas de 15 a 59 anos,2005-03-01,9,20,9,20,29
MACHARETI,consulta externa,repetidas en personas de 15 a 59 anos,2005-03-01,7,20,7,20,27
MAGDALENA,consulta externa,repetidas en personas de 15 a 59 anos,2005-03-01,38,72,38,72,110
MAIRANA,consulta externa,repetidas en personas de 15 a 59 anos,2005-03-01,2,11,2,11,13
MAPIRI,consulta externa,repetidas en personas de 15 a 59 anos,2005-03-01,2,3,2,3,5
MECAPACA,consulta externa,repetidas en personas de 15 a 59 anos,2005-03-01,23,20,23,20,43
MINEROS,consulta externa,repetidas en personas de 15 a 59 anos,2005-03-01,12,48,12,48,60
MIZQUE,consulta externa,repetidas en personas de 15 a 59 anos,2005-03-01,8,3,8,3,11
MOCOMOCO,consulta externa,repetidas en personas de 15 a 59 anos,2005-03-01,8,9,8,9,17
MOJINETE,consulta externa,repetidas en personas de 15 a 59 anos,2005-03-01,7,10,7,10,17
MOJOCOYA,consulta externa,repetidas en personas de 15 a 59 anos,2005-03-01,4,11,4,11,15
MONTEAGUDO,consulta externa,repetidas en personas de 15 a 59 anos,2005-03-01,63,303,63,303,366
MONTERO,consulta externa,repetidas en personas de 15 a 59 anos,2005-03-01,756,1352,756,1352,2108
MORO MORO,consulta externa,repetidas en personas de 15 a 59 anos,2005-03-01,0,1,0,1,1
MOROCHATA,consulta externa,repetidas en personas de 15 a 59 anos,2005-03-01,3,50,3,50,53
NACEBE (SANTA ROSA DEL ABUNA),consulta externa,repetidas en personas de 15 a 59 anos,2005-03-01,1,0,1,0,1
NUEVO MANOA (NUEVA ESPERANZA),consulta externa,repetidas en personas de 15 a 59 anos,2005-03-01,2,3,2,3,5
OCURI,consulta externa,repetidas en personas de 15 a 59 anos,2005-03-01,2,1,2,1,3
OKINAWA,consulta externa,repetidas en personas de 15 a 59 anos,2005-03-01,25,52,25,52,77
OMEREQUE,consulta externa,repetidas en personas de 15 a 59 anos,2005-03-01,2,4,2,4,6
ORURO,consulta externa,repetidas en personas de 15 a 59 anos,2005-03-01,1558,4022,1558,4022,5580
PADCAYA,consulta externa,repetidas en personas de 15 a 59 anos,2005-03-01,3,14,3,14,17
PADILLA,consulta externa,repetidas en personas de 15 a 59 anos,2005-03-01,7,23,7,23,30
PAILON,consulta externa,repetidas en personas de 15 a 59 anos,2005-03-01,1,160,1,160,161
PALCA,consulta externa,repetidas en personas de 15 a 59 anos,2005-03-01,2,12,2,12,14
PALOS BLANCOS,consulta externa,repetidas en personas de 15 a 59 anos,2005-03-01,60,63,60,63,123
PAMPA AULLAGAS,consulta externa,repetidas en personas de 15 a 59 anos,2005-03-01,0,4,0,4,4
PAMPA GRANDE,consulta externa,repetidas en personas de 15 a 59 anos,2005-03-01,7,38,7,38,45
PAPEL PAMPA,consulta externa,repetidas en personas de 15 a 59 anos,2005-03-01,0,1,0,1,1
PASORAPA,consulta externa,repetidas en personas de 15 a 59 anos,2005-03-01,0,1,0,1,1
PATACAMAYA,consulta externa,repetidas en personas de 15 a 59 anos,2005-03-01,0,1,0,1,1
PAZÑA,consulta externa,repetidas en personas de 15 a 59 anos,2005-03-01,31,40,31,40,71
PELECHUCO,consulta externa,repetidas en personas de 15 a 59 anos,2005-03-01,11,3,11,3,14
POCOATA,consulta externa,repetidas en personas de 15 a 59 anos,2005-03-01,4,5,4,5,9
POCONA,consulta externa,repetidas en personas de 15 a 59 anos,2005-03-01,1,4,1,4,5
POJO (CBBA),consulta externa,repetidas en personas de 15 a 59 anos,2005-03-01,4,6,4,6,10
POOPO,consulta externa,repetidas en personas de 15 a 59 anos,2005-03-01,7,10,7,10,17
PORCO,consulta externa,repetidas en personas de 15 a 59 anos,2005-03-01,3,5,3,5,8
POROMA,consulta externa,repetidas en personas de 15 a 59 anos,2005-03-01,4,10,4,10,14
PORONGO,consulta externa,repetidas en personas de 15 a 59 anos,2005-03-01,14,10,14,10,24
PORTACHUELO,consulta externa,repetidas en personas de 15 a 59 anos,2005-03-01,39,84,39,84,123
PORVENIR,consulta externa,repetidas en personas de 15 a 59 anos,2005-03-01,0,5,0,5,5
POSTRER VALLE,consulta externa,repetidas en personas de 15 a 59 anos,2005-03-01,2,10,2,10,12
POTOSI,consulta externa,repetidas en personas de 15 a 59 anos,2005-03-01,2288,3528,2288,3528,5816
PRESTO,consulta externa,repetidas en personas de 15 a 59 anos,2005-03-01,1,1,1,1,2
PUCARANI,consulta externa,repetidas en personas de 15 a 59 anos,2005-03-01,6,2,6,2,8
PUERTO ACOSTA,consulta externa,repetidas en personas de 15 a 59 anos,2005-03-01,26,42,26,42,68
PUERTO CARABUCO,consulta externa,repetidas en personas de 15 a 59 anos,2005-03-01,9,6,9,6,15
PUERTO GONZALO MORENO,consulta externa,repetidas en personas de 15 a 59 anos,2005-03-01,16,48,16,48,64
PUERTO PEREZ,consulta externa,repetidas en personas de 15 a 59 anos,2005-03-01,7,1,7,1,8
PUERTO QUIJARRO,consulta externa,repetidas en personas de 15 a 59 anos,2005-03-01,26,55,26,55,81
PUERTO RICO,consulta externa,repetidas en personas de 15 a 59 anos,2005-03-01,33,86,33,86,119
PUERTO SILES,consulta externa,repetidas en personas de 15 a 59 anos,2005-03-01,3,2,3,2,5
PUERTO SUAREZ,consulta externa,repetidas en personas de 15 a 59 anos,2005-03-01,20,36,20,36,56
PUERTO VILLARROEL,consulta externa,repetidas en personas de 15 a 59 anos,2005-03-01,32,39,32,39,71
PUNA,consulta externa,repetidas en personas de 15 a 59 anos,2005-03-01,8,21,8,21,29
PUNATA,consulta externa,repetidas en personas de 15 a 59 anos,2005-03-01,78,248,78,248,326
QUIABAYA,consulta externa,repetidas en personas de 15 a 59 anos,2005-03-01,1,5,1,5,6
QUILLACOLLO,consulta externa,repetidas en personas de 15 a 59 anos,2005-03-01,249,788,249,788,1037
QUIME,consulta externa,repetidas en personas de 15 a 59 anos,2005-03-01,7,11,7,11,18
RAVELO,consulta externa,repetidas en personas de 15 a 59 anos,2005-03-01,1,0,1,0,1
REYES,consulta externa,repetidas en personas de 15 a 59 anos,2005-03-01,20,45,20,45,65
RIBERALTA,consulta externa,repetidas en personas de 15 a 59 anos,2005-03-01,257,574,257,574,831
ROBORE,consulta externa,repetidas en personas de 15 a 59 anos,2005-03-01,22,74,22,74,96
RURRENABAQUE,consulta externa,repetidas en personas de 15 a 59 anos,2005-03-01,16,40,16,40,56
SABAYA,consulta externa,repetidas en personas de 15 a 59 anos,2005-03-01,3,1,3,1,4
SACABA,consulta externa,repetidas en personas de 15 a 59 anos,2005-03-01,143,417,143,417,560
SACABAMBA,consulta externa,repetidas en personas de 15 a 59 anos,2005-03-01,1,6,1,6,7
SACACA,consulta externa,repetidas en personas de 15 a 59 anos,2005-03-01,2,6,2,6,8
SAIPINA,consulta externa,repetidas en personas de 15 a 59 anos,2005-03-01,9,21,9,21,30
SALINAS DE GARCI MENDOZA,consulta externa,repetidas en personas de 15 a 59 anos,2005-03-01,7,22,7,22,29
SAMAIPATA,consulta externa,repetidas en personas de 15 a 59 anos,2005-03-01,0,2,0,2,2
SAN AGUSTIN,consulta externa,repetidas en personas de 15 a 59 anos,2005-03-01,3,3,3,3,6
SAN ANDRES,consulta externa,repetidas en personas de 15 a 59 anos,2005-03-01,14,17,14,17,31
SAN ANDRES DE MACHACA,consulta externa,repetidas en personas de 15 a 59 anos,2005-03-01,1,2,1,2,3
SAN ANTONIO DE ESMORUCO,consulta externa,repetidas en personas de 15 a 59 anos,2005-03-01,0,6,0,6,6
SAN ANTONIO DE LOMERIO,consulta externa,repetidas en personas de 15 a 59 anos,2005-03-01,1,1,1,1,2
SAN BENITO,consulta externa,repetidas en personas de 15 a 59 anos,2005-03-01,10,15,10,15,25
SAN BORJA,consulta externa,repetidas en personas de 15 a 59 anos,2005-03-01,29,125,29,125,154
SAN BUENA VENTURA,consulta externa,repetidas en personas de 15 a 59 anos,2005-03-01,7,9,7,9,16
SAN CARLOS,consulta externa,repetidas en personas de 15 a 59 anos,2005-03-01,7,56,7,56,63
SAN IGNACIO,consulta externa,repetidas en personas de 15 a 59 anos,2005-03-01,24,49,24,49,73
SAN IGNACIO DE VELASCO,consulta externa,repetidas en personas de 15 a 59 anos,2005-03-01,85,209,85,209,294
SAN JAVIER(BNI),consulta externa,repetidas en personas de 15 a 59 anos,2005-03-01,4,14,4,14,18
SAN JAVIER(STC),consulta externa,repetidas en personas de 15 a 59 anos,2005-03-01,19,73,19,73,92
SAN JOAQUIN,consulta externa,repetidas en personas de 15 a 59 anos,2005-03-01,5,34,5,34,39
SAN JOSE DE CHIQUITOS,consulta externa,repetidas en personas de 15 a 59 anos,2005-03-01,10,14,10,14,24
SAN JUAN DE YAPACANI,consulta externa,repetidas en personas de 15 a 59 anos,2005-03-01,16,13,16,13,29
SAN JULIAN,consulta externa,repetidas en personas de 15 a 59 anos,2005-03-01,66,376,66,376,442
SAN LORENZO(PND),consulta externa,repetidas en personas de 15 a 59 anos,2005-03-01,7,18,7,18,25
SAN LORENZO(TJA),consulta externa,repetidas en personas de 15 a 59 anos,2005-03-01,12,22,12,22,34
SAN LUCAS,consulta externa,repetidas en personas de 15 a 59 anos,2005-03-01,19,19,19,19,38
SAN MATIAS,consulta externa,repetidas en personas de 15 a 59 anos,2005-03-01,11,38,11,38,49
SAN MIGUEL DE VELASCO,consulta externa,repetidas en personas de 15 a 59 anos,2005-03-01,31,64,31,64,95
SAN PABLO DE LIPEZ,consulta externa,repetidas en personas de 15 a 59 anos,2005-03-01,10,19,10,19,29
SAN PEDRO,consulta externa,repetidas en personas de 15 a 59 anos,2005-03-01,37,35,37,35,72
SAN PEDRO DE BUENA VISTA,consulta externa,repetidas en personas de 15 a 59 anos,2005-03-01,1,1,1,1,2
SAN PEDRO DE CURAHUARA,consulta externa,repetidas en personas de 15 a 59 anos,2005-03-01,0,2,0,2,2
SAN PEDRO DE TIQUINA,consulta externa,repetidas en personas de 15 a 59 anos,2005-03-01,3,3,3,3,6
SAN RAFAEL,consulta externa,repetidas en personas de 15 a 59 anos,2005-03-01,7,3,7,3,10
SAN RAMON,consulta externa,repetidas en personas de 15 a 59 anos,2005-03-01,5,39,5,39,44
SAN RAMON,consulta externa,repetidas en personas de 15 a 59 anos,2005-03-01,15,119,15,119,134
SANTA ANA,consulta externa,repetidas en personas de 15 a 59 anos,2005-03-01,35,74,35,74,109
SANTA CRUZ DE LA SIERRA,consulta externa,repetidas en personas de 15 a 59 anos,2005-03-01,5975,14634,5975,14634,20609
SANTA ROSA,consulta externa,repetidas en personas de 15 a 59 anos,2005-03-01,1,21,1,21,22
SANTA ROSA DEL SARA,consulta externa,repetidas en personas de 15 a 59 anos,2005-03-01,0,5,0,5,5
SANTIAGO DE CALLAPA,consulta externa,repetidas en personas de 15 a 59 anos,2005-03-01,4,29,4,29,33
SANTIAGO DE HUARI,consulta externa,repetidas en personas de 15 a 59 anos,2005-03-01,15,9,15,9,24
SANTIVAÑES,consulta externa,repetidas en personas de 15 a 59 anos,2005-03-01,6,6,6,6,12
SAPAHAQUI,consulta externa,repetidas en personas de 15 a 59 anos,2005-03-01,4,2,4,2,6
SENA,consulta externa,repetidas en personas de 15 a 59 anos,2005-03-01,0,1,0,1,1
SICA SICA (VILLA AROMA),consulta externa,repetidas en personas de 15 a 59 anos,2005-03-01,4,10,4,10,14
SICAYA,consulta externa,repetidas en personas de 15 a 59 anos,2005-03-01,1,0,1,0,1
SIPE SIPE,consulta externa,repetidas en personas de 15 a 59 anos,2005-03-01,19,201,19,201,220
SOPACHUY,consulta externa,repetidas en personas de 15 a 59 anos,2005-03-01,4,4,4,4,8
SORACACHI,consulta externa,repetidas en personas de 15 a 59 anos,2005-03-01,1,7,1,7,8
SORATA,consulta externa,repetidas en personas de 15 a 59 anos,2005-03-01,15,22,15,22,37
SUCRE,consulta externa,repetidas en personas de 15 a 59 anos,2005-03-01,2547,6628,2547,6628,9175
TACACHI,consulta externa,repetidas en personas de 15 a 59 anos,2005-03-01,5,25,5,25,30
TACOBAMBA,consulta externa,repetidas en personas de 15 a 59 anos,2005-03-01,1,3,1,3,4
TACOPAYA,consulta externa,repetidas en personas de 15 a 59 anos,2005-03-01,1,5,1,5,6
TAPACARI,consulta externa,repetidas en personas de 15 a 59 anos,2005-03-01,7,27,7,27,34
TARABUCO,consulta externa,repetidas en personas de 15 a 59 anos,2005-03-01,39,38,39,38,77
TARACO,consulta externa,repetidas en personas de 15 a 59 anos,2005-03-01,1,1,1,1,2
TARATA,consulta externa,repetidas en personas de 15 a 59 anos,2005-03-01,3,15,3,15,18
TARIJA,consulta externa,repetidas en personas de 15 a 59 anos,2005-03-01,1944,5021,1944,5021,6965
TARVITA,consulta externa,repetidas en personas de 15 a 59 anos,2005-03-01,11,23,11,23,34
TIAWANACU,consulta externa,repetidas en personas de 15 a 59 anos,2005-03-01,2,2,2,2,4
TINGUIPAYA,consulta externa,repetidas en personas de 15 a 59 anos,2005-03-01,7,0,7,0,7
TIPUANI,consulta externa,repetidas en personas de 15 a 59 anos,2005-03-01,17,31,17,31,48
TIQUIPAYA,consulta externa,repetidas en personas de 15 a 59 anos,2005-03-01,14,145,14,145,159
TIRAQUE (CBBA),consulta externa,repetidas en personas de 15 a 59 anos,2005-03-01,20,132,20,132,152
TITO YUPANQUI (PARQUIPUJIO),consulta externa,repetidas en personas de 15 a 59 anos,2005-03-01,2,1,2,1,3
TOCO,consulta externa,repetidas en personas de 15 a 59 anos,2005-03-01,0,2,0,2,2
TOLATA,consulta externa,repetidas en personas de 15 a 59 anos,2005-03-01,3,3,3,3,6
TOLEDO,consulta externa,repetidas en personas de 15 a 59 anos,2005-03-01,6,16,6,16,22
TOMAVE,consulta externa,repetidas en personas de 15 a 59 anos,2005-03-01,3,17,3,17,20
TOMINA,consulta externa,repetidas en personas de 15 a 59 anos,2005-03-01,1,4,1,4,5
TORO TORO,consulta externa,repetidas en personas de 15 a 59 anos,2005-03-01,4,2,4,2,6
TOTORA(CBBA),consulta externa,repetidas en personas de 15 a 59 anos,2005-03-01,6,2,6,2,8
TOTORA(ORR),consulta externa,repetidas en personas de 15 a 59 anos,2005-03-01,1,3,1,3,4
TRIGAL,consulta externa,repetidas en personas de 15 a 59 anos,2005-03-01,3,3,3,3,6
TRINIDAD,consulta externa,repetidas en personas de 15 a 59 anos,2005-03-01,294,729,294,729,1023
TUPIZA,consulta externa,repetidas en personas de 15 a 59 anos,2005-03-01,160,242,160,242,402
TURCO,consulta externa,repetidas en personas de 15 a 59 anos,2005-03-01,3,0,3,0,3
UMALA,consulta externa,repetidas en personas de 15 a 59 anos,2005-03-01,2,1,2,1,3
UNCIA,consulta externa,repetidas en personas de 15 a 59 anos,2005-03-01,84,185,84,185,269
URIONDO (A. CONCEPCION),consulta externa,repetidas en personas de 15 a 59 anos,2005-03-01,4,9,4,9,13
URUBICHA,consulta externa,repetidas en personas de 15 a 59 anos,2005-03-01,0,174,0,174,174
UYUNI,consulta externa,repetidas en personas de 15 a 59 anos,2005-03-01,63,154,63,154,217
VACAS,consulta externa,repetidas en personas de 15 a 59 anos,2005-03-01,20,52,20,52,72
VALLEGRANDE,consulta externa,repetidas en personas de 15 a 59 anos,2005-03-01,77,98,77,98,175
VIACHA,consulta externa,repetidas en personas de 15 a 59 anos,2005-03-01,152,301,152,301,453
VILA VILA,consulta externa,repetidas en personas de 15 a 59 anos,2005-03-01,1,1,1,1,2
VILLA MONTES,consulta externa,repetidas en personas de 15 a 59 anos,2005-03-01,97,163,97,163,260
VILLA RIVERO,consulta externa,repetidas en personas de 15 a 59 anos,2005-03-01,4,33,4,33,37
VILLA SERRANO,consulta externa,repetidas en personas de 15 a 59 anos,2005-03-01,5,21,5,21,26
VILLA TUNARI,consulta externa,repetidas en personas de 15 a 59 anos,2005-03-01,63,90,63,90,153
VILLA VACA GUZMAN (MUYUPAMPA),consulta externa,repetidas en personas de 15 a 59 anos,2005-03-01,14,29,14,29,43
VILLAZON,consulta externa,repetidas en personas de 15 a 59 anos,2005-03-01,46,199,46,199,245
VINTO,consulta externa,repetidas en personas de 15 a 59 anos,2005-03-01,19,82,19,82,101
VITICHI,consulta externa,repetidas en personas de 15 a 59 anos,2005-03-01,8,24,8,24,32
WALDO BALLIVIAN,consulta externa,repetidas en personas de 15 a 59 anos,2005-03-01,1,2,1,2,3
WARNES,consulta externa,repetidas en personas de 15 a 59 anos,2005-03-01,21,104,21,104,125
YACO,consulta externa,repetidas en personas de 15 a 59 anos,2005-03-01,0,3,0,3,3
YACUIBA,consulta externa,repetidas en personas de 15 a 59 anos,2005-03-01,390,899,390,899,1289
YAMPARAEZ,consulta externa,repetidas en personas de 15 a 59 anos,2005-03-01,6,12,6,12,18
YANACACHI,consulta externa,repetidas en personas de 15 a 59 anos,2005-03-01,10,4,10,4,14
YAPACANI,consulta externa,repetidas en personas de 15 a 59 anos,2005-03-01,28,303,28,303,331
YOCALLA,consulta externa,repetidas en personas de 15 a 59 anos,2005-03-01,0,2,0,2,2
YOTALA,consulta externa,repetidas en personas de 15 a 59 anos,2005-03-01,22,170,22,170,192
YUNCHARA,consulta externa,repetidas en personas de 15 a 59 anos,2005-03-01,0,6,0,6,6
ZUDAÑEZ,consulta externa,repetidas en personas de 15 a 59 anos,2005-03-01,0,8,0,8,8
ACACIO,consulta externa,repetidas en personas de 15 a 59 anos,2005-04-01,4,15,4,15,19
ACHACACHI,consulta externa,repetidas en personas de 15 a 59 anos,2005-04-01,45,59,45,59,104
ACHOCALLA,consulta externa,repetidas en personas de 15 a 59 anos,2005-04-01,11,27,11,27,38
AIQUILE,consulta externa,repetidas en personas de 15 a 59 anos,2005-04-01,41,199,41,199,240
ALALAY,consulta externa,repetidas en personas de 15 a 59 anos,2005-04-01,0,1,0,1,1
ANCORAIMES,consulta externa,repetidas en personas de 15 a 59 anos,2005-04-01,11,1,11,1,12
ANDAMARCA,consulta externa,repetidas en personas de 15 a 59 anos,2005-04-01,1,1,1,1,2
ANTEQUERA,consulta externa,repetidas en personas de 15 a 59 anos,2005-04-01,0,5,0,5,5
ANZALDO,consulta externa,repetidas en personas de 15 a 59 anos,2005-04-01,1,8,1,8,9
APOLO,consulta externa,repetidas en personas de 15 a 59 anos,2005-04-01,11,16,11,16,27
ARAMPAMPA,consulta externa,repetidas en personas de 15 a 59 anos,2005-04-01,0,1,0,1,1
ARANI,consulta externa,repetidas en personas de 15 a 59 anos,2005-04-01,6,15,6,15,21
ARBIETO,consulta externa,repetidas en personas de 15 a 59 anos,2005-04-01,0,1,0,1,1
ARQUE,consulta externa,repetidas en personas de 15 a 59 anos,2005-04-01,2,4,2,4,6
ASCENCION DE GUARAYOS,consulta externa,repetidas en personas de 15 a 59 anos,2005-04-01,1,15,1,15,16
ATOCHA,consulta externa,repetidas en personas de 15 a 59 anos,2005-04-01,214,226,214,226,440
AUCAPATA,consulta externa,repetidas en personas de 15 a 59 anos,2005-04-01,0,1,0,1,1
AYATA,consulta externa,repetidas en personas de 15 a 59 anos,2005-04-01,4,0,4,0,4
AYO AYO,consulta externa,repetidas en personas de 15 a 59 anos,2005-04-01,3,8,3,8,11
AYOPAYA (V. DE INDEPENDENCIA),consulta externa,repetidas en personas de 15 a 59 anos,2005-04-01,2,15,2,15,17
AZURDUY,consulta externa,repetidas en personas de 15 a 59 anos,2005-04-01,0,3,0,3,3
BATALLAS,consulta externa,repetidas en personas de 15 a 59 anos,2005-04-01,0,10,0,10,10
BAURES,consulta externa,repetidas en personas de 15 a 59 anos,2005-04-01,13,13,13,13,26
BELEN DE ANDAMARCA,consulta externa,repetidas en personas de 15 a 59 anos,2005-04-01,0,1,0,1,1
BELEN DE URMIRI,consulta externa,repetidas en personas de 15 a 59 anos,2005-04-01,1,5,1,5,6
BELLA FLOR,consulta externa,repetidas en personas de 15 a 59 anos,2005-04-01,5,0,5,0,5
BERMEJO,consulta externa,repetidas en personas de 15 a 59 anos,2005-04-01,148,186,148,186,334
BETANZOS,consulta externa,repetidas en personas de 15 a 59 anos,2005-04-01,32,42,32,42,74
BOLIVAR,consulta externa,repetidas en personas de 15 a 59 anos,2005-04-01,1,3,1,3,4
BOLPEBRA,consulta externa,repetidas en personas de 15 a 59 anos,2005-04-01,1,0,1,0,1
BOYUIBE,consulta externa,repetidas en personas de 15 a 59 anos,2005-04-01,3,13,3,13,16
BUENA VISTA,consulta externa,repetidas en personas de 15 a 59 anos,2005-04-01,37,66,37,66,103
CABEZAS,consulta externa,repetidas en personas de 15 a 59 anos,2005-04-01,2,0,2,0,2
CAIROMA,consulta externa,repetidas en personas de 15 a 59 anos,2005-04-01,15,11,15,11,26
"CAIZA ""D""",consulta externa,repetidas en personas de 15 a 59 anos,2005-04-01,3,8,3,8,11
CAJUATA,consulta externa,repetidas en personas de 15 a 59 anos,2005-04-01,2,4,2,4,6
CALACOTO,consulta externa,repetidas en personas de 15 a 59 anos,2005-04-01,8,15,8,15,23
CALAMARCA,consulta externa,repetidas en personas de 15 a 59 anos,2005-04-01,9,17,9,17,26
CAMARGO,consulta externa,repetidas en personas de 15 a 59 anos,2005-04-01,11,53,11,53,64
CAMATAQUI (C. VILLA ABECIA),consulta externa,repetidas en personas de 15 a 59 anos,2005-04-01,4,7,4,7,11
CAMIRI,consulta externa,repetidas en personas de 15 a 59 anos,2005-04-01,101,187,101,187,288
CAPINOTA,consulta externa,repetidas en personas de 15 a 59 anos,2005-04-01,21,14,21,14,35
CAQUIAVIRI,consulta externa,repetidas en personas de 15 a 59 anos,2005-04-01,2,8,2,8,10
CARACOLLO,consulta externa,repetidas en personas de 15 a 59 anos,2005-04-01,9,15,9,15,24
CARANAVI,consulta externa,repetidas en personas de 15 a 59 anos,2005-04-01,39,52,39,52,91
CARAPARI,consulta externa,repetidas en personas de 15 a 59 anos,2005-04-01,9,10,9,10,19
CARMEN RIVERO TORREZ,consulta externa,repetidas en personas de 15 a 59 anos,2005-04-01,2,3,2,3,5
CATACORA,consulta externa,repetidas en personas de 15 a 59 anos,2005-04-01,2,1,2,1,3
CHACARILLA,consulta externa,repetidas en personas de 15 a 59 anos,2005-04-01,3,2,3,2,5
CHALLAPATA,consulta externa,repetidas en personas de 15 a 59 anos,2005-04-01,26,26,26,26,52
CHAQUI,consulta externa,repetidas en personas de 15 a 59 anos,2005-04-01,17,3,17,3,20
CHARAGUA,consulta externa,repetidas en personas de 15 a 59 anos,2005-04-01,9,23,9,23,32
CHARAÑA,consulta externa,repetidas en personas de 15 a 59 anos,2005-04-01,5,3,5,3,8
CHAYANTA,consulta externa,repetidas en personas de 15 a 59 anos,2005-04-01,13,16,13,16,29
CHIMORE,consulta externa,repetidas en personas de 15 a 59 anos,2005-04-01,10,114,10,114,124
CHIPAYA,consulta externa,repetidas en personas de 15 a 59 anos,2005-04-01,1,0,1,0,1
CHOQUE COTA,consulta externa,repetidas en personas de 15 a 59 anos,2005-04-01,0,3,0,3,3
CHULUMANI (V. DE LA LIBERTAD),consulta externa,repetidas en personas de 15 a 59 anos,2005-04-01,97,66,97,66,163
CHUMA,consulta externa,repetidas en personas de 15 a 59 anos,2005-04-01,16,22,16,22,38
CLIZA,consulta externa,repetidas en personas de 15 a 59 anos,2005-04-01,0,1,0,1,1
COBIJA,consulta externa,repetidas en personas de 15 a 59 anos,2005-04-01,103,516,103,516,619
COCHABAMBA,consulta externa,repetidas en personas de 15 a 59 anos,2005-04-01,7128,19265,7128,19265,26393
COLCAPIRHUA,consulta externa,repetidas en personas de 15 a 59 anos,2005-04-01,118,349,118,349,467
"COLCHA ""K""",consulta externa,repetidas en personas de 15 a 59 anos,2005-04-01,14,17,14,17,31
COLLANA,consulta externa,repetidas en personas de 15 a 59 anos,2005-04-01,1,3,1,3,4
COLOMI,consulta externa,repetidas en personas de 15 a 59 anos,2005-04-01,4,3,4,3,7
COLPA BELGICA,consulta externa,repetidas en personas de 15 a 59 anos,2005-04-01,59,62,59,62,121
COLQUECHACA,consulta externa,repetidas en personas de 15 a 59 anos,2005-04-01,7,14,7,14,21
COLQUENCHA,consulta externa,repetidas en personas de 15 a 59 anos,2005-04-01,1,5,1,5,6
COLQUIRI,consulta externa,repetidas en personas de 15 a 59 anos,2005-04-01,6,13,6,13,19
COMANCHE,consulta externa,repetidas en personas de 15 a 59 anos,2005-04-01,0,1,0,1,1
COMARAPA,consulta externa,repetidas en personas de 15 a 59 anos,2005-04-01,26,52,26,52,78
COMBAYA,consulta externa,repetidas en personas de 15 a 59 anos,2005-04-01,1,1,1,1,2
CONCEPCION,consulta externa,repetidas en personas de 15 a 59 anos,2005-04-01,2,4,2,4,6
COPACABANA,consulta externa,repetidas en personas de 15 a 59 anos,2005-04-01,1,0,1,0,1
CORIPATA,consulta externa,repetidas en personas de 15 a 59 anos,2005-04-01,0,2,0,2,2
CORO CORO,consulta externa,repetidas en personas de 15 a 59 anos,2005-04-01,3,3,3,3,6
COROICO,consulta externa,repetidas en personas de 15 a 59 anos,2005-04-01,82,110,82,110,192
CORQUE,consulta externa,repetidas en personas de 15 a 59 anos,2005-04-01,7,9,7,9,16
COTAGAITA,consulta externa,repetidas en personas de 15 a 59 anos,2005-04-01,83,101,83,101,184
COTOCA,consulta externa,repetidas en personas de 15 a 59 anos,2005-04-01,0,10,0,10,10
CUATRO CAÑADAS,consulta externa,repetidas en personas de 15 a 59 anos,2005-04-01,19,140,19,140,159
CUCHUMUELA (V. G. VILLARROEL),consulta externa,repetidas en personas de 15 a 59 anos,2005-04-01,0,3,0,3,3
CUEVO,consulta externa,repetidas en personas de 15 a 59 anos,2005-04-01,4,7,4,7,11
CULPINA,consulta externa,repetidas en personas de 15 a 59 anos,2005-04-01,4,12,4,12,16
CURAHUARA DE CARANGAS,consulta externa,repetidas en personas de 15 a 59 anos,2005-04-01,1,2,1,2,3
CURVA,consulta externa,repetidas en personas de 15 a 59 anos,2005-04-01,1,0,1,0,1
DESAGUADERO,consulta externa,repetidas en personas de 15 a 59 anos,2005-04-01,0,1,0,1,1
EL ALTO,consulta externa,repetidas en personas de 15 a 59 anos,2005-04-01,3589,6131,3589,6131,9720
EL CHORO,consulta externa,repetidas en personas de 15 a 59 anos,2005-04-01,2,0,2,0,2
EL PUENTE(STC),consulta externa,repetidas en personas de 15 a 59 anos,2005-04-01,1,5,1,5,6
EL PUENTE(TJA),consulta externa,repetidas en personas de 15 a 59 anos,2005-04-01,2,4,2,4,6
EL TORNO,consulta externa,repetidas en personas de 15 a 59 anos,2005-04-01,114,167,114,167,281
EL VILLAR,consulta externa,repetidas en personas de 15 a 59 anos,2005-04-01,4,5,4,5,9
ENTRE RIOS,consulta externa,repetidas en personas de 15 a 59 anos,2005-04-01,15,32,15,32,47
ENTRE RIOS,consulta externa,repetidas en personas de 15 a 59 anos,2005-04-01,8,27,8,27,35
ESCARA,consulta externa,repetidas en personas de 15 a 59 anos,2005-04-01,1,0,1,0,1
EUCALIPTUS,consulta externa,repetidas en personas de 15 a 59 anos,2005-04-01,1,1,1,1,2
EUREKA (SANTOS MERCADO),consulta externa,repetidas en personas de 15 a 59 anos,2005-04-01,0,1,0,1,1
EXALTACION,consulta externa,repetidas en personas de 15 a 59 anos,2005-04-01,2,4,2,4,6
FERNANDEZ ALONSO,consulta externa,repetidas en personas de 15 a 59 anos,2005-04-01,15,37,15,37,52
FILADELFIA,consulta externa,repetidas en personas de 15 a 59 anos,2005-04-01,1,0,1,0,1
GENERAL SAAVEDRA,consulta externa,repetidas en personas de 15 a 59 anos,2005-04-01,11,17,11,17,28
GRAL. J.J. PEREZ (CHARAZANI),consulta externa,repetidas en personas de 15 a 59 anos,2005-04-01,0,3,0,3,3
GUANAY,consulta externa,repetidas en personas de 15 a 59 anos,2005-04-01,1,0,1,0,1
GUAQUI,consulta externa,repetidas en personas de 15 a 59 anos,2005-04-01,7,10,7,10,17
GUAYARAMERIN,consulta externa,repetidas en personas de 15 a 59 anos,2005-04-01,130,400,130,400,530
GUTIERREZ,consulta externa,repetidas en personas de 15 a 59 anos,2005-04-01,11,18,11,18,29
HUACARETA,consulta externa,repetidas en personas de 15 a 59 anos,2005-04-01,4,13,4,13,17
HUACHACALLA,consulta externa,repetidas en personas de 15 a 59 anos,2005-04-01,1,1,1,1,2
HUANUNI,consulta externa,repetidas en personas de 15 a 59 anos,2005-04-01,19,18,19,18,37
HUARACAJE,consulta externa,repetidas en personas de 15 a 59 anos,2005-04-01,11,20,11,20,31
HUAYLLAMARCA,consulta externa,repetidas en personas de 15 a 59 anos,2005-04-01,1,1,1,1,2
ICLA,consulta externa,repetidas en personas de 15 a 59 anos,2005-04-01,9,12,9,12,21
INCAHUASI,consulta externa,repetidas en personas de 15 a 59 anos,2005-04-01,14,8,14,8,22
INGAVI (HUMAITA),consulta externa,repetidas en personas de 15 a 59 anos,2005-04-01,1,0,1,0,1
INQUISIVI,consulta externa,repetidas en personas de 15 a 59 anos,2005-04-01,3,5,3,5,8
IRUPANA (VILLA DE LANZA),consulta externa,repetidas en personas de 15 a 59 anos,2005-04-01,12,20,12,20,32
IXIAMAS,consulta externa,repetidas en personas de 15 a 59 anos,2005-04-01,8,19,8,19,27
JESUS DE MACHACA,consulta externa,repetidas en personas de 15 a 59 anos,2005-04-01,10,12,10,12,22
LA ASUNTA,consulta externa,repetidas en personas de 15 a 59 anos,2005-04-01,5,5,5,5,10
LA GUARDIA,consulta externa,repetidas en personas de 15 a 59 anos,2005-04-01,17,103,17,103,120
LA PAZ,consulta externa,repetidas en personas de 15 a 59 anos,2005-04-01,12978,30884,12978,30884,43862
LAJA,consulta externa,repetidas en personas de 15 a 59 anos,2005-04-01,13,3,13,3,16
LAS CARRERAS,consulta externa,repetidas en personas de 15 a 59 anos,2005-04-01,10,18,10,18,28
LLALLAGUA,consulta externa,repetidas en personas de 15 a 59 anos,2005-04-01,96,133,96,133,229
LLICA,consulta externa,repetidas en personas de 15 a 59 anos,2005-04-01,10,4,10,4,14
LORETO,consulta externa,repetidas en personas de 15 a 59 anos,2005-04-01,3,6,3,6,9
LURIBAY,consulta externa,repetidas en personas de 15 a 59 anos,2005-04-01,3,2,3,2,5
MACHACAMARCA,consulta externa,repetidas en personas de 15 a 59 anos,2005-04-01,16,20,16,20,36
MACHARETI,consulta externa,repetidas en personas de 15 a 59 anos,2005-04-01,4,17,4,17,21
MAGDALENA,consulta externa,repetidas en personas de 15 a 59 anos,2005-04-01,32,93,32,93,125
MAIRANA,consulta externa,repetidas en personas de 15 a 59 anos,2005-04-01,1,14,1,14,15
MAPIRI,consulta externa,repetidas en personas de 15 a 59 anos,2005-04-01,1,4,1,4,5
MECAPACA,consulta externa,repetidas en personas de 15 a 59 anos,2005-04-01,24,46,24,46,70
MINEROS,consulta externa,repetidas en personas de 15 a 59 anos,2005-04-01,3,55,3,55,58
MIZQUE,consulta externa,repetidas en personas de 15 a 59 anos,2005-04-01,10,19,10,19,29
MOCOMOCO,consulta externa,repetidas en personas de 15 a 59 anos,2005-04-01,10,5,10,5,15
MOJINETE,consulta externa,repetidas en personas de 15 a 59 anos,2005-04-01,2,6,2,6,8
MOJOCOYA,consulta externa,repetidas en personas de 15 a 59 anos,2005-04-01,0,5,0,5,5
MONTEAGUDO,consulta externa,repetidas en personas de 15 a 59 anos,2005-04-01,67,276,67,276,343
MONTERO,consulta externa,repetidas en personas de 15 a 59 anos,2005-04-01,603,1308,603,1308,1911
MORO MORO,consulta externa,repetidas en personas de 15 a 59 anos,2005-04-01,0,6,0,6,6
MOROCHATA,consulta externa,repetidas en personas de 15 a 59 anos,2005-04-01,7,54,7,54,61
NUEVO MANOA (NUEVA ESPERANZA),consulta externa,repetidas en personas de 15 a 59 anos,2005-04-01,6,7,6,7,13
OCURI,consulta externa,repetidas en personas de 15 a 59 anos,2005-04-01,1,0,1,0,1
OKINAWA,consulta externa,repetidas en personas de 15 a 59 anos,2005-04-01,14,34,14,34,48
OMEREQUE,consulta externa,repetidas en personas de 15 a 59 anos,2005-04-01,4,8,4,8,12
ORURO,consulta externa,repetidas en personas de 15 a 59 anos,2005-04-01,1766,4066,1766,4066,5832
PADCAYA,consulta externa,repetidas en personas de 15 a 59 anos,2005-04-01,7,7,7,7,14
PADILLA,consulta externa,repetidas en personas de 15 a 59 anos,2005-04-01,14,24,14,24,38
PAILON,consulta externa,repetidas en personas de 15 a 59 anos,2005-04-01,2,124,2,124,126
PALCA,consulta externa,repetidas en personas de 15 a 59 anos,2005-04-01,9,8,9,8,17
PALOS BLANCOS,consulta externa,repetidas en personas de 15 a 59 anos,2005-04-01,79,70,79,70,149
PAMPA AULLAGAS,consulta externa,repetidas en personas de 15 a 59 anos,2005-04-01,0,1,0,1,1
PAMPA GRANDE,consulta externa,repetidas en personas de 15 a 59 anos,2005-04-01,2,14,2,14,16
PASORAPA,consulta externa,repetidas en personas de 15 a 59 anos,2005-04-01,3,23,3,23,26
PATACAMAYA,consulta externa,repetidas en personas de 15 a 59 anos,2005-04-01,7,1,7,1,8
PAZÑA,consulta externa,repetidas en personas de 15 a 59 anos,2005-04-01,12,22,12,22,34
PELECHUCO,consulta externa,repetidas en personas de 15 a 59 anos,2005-04-01,6,5,6,5,11
POCOATA,consulta externa,repetidas en personas de 15 a 59 anos,2005-04-01,8,10,8,10,18
POCONA,consulta externa,repetidas en personas de 15 a 59 anos,2005-04-01,2,1,2,1,3
POJO (CBBA),consulta externa,repetidas en personas de 15 a 59 anos,2005-04-01,6,10,6,10,16
POOPO,consulta externa,repetidas en personas de 15 a 59 anos,2005-04-01,7,7,7,7,14
PORCO,consulta externa,repetidas en personas de 15 a 59 anos,2005-04-01,3,4,3,4,7
POROMA,consulta externa,repetidas en personas de 15 a 59 anos,2005-04-01,3,9,3,9,12
PORONGO,consulta externa,repetidas en personas de 15 a 59 anos,2005-04-01,3,16,3,16,19
PORTACHUELO,consulta externa,repetidas en personas de 15 a 59 anos,2005-04-01,36,82,36,82,118
PORVENIR,consulta externa,repetidas en personas de 15 a 59 anos,2005-04-01,5,7,5,7,12
POSTRER VALLE,consulta externa,repetidas en personas de 15 a 59 anos,2005-04-01,8,7,8,7,15
POTOSI,consulta externa,repetidas en personas de 15 a 59 anos,2005-04-01,2485,3386,2485,3386,5871
PRESTO,consulta externa,repetidas en personas de 15 a 59 anos,2005-04-01,2,1,2,1,3
PUCARA,consulta externa,repetidas en personas de 15 a 59 anos,2005-04-01,3,16,3,16,19
PUCARANI,consulta externa,repetidas en personas de 15 a 59 anos,2005-04-01,5,9,5,9,14
PUERTO ACOSTA,consulta externa,repetidas en personas de 15 a 59 anos,2005-04-01,17,38,17,38,55
PUERTO CARABUCO,consulta externa,repetidas en personas de 15 a 59 anos,2005-04-01,3,3,3,3,6
PUERTO GONZALO MORENO,consulta externa,repetidas en personas de 15 a 59 anos,2005-04-01,4,3,4,3,7
PUERTO PEREZ,consulta externa,repetidas en personas de 15 a 59 anos,2005-04-01,6,1,6,1,7
PUERTO QUIJARRO,consulta externa,repetidas en personas de 15 a 59 anos,2005-04-01,41,55,41,55,96
PUERTO RICO,consulta externa,repetidas en personas de 15 a 59 anos,2005-04-01,8,5,8,5,13
PUERTO SILES,consulta externa,repetidas en personas de 15 a 59 anos,2005-04-01,1,1,1,1,2
PUERTO SUAREZ,consulta externa,repetidas en personas de 15 a 59 anos,2005-04-01,15,31,15,31,46
PUERTO VILLARROEL,consulta externa,repetidas en personas de 15 a 59 anos,2005-04-01,27,48,27,48,75
PUNA,consulta externa,repetidas en personas de 15 a 59 anos,2005-04-01,16,50,16,50,66
PUNATA,consulta externa,repetidas en personas de 15 a 59 anos,2005-04-01,87,247,87,247,334
QUIABAYA,consulta externa,repetidas en personas de 15 a 59 anos,2005-04-01,3,2,3,2,5
QUILLACOLLO,consulta externa,repetidas en personas de 15 a 59 anos,2005-04-01,105,205,105,205,310
QUIME,consulta externa,repetidas en personas de 15 a 59 anos,2005-04-01,28,12,28,12,40
QUIRUSILLAS,consulta externa,repetidas en personas de 15 a 59 anos,2005-04-01,0,11,0,11,11
RAVELO,consulta externa,repetidas en personas de 15 a 59 anos,2005-04-01,1,4,1,4,5
REYES,consulta externa,repetidas en personas de 15 a 59 anos,2005-04-01,6,18,6,18,24
RIBERALTA,consulta externa,repetidas en personas de 15 a 59 anos,2005-04-01,34,469,34,469,503
ROBORE,consulta externa,repetidas en personas de 15 a 59 anos,2005-04-01,41,87,41,87,128
RURRENABAQUE,consulta externa,repetidas en personas de 15 a 59 anos,2005-04-01,2,12,2,12,14
SABAYA,consulta externa,repetidas en personas de 15 a 59 anos,2005-04-01,1,1,1,1,2
SACABA,consulta externa,repetidas en personas de 15 a 59 anos,2005-04-01,142,288,142,288,430
SACABAMBA,consulta externa,repetidas en personas de 15 a 59 anos,2005-04-01,0,2,0,2,2
SACACA,consulta externa,repetidas en personas de 15 a 59 anos,2005-04-01,3,3,3,3,6
SAIPINA,consulta externa,repetidas en personas de 15 a 59 anos,2005-04-01,6,9,6,9,15
SALINAS DE GARCI MENDOZA,consulta externa,repetidas en personas de 15 a 59 anos,2005-04-01,1,12,1,12,13
SAMAIPATA,consulta externa,repetidas en personas de 15 a 59 anos,2005-04-01,1,1,1,1,2
SAN AGUSTIN,consulta externa,repetidas en personas de 15 a 59 anos,2005-04-01,0,4,0,4,4
SAN ANDRES,consulta externa,repetidas en personas de 15 a 59 anos,2005-04-01,15,30,15,30,45
SAN ANDRES DE MACHACA,consulta externa,repetidas en personas de 15 a 59 anos,2005-04-01,2,0,2,0,2
SAN ANTONIO DE ESMORUCO,consulta externa,repetidas en personas de 15 a 59 anos,2005-04-01,2,6,2,6,8
SAN ANTONIO DE LOMERIO,consulta externa,repetidas en personas de 15 a 59 anos,2005-04-01,4,3,4,3,7
SAN BENITO,consulta externa,repetidas en personas de 15 a 59 anos,2005-04-01,9,13,9,13,22
SAN BORJA,consulta externa,repetidas en personas de 15 a 59 anos,2005-04-01,25,104,25,104,129
SAN BUENA VENTURA,consulta externa,repetidas en personas de 15 a 59 anos,2005-04-01,8,11,8,11,19
SAN CARLOS,consulta externa,repetidas en personas de 15 a 59 anos,2005-04-01,16,85,16,85,101
SAN IGNACIO,consulta externa,repetidas en personas de 15 a 59 anos,2005-04-01,28,73,28,73,101
SAN IGNACIO DE VELASCO,consulta externa,repetidas en personas de 15 a 59 anos,2005-04-01,72,189,72,189,261
SAN JAVIER(BNI),consulta externa,repetidas en personas de 15 a 59 anos,2005-04-01,0,6,0,6,6
SAN JAVIER(STC),consulta externa,repetidas en personas de 15 a 59 anos,2005-04-01,20,18,20,18,38
SAN JOAQUIN,consulta externa,repetidas en personas de 15 a 59 anos,2005-04-01,12,43,12,43,55
SAN JOSE DE CHIQUITOS,consulta externa,repetidas en personas de 15 a 59 anos,2005-04-01,5,21,5,21,26
SAN JUAN DE YAPACANI,consulta externa,repetidas en personas de 15 a 59 anos,2005-04-01,21,12,21,12,33
SAN JULIAN,consulta externa,repetidas en personas de 15 a 59 anos,2005-04-01,38,319,38,319,357
SAN LORENZO(PND),consulta externa,repetidas en personas de 15 a 59 anos,2005-04-01,0,4,0,4,4
SAN LORENZO(TJA),consulta externa,repetidas en personas de 15 a 59 anos,2005-04-01,14,39,14,39,53
SAN LUCAS,consulta externa,repetidas en personas de 15 a 59 anos,2005-04-01,9,26,9,26,35
SAN MATIAS,consulta externa,repetidas en personas de 15 a 59 anos,2005-04-01,4,15,4,15,19
SAN MIGUEL DE VELASCO,consulta externa,repetidas en personas de 15 a 59 anos,2005-04-01,15,50,15,50,65
SAN PABLO DE LIPEZ,consulta externa,repetidas en personas de 15 a 59 anos,2005-04-01,5,17,5,17,22
SAN PEDRO,consulta externa,repetidas en personas de 15 a 59 anos,2005-04-01,44,35,44,35,79
SAN PEDRO DE BUENA VISTA,consulta externa,repetidas en personas de 15 a 59 anos,2005-04-01,0,1,0,1,1
SAN PEDRO DE CURAHUARA,consulta externa,repetidas en personas de 15 a 59 anos,2005-04-01,1,2,1,2,3
SAN PEDRO DE TIQUINA,consulta externa,repetidas en personas de 15 a 59 anos,2005-04-01,3,3,3,3,6
SAN RAFAEL,consulta externa,repetidas en personas de 15 a 59 anos,2005-04-01,3,4,3,4,7
SAN RAMON,consulta externa,repetidas en personas de 15 a 59 anos,2005-04-01,1,36,1,36,37
SAN RAMON,consulta externa,repetidas en personas de 15 a 59 anos,2005-04-01,17,134,17,134,151
SANTA ANA,consulta externa,repetidas en personas de 15 a 59 anos,2005-04-01,43,80,43,80,123
SANTA CRUZ DE LA SIERRA,consulta externa,repetidas en personas de 15 a 59 anos,2005-04-01,6668,16311,6668,16311,22979
SANTA ROSA,consulta externa,repetidas en personas de 15 a 59 anos,2005-04-01,2,28,2,28,30
SANTA ROSA DEL SARA,consulta externa,repetidas en personas de 15 a 59 anos,2005-04-01,6,18,6,18,24
SANTIAGO DE CALLAPA,consulta externa,repetidas en personas de 15 a 59 anos,2005-04-01,3,5,3,5,8
SANTIAGO DE HUARI,consulta externa,repetidas en personas de 15 a 59 anos,2005-04-01,12,7,12,7,19
SANTIAGO DE MACHACA,consulta externa,repetidas en personas de 15 a 59 anos,2005-04-01,0,2,0,2,2
SANTIVAÑES,consulta externa,repetidas en personas de 15 a 59 anos,2005-04-01,8,6,8,6,14
SAPAHAQUI,consulta externa,repetidas en personas de 15 a 59 anos,2005-04-01,5,4,5,4,9
SENA,consulta externa,repetidas en personas de 15 a 59 anos,2005-04-01,4,5,4,5,9
SICA SICA (VILLA AROMA),consulta externa,repetidas en personas de 15 a 59 anos,2005-04-01,3,3,3,3,6
SICAYA,consulta externa,repetidas en personas de 15 a 59 anos,2005-04-01,2,0,2,0,2
SIPE SIPE,consulta externa,repetidas en personas de 15 a 59 anos,2005-04-01,25,211,25,211,236
SOPACHUY,consulta externa,repetidas en personas de 15 a 59 anos,2005-04-01,1,3,1,3,4
SORACACHI,consulta externa,repetidas en personas de 15 a 59 anos,2005-04-01,0,3,0,3,3
SORATA,consulta externa,repetidas en personas de 15 a 59 anos,2005-04-01,9,18,9,18,27
SUCRE,consulta externa,repetidas en personas de 15 a 59 anos,2005-04-01,2662,6257,2662,6257,8919
TACACHI,consulta externa,repetidas en personas de 15 a 59 anos,2005-04-01,10,17,10,17,27
TACACOMA,consulta externa,repetidas en personas de 15 a 59 anos,2005-04-01,0,1,0,1,1
TACOBAMBA,consulta externa,repetidas en personas de 15 a 59 anos,2005-04-01,2,1,2,1,3
TACOPAYA,consulta externa,repetidas en personas de 15 a 59 anos,2005-04-01,1,11,1,11,12
TAHUA,consulta externa,repetidas en personas de 15 a 59 anos,2005-04-01,0,1,0,1,1
TAPACARI,consulta externa,repetidas en personas de 15 a 59 anos,2005-04-01,9,24,9,24,33
TARABUCO,consulta externa,repetidas en personas de 15 a 59 anos,2005-04-01,25,34,25,34,59
TARACO,consulta externa,repetidas en personas de 15 a 59 anos,2005-04-01,3,2,3,2,5
TARATA,consulta externa,repetidas en personas de 15 a 59 anos,2005-04-01,3,4,3,4,7
TARIJA,consulta externa,repetidas en personas de 15 a 59 anos,2005-04-01,1638,5422,1638,5422,7060
TARVITA,consulta externa,repetidas en personas de 15 a 59 anos,2005-04-01,5,5,5,5,10
TEOPONTE,consulta externa,repetidas en personas de 15 a 59 anos,2005-04-01,9,10,9,10,19
TIAWANACU,consulta externa,repetidas en personas de 15 a 59 anos,2005-04-01,6,7,6,7,13
TINGUIPAYA,consulta externa,repetidas en personas de 15 a 59 anos,2005-04-01,1,2,1,2,3
TIPUANI,consulta externa,repetidas en personas de 15 a 59 anos,2005-04-01,2,7,2,7,9
TIQUIPAYA,consulta externa,repetidas en personas de 15 a 59 anos,2005-04-01,23,97,23,97,120
TIRAQUE (CBBA),consulta externa,repetidas en personas de 15 a 59 anos,2005-04-01,31,225,31,225,256
TITO YUPANQUI (PARQUIPUJIO),consulta externa,repetidas en personas de 15 a 59 anos,2005-04-01,2,1,2,1,3
TOCO,consulta externa,repetidas en personas de 15 a 59 anos,2005-04-01,1,2,1,2,3
TODOS SANTOS,consulta externa,repetidas en personas de 15 a 59 anos,2005-04-01,3,0,3,0,3
TOLATA,consulta externa,repetidas en personas de 15 a 59 anos,2005-04-01,1,1,1,1,2
TOLEDO,consulta externa,repetidas en personas de 15 a 59 anos,2005-04-01,7,11,7,11,18
TOMAVE,consulta externa,repetidas en personas de 15 a 59 anos,2005-04-01,0,2,0,2,2
TOMINA,consulta externa,repetidas en personas de 15 a 59 anos,2005-04-01,5,6,5,6,11
TORO TORO,consulta externa,repetidas en personas de 15 a 59 anos,2005-04-01,2,5,2,5,7
TOTORA(CBBA),consulta externa,repetidas en personas de 15 a 59 anos,2005-04-01,8,6,8,6,14
TRIGAL,consulta externa,repetidas en personas de 15 a 59 anos,2005-04-01,2,2,2,2,4
TRINIDAD,consulta externa,repetidas en personas de 15 a 59 anos,2005-04-01,317,601,317,601,918
TUPIZA,consulta externa,repetidas en personas de 15 a 59 anos,2005-04-01,152,227,152,227,379
UNCIA,consulta externa,repetidas en personas de 15 a 59 anos,2005-04-01,90,149,90,149,239
URIONDO (A. CONCEPCION),consulta externa,repetidas en personas de 15 a 59 anos,2005-04-01,5,11,5,11,16
URUBICHA,consulta externa,repetidas en personas de 15 a 59 anos,2005-04-01,3,158,3,158,161
UYUNI,consulta externa,repetidas en personas de 15 a 59 anos,2005-04-01,27,162,27,162,189
VACAS,consulta externa,repetidas en personas de 15 a 59 anos,2005-04-01,18,32,18,32,50
VALLEGRANDE,consulta externa,repetidas en personas de 15 a 59 anos,2005-04-01,40,79,40,79,119
VIACHA,consulta externa,repetidas en personas de 15 a 59 anos,2005-04-01,119,285,119,285,404
VILA VILA,consulta externa,repetidas en personas de 15 a 59 anos,2005-04-01,0,1,0,1,1
VILLA MONTES,consulta externa,repetidas en personas de 15 a 59 anos,2005-04-01,69,149,69,149,218
VILLA NUEVA (LOMA ALTA),consulta externa,repetidas en personas de 15 a 59 anos,2005-04-01,0,1,0,1,1
VILLA RIVERO,consulta externa,repetidas en personas de 15 a 59 anos,2005-04-01,7,27,7,27,34
VILLA SERRANO,consulta externa,repetidas en personas de 15 a 59 anos,2005-04-01,5,12,5,12,17
VILLA TUNARI,consulta externa,repetidas en personas de 15 a 59 anos,2005-04-01,64,104,64,104,168
VILLA VACA GUZMAN (MUYUPAMPA),consulta externa,repetidas en personas de 15 a 59 anos,2005-04-01,7,84,7,84,91
VILLAZON,consulta externa,repetidas en personas de 15 a 59 anos,2005-04-01,48,157,48,157,205
VINTO,consulta externa,repetidas en personas de 15 a 59 anos,2005-04-01,13,104,13,104,117
VITICHI,consulta externa,repetidas en personas de 15 a 59 anos,2005-04-01,6,19,6,19,25
WALDO BALLIVIAN,consulta externa,repetidas en personas de 15 a 59 anos,2005-04-01,1,3,1,3,4
WARNES,consulta externa,repetidas en personas de 15 a 59 anos,2005-04-01,70,128,70,128,198
YACUIBA,consulta externa,repetidas en personas de 15 a 59 anos,2005-04-01,364,997,364,997,1361
YAMPARAEZ,consulta externa,repetidas en personas de 15 a 59 anos,2005-04-01,13,19,13,19,32
YANACACHI,consulta externa,repetidas en personas de 15 a 59 anos,2005-04-01,7,6,7,6,13
YAPACANI,consulta externa,repetidas en personas de 15 a 59 anos,2005-04-01,48,257,48,257,305
YOCALLA,consulta externa,repetidas en personas de 15 a 59 anos,2005-04-01,7,7,7,7,14
YOTALA,consulta externa,repetidas en personas de 15 a 59 anos,2005-04-01,19,212,19,212,231
YUNCHARA,consulta externa,repetidas en personas de 15 a 59 anos,2005-04-01,1,2,1,2,3
ZUDAÑEZ,consulta externa,repetidas en personas de 15 a 59 anos,2005-04-01,6,8,6,8,14
ACACIO,consulta externa,repetidas en personas de 15 a 59 anos,2005-05-01,4,8,4,8,12
ACHACACHI,consulta externa,repetidas en personas de 15 a 59 anos,2005-05-01,56,46,56,46,102
ACHOCALLA,consulta externa,repetidas en personas de 15 a 59 anos,2005-05-01,6,66,6,66,72
AIQUILE,consulta externa,repetidas en personas de 15 a 59 anos,2005-05-01,64,263,64,263,327
ALALAY,consulta externa,repetidas en personas de 15 a 59 anos,2005-05-01,1,2,1,2,3
ALCALA,consulta externa,repetidas en personas de 15 a 59 anos,2005-05-01,0,2,0,2,2
ANCORAIMES,consulta externa,repetidas en personas de 15 a 59 anos,2005-05-01,16,18,16,18,34
ANDAMARCA,consulta externa,repetidas en personas de 15 a 59 anos,2005-05-01,0,2,0,2,2
ANTEQUERA,consulta externa,repetidas en personas de 15 a 59 anos,2005-05-01,1,2,1,2,3
ANZALDO,consulta externa,repetidas en personas de 15 a 59 anos,2005-05-01,4,4,4,4,8
APOLO,consulta externa,repetidas en personas de 15 a 59 anos,2005-05-01,10,16,10,16,26
ARANI,consulta externa,repetidas en personas de 15 a 59 anos,2005-05-01,5,14,5,14,19
ARBIETO,consulta externa,repetidas en personas de 15 a 59 anos,2005-05-01,6,18,6,18,24
ARQUE,consulta externa,repetidas en personas de 15 a 59 anos,2005-05-01,1,2,1,2,3
ASCENCION DE GUARAYOS,consulta externa,repetidas en personas de 15 a 59 anos,2005-05-01,5,6,5,6,11
ATOCHA,consulta externa,repetidas en personas de 15 a 59 anos,2005-05-01,211,198,211,198,409
AUCAPATA,consulta externa,repetidas en personas de 15 a 59 anos,2005-05-01,5,3,5,3,8
AYATA,consulta externa,repetidas en personas de 15 a 59 anos,2005-05-01,6,3,6,3,9
AYO AYO,consulta externa,repetidas en personas de 15 a 59 anos,2005-05-01,4,2,4,2,6
AYOPAYA (V. DE INDEPENDENCIA),consulta externa,repetidas en personas de 15 a 59 anos,2005-05-01,10,26,10,26,36
AZURDUY,consulta externa,repetidas en personas de 15 a 59 anos,2005-05-01,1,1,1,1,2
BATALLAS,consulta externa,repetidas en personas de 15 a 59 anos,2005-05-01,7,7,7,7,14
BAURES,consulta externa,repetidas en personas de 15 a 59 anos,2005-05-01,10,16,10,16,26
BELEN DE ANDAMARCA,consulta externa,repetidas en personas de 15 a 59 anos,2005-05-01,0,2,0,2,2
BELEN DE URMIRI,consulta externa,repetidas en personas de 15 a 59 anos,2005-05-01,0,6,0,6,6
BELLA FLOR,consulta externa,repetidas en personas de 15 a 59 anos,2005-05-01,3,0,3,0,3
BERMEJO,consulta externa,repetidas en personas de 15 a 59 anos,2005-05-01,67,101,67,101,168
BETANZOS,consulta externa,repetidas en personas de 15 a 59 anos,2005-05-01,27,27,27,27,54
BOLIVAR,consulta externa,repetidas en personas de 15 a 59 anos,2005-05-01,2,0,2,0,2
BOLPEBRA,consulta externa,repetidas en personas de 15 a 59 anos,2005-05-01,0,1,0,1,1
BOYUIBE,consulta externa,repetidas en personas de 15 a 59 anos,2005-05-01,2,7,2,7,9
BUENA VISTA,consulta externa,repetidas en personas de 15 a 59 anos,2005-05-01,30,56,30,56,86
CABEZAS,consulta externa,repetidas en personas de 15 a 59 anos,2005-05-01,5,1,5,1,6
CAIROMA,consulta externa,repetidas en personas de 15 a 59 anos,2005-05-01,3,5,3,5,8
"CAIZA ""D""",consulta externa,repetidas en personas de 15 a 59 anos,2005-05-01,9,8,9,8,17
CAJUATA,consulta externa,repetidas en personas de 15 a 59 anos,2005-05-01,5,1,5,1,6
CALACOTO,consulta externa,repetidas en personas de 15 a 59 anos,2005-05-01,1,2,1,2,3
CALAMARCA,consulta externa,repetidas en personas de 15 a 59 anos,2005-05-01,9,13,9,13,22
CAMARGO,consulta externa,repetidas en personas de 15 a 59 anos,2005-05-01,3,24,3,24,27
CAMATAQUI (C. VILLA ABECIA),consulta externa,repetidas en personas de 15 a 59 anos,2005-05-01,4,3,4,3,7
CAMIRI,consulta externa,repetidas en personas de 15 a 59 anos,2005-05-01,83,226,83,226,309
CAPINOTA,consulta externa,repetidas en personas de 15 a 59 anos,2005-05-01,25,31,25,31,56
CAQUIAVIRI,consulta externa,repetidas en personas de 15 a 59 anos,2005-05-01,10,4,10,4,14
CARACOLLO,consulta externa,repetidas en personas de 15 a 59 anos,2005-05-01,5,14,5,14,19
CARANAVI,consulta externa,repetidas en personas de 15 a 59 anos,2005-05-01,21,41,21,41,62
CARAPARI,consulta externa,repetidas en personas de 15 a 59 anos,2005-05-01,8,4,8,4,12
CARMEN RIVERO TORREZ,consulta externa,repetidas en personas de 15 a 59 anos,2005-05-01,1,1,1,1,2
CATACORA,consulta externa,repetidas en personas de 15 a 59 anos,2005-05-01,3,0,3,0,3
CHALLAPATA,consulta externa,repetidas en personas de 15 a 59 anos,2005-05-01,22,44,22,44,66
CHAQUI,consulta externa,repetidas en personas de 15 a 59 anos,2005-05-01,1,1,1,1,2
CHARAGUA,consulta externa,repetidas en personas de 15 a 59 anos,2005-05-01,7,20,7,20,27
CHARAÑA,consulta externa,repetidas en personas de 15 a 59 anos,2005-05-01,5,7,5,7,12
CHAYANTA,consulta externa,repetidas en personas de 15 a 59 anos,2005-05-01,16,11,16,11,27
CHIMORE,consulta externa,repetidas en personas de 15 a 59 anos,2005-05-01,11,71,11,71,82
CHOQUE COTA,consulta externa,repetidas en personas de 15 a 59 anos,2005-05-01,0,3,0,3,3
CHULUMANI (V. DE LA LIBERTAD),consulta externa,repetidas en personas de 15 a 59 anos,2005-05-01,45,24,45,24,69
CHUMA,consulta externa,repetidas en personas de 15 a 59 anos,2005-05-01,8,17,8,17,25
CLIZA,consulta externa,repetidas en personas de 15 a 59 anos,2005-05-01,1,5,1,5,6
COBIJA,consulta externa,repetidas en personas de 15 a 59 anos,2005-05-01,116,451,116,451,567
COCHABAMBA,consulta externa,repetidas en personas de 15 a 59 anos,2005-05-01,7033,16988,7033,16988,24021
COLCAPIRHUA,consulta externa,repetidas en personas de 15 a 59 anos,2005-05-01,121,286,121,286,407
"COLCHA ""K""",consulta externa,repetidas en personas de 15 a 59 anos,2005-05-01,3,13,3,13,16
COLLANA,consulta externa,repetidas en personas de 15 a 59 anos,2005-05-01,1,5,1,5,6
COLOMI,consulta externa,repetidas en personas de 15 a 59 anos,2005-05-01,18,19,18,19,37
COLPA BELGICA,consulta externa,repetidas en personas de 15 a 59 anos,2005-05-01,59,47,59,47,106
COLQUECHACA,consulta externa,repetidas en personas de 15 a 59 anos,2005-05-01,10,8,10,8,18
COLQUENCHA,consulta externa,repetidas en personas de 15 a 59 anos,2005-05-01,0,1,0,1,1
COLQUIRI,consulta externa,repetidas en personas de 15 a 59 anos,2005-05-01,5,18,5,18,23
COMANCHE,consulta externa,repetidas en personas de 15 a 59 anos,2005-05-01,3,3,3,3,6
COMARAPA,consulta externa,repetidas en personas de 15 a 59 anos,2005-05-01,38,33,38,33,71
COMBAYA,consulta externa,repetidas en personas de 15 a 59 anos,2005-05-01,1,1,1,1,2
CONCEPCION,consulta externa,repetidas en personas de 15 a 59 anos,2005-05-01,6,5,6,5,11
COPACABANA,consulta externa,repetidas en personas de 15 a 59 anos,2005-05-01,3,4,3,4,7
CORIPATA,consulta externa,repetidas en personas de 15 a 59 anos,2005-05-01,2,3,2,3,5
CORO CORO,consulta externa,repetidas en personas de 15 a 59 anos,2005-05-01,0,4,0,4,4
COROICO,consulta externa,repetidas en personas de 15 a 59 anos,2005-05-01,74,67,74,67,141
CORQUE,consulta externa,repetidas en personas de 15 a 59 anos,2005-05-01,22,28,22,28,50
COTAGAITA,consulta externa,repetidas en personas de 15 a 59 anos,2005-05-01,99,98,99,98,197
COTOCA,consulta externa,repetidas en personas de 15 a 59 anos,2005-05-01,0,2,0,2,2
CUATRO CAÑADAS,consulta externa,repetidas en personas de 15 a 59 anos,2005-05-01,14,142,14,142,156
CUCHUMUELA (V. G. VILLARROEL),consulta externa,repetidas en personas de 15 a 59 anos,2005-05-01,0,3,0,3,3
CUEVO,consulta externa,repetidas en personas de 15 a 59 anos,2005-05-01,3,1,3,1,4
CULPINA,consulta externa,repetidas en personas de 15 a 59 anos,2005-05-01,7,7,7,7,14
CURAHUARA DE CARANGAS,consulta externa,repetidas en personas de 15 a 59 anos,2005-05-01,2,2,2,2,4
DESAGUADERO,consulta externa,repetidas en personas de 15 a 59 anos,2005-05-01,5,4,5,4,9
EL ALTO,consulta externa,repetidas en personas de 15 a 59 anos,2005-05-01,2120,3929,2120,3929,6049
EL CHORO,consulta externa,repetidas en personas de 15 a 59 anos,2005-05-01,1,1,1,1,2
EL PUENTE(STC),consulta externa,repetidas en personas de 15 a 59 anos,2005-05-01,2,6,2,6,8
EL PUENTE(TJA),consulta externa,repetidas en personas de 15 a 59 anos,2005-05-01,3,9,3,9,12
EL TORNO,consulta externa,repetidas en personas de 15 a 59 anos,2005-05-01,100,147,100,147,247
EL VILLAR,consulta externa,repetidas en personas de 15 a 59 anos,2005-05-01,2,4,2,4,6
ENTRE RIOS,consulta externa,repetidas en personas de 15 a 59 anos,2005-05-01,16,33,16,33,49
ENTRE RIOS,consulta externa,repetidas en personas de 15 a 59 anos,2005-05-01,11,107,11,107,118
EUCALIPTUS,consulta externa,repetidas en personas de 15 a 59 anos,2005-05-01,0,4,0,4,4
EUREKA (SANTOS MERCADO),consulta externa,repetidas en personas de 15 a 59 anos,2005-05-01,1,0,1,0,1
EXALTACION,consulta externa,repetidas en personas de 15 a 59 anos,2005-05-01,1,3,1,3,4
FERNANDEZ ALONSO,consulta externa,repetidas en personas de 15 a 59 anos,2005-05-01,15,48,15,48,63
FILADELFIA,consulta externa,repetidas en personas de 15 a 59 anos,2005-05-01,10,64,10,64,74
GENERAL SAAVEDRA,consulta externa,repetidas en personas de 15 a 59 anos,2005-05-01,2,21,2,21,23
GRAL. J.J. PEREZ (CHARAZANI),consulta externa,repetidas en personas de 15 a 59 anos,2005-05-01,2,2,2,2,4
GUANAY,consulta externa,repetidas en personas de 15 a 59 anos,2005-05-01,0,2,0,2,2
GUAQUI,consulta externa,repetidas en personas de 15 a 59 anos,2005-05-01,1,7,1,7,8
GUAYARAMERIN,consulta externa,repetidas en personas de 15 a 59 anos,2005-05-01,125,187,125,187,312
GUTIERREZ,consulta externa,repetidas en personas de 15 a 59 anos,2005-05-01,9,11,9,11,20
HUACARETA,consulta externa,repetidas en personas de 15 a 59 anos,2005-05-01,7,43,7,43,50
HUACHACALLA,consulta externa,repetidas en personas de 15 a 59 anos,2005-05-01,1,0,1,0,1
HUANUNI,consulta externa,repetidas en personas de 15 a 59 anos,2005-05-01,165,178,165,178,343
HUARACAJE,consulta externa,repetidas en personas de 15 a 59 anos,2005-05-01,12,5,12,5,17
HUAYLLAMARCA,consulta externa,repetidas en personas de 15 a 59 anos,2005-05-01,5,13,5,13,18
ICHOCA,consulta externa,repetidas en personas de 15 a 59 anos,2005-05-01,2,2,2,2,4
ICLA,consulta externa,repetidas en personas de 15 a 59 anos,2005-05-01,1,10,1,10,11
INCAHUASI,consulta externa,repetidas en personas de 15 a 59 anos,2005-05-01,6,11,6,11,17
INGAVI (HUMAITA),consulta externa,repetidas en personas de 15 a 59 anos,2005-05-01,3,1,3,1,4
INQUISIVI,consulta externa,repetidas en personas de 15 a 59 anos,2005-05-01,5,10,5,10,15
IRUPANA (VILLA DE LANZA),consulta externa,repetidas en personas de 15 a 59 anos,2005-05-01,23,15,23,15,38
IXIAMAS,consulta externa,repetidas en personas de 15 a 59 anos,2005-05-01,11,10,11,10,21
JESUS DE MACHACA,consulta externa,repetidas en personas de 15 a 59 anos,2005-05-01,2,16,2,16,18
LA ASUNTA,consulta externa,repetidas en personas de 15 a 59 anos,2005-05-01,2,11,2,11,13
LA GUARDIA,consulta externa,repetidas en personas de 15 a 59 anos,2005-05-01,13,84,13,84,97
LA PAZ,consulta externa,repetidas en personas de 15 a 59 anos,2005-05-01,11455,27205,11455,27205,38660
LAGUNILLAS,consulta externa,repetidas en personas de 15 a 59 anos,2005-05-01,1,12,1,12,13
LAJA,consulta externa,repetidas en personas de 15 a 59 anos,2005-05-01,10,4,10,4,14
LAS CARRERAS,consulta externa,repetidas en personas de 15 a 59 anos,2005-05-01,3,15,3,15,18
LICOMA PAMPA,consulta externa,repetidas en personas de 15 a 59 anos,2005-05-01,0,1,0,1,1
LLALLAGUA,consulta externa,repetidas en personas de 15 a 59 anos,2005-05-01,69,132,69,132,201
LLICA,consulta externa,repetidas en personas de 15 a 59 anos,2005-05-01,3,4,3,4,7
LORETO,consulta externa,repetidas en personas de 15 a 59 anos,2005-05-01,1,9,1,9,10
LURIBAY,consulta externa,repetidas en personas de 15 a 59 anos,2005-05-01,4,10,4,10,14
MACHACAMARCA,consulta externa,repetidas en personas de 15 a 59 anos,2005-05-01,9,29,9,29,38
MACHARETI,consulta externa,repetidas en personas de 15 a 59 anos,2005-05-01,7,27,7,27,34
MAGDALENA,consulta externa,repetidas en personas de 15 a 59 anos,2005-05-01,49,110,49,110,159
MAIRANA,consulta externa,repetidas en personas de 15 a 59 anos,2005-05-01,2,6,2,6,8
MALLA,consulta externa,repetidas en personas de 15 a 59 anos,2005-05-01,1,5,1,5,6
MAPIRI,consulta externa,repetidas en personas de 15 a 59 anos,2005-05-01,1,2,1,2,3
MECAPACA,consulta externa,repetidas en personas de 15 a 59 anos,2005-05-01,33,51,33,51,84
MINEROS,consulta externa,repetidas en personas de 15 a 59 anos,2005-05-01,7,52,7,52,59
MIZQUE,consulta externa,repetidas en personas de 15 a 59 anos,2005-05-01,14,11,14,11,25
MOCOMOCO,consulta externa,repetidas en personas de 15 a 59 anos,2005-05-01,12,6,12,6,18
MOJINETE,consulta externa,repetidas en personas de 15 a 59 anos,2005-05-01,2,4,2,4,6
MOJOCOYA,consulta externa,repetidas en personas de 15 a 59 anos,2005-05-01,2,5,2,5,7
MONTEAGUDO,consulta externa,repetidas en personas de 15 a 59 anos,2005-05-01,82,463,82,463,545
MONTERO,consulta externa,repetidas en personas de 15 a 59 anos,2005-05-01,535,1075,535,1075,1610
MORO MORO,consulta externa,repetidas en personas de 15 a 59 anos,2005-05-01,1,0,1,0,1
MOROCHATA,consulta externa,repetidas en personas de 15 a 59 anos,2005-05-01,4,21,4,21,25
NACEBE (SANTA ROSA DEL ABUNA),consulta externa,repetidas en personas de 15 a 59 anos,2005-05-01,1,0,1,0,1
NUEVO MANOA (NUEVA ESPERANZA),consulta externa,repetidas en personas de 15 a 59 anos,2005-05-01,0,2,0,2,2
OCURI,consulta externa,repetidas en personas de 15 a 59 anos,2005-05-01,1,1,1,1,2
OKINAWA,consulta externa,repetidas en personas de 15 a 59 anos,2005-05-01,14,32,14,32,46
OMEREQUE,consulta externa,repetidas en personas de 15 a 59 anos,2005-05-01,0,3,0,3,3
ORURO,consulta externa,repetidas en personas de 15 a 59 anos,2005-05-01,1752,3875,1752,3875,5627
PADCAYA,consulta externa,repetidas en personas de 15 a 59 anos,2005-05-01,4,13,4,13,17
PADILLA,consulta externa,repetidas en personas de 15 a 59 anos,2005-05-01,10,12,10,12,22
PAILON,consulta externa,repetidas en personas de 15 a 59 anos,2005-05-01,4,142,4,142,146
PALCA,consulta externa,repetidas en personas de 15 a 59 anos,2005-05-01,13,9,13,9,22
PALOS BLANCOS,consulta externa,repetidas en personas de 15 a 59 anos,2005-05-01,83,88,83,88,171
PAMPA AULLAGAS,consulta externa,repetidas en personas de 15 a 59 anos,2005-05-01,1,0,1,0,1
PAMPA GRANDE,consulta externa,repetidas en personas de 15 a 59 anos,2005-05-01,4,13,4,13,17
PAPEL PAMPA,consulta externa,repetidas en personas de 15 a 59 anos,2005-05-01,2,4,2,4,6
PATACAMAYA,consulta externa,repetidas en personas de 15 a 59 anos,2005-05-01,3,6,3,6,9
PAZÑA,consulta externa,repetidas en personas de 15 a 59 anos,2005-05-01,23,20,23,20,43
PELECHUCO,consulta externa,repetidas en personas de 15 a 59 anos,2005-05-01,16,6,16,6,22
POCOATA,consulta externa,repetidas en personas de 15 a 59 anos,2005-05-01,4,6,4,6,10
POCONA,consulta externa,repetidas en personas de 15 a 59 anos,2005-05-01,4,4,4,4,8
POJO (CBBA),consulta externa,repetidas en personas de 15 a 59 anos,2005-05-01,2,1,2,1,3
POOPO,consulta externa,repetidas en personas de 15 a 59 anos,2005-05-01,9,6,9,6,15
PORCO,consulta externa,repetidas en personas de 15 a 59 anos,2005-05-01,1,1,1,1,2
POROMA,consulta externa,repetidas en personas de 15 a 59 anos,2005-05-01,7,7,7,7,14
PORONGO,consulta externa,repetidas en personas de 15 a 59 anos,2005-05-01,51,13,51,13,64
PORTACHUELO,consulta externa,repetidas en personas de 15 a 59 anos,2005-05-01,26,49,26,49,75
PORVENIR,consulta externa,repetidas en personas de 15 a 59 anos,2005-05-01,2,4,2,4,6
POSTRER VALLE,consulta externa,repetidas en personas de 15 a 59 anos,2005-05-01,4,11,4,11,15
POTOSI,consulta externa,repetidas en personas de 15 a 59 anos,2005-05-01,2038,3023,2038,3023,5061
PUCARA,consulta externa,repetidas en personas de 15 a 59 anos,2005-05-01,5,0,5,0,5
PUCARANI,consulta externa,repetidas en personas de 15 a 59 anos,2005-05-01,5,4,5,4,9
PUERTO ACOSTA,consulta externa,repetidas en personas de 15 a 59 anos,2005-05-01,31,37,31,37,68
PUERTO CARABUCO,consulta externa,repetidas en personas de 15 a 59 anos,2005-05-01,9,10,9,10,19
PUERTO GONZALO MORENO,consulta externa,repetidas en personas de 15 a 59 anos,2005-05-01,2,4,2,4,6
PUERTO PEREZ,consulta externa,repetidas en personas de 15 a 59 anos,2005-05-01,5,7,5,7,12
PUERTO QUIJARRO,consulta externa,repetidas en personas de 15 a 59 anos,2005-05-01,41,54,41,54,95
PUERTO RICO,consulta externa,repetidas en personas de 15 a 59 anos,2005-05-01,1,5,1,5,6
PUERTO SILES,consulta externa,repetidas en personas de 15 a 59 anos,2005-05-01,1,8,1,8,9
PUERTO SUAREZ,consulta externa,repetidas en personas de 15 a 59 anos,2005-05-01,14,43,14,43,57
PUERTO VILLARROEL,consulta externa,repetidas en personas de 15 a 59 anos,2005-05-01,35,39,35,39,74
PUNA,consulta externa,repetidas en personas de 15 a 59 anos,2005-05-01,9,13,9,13,22
PUNATA,consulta externa,repetidas en personas de 15 a 59 anos,2005-05-01,104,216,104,216,320
QUILLACOLLO,consulta externa,repetidas en personas de 15 a 59 anos,2005-05-01,273,781,273,781,1054
QUIME,consulta externa,repetidas en personas de 15 a 59 anos,2005-05-01,19,10,19,10,29
RAVELO,consulta externa,repetidas en personas de 15 a 59 anos,2005-05-01,0,10,0,10,10
REYES,consulta externa,repetidas en personas de 15 a 59 anos,2005-05-01,13,31,13,31,44
RIBERALTA,consulta externa,repetidas en personas de 15 a 59 anos,2005-05-01,54,431,54,431,485
ROBORE,consulta externa,repetidas en personas de 15 a 59 anos,2005-05-01,61,62,61,62,123
RURRENABAQUE,consulta externa,repetidas en personas de 15 a 59 anos,2005-05-01,18,73,18,73,91
SABAYA,consulta externa,repetidas en personas de 15 a 59 anos,2005-05-01,4,2,4,2,6
SACABA,consulta externa,repetidas en personas de 15 a 59 anos,2005-05-01,130,223,130,223,353
SACABAMBA,consulta externa,repetidas en personas de 15 a 59 anos,2005-05-01,2,6,2,6,8
SACACA,consulta externa,repetidas en personas de 15 a 59 anos,2005-05-01,4,2,4,2,6
SAIPINA,consulta externa,repetidas en personas de 15 a 59 anos,2005-05-01,5,27,5,27,32
SALINAS DE GARCI MENDOZA,consulta externa,repetidas en personas de 15 a 59 anos,2005-05-01,2,9,2,9,11
SAMAIPATA,consulta externa,repetidas en personas de 15 a 59 anos,2005-05-01,2,2,2,2,4
SAN AGUSTIN,consulta externa,repetidas en personas de 15 a 59 anos,2005-05-01,0,4,0,4,4
SAN ANDRES,consulta externa,repetidas en personas de 15 a 59 anos,2005-05-01,6,12,6,12,18
SAN ANDRES DE MACHACA,consulta externa,repetidas en personas de 15 a 59 anos,2005-05-01,3,3,3,3,6
SAN ANTONIO DE ESMORUCO,consulta externa,repetidas en personas de 15 a 59 anos,2005-05-01,0,7,0,7,7
SAN ANTONIO DE LOMERIO,consulta externa,repetidas en personas de 15 a 59 anos,2005-05-01,2,4,2,4,6
SAN BENITO,consulta externa,repetidas en personas de 15 a 59 anos,2005-05-01,6,7,6,7,13
SAN BORJA,consulta externa,repetidas en personas de 15 a 59 anos,2005-05-01,24,155,24,155,179
SAN BUENA VENTURA,consulta externa,repetidas en personas de 15 a 59 anos,2005-05-01,8,7,8,7,15
SAN CARLOS,consulta externa,repetidas en personas de 15 a 59 anos,2005-05-01,6,131,6,131,137
SAN IGNACIO,consulta externa,repetidas en personas de 15 a 59 anos,2005-05-01,27,94,27,94,121
SAN IGNACIO DE VELASCO,consulta externa,repetidas en personas de 15 a 59 anos,2005-05-01,72,180,72,180,252
SAN JAVIER(BNI),consulta externa,repetidas en personas de 15 a 59 anos,2005-05-01,0,6,0,6,6
SAN JAVIER(STC),consulta externa,repetidas en personas de 15 a 59 anos,2005-05-01,9,101,9,101,110
SAN JOAQUIN,consulta externa,repetidas en personas de 15 a 59 anos,2005-05-01,10,33,10,33,43
SAN JOSE DE CHIQUITOS,consulta externa,repetidas en personas de 15 a 59 anos,2005-05-01,4,14,4,14,18
SAN JUAN DE YAPACANI,consulta externa,repetidas en personas de 15 a 59 anos,2005-05-01,10,13,10,13,23
SAN JULIAN,consulta externa,repetidas en personas de 15 a 59 anos,2005-05-01,30,371,30,371,401
SAN LORENZO(PND),consulta externa,repetidas en personas de 15 a 59 anos,2005-05-01,3,3,3,3,6
SAN LORENZO(TJA),consulta externa,repetidas en personas de 15 a 59 anos,2005-05-01,6,16,6,16,22
SAN LUCAS,consulta externa,repetidas en personas de 15 a 59 anos,2005-05-01,7,21,7,21,28
SAN MATIAS,consulta externa,repetidas en personas de 15 a 59 anos,2005-05-01,2,21,2,21,23
SAN MIGUEL DE VELASCO,consulta externa,repetidas en personas de 15 a 59 anos,2005-05-01,10,29,10,29,39
SAN PABLO DE LIPEZ,consulta externa,repetidas en personas de 15 a 59 anos,2005-05-01,5,20,5,20,25
SAN PEDRO,consulta externa,repetidas en personas de 15 a 59 anos,2005-05-01,34,44,34,44,78
SAN PEDRO DE BUENA VISTA,consulta externa,repetidas en personas de 15 a 59 anos,2005-05-01,1,1,1,1,2
SAN PEDRO DE CURAHUARA,consulta externa,repetidas en personas de 15 a 59 anos,2005-05-01,1,3,1,3,4
SAN PEDRO DE TIQUINA,consulta externa,repetidas en personas de 15 a 59 anos,2005-05-01,5,5,5,5,10
SAN RAFAEL,consulta externa,repetidas en personas de 15 a 59 anos,2005-05-01,3,8,3,8,11
SAN RAMON,consulta externa,repetidas en personas de 15 a 59 anos,2005-05-01,4,41,4,41,45
SAN RAMON,consulta externa,repetidas en personas de 15 a 59 anos,2005-05-01,20,106,20,106,126
SANTA ANA,consulta externa,repetidas en personas de 15 a 59 anos,2005-05-01,40,69,40,69,109
SANTA CRUZ DE LA SIERRA,consulta externa,repetidas en personas de 15 a 59 anos,2005-05-01,4519,11249,4519,11249,15768
SANTA ROSA,consulta externa,repetidas en personas de 15 a 59 anos,2005-05-01,9,21,9,21,30
SANTA ROSA DEL SARA,consulta externa,repetidas en personas de 15 a 59 anos,2005-05-01,7,15,7,15,22
SANTIAGO DE HUARI,consulta externa,repetidas en personas de 15 a 59 anos,2005-05-01,9,17,9,17,26
SANTIAGO DE MACHACA,consulta externa,repetidas en personas de 15 a 59 anos,2005-05-01,3,8,3,8,11
SANTIVAÑES,consulta externa,repetidas en personas de 15 a 59 anos,2005-05-01,1,5,1,5,6
SANTUARIO DE QUILLACAS,consulta externa,repetidas en personas de 15 a 59 anos,2005-05-01,0,1,0,1,1
SAPAHAQUI,consulta externa,repetidas en personas de 15 a 59 anos,2005-05-01,6,10,6,10,16
SICA SICA (VILLA AROMA),consulta externa,repetidas en personas de 15 a 59 anos,2005-05-01,0,6,0,6,6
SICAYA,consulta externa,repetidas en personas de 15 a 59 anos,2005-05-01,1,2,1,2,3
SIPE SIPE,consulta externa,repetidas en personas de 15 a 59 anos,2005-05-01,34,161,34,161,195
SOPACHUY,consulta externa,repetidas en personas de 15 a 59 anos,2005-05-01,2,5,2,5,7
SORACACHI,consulta externa,repetidas en personas de 15 a 59 anos,2005-05-01,1,0,1,0,1
SORATA,consulta externa,repetidas en personas de 15 a 59 anos,2005-05-01,14,15,14,15,29
SUCRE,consulta externa,repetidas en personas de 15 a 59 anos,2005-05-01,2675,5878,2675,5878,8553
TACACHI,consulta externa,repetidas en personas de 15 a 59 anos,2005-05-01,7,30,7,30,37
TACACOMA,consulta externa,repetidas en personas de 15 a 59 anos,2005-05-01,4,2,4,2,6
TACOBAMBA,consulta externa,repetidas en personas de 15 a 59 anos,2005-05-01,1,1,1,1,2
TAPACARI,consulta externa,repetidas en personas de 15 a 59 anos,2005-05-01,13,29,13,29,42
TARABUCO,consulta externa,repetidas en personas de 15 a 59 anos,2005-05-01,19,20,19,20,39
TARACO,consulta externa,repetidas en personas de 15 a 59 anos,2005-05-01,4,4,4,4,8
TARATA,consulta externa,repetidas en personas de 15 a 59 anos,2005-05-01,3,8,3,8,11
TARIJA,consulta externa,repetidas en personas de 15 a 59 anos,2005-05-01,1432,5268,1432,5268,6700
TARVITA,consulta externa,repetidas en personas de 15 a 59 anos,2005-05-01,4,13,4,13,17
TEOPONTE,consulta externa,repetidas en personas de 15 a 59 anos,2005-05-01,3,3,3,3,6
TIAWANACU,consulta externa,repetidas en personas de 15 a 59 anos,2005-05-01,2,6,2,6,8
TINGUIPAYA,consulta externa,repetidas en personas de 15 a 59 anos,2005-05-01,2,5,2,5,7
TIPUANI,consulta externa,repetidas en personas de 15 a 59 anos,2005-05-01,18,3,18,3,21
TIQUIPAYA,consulta externa,repetidas en personas de 15 a 59 anos,2005-05-01,23,114,23,114,137
TIRAQUE (CBBA),consulta externa,repetidas en personas de 15 a 59 anos,2005-05-01,51,254,51,254,305
TITO YUPANQUI (PARQUIPUJIO),consulta externa,repetidas en personas de 15 a 59 anos,2005-05-01,0,3,0,3,3
TOCO,consulta externa,repetidas en personas de 15 a 59 anos,2005-05-01,3,1,3,1,4
TOLATA,consulta externa,repetidas en personas de 15 a 59 anos,2005-05-01,1,3,1,3,4
TOLEDO,consulta externa,repetidas en personas de 15 a 59 anos,2005-05-01,7,9,7,9,16
TOMAVE,consulta externa,repetidas en personas de 15 a 59 anos,2005-05-01,6,5,6,5,11
TOMINA,consulta externa,repetidas en personas de 15 a 59 anos,2005-05-01,1,5,1,5,6
TORO TORO,consulta externa,repetidas en personas de 15 a 59 anos,2005-05-01,7,6,7,6,13
TOTORA(CBBA),consulta externa,repetidas en personas de 15 a 59 anos,2005-05-01,4,4,4,4,8
TRIGAL,consulta externa,repetidas en personas de 15 a 59 anos,2005-05-01,1,0,1,0,1
TRINIDAD,consulta externa,repetidas en personas de 15 a 59 anos,2005-05-01,252,581,252,581,833
TUPIZA,consulta externa,repetidas en personas de 15 a 59 anos,2005-05-01,177,258,177,258,435
UNCIA,consulta externa,repetidas en personas de 15 a 59 anos,2005-05-01,91,169,91,169,260
URIONDO (A. CONCEPCION),consulta externa,repetidas en personas de 15 a 59 anos,2005-05-01,7,20,7,20,27
URUBICHA,consulta externa,repetidas en personas de 15 a 59 anos,2005-05-01,1,116,1,116,117
UYUNI,consulta externa,repetidas en personas de 15 a 59 anos,2005-05-01,24,173,24,173,197
VACAS,consulta externa,repetidas en personas de 15 a 59 anos,2005-05-01,21,47,21,47,68
VALLEGRANDE,consulta externa,repetidas en personas de 15 a 59 anos,2005-05-01,60,159,60,159,219
VIACHA,consulta externa,repetidas en personas de 15 a 59 anos,2005-05-01,97,217,97,217,314
VILA VILA,consulta externa,repetidas en personas de 15 a 59 anos,2005-05-01,1,1,1,1,2
VILLA MONTES,consulta externa,repetidas en personas de 15 a 59 anos,2005-05-01,56,96,56,96,152
VILLA NUEVA (LOMA ALTA),consulta externa,repetidas en personas de 15 a 59 anos,2005-05-01,1,1,1,1,2
VILLA RIVERO,consulta externa,repetidas en personas de 15 a 59 anos,2005-05-01,9,25,9,25,34
VILLA SERRANO,consulta externa,repetidas en personas de 15 a 59 anos,2005-05-01,4,9,4,9,13
VILLA TUNARI,consulta externa,repetidas en personas de 15 a 59 anos,2005-05-01,72,79,72,79,151
VILLA VACA GUZMAN (MUYUPAMPA),consulta externa,repetidas en personas de 15 a 59 anos,2005-05-01,5,190,5,190,195
VILLAZON,consulta externa,repetidas en personas de 15 a 59 anos,2005-05-01,41,147,41,147,188
VINTO,consulta externa,repetidas en personas de 15 a 59 anos,2005-05-01,31,93,31,93,124
VITICHI,consulta externa,repetidas en personas de 15 a 59 anos,2005-05-01,17,20,17,20,37
WALDO BALLIVIAN,consulta externa,repetidas en personas de 15 a 59 anos,2005-05-01,1,2,1,2,3
WARNES,consulta externa,repetidas en personas de 15 a 59 anos,2005-05-01,19,78,19,78,97
YACO,consulta externa,repetidas en personas de 15 a 59 anos,2005-05-01,2,4,2,4,6
YACUIBA,consulta externa,repetidas en personas de 15 a 59 anos,2005-05-01,284,919,284,919,1203
YAMPARAEZ,consulta externa,repetidas en personas de 15 a 59 anos,2005-05-01,10,24,10,24,34
YANACACHI,consulta externa,repetidas en personas de 15 a 59 anos,2005-05-01,8,22,8,22,30
YAPACANI,consulta externa,repetidas en personas de 15 a 59 anos,2005-05-01,23,300,23,300,323
YOCALLA,consulta externa,repetidas en personas de 15 a 59 anos,2005-05-01,0,4,0,4,4
YOTALA,consulta externa,repetidas en personas de 15 a 59 anos,2005-05-01,22,61,22,61,83
YUNCHARA,consulta externa,repetidas en personas de 15 a 59 anos,2005-05-01,4,4,4,4,8
ZUDAÑEZ,consulta externa,repetidas en personas de 15 a 59 anos,2005-05-01,2,3,2,3,5
ACACIO,consulta externa,repetidas en personas de 15 a 59 anos,2005-06-01,8,4,8,4,12
ACHACACHI,consulta externa,repetidas en personas de 15 a 59 anos,2005-06-01,34,45,34,45,79
ACHOCALLA,consulta externa,repetidas en personas de 15 a 59 anos,2005-06-01,5,15,5,15,20
AIQUILE,consulta externa,repetidas en personas de 15 a 59 anos,2005-06-01,43,174,43,174,217
ANCORAIMES,consulta externa,repetidas en personas de 15 a 59 anos,2005-06-01,6,16,6,16,22
ANTEQUERA,consulta externa,repetidas en personas de 15 a 59 anos,2005-06-01,2,0,2,0,2
ANZALDO,consulta externa,repetidas en personas de 15 a 59 anos,2005-06-01,3,8,3,8,11
APOLO,consulta externa,repetidas en personas de 15 a 59 anos,2005-06-01,11,9,11,9,20
ARANI,consulta externa,repetidas en personas de 15 a 59 anos,2005-06-01,5,21,5,21,26
ARBIETO,consulta externa,repetidas en personas de 15 a 59 anos,2005-06-01,1,12,1,12,13
ARQUE,consulta externa,repetidas en personas de 15 a 59 anos,2005-06-01,0,3,0,3,3
ASCENCION DE GUARAYOS,consulta externa,repetidas en personas de 15 a 59 anos,2005-06-01,1,6,1,6,7
ATOCHA,consulta externa,repetidas en personas de 15 a 59 anos,2005-06-01,250,176,250,176,426
AUCAPATA,consulta externa,repetidas en personas de 15 a 59 anos,2005-06-01,3,5,3,5,8
AYATA,consulta externa,repetidas en personas de 15 a 59 anos,2005-06-01,12,15,12,15,27
AYO AYO,consulta externa,repetidas en personas de 15 a 59 anos,2005-06-01,0,6,0,6,6
AYOPAYA (V. DE INDEPENDENCIA),consulta externa,repetidas en personas de 15 a 59 anos,2005-06-01,5,7,5,7,12
AZURDUY,consulta externa,repetidas en personas de 15 a 59 anos,2005-06-01,0,2,0,2,2
BATALLAS,consulta externa,repetidas en personas de 15 a 59 anos,2005-06-01,5,11,5,11,16
BAURES,consulta externa,repetidas en personas de 15 a 59 anos,2005-06-01,6,16,6,16,22
BELEN DE ANDAMARCA,consulta externa,repetidas en personas de 15 a 59 anos,2005-06-01,0,2,0,2,2
BELEN DE URMIRI,consulta externa,repetidas en personas de 15 a 59 anos,2005-06-01,1,1,1,1,2
BELLA FLOR,consulta externa,repetidas en personas de 15 a 59 anos,2005-06-01,6,0,6,0,6
BERMEJO,consulta externa,repetidas en personas de 15 a 59 anos,2005-06-01,82,113,82,113,195
BETANZOS,consulta externa,repetidas en personas de 15 a 59 anos,2005-06-01,26,71,26,71,97
BOLIVAR,consulta externa,repetidas en personas de 15 a 59 anos,2005-06-01,0,3,0,3,3
BOLPEBRA,consulta externa,repetidas en personas de 15 a 59 anos,2005-06-01,2,0,2,0,2
BOYUIBE,consulta externa,repetidas en personas de 15 a 59 anos,2005-06-01,7,17,7,17,24
BUENA VISTA,consulta externa,repetidas en personas de 15 a 59 anos,2005-06-01,42,73,42,73,115
CABEZAS,consulta externa,repetidas en personas de 15 a 59 anos,2005-06-01,7,6,7,6,13
CAIROMA,consulta externa,repetidas en personas de 15 a 59 anos,2005-06-01,4,5,4,5,9
"CAIZA ""D""",consulta externa,repetidas en personas de 15 a 59 anos,2005-06-01,18,8,18,8,26
CAJUATA,consulta externa,repetidas en personas de 15 a 59 anos,2005-06-01,2,4,2,4,6
CALACOTO,consulta externa,repetidas en personas de 15 a 59 anos,2005-06-01,0,1,0,1,1
CALAMARCA,consulta externa,repetidas en personas de 15 a 59 anos,2005-06-01,9,17,9,17,26
CAMARGO,consulta externa,repetidas en personas de 15 a 59 anos,2005-06-01,16,35,16,35,51
CAMATAQUI (C. VILLA ABECIA),consulta externa,repetidas en personas de 15 a 59 anos,2005-06-01,0,5,0,5,5
CAMIRI,consulta externa,repetidas en personas de 15 a 59 anos,2005-06-01,86,236,86,236,322
CAPINOTA,consulta externa,repetidas en personas de 15 a 59 anos,2005-06-01,61,80,61,80,141
CAQUIAVIRI,consulta externa,repetidas en personas de 15 a 59 anos,2005-06-01,1,7,1,7,8
CARACOLLO,consulta externa,repetidas en personas de 15 a 59 anos,2005-06-01,4,21,4,21,25
CARANAVI,consulta externa,repetidas en personas de 15 a 59 anos,2005-06-01,31,50,31,50,81
CARAPARI,consulta externa,repetidas en personas de 15 a 59 anos,2005-06-01,26,28,26,28,54
CARMEN RIVERO TORREZ,consulta externa,repetidas en personas de 15 a 59 anos,2005-06-01,0,1,0,1,1
CATACORA,consulta externa,repetidas en personas de 15 a 59 anos,2005-06-01,0,2,0,2,2
CHALLAPATA,consulta externa,repetidas en personas de 15 a 59 anos,2005-06-01,15,26,15,26,41
CHAQUI,consulta externa,repetidas en personas de 15 a 59 anos,2005-06-01,2,0,2,0,2
CHARAGUA,consulta externa,repetidas en personas de 15 a 59 anos,2005-06-01,14,17,14,17,31
CHARAÑA,consulta externa,repetidas en personas de 15 a 59 anos,2005-06-01,7,6,7,6,13
CHAYANTA,consulta externa,repetidas en personas de 15 a 59 anos,2005-06-01,13,13,13,13,26
CHIMORE,consulta externa,repetidas en personas de 15 a 59 anos,2005-06-01,12,36,12,36,48
CHIPAYA,consulta externa,repetidas en personas de 15 a 59 anos,2005-06-01,0,1,0,1,1
CHULUMANI (V. DE LA LIBERTAD),consulta externa,repetidas en personas de 15 a 59 anos,2005-06-01,66,55,66,55,121
CHUMA,consulta externa,repetidas en personas de 15 a 59 anos,2005-06-01,7,18,7,18,25
CLIZA,consulta externa,repetidas en personas de 15 a 59 anos,2005-06-01,1,3,1,3,4
COBIJA,consulta externa,repetidas en personas de 15 a 59 anos,2005-06-01,102,284,102,284,386
COCHABAMBA,consulta externa,repetidas en personas de 15 a 59 anos,2005-06-01,6645,17386,6645,17386,24031
COLCAPIRHUA,consulta externa,repetidas en personas de 15 a 59 anos,2005-06-01,108,294,108,294,402
"COLCHA ""K""",consulta externa,repetidas en personas de 15 a 59 anos,2005-06-01,9,2,9,2,11
COLLANA,consulta externa,repetidas en personas de 15 a 59 anos,2005-06-01,3,3,3,3,6
COLOMI,consulta externa,repetidas en personas de 15 a 59 anos,2005-06-01,6,13,6,13,19
COLPA BELGICA,consulta externa,repetidas en personas de 15 a 59 anos,2005-06-01,91,53,91,53,144
COLQUECHACA,consulta externa,repetidas en personas de 15 a 59 anos,2005-06-01,9,17,9,17,26
COLQUENCHA,consulta externa,repetidas en personas de 15 a 59 anos,2005-06-01,6,5,6,5,11
COLQUIRI,consulta externa,repetidas en personas de 15 a 59 anos,2005-06-01,7,7,7,7,14
COMANCHE,consulta externa,repetidas en personas de 15 a 59 anos,2005-06-01,1,5,1,5,6
COMARAPA,consulta externa,repetidas en personas de 15 a 59 anos,2005-06-01,31,60,31,60,91
COMBAYA,consulta externa,repetidas en personas de 15 a 59 anos,2005-06-01,1,2,1,2,3
CONCEPCION,consulta externa,repetidas en personas de 15 a 59 anos,2005-06-01,7,5,7,5,12
COPACABANA,consulta externa,repetidas en personas de 15 a 59 anos,2005-06-01,0,1,0,1,1
CORIPATA,consulta externa,repetidas en personas de 15 a 59 anos,2005-06-01,2,3,2,3,5
CORO CORO,consulta externa,repetidas en personas de 15 a 59 anos,2005-06-01,2,3,2,3,5
COROICO,consulta externa,repetidas en personas de 15 a 59 anos,2005-06-01,59,85,59,85,144
CORQUE,consulta externa,repetidas en personas de 15 a 59 anos,2005-06-01,15,10,15,10,25
COTAGAITA,consulta externa,repetidas en personas de 15 a 59 anos,2005-06-01,87,72,87,72,159
COTOCA,consulta externa,repetidas en personas de 15 a 59 anos,2005-06-01,1,5,1,5,6
CUATRO CAÑADAS,consulta externa,repetidas en personas de 15 a 59 anos,2005-06-01,10,116,10,116,126
CUCHUMUELA (V. G. VILLARROEL),consulta externa,repetidas en personas de 15 a 59 anos,2005-06-01,2,2,2,2,4
CUEVO,consulta externa,repetidas en personas de 15 a 59 anos,2005-06-01,6,7,6,7,13
CULPINA,consulta externa,repetidas en personas de 15 a 59 anos,2005-06-01,2,15,2,15,17
CURAHUARA DE CARANGAS,consulta externa,repetidas en personas de 15 a 59 anos,2005-06-01,1,2,1,2,3
DESAGUADERO,consulta externa,repetidas en personas de 15 a 59 anos,2005-06-01,2,1,2,1,3
EL ALTO,consulta externa,repetidas en personas de 15 a 59 anos,2005-06-01,2318,4043,2318,4043,6361
EL CHORO,consulta externa,repetidas en personas de 15 a 59 anos,2005-06-01,1,0,1,0,1
EL PUENTE(STC),consulta externa,repetidas en personas de 15 a 59 anos,2005-06-01,3,3,3,3,6
EL PUENTE(TJA),consulta externa,repetidas en personas de 15 a 59 anos,2005-06-01,4,8,4,8,12
EL TORNO,consulta externa,repetidas en personas de 15 a 59 anos,2005-06-01,116,160,116,160,276
EL VILLAR,consulta externa,repetidas en personas de 15 a 59 anos,2005-06-01,1,5,1,5,6
ENTRE RIOS,consulta externa,repetidas en personas de 15 a 59 anos,2005-06-01,11,13,11,13,24
ENTRE RIOS,consulta externa,repetidas en personas de 15 a 59 anos,2005-06-01,14,12,14,12,26
EUCALIPTUS,consulta externa,repetidas en personas de 15 a 59 anos,2005-06-01,1,5,1,5,6
EUREKA (SANTOS MERCADO),consulta externa,repetidas en personas de 15 a 59 anos,2005-06-01,1,1,1,1,2
EXALTACION,consulta externa,repetidas en personas de 15 a 59 anos,2005-06-01,2,2,2,2,4
FERNANDEZ ALONSO,consulta externa,repetidas en personas de 15 a 59 anos,2005-06-01,10,36,10,36,46
GENERAL SAAVEDRA,consulta externa,repetidas en personas de 15 a 59 anos,2005-06-01,7,24,7,24,31
GRAL. J.J. PEREZ (CHARAZANI),consulta externa,repetidas en personas de 15 a 59 anos,2005-06-01,3,3,3,3,6
GUAQUI,consulta externa,repetidas en personas de 15 a 59 anos,2005-06-01,7,10,7,10,17
GUAYARAMERIN,consulta externa,repetidas en personas de 15 a 59 anos,2005-06-01,201,396,201,396,597
GUTIERREZ,consulta externa,repetidas en personas de 15 a 59 anos,2005-06-01,14,27,14,27,41
HUACARETA,consulta externa,repetidas en personas de 15 a 59 anos,2005-06-01,5,9,5,9,14
HUACAYA (VILLA DE HUACAYA),consulta externa,repetidas en personas de 15 a 59 anos,2005-06-01,1,1,1,1,2
HUANUNI,consulta externa,repetidas en personas de 15 a 59 anos,2005-06-01,99,98,99,98,197
HUARACAJE,consulta externa,repetidas en personas de 15 a 59 anos,2005-06-01,6,3,6,3,9
HUAYLLAMARCA,consulta externa,repetidas en personas de 15 a 59 anos,2005-06-01,0,3,0,3,3
ICHOCA,consulta externa,repetidas en personas de 15 a 59 anos,2005-06-01,3,4,3,4,7
ICLA,consulta externa,repetidas en personas de 15 a 59 anos,2005-06-01,2,9,2,9,11
INCAHUASI,consulta externa,repetidas en personas de 15 a 59 anos,2005-06-01,4,12,4,12,16
INQUISIVI,consulta externa,repetidas en personas de 15 a 59 anos,2005-06-01,2,8,2,8,10
IRUPANA (VILLA DE LANZA),consulta externa,repetidas en personas de 15 a 59 anos,2005-06-01,17,15,17,15,32
IXIAMAS,consulta externa,repetidas en personas de 15 a 59 anos,2005-06-01,9,14,9,14,23
JESUS DE MACHACA,consulta externa,repetidas en personas de 15 a 59 anos,2005-06-01,9,21,9,21,30
LA ASUNTA,consulta externa,repetidas en personas de 15 a 59 anos,2005-06-01,6,11,6,11,17
LA GUARDIA,consulta externa,repetidas en personas de 15 a 59 anos,2005-06-01,11,85,11,85,96
LA PAZ,consulta externa,repetidas en personas de 15 a 59 anos,2005-06-01,10411,24524,10411,24524,34935
LAGUNILLAS,consulta externa,repetidas en personas de 15 a 59 anos,2005-06-01,11,11,11,11,22
LAJA,consulta externa,repetidas en personas de 15 a 59 anos,2005-06-01,6,6,6,6,12
LAS CARRERAS,consulta externa,repetidas en personas de 15 a 59 anos,2005-06-01,7,22,7,22,29
LICOMA PAMPA,consulta externa,repetidas en personas de 15 a 59 anos,2005-06-01,0,2,0,2,2
LLALLAGUA,consulta externa,repetidas en personas de 15 a 59 anos,2005-06-01,62,110,62,110,172
LLICA,consulta externa,repetidas en personas de 15 a 59 anos,2005-06-01,8,14,8,14,22
LORETO,consulta externa,repetidas en personas de 15 a 59 anos,2005-06-01,5,7,5,7,12
LURIBAY,consulta externa,repetidas en personas de 15 a 59 anos,2005-06-01,0,2,0,2,2
MACHACAMARCA,consulta externa,repetidas en personas de 15 a 59 anos,2005-06-01,9,20,9,20,29
MACHARETI,consulta externa,repetidas en personas de 15 a 59 anos,2005-06-01,7,57,7,57,64
MAGDALENA,consulta externa,repetidas en personas de 15 a 59 anos,2005-06-01,51,89,51,89,140
MAIRANA,consulta externa,repetidas en personas de 15 a 59 anos,2005-06-01,1,9,1,9,10
MALLA,consulta externa,repetidas en personas de 15 a 59 anos,2005-06-01,2,3,2,3,5
MAPIRI,consulta externa,repetidas en personas de 15 a 59 anos,2005-06-01,5,14,5,14,19
MECAPACA,consulta externa,repetidas en personas de 15 a 59 anos,2005-06-01,24,25,24,25,49
MINEROS,consulta externa,repetidas en personas de 15 a 59 anos,2005-06-01,16,58,16,58,74
MIZQUE,consulta externa,repetidas en personas de 15 a 59 anos,2005-06-01,6,6,6,6,12
MOCOMOCO,consulta externa,repetidas en personas de 15 a 59 anos,2005-06-01,7,10,7,10,17
MOJINETE,consulta externa,repetidas en personas de 15 a 59 anos,2005-06-01,1,7,1,7,8
MOJOCOYA,consulta externa,repetidas en personas de 15 a 59 anos,2005-06-01,5,13,5,13,18
MONTEAGUDO,consulta externa,repetidas en personas de 15 a 59 anos,2005-06-01,82,352,82,352,434
MONTERO,consulta externa,repetidas en personas de 15 a 59 anos,2005-06-01,712,1765,712,1765,2477
MORO MORO,consulta externa,repetidas en personas de 15 a 59 anos,2005-06-01,2,3,2,3,5
MOROCHATA,consulta externa,repetidas en personas de 15 a 59 anos,2005-06-01,8,54,8,54,62
NACEBE (SANTA ROSA DEL ABUNA),consulta externa,repetidas en personas de 15 a 59 anos,2005-06-01,3,2,3,2,5
NUEVO MANOA (NUEVA ESPERANZA),consulta externa,repetidas en personas de 15 a 59 anos,2005-06-01,0,3,0,3,3
OCURI,consulta externa,repetidas en personas de 15 a 59 anos,2005-06-01,1,4,1,4,5
OKINAWA,consulta externa,repetidas en personas de 15 a 59 anos,2005-06-01,14,34,14,34,48
OMEREQUE,consulta externa,repetidas en personas de 15 a 59 anos,2005-06-01,1,6,1,6,7
ORURO,consulta externa,repetidas en personas de 15 a 59 anos,2005-06-01,1765,3662,1765,3662,5427
PADCAYA,consulta externa,repetidas en personas de 15 a 59 anos,2005-06-01,7,12,7,12,19
PADILLA,consulta externa,repetidas en personas de 15 a 59 anos,2005-06-01,13,18,13,18,31
PAILON,consulta externa,repetidas en personas de 15 a 59 anos,2005-06-01,2,146,2,146,148
PALCA,consulta externa,repetidas en personas de 15 a 59 anos,2005-06-01,1,5,1,5,6
PALOS BLANCOS,consulta externa,repetidas en personas de 15 a 59 anos,2005-06-01,83,53,83,53,136
PAMPA GRANDE,consulta externa,repetidas en personas de 15 a 59 anos,2005-06-01,4,10,4,10,14
PAPEL PAMPA,consulta externa,repetidas en personas de 15 a 59 anos,2005-06-01,4,3,4,3,7
PASORAPA,consulta externa,repetidas en personas de 15 a 59 anos,2005-06-01,1,3,1,3,4
PATACAMAYA,consulta externa,repetidas en personas de 15 a 59 anos,2005-06-01,0,2,0,2,2
PAZÑA,consulta externa,repetidas en personas de 15 a 59 anos,2005-06-01,22,33,22,33,55
PELECHUCO,consulta externa,repetidas en personas de 15 a 59 anos,2005-06-01,9,5,9,5,14
POCOATA,consulta externa,repetidas en personas de 15 a 59 anos,2005-06-01,6,5,6,5,11
POJO (CBBA),consulta externa,repetidas en personas de 15 a 59 anos,2005-06-01,2,1,2,1,3
POOPO,consulta externa,repetidas en personas de 15 a 59 anos,2005-06-01,8,5,8,5,13
PORCO,consulta externa,repetidas en personas de 15 a 59 anos,2005-06-01,1,5,1,5,6
POROMA,consulta externa,repetidas en personas de 15 a 59 anos,2005-06-01,8,11,8,11,19
PORONGO,consulta externa,repetidas en personas de 15 a 59 anos,2005-06-01,9,17,9,17,26
PORTACHUELO,consulta externa,repetidas en personas de 15 a 59 anos,2005-06-01,42,70,42,70,112
PORVENIR,consulta externa,repetidas en personas de 15 a 59 anos,2005-06-01,14,4,14,4,18
POSTRER VALLE,consulta externa,repetidas en personas de 15 a 59 anos,2005-06-01,2,9,2,9,11
POTOSI,consulta externa,repetidas en personas de 15 a 59 anos,2005-06-01,2324,3084,2324,3084,5408
PRESTO,consulta externa,repetidas en personas de 15 a 59 anos,2005-06-01,1,2,1,2,3
PUCARA,consulta externa,repetidas en personas de 15 a 59 anos,2005-06-01,10,12,10,12,22
PUCARANI,consulta externa,repetidas en personas de 15 a 59 anos,2005-06-01,4,9,4,9,13
PUERTO ACOSTA,consulta externa,repetidas en personas de 15 a 59 anos,2005-06-01,14,21,14,21,35
PUERTO CARABUCO,consulta externa,repetidas en personas de 15 a 59 anos,2005-06-01,4,6,4,6,10
PUERTO GONZALO MORENO,consulta externa,repetidas en personas de 15 a 59 anos,2005-06-01,6,4,6,4,10
PUERTO PEREZ,consulta externa,repetidas en personas de 15 a 59 anos,2005-06-01,2,1,2,1,3
PUERTO QUIJARRO,consulta externa,repetidas en personas de 15 a 59 anos,2005-06-01,41,63,41,63,104
PUERTO RICO,consulta externa,repetidas en personas de 15 a 59 anos,2005-06-01,41,84,41,84,125
PUERTO SUAREZ,consulta externa,repetidas en personas de 15 a 59 anos,2005-06-01,15,48,15,48,63
PUERTO VILLARROEL,consulta externa,repetidas en personas de 15 a 59 anos,2005-06-01,34,53,34,53,87
PUNA,consulta externa,repetidas en personas de 15 a 59 anos,2005-06-01,10,14,10,14,24
PUNATA,consulta externa,repetidas en personas de 15 a 59 anos,2005-06-01,180,267,180,267,447
QUIABAYA,consulta externa,repetidas en personas de 15 a 59 anos,2005-06-01,0,3,0,3,3
QUILLACOLLO,consulta externa,repetidas en personas de 15 a 59 anos,2005-06-01,201,799,201,799,1000
QUIME,consulta externa,repetidas en personas de 15 a 59 anos,2005-06-01,3,4,3,4,7
RAVELO,consulta externa,repetidas en personas de 15 a 59 anos,2005-06-01,1,5,1,5,6
REYES,consulta externa,repetidas en personas de 15 a 59 anos,2005-06-01,11,36,11,36,47
RIBERALTA,consulta externa,repetidas en personas de 15 a 59 anos,2005-06-01,42,328,42,328,370
ROBORE,consulta externa,repetidas en personas de 15 a 59 anos,2005-06-01,19,53,19,53,72
RURRENABAQUE,consulta externa,repetidas en personas de 15 a 59 anos,2005-06-01,22,69,22,69,91
SABAYA,consulta externa,repetidas en personas de 15 a 59 anos,2005-06-01,2,0,2,0,2
SACABA,consulta externa,repetidas en personas de 15 a 59 anos,2005-06-01,157,258,157,258,415
SACABAMBA,consulta externa,repetidas en personas de 15 a 59 anos,2005-06-01,4,3,4,3,7
SACACA,consulta externa,repetidas en personas de 15 a 59 anos,2005-06-01,4,0,4,0,4
SAIPINA,consulta externa,repetidas en personas de 15 a 59 anos,2005-06-01,14,33,14,33,47
SALINAS DE GARCI MENDOZA,consulta externa,repetidas en personas de 15 a 59 anos,2005-06-01,4,12,4,12,16
SAMAIPATA,consulta externa,repetidas en personas de 15 a 59 anos,2005-06-01,2,1,2,1,3
SAN AGUSTIN,consulta externa,repetidas en personas de 15 a 59 anos,2005-06-01,0,4,0,4,4
SAN ANDRES,consulta externa,repetidas en personas de 15 a 59 anos,2005-06-01,1,15,1,15,16
SAN ANDRES DE MACHACA,consulta externa,repetidas en personas de 15 a 59 anos,2005-06-01,0,4,0,4,4
SAN ANTONIO DE ESMORUCO,consulta externa,repetidas en personas de 15 a 59 anos,2005-06-01,1,7,1,7,8
SAN ANTONIO DE LOMERIO,consulta externa,repetidas en personas de 15 a 59 anos,2005-06-01,1,1,1,1,2
SAN BENITO,consulta externa,repetidas en personas de 15 a 59 anos,2005-06-01,5,8,5,8,13
SAN BORJA,consulta externa,repetidas en personas de 15 a 59 anos,2005-06-01,30,102,30,102,132
SAN BUENA VENTURA,consulta externa,repetidas en personas de 15 a 59 anos,2005-06-01,2,9,2,9,11
SAN CARLOS,consulta externa,repetidas en personas de 15 a 59 anos,2005-06-01,13,111,13,111,124
SAN IGNACIO,consulta externa,repetidas en personas de 15 a 59 anos,2005-06-01,26,95,26,95,121
SAN IGNACIO DE VELASCO,consulta externa,repetidas en personas de 15 a 59 anos,2005-06-01,52,153,52,153,205
SAN JAVIER(BNI),consulta externa,repetidas en personas de 15 a 59 anos,2005-06-01,2,4,2,4,6
SAN JAVIER(STC),consulta externa,repetidas en personas de 15 a 59 anos,2005-06-01,8,79,8,79,87
SAN JOAQUIN,consulta externa,repetidas en personas de 15 a 59 anos,2005-06-01,3,39,3,39,42
SAN JOSE DE CHIQUITOS,consulta externa,repetidas en personas de 15 a 59 anos,2005-06-01,8,16,8,16,24
SAN JUAN DE YAPACANI,consulta externa,repetidas en personas de 15 a 59 anos,2005-06-01,8,35,8,35,43
SAN JULIAN,consulta externa,repetidas en personas de 15 a 59 anos,2005-06-01,25,352,25,352,377
SAN LORENZO(PND),consulta externa,repetidas en personas de 15 a 59 anos,2005-06-01,1,7,1,7,8
SAN LORENZO(TJA),consulta externa,repetidas en personas de 15 a 59 anos,2005-06-01,14,27,14,27,41
SAN LUCAS,consulta externa,repetidas en personas de 15 a 59 anos,2005-06-01,25,31,25,31,56
SAN MATIAS,consulta externa,repetidas en personas de 15 a 59 anos,2005-06-01,3,65,3,65,68
SAN MIGUEL DE VELASCO,consulta externa,repetidas en personas de 15 a 59 anos,2005-06-01,22,73,22,73,95
SAN PABLO DE LIPEZ,consulta externa,repetidas en personas de 15 a 59 anos,2005-06-01,6,16,6,16,22
SAN PEDRO,consulta externa,repetidas en personas de 15 a 59 anos,2005-06-01,33,35,33,35,68
SAN PEDRO DE BUENA VISTA,consulta externa,repetidas en personas de 15 a 59 anos,2005-06-01,0,3,0,3,3
SAN PEDRO DE CURAHUARA,consulta externa,repetidas en personas de 15 a 59 anos,2005-06-01,2,2,2,2,4
SAN PEDRO DE QUEMES,consulta externa,repetidas en personas de 15 a 59 anos,2005-06-01,0,1,0,1,1
SAN PEDRO DE TIQUINA,consulta externa,repetidas en personas de 15 a 59 anos,2005-06-01,8,3,8,3,11
SAN RAFAEL,consulta externa,repetidas en personas de 15 a 59 anos,2005-06-01,3,12,3,12,15
SAN RAMON,consulta externa,repetidas en personas de 15 a 59 anos,2005-06-01,1,33,1,33,34
SAN RAMON,consulta externa,repetidas en personas de 15 a 59 anos,2005-06-01,9,100,9,100,109
SANTA ANA,consulta externa,repetidas en personas de 15 a 59 anos,2005-06-01,47,82,47,82,129
SANTA CRUZ DE LA SIERRA,consulta externa,repetidas en personas de 15 a 59 anos,2005-06-01,5257,15701,5257,15701,20958
SANTA ROSA,consulta externa,repetidas en personas de 15 a 59 anos,2005-06-01,4,10,4,10,14
SANTA ROSA DEL SARA,consulta externa,repetidas en personas de 15 a 59 anos,2005-06-01,8,14,8,14,22
SANTIAGO DE CALLAPA,consulta externa,repetidas en personas de 15 a 59 anos,2005-06-01,1,4,1,4,5
SANTIAGO DE HUARI,consulta externa,repetidas en personas de 15 a 59 anos,2005-06-01,13,13,13,13,26
SANTIAGO DE MACHACA,consulta externa,repetidas en personas de 15 a 59 anos,2005-06-01,0,2,0,2,2
SANTIVAÑES,consulta externa,repetidas en personas de 15 a 59 anos,2005-06-01,3,6,3,6,9
SAPAHAQUI,consulta externa,repetidas en personas de 15 a 59 anos,2005-06-01,5,2,5,2,7
SICA SICA (VILLA AROMA),consulta externa,repetidas en personas de 15 a 59 anos,2005-06-01,4,1,4,1,5
SICAYA,consulta externa,repetidas en personas de 15 a 59 anos,2005-06-01,0,2,0,2,2
SIPE SIPE,consulta externa,repetidas en personas de 15 a 59 anos,2005-06-01,14,113,14,113,127
SOPACHUY,consulta externa,repetidas en personas de 15 a 59 anos,2005-06-01,2,2,2,2,4
SORACACHI,consulta externa,repetidas en personas de 15 a 59 anos,2005-06-01,4,1,4,1,5
SORATA,consulta externa,repetidas en personas de 15 a 59 anos,2005-06-01,11,9,11,9,20
SUCRE,consulta externa,repetidas en personas de 15 a 59 anos,2005-06-01,2628,6063,2628,6063,8691
TACACHI,consulta externa,repetidas en personas de 15 a 59 anos,2005-06-01,6,32,6,32,38
TACACOMA,consulta externa,repetidas en personas de 15 a 59 anos,2005-06-01,4,13,4,13,17
TACOBAMBA,consulta externa,repetidas en personas de 15 a 59 anos,2005-06-01,1,1,1,1,2
TACOPAYA,consulta externa,repetidas en personas de 15 a 59 anos,2005-06-01,3,2,3,2,5
TAPACARI,consulta externa,repetidas en personas de 15 a 59 anos,2005-06-01,3,25,3,25,28
TARABUCO,consulta externa,repetidas en personas de 15 a 59 anos,2005-06-01,15,33,15,33,48
TARACO,consulta externa,repetidas en personas de 15 a 59 anos,2005-06-01,1,1,1,1,2
TARATA,consulta externa,repetidas en personas de 15 a 59 anos,2005-06-01,0,4,0,4,4
TARIJA,consulta externa,repetidas en personas de 15 a 59 anos,2005-06-01,1780,6388,1780,6388,8168
TARVITA,consulta externa,repetidas en personas de 15 a 59 anos,2005-06-01,3,7,3,7,10
TEOPONTE,consulta externa,repetidas en personas de 15 a 59 anos,2005-06-01,0,1,0,1,1
TIAWANACU,consulta externa,repetidas en personas de 15 a 59 anos,2005-06-01,3,3,3,3,6
TINGUIPAYA,consulta externa,repetidas en personas de 15 a 59 anos,2005-06-01,3,9,3,9,12
TIPUANI,consulta externa,repetidas en personas de 15 a 59 anos,2005-06-01,15,23,15,23,38
TIQUIPAYA,consulta externa,repetidas en personas de 15 a 59 anos,2005-06-01,11,168,11,168,179
TIRAQUE (CBBA),consulta externa,repetidas en personas de 15 a 59 anos,2005-06-01,52,240,52,240,292
TITO YUPANQUI (PARQUIPUJIO),consulta externa,repetidas en personas de 15 a 59 anos,2005-06-01,3,4,3,4,7
TOCO,consulta externa,repetidas en personas de 15 a 59 anos,2005-06-01,2,1,2,1,3
TODOS SANTOS,consulta externa,repetidas en personas de 15 a 59 anos,2005-06-01,3,0,3,0,3
TOLATA,consulta externa,repetidas en personas de 15 a 59 anos,2005-06-01,0,3,0,3,3
TOLEDO,consulta externa,repetidas en personas de 15 a 59 anos,2005-06-01,8,11,8,11,19
TOMAVE,consulta externa,repetidas en personas de 15 a 59 anos,2005-06-01,8,10,8,10,18
TOMINA,consulta externa,repetidas en personas de 15 a 59 anos,2005-06-01,1,8,1,8,9
TORO TORO,consulta externa,repetidas en personas de 15 a 59 anos,2005-06-01,1,3,1,3,4
TOTORA(CBBA),consulta externa,repetidas en personas de 15 a 59 anos,2005-06-01,5,5,5,5,10
TRIGAL,consulta externa,repetidas en personas de 15 a 59 anos,2005-06-01,3,0,3,0,3
TRINIDAD,consulta externa,repetidas en personas de 15 a 59 anos,2005-06-01,272,730,272,730,1002
TUPIZA,consulta externa,repetidas en personas de 15 a 59 anos,2005-06-01,149,237,149,237,386
UNCIA,consulta externa,repetidas en personas de 15 a 59 anos,2005-06-01,78,201,78,201,279
URIONDO (A. CONCEPCION),consulta externa,repetidas en personas de 15 a 59 anos,2005-06-01,10,26,10,26,36
URUBICHA,consulta externa,repetidas en personas de 15 a 59 anos,2005-06-01,0,130,0,130,130
UYUNI,consulta externa,repetidas en personas de 15 a 59 anos,2005-06-01,27,136,27,136,163
VACAS,consulta externa,repetidas en personas de 15 a 59 anos,2005-06-01,22,78,22,78,100
VALLEGRANDE,consulta externa,repetidas en personas de 15 a 59 anos,2005-06-01,84,177,84,177,261
VIACHA,consulta externa,repetidas en personas de 15 a 59 anos,2005-06-01,81,186,81,186,267
VILA VILA,consulta externa,repetidas en personas de 15 a 59 anos,2005-06-01,2,1,2,1,3
VILLA MONTES,consulta externa,repetidas en personas de 15 a 59 anos,2005-06-01,72,132,72,132,204
VILLA RIVERO,consulta externa,repetidas en personas de 15 a 59 anos,2005-06-01,8,24,8,24,32
VILLA SERRANO,consulta externa,repetidas en personas de 15 a 59 anos,2005-06-01,7,6,7,6,13
VILLA TUNARI,consulta externa,repetidas en personas de 15 a 59 anos,2005-06-01,49,67,49,67,116
VILLA VACA GUZMAN (MUYUPAMPA),consulta externa,repetidas en personas de 15 a 59 anos,2005-06-01,22,95,22,95,117
VILLAZON,consulta externa,repetidas en personas de 15 a 59 anos,2005-06-01,42,148,42,148,190
VINTO,consulta externa,repetidas en personas de 15 a 59 anos,2005-06-01,25,63,25,63,88
VITICHI,consulta externa,repetidas en personas de 15 a 59 anos,2005-06-01,14,17,14,17,31
WALDO BALLIVIAN,consulta externa,repetidas en personas de 15 a 59 anos,2005-06-01,5,0,5,0,5
WARNES,consulta externa,repetidas en personas de 15 a 59 anos,2005-06-01,16,109,16,109,125
YACO,consulta externa,repetidas en personas de 15 a 59 anos,2005-06-01,2,5,2,5,7
YACUIBA,consulta externa,repetidas en personas de 15 a 59 anos,2005-06-01,363,1167,363,1167,1530
YAMPARAEZ,consulta externa,repetidas en personas de 15 a 59 anos,2005-06-01,11,17,11,17,28
YANACACHI,consulta externa,repetidas en personas de 15 a 59 anos,2005-06-01,8,4,8,4,12
YAPACANI,consulta externa,repetidas en personas de 15 a 59 anos,2005-06-01,18,255,18,255,273
YOCALLA,consulta externa,repetidas en personas de 15 a 59 anos,2005-06-01,1,1,1,1,2
YOTALA,consulta externa,repetidas en personas de 15 a 59 anos,2005-06-01,18,57,18,57,75
YUNCHARA,consulta externa,repetidas en personas de 15 a 59 anos,2005-06-01,2,1,2,1,3
ZUDAÑEZ,consulta externa,repetidas en personas de 15 a 59 anos,2005-06-01,4,3,4,3,7
ACACIO,consulta externa,repetidas en personas de 15 a 59 anos,2005-07-01,3,2,3,2,5
ACHACACHI,consulta externa,repetidas en personas de 15 a 59 anos,2005-07-01,47,54,47,54,101
ACHOCALLA,consulta externa,repetidas en personas de 15 a 59 anos,2005-07-01,6,4,6,4,10
AIQUILE,consulta externa,repetidas en personas de 15 a 59 anos,2005-07-01,42,229,42,229,271
ALALAY,consulta externa,repetidas en personas de 15 a 59 anos,2005-07-01,2,3,2,3,5
ANCORAIMES,consulta externa,repetidas en personas de 15 a 59 anos,2005-07-01,11,12,11,12,23
ANDAMARCA,consulta externa,repetidas en personas de 15 a 59 anos,2005-07-01,1,5,1,5,6
ANTEQUERA,consulta externa,repetidas en personas de 15 a 59 anos,2005-07-01,0,3,0,3,3
ANZALDO,consulta externa,repetidas en personas de 15 a 59 anos,2005-07-01,4,16,4,16,20
APOLO,consulta externa,repetidas en personas de 15 a 59 anos,2005-07-01,8,8,8,8,16
ARAMPAMPA,consulta externa,repetidas en personas de 15 a 59 anos,2005-07-01,1,1,1,1,2
ARANI,consulta externa,repetidas en personas de 15 a 59 anos,2005-07-01,6,18,6,18,24
ARBIETO,consulta externa,repetidas en personas de 15 a 59 anos,2005-07-01,2,13,2,13,15
ARQUE,consulta externa,repetidas en personas de 15 a 59 anos,2005-07-01,4,1,4,1,5
ASCENCION DE GUARAYOS,consulta externa,repetidas en personas de 15 a 59 anos,2005-07-01,1,0,1,0,1
ATOCHA,consulta externa,repetidas en personas de 15 a 59 anos,2005-07-01,244,230,244,230,474
AUCAPATA,consulta externa,repetidas en personas de 15 a 59 anos,2005-07-01,4,6,4,6,10
AYATA,consulta externa,repetidas en personas de 15 a 59 anos,2005-07-01,11,8,11,8,19
AYO AYO,consulta externa,repetidas en personas de 15 a 59 anos,2005-07-01,3,15,3,15,18
AYOPAYA (V. DE INDEPENDENCIA),consulta externa,repetidas en personas de 15 a 59 anos,2005-07-01,4,8,4,8,12
AZURDUY,consulta externa,repetidas en personas de 15 a 59 anos,2005-07-01,2,0,2,0,2
BATALLAS,consulta externa,repetidas en personas de 15 a 59 anos,2005-07-01,7,20,7,20,27
BAURES,consulta externa,repetidas en personas de 15 a 59 anos,2005-07-01,11,12,11,12,23
BELEN DE ANDAMARCA,consulta externa,repetidas en personas de 15 a 59 anos,2005-07-01,1,0,1,0,1
BELEN DE URMIRI,consulta externa,repetidas en personas de 15 a 59 anos,2005-07-01,2,2,2,2,4
BELLA FLOR,consulta externa,repetidas en personas de 15 a 59 anos,2005-07-01,2,2,2,2,4
BERMEJO,consulta externa,repetidas en personas de 15 a 59 anos,2005-07-01,96,127,96,127,223
BETANZOS,consulta externa,repetidas en personas de 15 a 59 anos,2005-07-01,33,68,33,68,101
BOLIVAR,consulta externa,repetidas en personas de 15 a 59 anos,2005-07-01,0,5,0,5,5
BOLPEBRA,consulta externa,repetidas en personas de 15 a 59 anos,2005-07-01,2,0,2,0,2
BOYUIBE,consulta externa,repetidas en personas de 15 a 59 anos,2005-07-01,4,24,4,24,28
BUENA VISTA,consulta externa,repetidas en personas de 15 a 59 anos,2005-07-01,27,70,27,70,97
CABEZAS,consulta externa,repetidas en personas de 15 a 59 anos,2005-07-01,1,2,1,2,3
CAIROMA,consulta externa,repetidas en personas de 15 a 59 anos,2005-07-01,4,3,4,3,7
"CAIZA ""D""",consulta externa,repetidas en personas de 15 a 59 anos,2005-07-01,3,8,3,8,11
CAJUATA,consulta externa,repetidas en personas de 15 a 59 anos,2005-07-01,1,1,1,1,2
CALACOTO,consulta externa,repetidas en personas de 15 a 59 anos,2005-07-01,1,0,1,0,1
CALAMARCA,consulta externa,repetidas en personas de 15 a 59 anos,2005-07-01,10,15,10,15,25
CAMARGO,consulta externa,repetidas en personas de 15 a 59 anos,2005-07-01,5,31,5,31,36
CAMATAQUI (C. VILLA ABECIA),consulta externa,repetidas en personas de 15 a 59 anos,2005-07-01,2,2,2,2,4
CAMIRI,consulta externa,repetidas en personas de 15 a 59 anos,2005-07-01,83,210,83,210,293
CAPINOTA,consulta externa,repetidas en personas de 15 a 59 anos,2005-07-01,34,48,34,48,82
CAQUIAVIRI,consulta externa,repetidas en personas de 15 a 59 anos,2005-07-01,3,2,3,2,5
CARACOLLO,consulta externa,repetidas en personas de 15 a 59 anos,2005-07-01,6,13,6,13,19
CARANAVI,consulta externa,repetidas en personas de 15 a 59 anos,2005-07-01,30,74,30,74,104
CARAPARI,consulta externa,repetidas en personas de 15 a 59 anos,2005-07-01,4,4,4,4,8
CARIPUYO,consulta externa,repetidas en personas de 15 a 59 anos,2005-07-01,2,1,2,1,3
CARMEN RIVERO TORREZ,consulta externa,repetidas en personas de 15 a 59 anos,2005-07-01,0,2,0,2,2
CHACARILLA,consulta externa,repetidas en personas de 15 a 59 anos,2005-07-01,0,1,0,1,1
CHALLAPATA,consulta externa,repetidas en personas de 15 a 59 anos,2005-07-01,8,10,8,10,18
CHAQUI,consulta externa,repetidas en personas de 15 a 59 anos,2005-07-01,1,1,1,1,2
CHARAGUA,consulta externa,repetidas en personas de 15 a 59 anos,2005-07-01,20,52,20,52,72
CHARAÑA,consulta externa,repetidas en personas de 15 a 59 anos,2005-07-01,3,5,3,5,8
CHAYANTA,consulta externa,repetidas en personas de 15 a 59 anos,2005-07-01,4,10,4,10,14
CHIMORE,consulta externa,repetidas en personas de 15 a 59 anos,2005-07-01,18,30,18,30,48
CHOQUE COTA,consulta externa,repetidas en personas de 15 a 59 anos,2005-07-01,3,5,3,5,8
CHULUMANI (V. DE LA LIBERTAD),consulta externa,repetidas en personas de 15 a 59 anos,2005-07-01,96,84,96,84,180
CHUMA,consulta externa,repetidas en personas de 15 a 59 anos,2005-07-01,12,26,12,26,38
CLIZA,consulta externa,repetidas en personas de 15 a 59 anos,2005-07-01,2,8,2,8,10
COBIJA,consulta externa,repetidas en personas de 15 a 59 anos,2005-07-01,93,366,93,366,459
COCHABAMBA,consulta externa,repetidas en personas de 15 a 59 anos,2005-07-01,7737,18225,7737,18225,25962
COLCAPIRHUA,consulta externa,repetidas en personas de 15 a 59 anos,2005-07-01,103,278,103,278,381
"COLCHA ""K""",consulta externa,repetidas en personas de 15 a 59 anos,2005-07-01,12,13,12,13,25
COLLANA,consulta externa,repetidas en personas de 15 a 59 anos,2005-07-01,6,3,6,3,9
COLOMI,consulta externa,repetidas en personas de 15 a 59 anos,2005-07-01,5,9,5,9,14
COLPA BELGICA,consulta externa,repetidas en personas de 15 a 59 anos,2005-07-01,12,33,12,33,45
COLQUECHACA,consulta externa,repetidas en personas de 15 a 59 anos,2005-07-01,5,14,5,14,19
COLQUENCHA,consulta externa,repetidas en personas de 15 a 59 anos,2005-07-01,0,3,0,3,3
COLQUIRI,consulta externa,repetidas en personas de 15 a 59 anos,2005-07-01,10,15,10,15,25
COMANCHE,consulta externa,repetidas en personas de 15 a 59 anos,2005-07-01,4,1,4,1,5
COMARAPA,consulta externa,repetidas en personas de 15 a 59 anos,2005-07-01,21,36,21,36,57
CONCEPCION,consulta externa,repetidas en personas de 15 a 59 anos,2005-07-01,0,1,0,1,1
COPACABANA,consulta externa,repetidas en personas de 15 a 59 anos,2005-07-01,5,3,5,3,8
CORIPATA,consulta externa,repetidas en personas de 15 a 59 anos,2005-07-01,3,2,3,2,5
CORO CORO,consulta externa,repetidas en personas de 15 a 59 anos,2005-07-01,5,7,5,7,12
COROICO,consulta externa,repetidas en personas de 15 a 59 anos,2005-07-01,10,17,10,17,27
CORQUE,consulta externa,repetidas en personas de 15 a 59 anos,2005-07-01,33,32,33,32,65
COTAGAITA,consulta externa,repetidas en personas de 15 a 59 anos,2005-07-01,86,77,86,77,163
COTOCA,consulta externa,repetidas en personas de 15 a 59 anos,2005-07-01,6,10,6,10,16
CUATRO CAÑADAS,consulta externa,repetidas en personas de 15 a 59 anos,2005-07-01,17,107,17,107,124
CUCHUMUELA (V. G. VILLARROEL),consulta externa,repetidas en personas de 15 a 59 anos,2005-07-01,0,1,0,1,1
CUEVO,consulta externa,repetidas en personas de 15 a 59 anos,2005-07-01,5,3,5,3,8
CULPINA,consulta externa,repetidas en personas de 15 a 59 anos,2005-07-01,3,11,3,11,14
CURAHUARA DE CARANGAS,consulta externa,repetidas en personas de 15 a 59 anos,2005-07-01,0,1,0,1,1
DESAGUADERO,consulta externa,repetidas en personas de 15 a 59 anos,2005-07-01,2,1,2,1,3
EL ALTO,consulta externa,repetidas en personas de 15 a 59 anos,2005-07-01,2513,4956,2513,4956,7469
EL CHORO,consulta externa,repetidas en personas de 15 a 59 anos,2005-07-01,1,0,1,0,1
EL PUENTE(STC),consulta externa,repetidas en personas de 15 a 59 anos,2005-07-01,2,26,2,26,28
EL PUENTE(TJA),consulta externa,repetidas en personas de 15 a 59 anos,2005-07-01,3,5,3,5,8
EL TORNO,consulta externa,repetidas en personas de 15 a 59 anos,2005-07-01,119,206,119,206,325
EL VILLAR,consulta externa,repetidas en personas de 15 a 59 anos,2005-07-01,3,6,3,6,9
ENTRE RIOS,consulta externa,repetidas en personas de 15 a 59 anos,2005-07-01,11,10,11,10,21
ENTRE RIOS,consulta externa,repetidas en personas de 15 a 59 anos,2005-07-01,18,36,18,36,54
EUCALIPTUS,consulta externa,repetidas en personas de 15 a 59 anos,2005-07-01,4,3,4,3,7
EXALTACION,consulta externa,repetidas en personas de 15 a 59 anos,2005-07-01,5,11,5,11,16
FERNANDEZ ALONSO,consulta externa,repetidas en personas de 15 a 59 anos,2005-07-01,14,32,14,32,46
GENERAL SAAVEDRA,consulta externa,repetidas en personas de 15 a 59 anos,2005-07-01,8,26,8,26,34
GRAL. J.J. PEREZ (CHARAZANI),consulta externa,repetidas en personas de 15 a 59 anos,2005-07-01,1,4,1,4,5
GUANAY,consulta externa,repetidas en personas de 15 a 59 anos,2005-07-01,2,0,2,0,2
GUAQUI,consulta externa,repetidas en personas de 15 a 59 anos,2005-07-01,5,1,5,1,6
GUAYARAMERIN,consulta externa,repetidas en personas de 15 a 59 anos,2005-07-01,346,265,346,265,611
GUTIERREZ,consulta externa,repetidas en personas de 15 a 59 anos,2005-07-01,12,12,12,12,24
HUACARETA,consulta externa,repetidas en personas de 15 a 59 anos,2005-07-01,13,32,13,32,45
HUACHACALLA,consulta externa,repetidas en personas de 15 a 59 anos,2005-07-01,2,0,2,0,2
HUANUNI,consulta externa,repetidas en personas de 15 a 59 anos,2005-07-01,114,119,114,119,233
HUARACAJE,consulta externa,repetidas en personas de 15 a 59 anos,2005-07-01,1,2,1,2,3
HUAYLLAMARCA,consulta externa,repetidas en personas de 15 a 59 anos,2005-07-01,3,17,3,17,20
ICLA,consulta externa,repetidas en personas de 15 a 59 anos,2005-07-01,9,10,9,10,19
INCAHUASI,consulta externa,repetidas en personas de 15 a 59 anos,2005-07-01,3,18,3,18,21
INGAVI (HUMAITA),consulta externa,repetidas en personas de 15 a 59 anos,2005-07-01,3,0,3,0,3
INQUISIVI,consulta externa,repetidas en personas de 15 a 59 anos,2005-07-01,5,2,5,2,7
IRUPANA (VILLA DE LANZA),consulta externa,repetidas en personas de 15 a 59 anos,2005-07-01,15,26,15,26,41
IXIAMAS,consulta externa,repetidas en personas de 15 a 59 anos,2005-07-01,9,12,9,12,21
JESUS DE MACHACA,consulta externa,repetidas en personas de 15 a 59 anos,2005-07-01,5,12,5,12,17
LA ASUNTA,consulta externa,repetidas en personas de 15 a 59 anos,2005-07-01,6,7,6,7,13
LA GUARDIA,consulta externa,repetidas en personas de 15 a 59 anos,2005-07-01,19,110,19,110,129
LA PAZ,consulta externa,repetidas en personas de 15 a 59 anos,2005-07-01,11370,27963,11370,27963,39333
LAGUNILLAS,consulta externa,repetidas en personas de 15 a 59 anos,2005-07-01,8,19,8,19,27
LAJA,consulta externa,repetidas en personas de 15 a 59 anos,2005-07-01,5,7,5,7,12
LAS CARRERAS,consulta externa,repetidas en personas de 15 a 59 anos,2005-07-01,7,15,7,15,22
LLALLAGUA,consulta externa,repetidas en personas de 15 a 59 anos,2005-07-01,64,111,64,111,175
LLICA,consulta externa,repetidas en personas de 15 a 59 anos,2005-07-01,4,0,4,0,4
LORETO,consulta externa,repetidas en personas de 15 a 59 anos,2005-07-01,4,24,4,24,28
LURIBAY,consulta externa,repetidas en personas de 15 a 59 anos,2005-07-01,3,4,3,4,7
MACHACAMARCA,consulta externa,repetidas en personas de 15 a 59 anos,2005-07-01,14,30,14,30,44
MACHARETI,consulta externa,repetidas en personas de 15 a 59 anos,2005-07-01,10,79,10,79,89
MAGDALENA,consulta externa,repetidas en personas de 15 a 59 anos,2005-07-01,28,92,28,92,120
MAIRANA,consulta externa,repetidas en personas de 15 a 59 anos,2005-07-01,0,5,0,5,5
MALLA,consulta externa,repetidas en personas de 15 a 59 anos,2005-07-01,0,2,0,2,2
MAPIRI,consulta externa,repetidas en personas de 15 a 59 anos,2005-07-01,1,2,1,2,3
MECAPACA,consulta externa,repetidas en personas de 15 a 59 anos,2005-07-01,33,29,33,29,62
MINEROS,consulta externa,repetidas en personas de 15 a 59 anos,2005-07-01,7,40,7,40,47
MIZQUE,consulta externa,repetidas en personas de 15 a 59 anos,2005-07-01,6,19,6,19,25
MOCOMOCO,consulta externa,repetidas en personas de 15 a 59 anos,2005-07-01,4,6,4,6,10
MOJINETE,consulta externa,repetidas en personas de 15 a 59 anos,2005-07-01,8,4,8,4,12
MOJOCOYA,consulta externa,repetidas en personas de 15 a 59 anos,2005-07-01,12,9,12,9,21
MONTEAGUDO,consulta externa,repetidas en personas de 15 a 59 anos,2005-07-01,73,349,73,349,422
MONTERO,consulta externa,repetidas en personas de 15 a 59 anos,2005-07-01,725,1730,725,1730,2455
MORO MORO,consulta externa,repetidas en personas de 15 a 59 anos,2005-07-01,3,0,3,0,3
MOROCHATA,consulta externa,repetidas en personas de 15 a 59 anos,2005-07-01,4,29,4,29,33
NACEBE (SANTA ROSA DEL ABUNA),consulta externa,repetidas en personas de 15 a 59 anos,2005-07-01,1,0,1,0,1
NUEVO MANOA (NUEVA ESPERANZA),consulta externa,repetidas en personas de 15 a 59 anos,2005-07-01,0,1,0,1,1
OCURI,consulta externa,repetidas en personas de 15 a 59 anos,2005-07-01,0,2,0,2,2
OKINAWA,consulta externa,repetidas en personas de 15 a 59 anos,2005-07-01,13,37,13,37,50
OMEREQUE,consulta externa,repetidas en personas de 15 a 59 anos,2005-07-01,5,7,5,7,12
ORURO,consulta externa,repetidas en personas de 15 a 59 anos,2005-07-01,1554,3968,1554,3968,5522
PADCAYA,consulta externa,repetidas en personas de 15 a 59 anos,2005-07-01,2,13,2,13,15
PADILLA,consulta externa,repetidas en personas de 15 a 59 anos,2005-07-01,15,15,15,15,30
PAILON,consulta externa,repetidas en personas de 15 a 59 anos,2005-07-01,6,7,6,7,13
PALCA,consulta externa,repetidas en personas de 15 a 59 anos,2005-07-01,8,10,8,10,18
PALOS BLANCOS,consulta externa,repetidas en personas de 15 a 59 anos,2005-07-01,42,47,42,47,89
PAMPA AULLAGAS,consulta externa,repetidas en personas de 15 a 59 anos,2005-07-01,1,6,1,6,7
PAMPA GRANDE,consulta externa,repetidas en personas de 15 a 59 anos,2005-07-01,13,11,13,11,24
PAPEL PAMPA,consulta externa,repetidas en personas de 15 a 59 anos,2005-07-01,6,0,6,0,6
PATACAMAYA,consulta externa,repetidas en personas de 15 a 59 anos,2005-07-01,3,0,3,0,3
PAZÑA,consulta externa,repetidas en personas de 15 a 59 anos,2005-07-01,14,21,14,21,35
PELECHUCO,consulta externa,repetidas en personas de 15 a 59 anos,2005-07-01,10,9,10,9,19
POCOATA,consulta externa,repetidas en personas de 15 a 59 anos,2005-07-01,10,7,10,7,17
POCONA,consulta externa,repetidas en personas de 15 a 59 anos,2005-07-01,2,1,2,1,3
POJO (CBBA),consulta externa,repetidas en personas de 15 a 59 anos,2005-07-01,3,8,3,8,11
POOPO,consulta externa,repetidas en personas de 15 a 59 anos,2005-07-01,6,6,6,6,12
PORCO,consulta externa,repetidas en personas de 15 a 59 anos,2005-07-01,1,6,1,6,7
POROMA,consulta externa,repetidas en personas de 15 a 59 anos,2005-07-01,3,5,3,5,8
PORONGO,consulta externa,repetidas en personas de 15 a 59 anos,2005-07-01,4,17,4,17,21
PORTACHUELO,consulta externa,repetidas en personas de 15 a 59 anos,2005-07-01,42,74,42,74,116
PORVENIR,consulta externa,repetidas en personas de 15 a 59 anos,2005-07-01,9,11,9,11,20
POSTRER VALLE,consulta externa,repetidas en personas de 15 a 59 anos,2005-07-01,6,8,6,8,14
POTOSI,consulta externa,repetidas en personas de 15 a 59 anos,2005-07-01,1707,3769,1707,3769,5476
PRESTO,consulta externa,repetidas en personas de 15 a 59 anos,2005-07-01,4,21,4,21,25
PUCARA,consulta externa,repetidas en personas de 15 a 59 anos,2005-07-01,1,5,1,5,6
PUCARANI,consulta externa,repetidas en personas de 15 a 59 anos,2005-07-01,4,8,4,8,12
PUERTO ACOSTA,consulta externa,repetidas en personas de 15 a 59 anos,2005-07-01,7,24,7,24,31
PUERTO CARABUCO,consulta externa,repetidas en personas de 15 a 59 anos,2005-07-01,1,8,1,8,9
PUERTO GONZALO MORENO,consulta externa,repetidas en personas de 15 a 59 anos,2005-07-01,3,6,3,6,9
PUERTO PEREZ,consulta externa,repetidas en personas de 15 a 59 anos,2005-07-01,0,6,0,6,6
PUERTO QUIJARRO,consulta externa,repetidas en personas de 15 a 59 anos,2005-07-01,32,67,32,67,99
PUERTO RICO,consulta externa,repetidas en personas de 15 a 59 anos,2005-07-01,2,3,2,3,5
PUERTO SILES,consulta externa,repetidas en personas de 15 a 59 anos,2005-07-01,0,5,0,5,5
PUERTO SUAREZ,consulta externa,repetidas en personas de 15 a 59 anos,2005-07-01,10,52,10,52,62
PUERTO VILLARROEL,consulta externa,repetidas en personas de 15 a 59 anos,2005-07-01,34,54,34,54,88
PUNA,consulta externa,repetidas en personas de 15 a 59 anos,2005-07-01,6,20,6,20,26
PUNATA,consulta externa,repetidas en personas de 15 a 59 anos,2005-07-01,116,259,116,259,375
QUIABAYA,consulta externa,repetidas en personas de 15 a 59 anos,2005-07-01,0,2,0,2,2
QUILLACOLLO,consulta externa,repetidas en personas de 15 a 59 anos,2005-07-01,264,836,264,836,1100
QUIME,consulta externa,repetidas en personas de 15 a 59 anos,2005-07-01,8,9,8,9,17
RAVELO,consulta externa,repetidas en personas de 15 a 59 anos,2005-07-01,1,1,1,1,2
REYES,consulta externa,repetidas en personas de 15 a 59 anos,2005-07-01,9,38,9,38,47
RIBERALTA,consulta externa,repetidas en personas de 15 a 59 anos,2005-07-01,45,391,45,391,436
ROBORE,consulta externa,repetidas en personas de 15 a 59 anos,2005-07-01,13,49,13,49,62
RURRENABAQUE,consulta externa,repetidas en personas de 15 a 59 anos,2005-07-01,34,123,34,123,157
SABAYA,consulta externa,repetidas en personas de 15 a 59 anos,2005-07-01,0,1,0,1,1
SACABA,consulta externa,repetidas en personas de 15 a 59 anos,2005-07-01,114,231,114,231,345
SACABAMBA,consulta externa,repetidas en personas de 15 a 59 anos,2005-07-01,4,4,4,4,8
SACACA,consulta externa,repetidas en personas de 15 a 59 anos,2005-07-01,1,3,1,3,4
SAIPINA,consulta externa,repetidas en personas de 15 a 59 anos,2005-07-01,24,37,24,37,61
SALINAS DE GARCI MENDOZA,consulta externa,repetidas en personas de 15 a 59 anos,2005-07-01,4,8,4,8,12
SAMAIPATA,consulta externa,repetidas en personas de 15 a 59 anos,2005-07-01,0,2,0,2,2
SAN ANDRES,consulta externa,repetidas en personas de 15 a 59 anos,2005-07-01,14,16,14,16,30
SAN ANDRES DE MACHACA,consulta externa,repetidas en personas de 15 a 59 anos,2005-07-01,0,3,0,3,3
SAN ANTONIO DE ESMORUCO,consulta externa,repetidas en personas de 15 a 59 anos,2005-07-01,4,5,4,5,9
SAN ANTONIO DE LOMERIO,consulta externa,repetidas en personas de 15 a 59 anos,2005-07-01,1,4,1,4,5
SAN BENITO,consulta externa,repetidas en personas de 15 a 59 anos,2005-07-01,15,19,15,19,34
SAN BORJA,consulta externa,repetidas en personas de 15 a 59 anos,2005-07-01,20,59,20,59,79
SAN BUENA VENTURA,consulta externa,repetidas en personas de 15 a 59 anos,2005-07-01,9,9,9,9,18
SAN CARLOS,consulta externa,repetidas en personas de 15 a 59 anos,2005-07-01,13,137,13,137,150
SAN IGNACIO,consulta externa,repetidas en personas de 15 a 59 anos,2005-07-01,23,74,23,74,97
SAN IGNACIO DE VELASCO,consulta externa,repetidas en personas de 15 a 59 anos,2005-07-01,48,93,48,93,141
SAN JAVIER(BNI),consulta externa,repetidas en personas de 15 a 59 anos,2005-07-01,7,4,7,4,11
SAN JAVIER(STC),consulta externa,repetidas en personas de 15 a 59 anos,2005-07-01,11,67,11,67,78
SAN JOAQUIN,consulta externa,repetidas en personas de 15 a 59 anos,2005-07-01,8,27,8,27,35
SAN JOSE DE CHIQUITOS,consulta externa,repetidas en personas de 15 a 59 anos,2005-07-01,4,11,4,11,15
SAN JUAN DE YAPACANI,consulta externa,repetidas en personas de 15 a 59 anos,2005-07-01,7,36,7,36,43
SAN JULIAN,consulta externa,repetidas en personas de 15 a 59 anos,2005-07-01,26,336,26,336,362
SAN LORENZO(PND),consulta externa,repetidas en personas de 15 a 59 anos,2005-07-01,6,16,6,16,22
SAN LORENZO(TJA),consulta externa,repetidas en personas de 15 a 59 anos,2005-07-01,11,35,11,35,46
SAN LUCAS,consulta externa,repetidas en personas de 15 a 59 anos,2005-07-01,11,33,11,33,44
SAN MATIAS,consulta externa,repetidas en personas de 15 a 59 anos,2005-07-01,0,37,0,37,37
SAN MIGUEL DE VELASCO,consulta externa,repetidas en personas de 15 a 59 anos,2005-07-01,36,88,36,88,124
SAN PABLO DE LIPEZ,consulta externa,repetidas en personas de 15 a 59 anos,2005-07-01,2,15,2,15,17
SAN PEDRO,consulta externa,repetidas en personas de 15 a 59 anos,2005-07-01,30,40,30,40,70
SAN PEDRO DE BUENA VISTA,consulta externa,repetidas en personas de 15 a 59 anos,2005-07-01,4,2,4,2,6
SAN PEDRO DE CURAHUARA,consulta externa,repetidas en personas de 15 a 59 anos,2005-07-01,1,2,1,2,3
SAN PEDRO DE QUEMES,consulta externa,repetidas en personas de 15 a 59 anos,2005-07-01,0,1,0,1,1
SAN PEDRO DE TIQUINA,consulta externa,repetidas en personas de 15 a 59 anos,2005-07-01,9,6,9,6,15
SAN PEDRO(PND),consulta externa,repetidas en personas de 15 a 59 anos,2005-07-01,1,0,1,0,1
SAN RAFAEL,consulta externa,repetidas en personas de 15 a 59 anos,2005-07-01,2,6,2,6,8
SAN RAMON,consulta externa,repetidas en personas de 15 a 59 anos,2005-07-01,2,54,2,54,56
SAN RAMON,consulta externa,repetidas en personas de 15 a 59 anos,2005-07-01,10,101,10,101,111
SANTA ANA,consulta externa,repetidas en personas de 15 a 59 anos,2005-07-01,30,59,30,59,89
SANTA CRUZ DE LA SIERRA,consulta externa,repetidas en personas de 15 a 59 anos,2005-07-01,5158,13145,5158,13145,18303
SANTA ROSA,consulta externa,repetidas en personas de 15 a 59 anos,2005-07-01,27,42,27,42,69
SANTA ROSA DEL SARA,consulta externa,repetidas en personas de 15 a 59 anos,2005-07-01,8,17,8,17,25
SANTIAGO DE HUARI,consulta externa,repetidas en personas de 15 a 59 anos,2005-07-01,26,16,26,16,42
SANTIAGO DE MACHACA,consulta externa,repetidas en personas de 15 a 59 anos,2005-07-01,0,1,0,1,1
SANTIVAÑES,consulta externa,repetidas en personas de 15 a 59 anos,2005-07-01,3,10,3,10,13
SANTUARIO DE QUILLACAS,consulta externa,repetidas en personas de 15 a 59 anos,2005-07-01,1,0,1,0,1
SAPAHAQUI,consulta externa,repetidas en personas de 15 a 59 anos,2005-07-01,3,9,3,9,12
SICA SICA (VILLA AROMA),consulta externa,repetidas en personas de 15 a 59 anos,2005-07-01,5,2,5,2,7
SICAYA,consulta externa,repetidas en personas de 15 a 59 anos,2005-07-01,1,1,1,1,2
SIPE SIPE,consulta externa,repetidas en personas de 15 a 59 anos,2005-07-01,12,129,12,129,141
SOPACHUY,consulta externa,repetidas en personas de 15 a 59 anos,2005-07-01,1,2,1,2,3
SORACACHI,consulta externa,repetidas en personas de 15 a 59 anos,2005-07-01,5,8,5,8,13
SORATA,consulta externa,repetidas en personas de 15 a 59 anos,2005-07-01,12,20,12,20,32
SUCRE,consulta externa,repetidas en personas de 15 a 59 anos,2005-07-01,2403,6170,2403,6170,8573
TACACHI,consulta externa,repetidas en personas de 15 a 59 anos,2005-07-01,8,31,8,31,39
TACACOMA,consulta externa,repetidas en personas de 15 a 59 anos,2005-07-01,1,5,1,5,6
TACOBAMBA,consulta externa,repetidas en personas de 15 a 59 anos,2005-07-01,0,3,0,3,3
TACOPAYA,consulta externa,repetidas en personas de 15 a 59 anos,2005-07-01,1,7,1,7,8
TAHUA,consulta externa,repetidas en personas de 15 a 59 anos,2005-07-01,0,1,0,1,1
TAPACARI,consulta externa,repetidas en personas de 15 a 59 anos,2005-07-01,8,20,8,20,28
TARABUCO,consulta externa,repetidas en personas de 15 a 59 anos,2005-07-01,29,39,29,39,68
TARACO,consulta externa,repetidas en personas de 15 a 59 anos,2005-07-01,0,1,0,1,1
TARATA,consulta externa,repetidas en personas de 15 a 59 anos,2005-07-01,3,9,3,9,12
TARIJA,consulta externa,repetidas en personas de 15 a 59 anos,2005-07-01,2363,4721,2363,4721,7084
TARVITA,consulta externa,repetidas en personas de 15 a 59 anos,2005-07-01,1,20,1,20,21
TEOPONTE,consulta externa,repetidas en personas de 15 a 59 anos,2005-07-01,2,3,2,3,5
TIAWANACU,consulta externa,repetidas en personas de 15 a 59 anos,2005-07-01,0,1,0,1,1
TINGUIPAYA,consulta externa,repetidas en personas de 15 a 59 anos,2005-07-01,4,4,4,4,8
TIPUANI,consulta externa,repetidas en personas de 15 a 59 anos,2005-07-01,7,8,7,8,15
TIQUIPAYA,consulta externa,repetidas en personas de 15 a 59 anos,2005-07-01,24,88,24,88,112
TIRAQUE (CBBA),consulta externa,repetidas en personas de 15 a 59 anos,2005-07-01,73,311,73,311,384
TITO YUPANQUI (PARQUIPUJIO),consulta externa,repetidas en personas de 15 a 59 anos,2005-07-01,1,9,1,9,10
TOCO,consulta externa,repetidas en personas de 15 a 59 anos,2005-07-01,2,7,2,7,9
TOLATA,consulta externa,repetidas en personas de 15 a 59 anos,2005-07-01,0,4,0,4,4
TOLEDO,consulta externa,repetidas en personas de 15 a 59 anos,2005-07-01,17,8,17,8,25
TOMAVE,consulta externa,repetidas en personas de 15 a 59 anos,2005-07-01,6,24,6,24,30
TOMINA,consulta externa,repetidas en personas de 15 a 59 anos,2005-07-01,4,5,4,5,9
TORO TORO,consulta externa,repetidas en personas de 15 a 59 anos,2005-07-01,3,10,3,10,13
TOTORA(CBBA),consulta externa,repetidas en personas de 15 a 59 anos,2005-07-01,5,6,5,6,11
TOTORA(ORR),consulta externa,repetidas en personas de 15 a 59 anos,2005-07-01,0,1,0,1,1
TRIGAL,consulta externa,repetidas en personas de 15 a 59 anos,2005-07-01,2,1,2,1,3
TRINIDAD,consulta externa,repetidas en personas de 15 a 59 anos,2005-07-01,288,725,288,725,1013
TUPIZA,consulta externa,repetidas en personas de 15 a 59 anos,2005-07-01,148,223,148,223,371
UNCIA,consulta externa,repetidas en personas de 15 a 59 anos,2005-07-01,126,193,126,193,319
URIONDO (A. CONCEPCION),consulta externa,repetidas en personas de 15 a 59 anos,2005-07-01,4,10,4,10,14
URUBICHA,consulta externa,repetidas en personas de 15 a 59 anos,2005-07-01,2,87,2,87,89
UYUNI,consulta externa,repetidas en personas de 15 a 59 anos,2005-07-01,72,172,72,172,244
VACAS,consulta externa,repetidas en personas de 15 a 59 anos,2005-07-01,24,48,24,48,72
VALLEGRANDE,consulta externa,repetidas en personas de 15 a 59 anos,2005-07-01,58,155,58,155,213
VIACHA,consulta externa,repetidas en personas de 15 a 59 anos,2005-07-01,96,221,96,221,317
VILA VILA,consulta externa,repetidas en personas de 15 a 59 anos,2005-07-01,1,1,1,1,2
VILLA MONTES,consulta externa,repetidas en personas de 15 a 59 anos,2005-07-01,89,144,89,144,233
VILLA RIVERO,consulta externa,repetidas en personas de 15 a 59 anos,2005-07-01,9,23,9,23,32
VILLA SERRANO,consulta externa,repetidas en personas de 15 a 59 anos,2005-07-01,5,9,5,9,14
VILLA TUNARI,consulta externa,repetidas en personas de 15 a 59 anos,2005-07-01,51,83,51,83,134
VILLA VACA GUZMAN (MUYUPAMPA),consulta externa,repetidas en personas de 15 a 59 anos,2005-07-01,5,46,5,46,51
VILLAZON,consulta externa,repetidas en personas de 15 a 59 anos,2005-07-01,28,135,28,135,163
VINTO,consulta externa,repetidas en personas de 15 a 59 anos,2005-07-01,14,12,14,12,26
VITICHI,consulta externa,repetidas en personas de 15 a 59 anos,2005-07-01,8,11,8,11,19
WALDO BALLIVIAN,consulta externa,repetidas en personas de 15 a 59 anos,2005-07-01,0,1,0,1,1
WARNES,consulta externa,repetidas en personas de 15 a 59 anos,2005-07-01,15,79,15,79,94
YACO,consulta externa,repetidas en personas de 15 a 59 anos,2005-07-01,1,3,1,3,4
YACUIBA,consulta externa,repetidas en personas de 15 a 59 anos,2005-07-01,379,923,379,923,1302
YAMPARAEZ,consulta externa,repetidas en personas de 15 a 59 anos,2005-07-01,8,26,8,26,34
YANACACHI,consulta externa,repetidas en personas de 15 a 59 anos,2005-07-01,3,3,3,3,6
YAPACANI,consulta externa,repetidas en personas de 15 a 59 anos,2005-07-01,16,326,16,326,342
YOCALLA,consulta externa,repetidas en personas de 15 a 59 anos,2005-07-01,4,9,4,9,13
YOTALA,consulta externa,repetidas en personas de 15 a 59 anos,2005-07-01,18,61,18,61,79
YUNCHARA,consulta externa,repetidas en personas de 15 a 59 anos,2005-07-01,2,5,2,5,7
ZUDAÑEZ,consulta externa,repetidas en personas de 15 a 59 anos,2005-07-01,8,5,8,5,13
ACACIO,consulta externa,repetidas en personas de 15 a 59 anos,2005-08-01,5,4,5,4,9
ACHACACHI,consulta externa,repetidas en personas de 15 a 59 anos,2005-08-01,53,50,53,50,103
ACHOCALLA,consulta externa,repetidas en personas de 15 a 59 anos,2005-08-01,4,4,4,4,8
AIQUILE,consulta externa,repetidas en personas de 15 a 59 anos,2005-08-01,27,153,27,153,180
ANCORAIMES,consulta externa,repetidas en personas de 15 a 59 anos,2005-08-01,8,14,8,14,22
ANDAMARCA,consulta externa,repetidas en personas de 15 a 59 anos,2005-08-01,1,0,1,0,1
ANTEQUERA,consulta externa,repetidas en personas de 15 a 59 anos,2005-08-01,1,1,1,1,2
ANZALDO,consulta externa,repetidas en personas de 15 a 59 anos,2005-08-01,4,12,4,12,16
APOLO,consulta externa,repetidas en personas de 15 a 59 anos,2005-08-01,6,4,6,4,10
ARANI,consulta externa,repetidas en personas de 15 a 59 anos,2005-08-01,10,14,10,14,24
ARBIETO,consulta externa,repetidas en personas de 15 a 59 anos,2005-08-01,6,31,6,31,37
ARQUE,consulta externa,repetidas en personas de 15 a 59 anos,2005-08-01,0,2,0,2,2
ASCENCION DE GUARAYOS,consulta externa,repetidas en personas de 15 a 59 anos,2005-08-01,4,7,4,7,11
ATOCHA,consulta externa,repetidas en personas de 15 a 59 anos,2005-08-01,304,282,304,282,586
AUCAPATA,consulta externa,repetidas en personas de 15 a 59 anos,2005-08-01,2,10,2,10,12
AYATA,consulta externa,repetidas en personas de 15 a 59 anos,2005-08-01,7,8,7,8,15
AYO AYO,consulta externa,repetidas en personas de 15 a 59 anos,2005-08-01,5,6,5,6,11
AYOPAYA (V. DE INDEPENDENCIA),consulta externa,repetidas en personas de 15 a 59 anos,2005-08-01,3,13,3,13,16
AZURDUY,consulta externa,repetidas en personas de 15 a 59 anos,2005-08-01,0,1,0,1,1
BATALLAS,consulta externa,repetidas en personas de 15 a 59 anos,2005-08-01,4,7,4,7,11
BAURES,consulta externa,repetidas en personas de 15 a 59 anos,2005-08-01,11,23,11,23,34
BELEN DE ANDAMARCA,consulta externa,repetidas en personas de 15 a 59 anos,2005-08-01,3,5,3,5,8
BELEN DE URMIRI,consulta externa,repetidas en personas de 15 a 59 anos,2005-08-01,6,12,6,12,18
BELLA FLOR,consulta externa,repetidas en personas de 15 a 59 anos,2005-08-01,2,0,2,0,2
BERMEJO,consulta externa,repetidas en personas de 15 a 59 anos,2005-08-01,107,152,107,152,259
BETANZOS,consulta externa,repetidas en personas de 15 a 59 anos,2005-08-01,15,48,15,48,63
BOLIVAR,consulta externa,repetidas en personas de 15 a 59 anos,2005-08-01,2,0,2,0,2
BOLPEBRA,consulta externa,repetidas en personas de 15 a 59 anos,2005-08-01,1,1,1,1,2
BOYUIBE,consulta externa,repetidas en personas de 15 a 59 anos,2005-08-01,5,13,5,13,18
BUENA VISTA,consulta externa,repetidas en personas de 15 a 59 anos,2005-08-01,24,65,24,65,89
CABEZAS,consulta externa,repetidas en personas de 15 a 59 anos,2005-08-01,2,5,2,5,7
CAIROMA,consulta externa,repetidas en personas de 15 a 59 anos,2005-08-01,6,1,6,1,7
"CAIZA ""D""",consulta externa,repetidas en personas de 15 a 59 anos,2005-08-01,6,11,6,11,17
CAJUATA,consulta externa,repetidas en personas de 15 a 59 anos,2005-08-01,2,0,2,0,2
CALAMARCA,consulta externa,repetidas en personas de 15 a 59 anos,2005-08-01,6,11,6,11,17
CAMARGO,consulta externa,repetidas en personas de 15 a 59 anos,2005-08-01,6,35,6,35,41
CAMATAQUI (C. VILLA ABECIA),consulta externa,repetidas en personas de 15 a 59 anos,2005-08-01,4,4,4,4,8
CAMIRI,consulta externa,repetidas en personas de 15 a 59 anos,2005-08-01,85,217,85,217,302
CAPINOTA,consulta externa,repetidas en personas de 15 a 59 anos,2005-08-01,22,57,22,57,79
CAQUIAVIRI,consulta externa,repetidas en personas de 15 a 59 anos,2005-08-01,9,7,9,7,16
CARACOLLO,consulta externa,repetidas en personas de 15 a 59 anos,2005-08-01,2,9,2,9,11
CARANAVI,consulta externa,repetidas en personas de 15 a 59 anos,2005-08-01,25,50,25,50,75
CARAPARI,consulta externa,repetidas en personas de 15 a 59 anos,2005-08-01,8,6,8,6,14
CARIPUYO,consulta externa,repetidas en personas de 15 a 59 anos,2005-08-01,8,2,8,2,10
CARMEN RIVERO TORREZ,consulta externa,repetidas en personas de 15 a 59 anos,2005-08-01,0,2,0,2,2
CATACORA,consulta externa,repetidas en personas de 15 a 59 anos,2005-08-01,0,1,0,1,1
CHALLAPATA,consulta externa,repetidas en personas de 15 a 59 anos,2005-08-01,50,65,50,65,115
CHAQUI,consulta externa,repetidas en personas de 15 a 59 anos,2005-08-01,4,1,4,1,5
CHARAGUA,consulta externa,repetidas en personas de 15 a 59 anos,2005-08-01,31,46,31,46,77
CHARAÑA,consulta externa,repetidas en personas de 15 a 59 anos,2005-08-01,6,1,6,1,7
CHAYANTA,consulta externa,repetidas en personas de 15 a 59 anos,2005-08-01,12,15,12,15,27
CHIMORE,consulta externa,repetidas en personas de 15 a 59 anos,2005-08-01,8,36,8,36,44
CHULUMANI (V. DE LA LIBERTAD),consulta externa,repetidas en personas de 15 a 59 anos,2005-08-01,85,68,85,68,153
CHUMA,consulta externa,repetidas en personas de 15 a 59 anos,2005-08-01,6,12,6,12,18
CLIZA,consulta externa,repetidas en personas de 15 a 59 anos,2005-08-01,3,10,3,10,13
COBIJA,consulta externa,repetidas en personas de 15 a 59 anos,2005-08-01,89,458,89,458,547
COCHABAMBA,consulta externa,repetidas en personas de 15 a 59 anos,2005-08-01,7940,19495,7940,19495,27435
COLCAPIRHUA,consulta externa,repetidas en personas de 15 a 59 anos,2005-08-01,122,326,122,326,448
"COLCHA ""K""",consulta externa,repetidas en personas de 15 a 59 anos,2005-08-01,12,25,12,25,37
COLLANA,consulta externa,repetidas en personas de 15 a 59 anos,2005-08-01,6,6,6,6,12
COLOMI,consulta externa,repetidas en personas de 15 a 59 anos,2005-08-01,4,16,4,16,20
COLPA BELGICA,consulta externa,repetidas en personas de 15 a 59 anos,2005-08-01,6,40,6,40,46
COLQUECHACA,consulta externa,repetidas en personas de 15 a 59 anos,2005-08-01,12,10,12,10,22
COLQUENCHA,consulta externa,repetidas en personas de 15 a 59 anos,2005-08-01,3,4,3,4,7
COLQUIRI,consulta externa,repetidas en personas de 15 a 59 anos,2005-08-01,6,16,6,16,22
COMANCHE,consulta externa,repetidas en personas de 15 a 59 anos,2005-08-01,0,2,0,2,2
COMARAPA,consulta externa,repetidas en personas de 15 a 59 anos,2005-08-01,36,58,36,58,94
COMBAYA,consulta externa,repetidas en personas de 15 a 59 anos,2005-08-01,0,9,0,9,9
COPACABANA,consulta externa,repetidas en personas de 15 a 59 anos,2005-08-01,3,0,3,0,3
CORIPATA,consulta externa,repetidas en personas de 15 a 59 anos,2005-08-01,3,5,3,5,8
CORO CORO,consulta externa,repetidas en personas de 15 a 59 anos,2005-08-01,7,11,7,11,18
COROICO,consulta externa,repetidas en personas de 15 a 59 anos,2005-08-01,61,225,61,225,286
CORQUE,consulta externa,repetidas en personas de 15 a 59 anos,2005-08-01,11,11,11,11,22
COTAGAITA,consulta externa,repetidas en personas de 15 a 59 anos,2005-08-01,64,49,64,49,113
COTOCA,consulta externa,repetidas en personas de 15 a 59 anos,2005-08-01,4,4,4,4,8
CUATRO CAÑADAS,consulta externa,repetidas en personas de 15 a 59 anos,2005-08-01,14,106,14,106,120
CUCHUMUELA (V. G. VILLARROEL),consulta externa,repetidas en personas de 15 a 59 anos,2005-08-01,2,0,2,0,2
CUEVO,consulta externa,repetidas en personas de 15 a 59 anos,2005-08-01,11,5,11,5,16
CULPINA,consulta externa,repetidas en personas de 15 a 59 anos,2005-08-01,11,18,11,18,29
CURAHUARA DE CARANGAS,consulta externa,repetidas en personas de 15 a 59 anos,2005-08-01,1,0,1,0,1
CURVA,consulta externa,repetidas en personas de 15 a 59 anos,2005-08-01,1,1,1,1,2
DESAGUADERO,consulta externa,repetidas en personas de 15 a 59 anos,2005-08-01,5,0,5,0,5
EL ALTO,consulta externa,repetidas en personas de 15 a 59 anos,2005-08-01,2902,5448,2902,5448,8350
EL CHORO,consulta externa,repetidas en personas de 15 a 59 anos,2005-08-01,1,7,1,7,8
EL PUENTE(STC),consulta externa,repetidas en personas de 15 a 59 anos,2005-08-01,3,3,3,3,6
EL PUENTE(TJA),consulta externa,repetidas en personas de 15 a 59 anos,2005-08-01,4,5,4,5,9
EL TORNO,consulta externa,repetidas en personas de 15 a 59 anos,2005-08-01,152,225,152,225,377
EL VILLAR,consulta externa,repetidas en personas de 15 a 59 anos,2005-08-01,2,11,2,11,13
ENTRE RIOS,consulta externa,repetidas en personas de 15 a 59 anos,2005-08-01,8,9,8,9,17
ENTRE RIOS,consulta externa,repetidas en personas de 15 a 59 anos,2005-08-01,19,23,19,23,42
EUCALIPTUS,consulta externa,repetidas en personas de 15 a 59 anos,2005-08-01,2,2,2,2,4
EUREKA (SANTOS MERCADO),consulta externa,repetidas en personas de 15 a 59 anos,2005-08-01,1,0,1,0,1
EXALTACION,consulta externa,repetidas en personas de 15 a 59 anos,2005-08-01,5,1,5,1,6
FERNANDEZ ALONSO,consulta externa,repetidas en personas de 15 a 59 anos,2005-08-01,10,16,10,16,26
GENERAL SAAVEDRA,consulta externa,repetidas en personas de 15 a 59 anos,2005-08-01,5,34,5,34,39
GRAL. J.J. PEREZ (CHARAZANI),consulta externa,repetidas en personas de 15 a 59 anos,2005-08-01,1,6,1,6,7
GUANAY,consulta externa,repetidas en personas de 15 a 59 anos,2005-08-01,1,1,1,1,2
GUAQUI,consulta externa,repetidas en personas de 15 a 59 anos,2005-08-01,1,3,1,3,4
GUAYARAMERIN,consulta externa,repetidas en personas de 15 a 59 anos,2005-08-01,234,295,234,295,529
GUTIERREZ,consulta externa,repetidas en personas de 15 a 59 anos,2005-08-01,38,93,38,93,131
HUACARETA,consulta externa,repetidas en personas de 15 a 59 anos,2005-08-01,28,25,28,25,53
HUACAYA (VILLA DE HUACAYA),consulta externa,repetidas en personas de 15 a 59 anos,2005-08-01,0,3,0,3,3
HUACHACALLA,consulta externa,repetidas en personas de 15 a 59 anos,2005-08-01,3,2,3,2,5
HUANUNI,consulta externa,repetidas en personas de 15 a 59 anos,2005-08-01,112,120,112,120,232
HUARACAJE,consulta externa,repetidas en personas de 15 a 59 anos,2005-08-01,5,10,5,10,15
ICHOCA,consulta externa,repetidas en personas de 15 a 59 anos,2005-08-01,3,2,3,2,5
ICLA,consulta externa,repetidas en personas de 15 a 59 anos,2005-08-01,4,4,4,4,8
INCAHUASI,consulta externa,repetidas en personas de 15 a 59 anos,2005-08-01,3,14,3,14,17
INGAVI (HUMAITA),consulta externa,repetidas en personas de 15 a 59 anos,2005-08-01,0,1,0,1,1
INQUISIVI,consulta externa,repetidas en personas de 15 a 59 anos,2005-08-01,5,3,5,3,8
IRUPANA (VILLA DE LANZA),consulta externa,repetidas en personas de 15 a 59 anos,2005-08-01,23,21,23,21,44
IXIAMAS,consulta externa,repetidas en personas de 15 a 59 anos,2005-08-01,16,9,16,9,25
JESUS DE MACHACA,consulta externa,repetidas en personas de 15 a 59 anos,2005-08-01,18,19,18,19,37
LA ASUNTA,consulta externa,repetidas en personas de 15 a 59 anos,2005-08-01,3,5,3,5,8
LA GUARDIA,consulta externa,repetidas en personas de 15 a 59 anos,2005-08-01,27,123,27,123,150
LA PAZ,consulta externa,repetidas en personas de 15 a 59 anos,2005-08-01,13160,30200,13160,30200,43360
LAGUNILLAS,consulta externa,repetidas en personas de 15 a 59 anos,2005-08-01,6,13,6,13,19
LAJA,consulta externa,repetidas en personas de 15 a 59 anos,2005-08-01,10,11,10,11,21
LAS CARRERAS,consulta externa,repetidas en personas de 15 a 59 anos,2005-08-01,6,8,6,8,14
LICOMA PAMPA,consulta externa,repetidas en personas de 15 a 59 anos,2005-08-01,1,0,1,0,1
LLALLAGUA,consulta externa,repetidas en personas de 15 a 59 anos,2005-08-01,78,138,78,138,216
LLICA,consulta externa,repetidas en personas de 15 a 59 anos,2005-08-01,2,8,2,8,10
LORETO,consulta externa,repetidas en personas de 15 a 59 anos,2005-08-01,6,10,6,10,16
LURIBAY,consulta externa,repetidas en personas de 15 a 59 anos,2005-08-01,0,7,0,7,7
MACHACAMARCA,consulta externa,repetidas en personas de 15 a 59 anos,2005-08-01,18,38,18,38,56
MACHARETI,consulta externa,repetidas en personas de 15 a 59 anos,2005-08-01,14,43,14,43,57
MAGDALENA,consulta externa,repetidas en personas de 15 a 59 anos,2005-08-01,27,89,27,89,116
MAIRANA,consulta externa,repetidas en personas de 15 a 59 anos,2005-08-01,1,4,1,4,5
MALLA,consulta externa,repetidas en personas de 15 a 59 anos,2005-08-01,2,3,2,3,5
MAPIRI,consulta externa,repetidas en personas de 15 a 59 anos,2005-08-01,0,2,0,2,2
MECAPACA,consulta externa,repetidas en personas de 15 a 59 anos,2005-08-01,27,29,27,29,56
MINEROS,consulta externa,repetidas en personas de 15 a 59 anos,2005-08-01,5,50,5,50,55
MIZQUE,consulta externa,repetidas en personas de 15 a 59 anos,2005-08-01,11,14,11,14,25
MOCOMOCO,consulta externa,repetidas en personas de 15 a 59 anos,2005-08-01,6,38,6,38,44
MOJINETE,consulta externa,repetidas en personas de 15 a 59 anos,2005-08-01,9,13,9,13,22
MOJOCOYA,consulta externa,repetidas en personas de 15 a 59 anos,2005-08-01,5,12,5,12,17
MONTEAGUDO,consulta externa,repetidas en personas de 15 a 59 anos,2005-08-01,75,363,75,363,438
MONTERO,consulta externa,repetidas en personas de 15 a 59 anos,2005-08-01,673,1716,673,1716,2389
MORO MORO,consulta externa,repetidas en personas de 15 a 59 anos,2005-08-01,1,2,1,2,3
MOROCHATA,consulta externa,repetidas en personas de 15 a 59 anos,2005-08-01,20,110,20,110,130
NACEBE (SANTA ROSA DEL ABUNA),consulta externa,repetidas en personas de 15 a 59 anos,2005-08-01,0,2,0,2,2
NAZACARA DE PACAJES,consulta externa,repetidas en personas de 15 a 59 anos,2005-08-01,1,0,1,0,1
NUEVO MANOA (NUEVA ESPERANZA),consulta externa,repetidas en personas de 15 a 59 anos,2005-08-01,0,4,0,4,4
OCURI,consulta externa,repetidas en personas de 15 a 59 anos,2005-08-01,1,14,1,14,15
OKINAWA,consulta externa,repetidas en personas de 15 a 59 anos,2005-08-01,7,19,7,19,26
OMEREQUE,consulta externa,repetidas en personas de 15 a 59 anos,2005-08-01,5,5,5,5,10
ORURO,consulta externa,repetidas en personas de 15 a 59 anos,2005-08-01,1674,4294,1674,4294,5968
PADCAYA,consulta externa,repetidas en personas de 15 a 59 anos,2005-08-01,9,28,9,28,37
PADILLA,consulta externa,repetidas en personas de 15 a 59 anos,2005-08-01,11,9,11,9,20
PAILON,consulta externa,repetidas en personas de 15 a 59 anos,2005-08-01,3,14,3,14,17
PALCA,consulta externa,repetidas en personas de 15 a 59 anos,2005-08-01,3,18,3,18,21
PALOS BLANCOS,consulta externa,repetidas en personas de 15 a 59 anos,2005-08-01,53,91,53,91,144
PAMPA AULLAGAS,consulta externa,repetidas en personas de 15 a 59 anos,2005-08-01,2,1,2,1,3
PAMPA GRANDE,consulta externa,repetidas en personas de 15 a 59 anos,2005-08-01,7,18,7,18,25
PAPEL PAMPA,consulta externa,repetidas en personas de 15 a 59 anos,2005-08-01,6,3,6,3,9
PASORAPA,consulta externa,repetidas en personas de 15 a 59 anos,2005-08-01,2,1,2,1,3
PATACAMAYA,consulta externa,repetidas en personas de 15 a 59 anos,2005-08-01,0,1,0,1,1
PAZÑA,consulta externa,repetidas en personas de 15 a 59 anos,2005-08-01,19,29,19,29,48
PELECHUCO,consulta externa,repetidas en personas de 15 a 59 anos,2005-08-01,4,1,4,1,5
POCOATA,consulta externa,repetidas en personas de 15 a 59 anos,2005-08-01,5,7,5,7,12
POCONA,consulta externa,repetidas en personas de 15 a 59 anos,2005-08-01,4,4,4,4,8
POJO (CBBA),consulta externa,repetidas en personas de 15 a 59 anos,2005-08-01,3,1,3,1,4
POOPO,consulta externa,repetidas en personas de 15 a 59 anos,2005-08-01,8,4,8,4,12
PORCO,consulta externa,repetidas en personas de 15 a 59 anos,2005-08-01,3,11,3,11,14
POROMA,consulta externa,repetidas en personas de 15 a 59 anos,2005-08-01,8,14,8,14,22
PORONGO,consulta externa,repetidas en personas de 15 a 59 anos,2005-08-01,1,10,1,10,11
PORTACHUELO,consulta externa,repetidas en personas de 15 a 59 anos,2005-08-01,21,39,21,39,60
PORVENIR,consulta externa,repetidas en personas de 15 a 59 anos,2005-08-01,6,3,6,3,9
POSTRER VALLE,consulta externa,repetidas en personas de 15 a 59 anos,2005-08-01,2,4,2,4,6
POTOSI,consulta externa,repetidas en personas de 15 a 59 anos,2005-08-01,1873,3919,1873,3919,5792
PRESTO,consulta externa,repetidas en personas de 15 a 59 anos,2005-08-01,2,1,2,1,3
PUCARANI,consulta externa,repetidas en personas de 15 a 59 anos,2005-08-01,9,6,9,6,15
PUERTO ACOSTA,consulta externa,repetidas en personas de 15 a 59 anos,2005-08-01,21,29,21,29,50
PUERTO CARABUCO,consulta externa,repetidas en personas de 15 a 59 anos,2005-08-01,5,7,5,7,12
PUERTO GONZALO MORENO,consulta externa,repetidas en personas de 15 a 59 anos,2005-08-01,4,5,4,5,9
PUERTO PEREZ,consulta externa,repetidas en personas de 15 a 59 anos,2005-08-01,8,3,8,3,11
PUERTO QUIJARRO,consulta externa,repetidas en personas de 15 a 59 anos,2005-08-01,30,87,30,87,117
PUERTO RICO,consulta externa,repetidas en personas de 15 a 59 anos,2005-08-01,9,4,9,4,13
PUERTO SUAREZ,consulta externa,repetidas en personas de 15 a 59 anos,2005-08-01,15,53,15,53,68
PUERTO VILLARROEL,consulta externa,repetidas en personas de 15 a 59 anos,2005-08-01,29,49,29,49,78
PUNA,consulta externa,repetidas en personas de 15 a 59 anos,2005-08-01,8,28,8,28,36
PUNATA,consulta externa,repetidas en personas de 15 a 59 anos,2005-08-01,107,289,107,289,396
QUIABAYA,consulta externa,repetidas en personas de 15 a 59 anos,2005-08-01,1,1,1,1,2
QUILLACOLLO,consulta externa,repetidas en personas de 15 a 59 anos,2005-08-01,207,750,207,750,957
QUIME,consulta externa,repetidas en personas de 15 a 59 anos,2005-08-01,12,5,12,5,17
RAVELO,consulta externa,repetidas en personas de 15 a 59 anos,2005-08-01,1,3,1,3,4
REYES,consulta externa,repetidas en personas de 15 a 59 anos,2005-08-01,14,62,14,62,76
RIBERALTA,consulta externa,repetidas en personas de 15 a 59 anos,2005-08-01,61,470,61,470,531
ROBORE,consulta externa,repetidas en personas de 15 a 59 anos,2005-08-01,32,66,32,66,98
RURRENABAQUE,consulta externa,repetidas en personas de 15 a 59 anos,2005-08-01,19,63,19,63,82
SABAYA,consulta externa,repetidas en personas de 15 a 59 anos,2005-08-01,0,2,0,2,2
SACABA,consulta externa,repetidas en personas de 15 a 59 anos,2005-08-01,140,275,140,275,415
SACABAMBA,consulta externa,repetidas en personas de 15 a 59 anos,2005-08-01,3,3,3,3,6
SACACA,consulta externa,repetidas en personas de 15 a 59 anos,2005-08-01,1,0,1,0,1
SAIPINA,consulta externa,repetidas en personas de 15 a 59 anos,2005-08-01,10,33,10,33,43
SALINAS DE GARCI MENDOZA,consulta externa,repetidas en personas de 15 a 59 anos,2005-08-01,3,7,3,7,10
SAMAIPATA,consulta externa,repetidas en personas de 15 a 59 anos,2005-08-01,1,5,1,5,6
SAN AGUSTIN,consulta externa,repetidas en personas de 15 a 59 anos,2005-08-01,3,2,3,2,5
SAN ANDRES,consulta externa,repetidas en personas de 15 a 59 anos,2005-08-01,16,16,16,16,32
SAN ANDRES DE MACHACA,consulta externa,repetidas en personas de 15 a 59 anos,2005-08-01,0,6,0,6,6
SAN ANTONIO DE ESMORUCO,consulta externa,repetidas en personas de 15 a 59 anos,2005-08-01,3,9,3,9,12
SAN ANTONIO DE LOMERIO,consulta externa,repetidas en personas de 15 a 59 anos,2005-08-01,10,6,10,6,16
SAN BENITO,consulta externa,repetidas en personas de 15 a 59 anos,2005-08-01,11,26,11,26,37
SAN BORJA,consulta externa,repetidas en personas de 15 a 59 anos,2005-08-01,16,90,16,90,106
SAN BUENA VENTURA,consulta externa,repetidas en personas de 15 a 59 anos,2005-08-01,9,12,9,12,21
SAN CARLOS,consulta externa,repetidas en personas de 15 a 59 anos,2005-08-01,11,129,11,129,140
SAN IGNACIO,consulta externa,repetidas en personas de 15 a 59 anos,2005-08-01,23,60,23,60,83
SAN IGNACIO DE VELASCO,consulta externa,repetidas en personas de 15 a 59 anos,2005-08-01,61,117,61,117,178
SAN JAVIER(BNI),consulta externa,repetidas en personas de 15 a 59 anos,2005-08-01,1,8,1,8,9
SAN JAVIER(STC),consulta externa,repetidas en personas de 15 a 59 anos,2005-08-01,4,54,4,54,58
SAN JOAQUIN,consulta externa,repetidas en personas de 15 a 59 anos,2005-08-01,8,20,8,20,28
SAN JOSE DE CHIQUITOS,consulta externa,repetidas en personas de 15 a 59 anos,2005-08-01,9,24,9,24,33
SAN JUAN DE YAPACANI,consulta externa,repetidas en personas de 15 a 59 anos,2005-08-01,9,37,9,37,46
SAN JULIAN,consulta externa,repetidas en personas de 15 a 59 anos,2005-08-01,51,379,51,379,430
SAN LORENZO(PND),consulta externa,repetidas en personas de 15 a 59 anos,2005-08-01,7,8,7,8,15
SAN LORENZO(TJA),consulta externa,repetidas en personas de 15 a 59 anos,2005-08-01,11,12,11,12,23
SAN LUCAS,consulta externa,repetidas en personas de 15 a 59 anos,2005-08-01,12,13,12,13,25
SAN MATIAS,consulta externa,repetidas en personas de 15 a 59 anos,2005-08-01,5,43,5,43,48
SAN MIGUEL DE VELASCO,consulta externa,repetidas en personas de 15 a 59 anos,2005-08-01,21,81,21,81,102
SAN PABLO DE LIPEZ,consulta externa,repetidas en personas de 15 a 59 anos,2005-08-01,5,11,5,11,16
SAN PEDRO,consulta externa,repetidas en personas de 15 a 59 anos,2005-08-01,32,42,32,42,74
SAN PEDRO DE BUENA VISTA,consulta externa,repetidas en personas de 15 a 59 anos,2005-08-01,2,1,2,1,3
SAN PEDRO DE CURAHUARA,consulta externa,repetidas en personas de 15 a 59 anos,2005-08-01,1,1,1,1,2
SAN PEDRO DE TIQUINA,consulta externa,repetidas en personas de 15 a 59 anos,2005-08-01,7,3,7,3,10
SAN PEDRO(PND),consulta externa,repetidas en personas de 15 a 59 anos,2005-08-01,2,7,2,7,9
SAN RAFAEL,consulta externa,repetidas en personas de 15 a 59 anos,2005-08-01,1,6,1,6,7
SAN RAMON,consulta externa,repetidas en personas de 15 a 59 anos,2005-08-01,14,88,14,88,102
SAN RAMON,consulta externa,repetidas en personas de 15 a 59 anos,2005-08-01,1,29,1,29,30
SANTA ANA,consulta externa,repetidas en personas de 15 a 59 anos,2005-08-01,41,68,41,68,109
SANTA CRUZ DE LA SIERRA,consulta externa,repetidas en personas de 15 a 59 anos,2005-08-01,7211,17354,7211,17354,24565
SANTA ROSA,consulta externa,repetidas en personas de 15 a 59 anos,2005-08-01,3,14,3,14,17
SANTA ROSA DEL SARA,consulta externa,repetidas en personas de 15 a 59 anos,2005-08-01,16,97,16,97,113
SANTIAGO DE HUARI,consulta externa,repetidas en personas de 15 a 59 anos,2005-08-01,18,15,18,15,33
SANTIAGO DE MACHACA,consulta externa,repetidas en personas de 15 a 59 anos,2005-08-01,2,0,2,0,2
SANTIVAÑES,consulta externa,repetidas en personas de 15 a 59 anos,2005-08-01,7,16,7,16,23
SAPAHAQUI,consulta externa,repetidas en personas de 15 a 59 anos,2005-08-01,2,4,2,4,6
SENA,consulta externa,repetidas en personas de 15 a 59 anos,2005-08-01,6,1,6,1,7
SICA SICA (VILLA AROMA),consulta externa,repetidas en personas de 15 a 59 anos,2005-08-01,2,9,2,9,11
SIPE SIPE,consulta externa,repetidas en personas de 15 a 59 anos,2005-08-01,18,265,18,265,283
SOPACHUY,consulta externa,repetidas en personas de 15 a 59 anos,2005-08-01,6,4,6,4,10
SORACACHI,consulta externa,repetidas en personas de 15 a 59 anos,2005-08-01,2,3,2,3,5
SORATA,consulta externa,repetidas en personas de 15 a 59 anos,2005-08-01,10,3,10,3,13
SUCRE,consulta externa,repetidas en personas de 15 a 59 anos,2005-08-01,2736,7172,2736,7172,9908
TACACHI,consulta externa,repetidas en personas de 15 a 59 anos,2005-08-01,9,35,9,35,44
TACACOMA,consulta externa,repetidas en personas de 15 a 59 anos,2005-08-01,0,4,0,4,4
TACOBAMBA,consulta externa,repetidas en personas de 15 a 59 anos,2005-08-01,0,1,0,1,1
TAHUA,consulta externa,repetidas en personas de 15 a 59 anos,2005-08-01,1,0,1,0,1
TAPACARI,consulta externa,repetidas en personas de 15 a 59 anos,2005-08-01,8,25,8,25,33
TARABUCO,consulta externa,repetidas en personas de 15 a 59 anos,2005-08-01,33,49,33,49,82
TARACO,consulta externa,repetidas en personas de 15 a 59 anos,2005-08-01,2,2,2,2,4
TARATA,consulta externa,repetidas en personas de 15 a 59 anos,2005-08-01,3,9,3,9,12
TARIJA,consulta externa,repetidas en personas de 15 a 59 anos,2005-08-01,1955,6101,1955,6101,8056
TARVITA,consulta externa,repetidas en personas de 15 a 59 anos,2005-08-01,7,23,7,23,30
TEOPONTE,consulta externa,repetidas en personas de 15 a 59 anos,2005-08-01,3,6,3,6,9
TIAWANACU,consulta externa,repetidas en personas de 15 a 59 anos,2005-08-01,8,7,8,7,15
TINGUIPAYA,consulta externa,repetidas en personas de 15 a 59 anos,2005-08-01,6,16,6,16,22
TIPUANI,consulta externa,repetidas en personas de 15 a 59 anos,2005-08-01,8,7,8,7,15
TIQUIPAYA,consulta externa,repetidas en personas de 15 a 59 anos,2005-08-01,23,105,23,105,128
TIRAQUE (CBBA),consulta externa,repetidas en personas de 15 a 59 anos,2005-08-01,74,277,74,277,351
TITO YUPANQUI (PARQUIPUJIO),consulta externa,repetidas en personas de 15 a 59 anos,2005-08-01,2,1,2,1,3
TOCO,consulta externa,repetidas en personas de 15 a 59 anos,2005-08-01,0,2,0,2,2
TODOS SANTOS,consulta externa,repetidas en personas de 15 a 59 anos,2005-08-01,3,0,3,0,3
TOLATA,consulta externa,repetidas en personas de 15 a 59 anos,2005-08-01,7,12,7,12,19
TOLEDO,consulta externa,repetidas en personas de 15 a 59 anos,2005-08-01,4,22,4,22,26
TOMAVE,consulta externa,repetidas en personas de 15 a 59 anos,2005-08-01,2,11,2,11,13
TOMINA,consulta externa,repetidas en personas de 15 a 59 anos,2005-08-01,8,13,8,13,21
TORO TORO,consulta externa,repetidas en personas de 15 a 59 anos,2005-08-01,0,3,0,3,3
TOTORA(CBBA),consulta externa,repetidas en personas de 15 a 59 anos,2005-08-01,2,4,2,4,6
TRIGAL,consulta externa,repetidas en personas de 15 a 59 anos,2005-08-01,3,4,3,4,7
TRINIDAD,consulta externa,repetidas en personas de 15 a 59 anos,2005-08-01,248,739,248,739,987
TUPIZA,consulta externa,repetidas en personas de 15 a 59 anos,2005-08-01,139,240,139,240,379
TURCO,consulta externa,repetidas en personas de 15 a 59 anos,2005-08-01,0,1,0,1,1
UMALA,consulta externa,repetidas en personas de 15 a 59 anos,2005-08-01,0,3,0,3,3
UNCIA,consulta externa,repetidas en personas de 15 a 59 anos,2005-08-01,104,137,104,137,241
URIONDO (A. CONCEPCION),consulta externa,repetidas en personas de 15 a 59 anos,2005-08-01,53,105,53,105,158
URUBICHA,consulta externa,repetidas en personas de 15 a 59 anos,2005-08-01,3,113,3,113,116
UYUNI,consulta externa,repetidas en personas de 15 a 59 anos,2005-08-01,41,103,41,103,144
VACAS,consulta externa,repetidas en personas de 15 a 59 anos,2005-08-01,11,42,11,42,53
VALLEGRANDE,consulta externa,repetidas en personas de 15 a 59 anos,2005-08-01,55,197,55,197,252
VIACHA,consulta externa,repetidas en personas de 15 a 59 anos,2005-08-01,104,248,104,248,352
VILA VILA,consulta externa,repetidas en personas de 15 a 59 anos,2005-08-01,2,1,2,1,3
VILLA MONTES,consulta externa,repetidas en personas de 15 a 59 anos,2005-08-01,80,148,80,148,228
VILLA NUEVA (LOMA ALTA),consulta externa,repetidas en personas de 15 a 59 anos,2005-08-01,0,1,0,1,1
VILLA RIVERO,consulta externa,repetidas en personas de 15 a 59 anos,2005-08-01,7,38,7,38,45
VILLA SERRANO,consulta externa,repetidas en personas de 15 a 59 anos,2005-08-01,7,6,7,6,13
VILLA TUNARI,consulta externa,repetidas en personas de 15 a 59 anos,2005-08-01,44,69,44,69,113
VILLA VACA GUZMAN (MUYUPAMPA),consulta externa,repetidas en personas de 15 a 59 anos,2005-08-01,4,45,4,45,49
VILLAZON,consulta externa,repetidas en personas de 15 a 59 anos,2005-08-01,53,153,53,153,206
VINTO,consulta externa,repetidas en personas de 15 a 59 anos,2005-08-01,23,101,23,101,124
VITICHI,consulta externa,repetidas en personas de 15 a 59 anos,2005-08-01,18,7,18,7,25
WALDO BALLIVIAN,consulta externa,repetidas en personas de 15 a 59 anos,2005-08-01,6,2,6,2,8
WARNES,consulta externa,repetidas en personas de 15 a 59 anos,2005-08-01,7,73,7,73,80
YACO,consulta externa,repetidas en personas de 15 a 59 anos,2005-08-01,0,3,0,3,3
YACUIBA,consulta externa,repetidas en personas de 15 a 59 anos,2005-08-01,271,787,271,787,1058
YAMPARAEZ,consulta externa,repetidas en personas de 15 a 59 anos,2005-08-01,9,29,9,29,38
YANACACHI,consulta externa,repetidas en personas de 15 a 59 anos,2005-08-01,6,11,6,11,17
YAPACANI,consulta externa,repetidas en personas de 15 a 59 anos,2005-08-01,19,336,19,336,355
YOCALLA,consulta externa,repetidas en personas de 15 a 59 anos,2005-08-01,4,4,4,4,8
YOTALA,consulta externa,repetidas en personas de 15 a 59 anos,2005-08-01,18,43,18,43,61
YUNCHARA,consulta externa,repetidas en personas de 15 a 59 anos,2005-08-01,2,8,2,8,10
ZUDAÑEZ,consulta externa,repetidas en personas de 15 a 59 anos,2005-08-01,5,7,5,7,12
ACACIO,consulta externa,repetidas en personas de 15 a 59 anos,2005-09-01,0,4,0,4,4
ACHACACHI,consulta externa,repetidas en personas de 15 a 59 anos,2005-09-01,58,57,58,57,115
ACHOCALLA,consulta externa,repetidas en personas de 15 a 59 anos,2005-09-01,3,6,3,6,9
AIQUILE,consulta externa,repetidas en personas de 15 a 59 anos,2005-09-01,46,333,46,333,379
ALALAY,consulta externa,repetidas en personas de 15 a 59 anos,2005-09-01,1,1,1,1,2
ANCORAIMES,consulta externa,repetidas en personas de 15 a 59 anos,2005-09-01,10,15,10,15,25
ANDAMARCA,consulta externa,repetidas en personas de 15 a 59 anos,2005-09-01,4,1,4,1,5
ANTEQUERA,consulta externa,repetidas en personas de 15 a 59 anos,2005-09-01,3,1,3,1,4
ANZALDO,consulta externa,repetidas en personas de 15 a 59 anos,2005-09-01,4,14,4,14,18
APOLO,consulta externa,repetidas en personas de 15 a 59 anos,2005-09-01,9,10,9,10,19
ARAMPAMPA,consulta externa,repetidas en personas de 15 a 59 anos,2005-09-01,5,0,5,0,5
ARANI,consulta externa,repetidas en personas de 15 a 59 anos,2005-09-01,15,15,15,15,30
ARBIETO,consulta externa,repetidas en personas de 15 a 59 anos,2005-09-01,7,32,7,32,39
ARQUE,consulta externa,repetidas en personas de 15 a 59 anos,2005-09-01,2,4,2,4,6
ASCENCION DE GUARAYOS,consulta externa,repetidas en personas de 15 a 59 anos,2005-09-01,0,2,0,2,2
ATOCHA,consulta externa,repetidas en personas de 15 a 59 anos,2005-09-01,289,224,289,224,513
AUCAPATA,consulta externa,repetidas en personas de 15 a 59 anos,2005-09-01,4,5,4,5,9
AYATA,consulta externa,repetidas en personas de 15 a 59 anos,2005-09-01,6,7,6,7,13
AYO AYO,consulta externa,repetidas en personas de 15 a 59 anos,2005-09-01,3,11,3,11,14
AYOPAYA (V. DE INDEPENDENCIA),consulta externa,repetidas en personas de 15 a 59 anos,2005-09-01,3,16,3,16,19
AZURDUY,consulta externa,repetidas en personas de 15 a 59 anos,2005-09-01,0,6,0,6,6
BATALLAS,consulta externa,repetidas en personas de 15 a 59 anos,2005-09-01,6,6,6,6,12
BAURES,consulta externa,repetidas en personas de 15 a 59 anos,2005-09-01,20,13,20,13,33
BELEN DE ANDAMARCA,consulta externa,repetidas en personas de 15 a 59 anos,2005-09-01,2,10,2,10,12
BELEN DE URMIRI,consulta externa,repetidas en personas de 15 a 59 anos,2005-09-01,4,3,4,3,7
BERMEJO,consulta externa,repetidas en personas de 15 a 59 anos,2005-09-01,84,121,84,121,205
BETANZOS,consulta externa,repetidas en personas de 15 a 59 anos,2005-09-01,30,57,30,57,87
BOLIVAR,consulta externa,repetidas en personas de 15 a 59 anos,2005-09-01,3,12,3,12,15
BOLPEBRA,consulta externa,repetidas en personas de 15 a 59 anos,2005-09-01,1,1,1,1,2
BOYUIBE,consulta externa,repetidas en personas de 15 a 59 anos,2005-09-01,6,7,6,7,13
BUENA VISTA,consulta externa,repetidas en personas de 15 a 59 anos,2005-09-01,34,79,34,79,113
CABEZAS,consulta externa,repetidas en personas de 15 a 59 anos,2005-09-01,11,17,11,17,28
CAIROMA,consulta externa,repetidas en personas de 15 a 59 anos,2005-09-01,1,8,1,8,9
"CAIZA ""D""",consulta externa,repetidas en personas de 15 a 59 anos,2005-09-01,6,5,6,5,11
CAJUATA,consulta externa,repetidas en personas de 15 a 59 anos,2005-09-01,2,4,2,4,6
CALAMARCA,consulta externa,repetidas en personas de 15 a 59 anos,2005-09-01,4,22,4,22,26
CAMARGO,consulta externa,repetidas en personas de 15 a 59 anos,2005-09-01,8,34,8,34,42
CAMATAQUI (C. VILLA ABECIA),consulta externa,repetidas en personas de 15 a 59 anos,2005-09-01,4,0,4,0,4
CAMIRI,consulta externa,repetidas en personas de 15 a 59 anos,2005-09-01,78,168,78,168,246
CAPINOTA,consulta externa,repetidas en personas de 15 a 59 anos,2005-09-01,37,56,37,56,93
CAQUIAVIRI,consulta externa,repetidas en personas de 15 a 59 anos,2005-09-01,9,11,9,11,20
CARACOLLO,consulta externa,repetidas en personas de 15 a 59 anos,2005-09-01,6,15,6,15,21
CARANAVI,consulta externa,repetidas en personas de 15 a 59 anos,2005-09-01,17,38,17,38,55
CARAPARI,consulta externa,repetidas en personas de 15 a 59 anos,2005-09-01,3,1,3,1,4
CARIPUYO,consulta externa,repetidas en personas de 15 a 59 anos,2005-09-01,2,1,2,1,3
CARMEN RIVERO TORREZ,consulta externa,repetidas en personas de 15 a 59 anos,2005-09-01,5,12,5,12,17
CHACARILLA,consulta externa,repetidas en personas de 15 a 59 anos,2005-09-01,0,1,0,1,1
CHALLAPATA,consulta externa,repetidas en personas de 15 a 59 anos,2005-09-01,23,70,23,70,93
CHAQUI,consulta externa,repetidas en personas de 15 a 59 anos,2005-09-01,1,15,1,15,16
CHARAGUA,consulta externa,repetidas en personas de 15 a 59 anos,2005-09-01,14,69,14,69,83
CHARAÑA,consulta externa,repetidas en personas de 15 a 59 anos,2005-09-01,2,1,2,1,3
CHAYANTA,consulta externa,repetidas en personas de 15 a 59 anos,2005-09-01,13,10,13,10,23
CHIMORE,consulta externa,repetidas en personas de 15 a 59 anos,2005-09-01,10,37,10,37,47
CHOQUE COTA,consulta externa,repetidas en personas de 15 a 59 anos,2005-09-01,5,9,5,9,14
CHULUMANI (V. DE LA LIBERTAD),consulta externa,repetidas en personas de 15 a 59 anos,2005-09-01,75,55,75,55,130
CHUMA,consulta externa,repetidas en personas de 15 a 59 anos,2005-09-01,9,10,9,10,19
CLIZA,consulta externa,repetidas en personas de 15 a 59 anos,2005-09-01,2,4,2,4,6
COBIJA,consulta externa,repetidas en personas de 15 a 59 anos,2005-09-01,83,453,83,453,536
COCHABAMBA,consulta externa,repetidas en personas de 15 a 59 anos,2005-09-01,7778,18240,7778,18240,26018
COLCAPIRHUA,consulta externa,repetidas en personas de 15 a 59 anos,2005-09-01,105,315,105,315,420
"COLCHA ""K""",consulta externa,repetidas en personas de 15 a 59 anos,2005-09-01,3,12,3,12,15
COLLANA,consulta externa,repetidas en personas de 15 a 59 anos,2005-09-01,3,1,3,1,4
COLOMI,consulta externa,repetidas en personas de 15 a 59 anos,2005-09-01,5,12,5,12,17
COLPA BELGICA,consulta externa,repetidas en personas de 15 a 59 anos,2005-09-01,4,34,4,34,38
COLQUECHACA,consulta externa,repetidas en personas de 15 a 59 anos,2005-09-01,9,15,9,15,24
COLQUENCHA,consulta externa,repetidas en personas de 15 a 59 anos,2005-09-01,0,8,0,8,8
COLQUIRI,consulta externa,repetidas en personas de 15 a 59 anos,2005-09-01,9,19,9,19,28
COMANCHE,consulta externa,repetidas en personas de 15 a 59 anos,2005-09-01,1,2,1,2,3
COMARAPA,consulta externa,repetidas en personas de 15 a 59 anos,2005-09-01,33,34,33,34,67
COMBAYA,consulta externa,repetidas en personas de 15 a 59 anos,2005-09-01,0,1,0,1,1
CONCEPCION,consulta externa,repetidas en personas de 15 a 59 anos,2005-09-01,6,5,6,5,11
COPACABANA,consulta externa,repetidas en personas de 15 a 59 anos,2005-09-01,3,6,3,6,9
CORIPATA,consulta externa,repetidas en personas de 15 a 59 anos,2005-09-01,3,3,3,3,6
CORO CORO,consulta externa,repetidas en personas de 15 a 59 anos,2005-09-01,3,5,3,5,8
COROICO,consulta externa,repetidas en personas de 15 a 59 anos,2005-09-01,71,119,71,119,190
CORQUE,consulta externa,repetidas en personas de 15 a 59 anos,2005-09-01,24,38,24,38,62
COTAGAITA,consulta externa,repetidas en personas de 15 a 59 anos,2005-09-01,107,100,107,100,207
COTOCA,consulta externa,repetidas en personas de 15 a 59 anos,2005-09-01,0,2,0,2,2
CUATRO CAÑADAS,consulta externa,repetidas en personas de 15 a 59 anos,2005-09-01,7,71,7,71,78
CUCHUMUELA (V. G. VILLARROEL),consulta externa,repetidas en personas de 15 a 59 anos,2005-09-01,2,3,2,3,5
CUEVO,consulta externa,repetidas en personas de 15 a 59 anos,2005-09-01,6,5,6,5,11
CULPINA,consulta externa,repetidas en personas de 15 a 59 anos,2005-09-01,4,25,4,25,29
CURAHUARA DE CARANGAS,consulta externa,repetidas en personas de 15 a 59 anos,2005-09-01,2,2,2,2,4
CURVA,consulta externa,repetidas en personas de 15 a 59 anos,2005-09-01,0,1,0,1,1
DESAGUADERO,consulta externa,repetidas en personas de 15 a 59 anos,2005-09-01,1,1,1,1,2
EL ALTO,consulta externa,repetidas en personas de 15 a 59 anos,2005-09-01,2445,5537,2445,5537,7982
EL CHORO,consulta externa,repetidas en personas de 15 a 59 anos,2005-09-01,1,3,1,3,4
EL PUENTE(STC),consulta externa,repetidas en personas de 15 a 59 anos,2005-09-01,0,2,0,2,2
EL PUENTE(TJA),consulta externa,repetidas en personas de 15 a 59 anos,2005-09-01,7,4,7,4,11
EL TORNO,consulta externa,repetidas en personas de 15 a 59 anos,2005-09-01,178,214,178,214,392
EL VILLAR,consulta externa,repetidas en personas de 15 a 59 anos,2005-09-01,0,4,0,4,4
ENTRE RIOS,consulta externa,repetidas en personas de 15 a 59 anos,2005-09-01,15,8,15,8,23
ENTRE RIOS,consulta externa,repetidas en personas de 15 a 59 anos,2005-09-01,26,25,26,25,51
ESCARA,consulta externa,repetidas en personas de 15 a 59 anos,2005-09-01,0,1,0,1,1
EUCALIPTUS,consulta externa,repetidas en personas de 15 a 59 anos,2005-09-01,4,5,4,5,9
EUREKA (SANTOS MERCADO),consulta externa,repetidas en personas de 15 a 59 anos,2005-09-01,0,1,0,1,1
EXALTACION,consulta externa,repetidas en personas de 15 a 59 anos,2005-09-01,0,7,0,7,7
FERNANDEZ ALONSO,consulta externa,repetidas en personas de 15 a 59 anos,2005-09-01,18,24,18,24,42
GENERAL SAAVEDRA,consulta externa,repetidas en personas de 15 a 59 anos,2005-09-01,11,15,11,15,26
GRAL. J.J. PEREZ (CHARAZANI),consulta externa,repetidas en personas de 15 a 59 anos,2005-09-01,2,0,2,0,2
GUAQUI,consulta externa,repetidas en personas de 15 a 59 anos,2005-09-01,6,9,6,9,15
GUAYARAMERIN,consulta externa,repetidas en personas de 15 a 59 anos,2005-09-01,168,216,168,216,384
GUTIERREZ,consulta externa,repetidas en personas de 15 a 59 anos,2005-09-01,11,23,11,23,34
HUACARETA,consulta externa,repetidas en personas de 15 a 59 anos,2005-09-01,17,51,17,51,68
HUACHACALLA,consulta externa,repetidas en personas de 15 a 59 anos,2005-09-01,4,3,4,3,7
HUANUNI,consulta externa,repetidas en personas de 15 a 59 anos,2005-09-01,122,127,122,127,249
HUARACAJE,consulta externa,repetidas en personas de 15 a 59 anos,2005-09-01,4,2,4,2,6
ICHOCA,consulta externa,repetidas en personas de 15 a 59 anos,2005-09-01,3,5,3,5,8
ICLA,consulta externa,repetidas en personas de 15 a 59 anos,2005-09-01,2,7,2,7,9
INCAHUASI,consulta externa,repetidas en personas de 15 a 59 anos,2005-09-01,1,5,1,5,6
INGAVI (HUMAITA),consulta externa,repetidas en personas de 15 a 59 anos,2005-09-01,5,7,5,7,12
INQUISIVI,consulta externa,repetidas en personas de 15 a 59 anos,2005-09-01,3,3,3,3,6
IRUPANA (VILLA DE LANZA),consulta externa,repetidas en personas de 15 a 59 anos,2005-09-01,19,12,19,12,31
IXIAMAS,consulta externa,repetidas en personas de 15 a 59 anos,2005-09-01,9,74,9,74,83
JESUS DE MACHACA,consulta externa,repetidas en personas de 15 a 59 anos,2005-09-01,7,14,7,14,21
LA ASUNTA,consulta externa,repetidas en personas de 15 a 59 anos,2005-09-01,12,15,12,15,27
LA GUARDIA,consulta externa,repetidas en personas de 15 a 59 anos,2005-09-01,19,158,19,158,177
LA PAZ,consulta externa,repetidas en personas de 15 a 59 anos,2005-09-01,14270,31661,14270,31661,45931
LAGUNILLAS,consulta externa,repetidas en personas de 15 a 59 anos,2005-09-01,4,6,4,6,10
LAJA,consulta externa,repetidas en personas de 15 a 59 anos,2005-09-01,10,4,10,4,14
LAS CARRERAS,consulta externa,repetidas en personas de 15 a 59 anos,2005-09-01,1,3,1,3,4
LLALLAGUA,consulta externa,repetidas en personas de 15 a 59 anos,2005-09-01,82,150,82,150,232
LLICA,consulta externa,repetidas en personas de 15 a 59 anos,2005-09-01,8,12,8,12,20
LORETO,consulta externa,repetidas en personas de 15 a 59 anos,2005-09-01,4,13,4,13,17
LURIBAY,consulta externa,repetidas en personas de 15 a 59 anos,2005-09-01,2,2,2,2,4
MACHACAMARCA,consulta externa,repetidas en personas de 15 a 59 anos,2005-09-01,13,16,13,16,29
MACHARETI,consulta externa,repetidas en personas de 15 a 59 anos,2005-09-01,2,55,2,55,57
MAGDALENA,consulta externa,repetidas en personas de 15 a 59 anos,2005-09-01,32,27,32,27,59
MAIRANA,consulta externa,repetidas en personas de 15 a 59 anos,2005-09-01,1,5,1,5,6
MALLA,consulta externa,repetidas en personas de 15 a 59 anos,2005-09-01,3,3,3,3,6
MAPIRI,consulta externa,repetidas en personas de 15 a 59 anos,2005-09-01,6,3,6,3,9
MECAPACA,consulta externa,repetidas en personas de 15 a 59 anos,2005-09-01,30,29,30,29,59
MINEROS,consulta externa,repetidas en personas de 15 a 59 anos,2005-09-01,6,69,6,69,75
MIZQUE,consulta externa,repetidas en personas de 15 a 59 anos,2005-09-01,4,1,4,1,5
MOCOMOCO,consulta externa,repetidas en personas de 15 a 59 anos,2005-09-01,4,9,4,9,13
MOJINETE,consulta externa,repetidas en personas de 15 a 59 anos,2005-09-01,3,6,3,6,9
MOJOCOYA,consulta externa,repetidas en personas de 15 a 59 anos,2005-09-01,1,5,1,5,6
MONTEAGUDO,consulta externa,repetidas en personas de 15 a 59 anos,2005-09-01,89,296,89,296,385
MONTERO,consulta externa,repetidas en personas de 15 a 59 anos,2005-09-01,766,1573,766,1573,2339
MORO MORO,consulta externa,repetidas en personas de 15 a 59 anos,2005-09-01,1,1,1,1,2
MOROCHATA,consulta externa,repetidas en personas de 15 a 59 anos,2005-09-01,7,47,7,47,54
NUEVO MANOA (NUEVA ESPERANZA),consulta externa,repetidas en personas de 15 a 59 anos,2005-09-01,1,6,1,6,7
OCURI,consulta externa,repetidas en personas de 15 a 59 anos,2005-09-01,1,0,1,0,1
OKINAWA,consulta externa,repetidas en personas de 15 a 59 anos,2005-09-01,12,45,12,45,57
OMEREQUE,consulta externa,repetidas en personas de 15 a 59 anos,2005-09-01,5,4,5,4,9
ORURO,consulta externa,repetidas en personas de 15 a 59 anos,2005-09-01,1645,4293,1645,4293,5938
PADCAYA,consulta externa,repetidas en personas de 15 a 59 anos,2005-09-01,12,7,12,7,19
PADILLA,consulta externa,repetidas en personas de 15 a 59 anos,2005-09-01,10,17,10,17,27
PAILON,consulta externa,repetidas en personas de 15 a 59 anos,2005-09-01,12,12,12,12,24
PALCA,consulta externa,repetidas en personas de 15 a 59 anos,2005-09-01,5,8,5,8,13
PALOS BLANCOS,consulta externa,repetidas en personas de 15 a 59 anos,2005-09-01,49,50,49,50,99
PAMPA AULLAGAS,consulta externa,repetidas en personas de 15 a 59 anos,2005-09-01,0,3,0,3,3
PAMPA GRANDE,consulta externa,repetidas en personas de 15 a 59 anos,2005-09-01,1,18,1,18,19
PAPEL PAMPA,consulta externa,repetidas en personas de 15 a 59 anos,2005-09-01,10,7,10,7,17
PASORAPA,consulta externa,repetidas en personas de 15 a 59 anos,2005-09-01,1,2,1,2,3
PATACAMAYA,consulta externa,repetidas en personas de 15 a 59 anos,2005-09-01,5,5,5,5,10
PAZÑA,consulta externa,repetidas en personas de 15 a 59 anos,2005-09-01,16,17,16,17,33
PELECHUCO,consulta externa,repetidas en personas de 15 a 59 anos,2005-09-01,3,4,3,4,7
POCOATA,consulta externa,repetidas en personas de 15 a 59 anos,2005-09-01,1,5,1,5,6
POCONA,consulta externa,repetidas en personas de 15 a 59 anos,2005-09-01,1,8,1,8,9
POJO (CBBA),consulta externa,repetidas en personas de 15 a 59 anos,2005-09-01,4,1,4,1,5
POOPO,consulta externa,repetidas en personas de 15 a 59 anos,2005-09-01,4,2,4,2,6
PORCO,consulta externa,repetidas en personas de 15 a 59 anos,2005-09-01,5,7,5,7,12
POROMA,consulta externa,repetidas en personas de 15 a 59 anos,2005-09-01,7,13,7,13,20
PORONGO,consulta externa,repetidas en personas de 15 a 59 anos,2005-09-01,15,12,15,12,27
PORTACHUELO,consulta externa,repetidas en personas de 15 a 59 anos,2005-09-01,19,35,19,35,54
PORVENIR,consulta externa,repetidas en personas de 15 a 59 anos,2005-09-01,3,2,3,2,5
POSTRER VALLE,consulta externa,repetidas en personas de 15 a 59 anos,2005-09-01,2,5,2,5,7
POTOSI,consulta externa,repetidas en personas de 15 a 59 anos,2005-09-01,1854,4242,1854,4242,6096
PRESTO,consulta externa,repetidas en personas de 15 a 59 anos,2005-09-01,2,3,2,3,5
PUCARA,consulta externa,repetidas en personas de 15 a 59 anos,2005-09-01,0,1,0,1,1
PUCARANI,consulta externa,repetidas en personas de 15 a 59 anos,2005-09-01,5,6,5,6,11
PUERTO ACOSTA,consulta externa,repetidas en personas de 15 a 59 anos,2005-09-01,11,12,11,12,23
PUERTO CARABUCO,consulta externa,repetidas en personas de 15 a 59 anos,2005-09-01,4,7,4,7,11
PUERTO GONZALO MORENO,consulta externa,repetidas en personas de 15 a 59 anos,2005-09-01,11,1,11,1,12
PUERTO PEREZ,consulta externa,repetidas en personas de 15 a 59 anos,2005-09-01,15,15,15,15,30
PUERTO QUIJARRO,consulta externa,repetidas en personas de 15 a 59 anos,2005-09-01,46,83,46,83,129
PUERTO RICO,consulta externa,repetidas en personas de 15 a 59 anos,2005-09-01,4,1,4,1,5
PUERTO SUAREZ,consulta externa,repetidas en personas de 15 a 59 anos,2005-09-01,17,40,17,40,57
PUERTO VILLARROEL,consulta externa,repetidas en personas de 15 a 59 anos,2005-09-01,46,54,46,54,100
PUNA,consulta externa,repetidas en personas de 15 a 59 anos,2005-09-01,11,12,11,12,23
PUNATA,consulta externa,repetidas en personas de 15 a 59 anos,2005-09-01,141,276,141,276,417
QUIABAYA,consulta externa,repetidas en personas de 15 a 59 anos,2005-09-01,1,1,1,1,2
QUILLACOLLO,consulta externa,repetidas en personas de 15 a 59 anos,2005-09-01,211,730,211,730,941
QUIME,consulta externa,repetidas en personas de 15 a 59 anos,2005-09-01,6,2,6,2,8
RAVELO,consulta externa,repetidas en personas de 15 a 59 anos,2005-09-01,1,2,1,2,3
REYES,consulta externa,repetidas en personas de 15 a 59 anos,2005-09-01,17,46,17,46,63
RIBERALTA,consulta externa,repetidas en personas de 15 a 59 anos,2005-09-01,39,327,39,327,366
ROBORE,consulta externa,repetidas en personas de 15 a 59 anos,2005-09-01,12,46,12,46,58
RURRENABAQUE,consulta externa,repetidas en personas de 15 a 59 anos,2005-09-01,20,49,20,49,69
SABAYA,consulta externa,repetidas en personas de 15 a 59 anos,2005-09-01,5,3,5,3,8
SACABA,consulta externa,repetidas en personas de 15 a 59 anos,2005-09-01,157,351,157,351,508
SACABAMBA,consulta externa,repetidas en personas de 15 a 59 anos,2005-09-01,4,2,4,2,6
SACACA,consulta externa,repetidas en personas de 15 a 59 anos,2005-09-01,4,6,4,6,10
SAIPINA,consulta externa,repetidas en personas de 15 a 59 anos,2005-09-01,9,35,9,35,44
SALINAS DE GARCI MENDOZA,consulta externa,repetidas en personas de 15 a 59 anos,2005-09-01,2,6,2,6,8
SAMAIPATA,consulta externa,repetidas en personas de 15 a 59 anos,2005-09-01,3,4,3,4,7
SAN AGUSTIN,consulta externa,repetidas en personas de 15 a 59 anos,2005-09-01,1,10,1,10,11
SAN ANDRES,consulta externa,repetidas en personas de 15 a 59 anos,2005-09-01,7,20,7,20,27
SAN ANDRES DE MACHACA,consulta externa,repetidas en personas de 15 a 59 anos,2005-09-01,17,17,17,17,34
SAN ANTONIO DE ESMORUCO,consulta externa,repetidas en personas de 15 a 59 anos,2005-09-01,1,7,1,7,8
SAN ANTONIO DE LOMERIO,consulta externa,repetidas en personas de 15 a 59 anos,2005-09-01,1,3,1,3,4
SAN BENITO,consulta externa,repetidas en personas de 15 a 59 anos,2005-09-01,12,31,12,31,43
SAN BORJA,consulta externa,repetidas en personas de 15 a 59 anos,2005-09-01,28,86,28,86,114
SAN BUENA VENTURA,consulta externa,repetidas en personas de 15 a 59 anos,2005-09-01,5,19,5,19,24
SAN CARLOS,consulta externa,repetidas en personas de 15 a 59 anos,2005-09-01,8,226,8,226,234
SAN IGNACIO,consulta externa,repetidas en personas de 15 a 59 anos,2005-09-01,30,64,30,64,94
SAN IGNACIO DE VELASCO,consulta externa,repetidas en personas de 15 a 59 anos,2005-09-01,68,150,68,150,218
SAN JAVIER(BNI),consulta externa,repetidas en personas de 15 a 59 anos,2005-09-01,2,4,2,4,6
SAN JAVIER(STC),consulta externa,repetidas en personas de 15 a 59 anos,2005-09-01,8,56,8,56,64
SAN JOAQUIN,consulta externa,repetidas en personas de 15 a 59 anos,2005-09-01,5,20,5,20,25
SAN JOSE DE CHIQUITOS,consulta externa,repetidas en personas de 15 a 59 anos,2005-09-01,1,20,1,20,21
SAN JUAN DE YAPACANI,consulta externa,repetidas en personas de 15 a 59 anos,2005-09-01,11,38,11,38,49
SAN JULIAN,consulta externa,repetidas en personas de 15 a 59 anos,2005-09-01,41,293,41,293,334
SAN LORENZO(PND),consulta externa,repetidas en personas de 15 a 59 anos,2005-09-01,4,3,4,3,7
SAN LORENZO(TJA),consulta externa,repetidas en personas de 15 a 59 anos,2005-09-01,11,23,11,23,34
SAN LUCAS,consulta externa,repetidas en personas de 15 a 59 anos,2005-09-01,5,17,5,17,22
SAN MATIAS,consulta externa,repetidas en personas de 15 a 59 anos,2005-09-01,2,20,2,20,22
SAN MIGUEL DE VELASCO,consulta externa,repetidas en personas de 15 a 59 anos,2005-09-01,28,74,28,74,102
SAN PABLO DE LIPEZ,consulta externa,repetidas en personas de 15 a 59 anos,2005-09-01,6,9,6,9,15
SAN PEDRO,consulta externa,repetidas en personas de 15 a 59 anos,2005-09-01,21,43,21,43,64
SAN PEDRO DE BUENA VISTA,consulta externa,repetidas en personas de 15 a 59 anos,2005-09-01,2,2,2,2,4
SAN PEDRO DE CURAHUARA,consulta externa,repetidas en personas de 15 a 59 anos,2005-09-01,3,6,3,6,9
SAN PEDRO DE TIQUINA,consulta externa,repetidas en personas de 15 a 59 anos,2005-09-01,3,2,3,2,5
SAN RAFAEL,consulta externa,repetidas en personas de 15 a 59 anos,2005-09-01,6,2,6,2,8
SAN RAMON,consulta externa,repetidas en personas de 15 a 59 anos,2005-09-01,2,27,2,27,29
SAN RAMON,consulta externa,repetidas en personas de 15 a 59 anos,2005-09-01,13,96,13,96,109
SANTA ANA,consulta externa,repetidas en personas de 15 a 59 anos,2005-09-01,51,79,51,79,130
SANTA CRUZ DE LA SIERRA,consulta externa,repetidas en personas de 15 a 59 anos,2005-09-01,6603,15774,6603,15774,22377
SANTA ROSA,consulta externa,repetidas en personas de 15 a 59 anos,2005-09-01,3,8,3,8,11
SANTA ROSA DEL SARA,consulta externa,repetidas en personas de 15 a 59 anos,2005-09-01,4,26,4,26,30
SANTIAGO DE CALLAPA,consulta externa,repetidas en personas de 15 a 59 anos,2005-09-01,0,2,0,2,2
SANTIAGO DE HUARI,consulta externa,repetidas en personas de 15 a 59 anos,2005-09-01,10,21,10,21,31
SANTIVAÑES,consulta externa,repetidas en personas de 15 a 59 anos,2005-09-01,3,8,3,8,11
SAPAHAQUI,consulta externa,repetidas en personas de 15 a 59 anos,2005-09-01,2,1,2,1,3
SENA,consulta externa,repetidas en personas de 15 a 59 anos,2005-09-01,2,1,2,1,3
SICA SICA (VILLA AROMA),consulta externa,repetidas en personas de 15 a 59 anos,2005-09-01,5,4,5,4,9
SIPE SIPE,consulta externa,repetidas en personas de 15 a 59 anos,2005-09-01,22,255,22,255,277
SOPACHUY,consulta externa,repetidas en personas de 15 a 59 anos,2005-09-01,1,4,1,4,5
SORACACHI,consulta externa,repetidas en personas de 15 a 59 anos,2005-09-01,1,3,1,3,4
SORATA,consulta externa,repetidas en personas de 15 a 59 anos,2005-09-01,14,7,14,7,21
SUCRE,consulta externa,repetidas en personas de 15 a 59 anos,2005-09-01,2694,6852,2694,6852,9546
TACACHI,consulta externa,repetidas en personas de 15 a 59 anos,2005-09-01,7,38,7,38,45
TACACOMA,consulta externa,repetidas en personas de 15 a 59 anos,2005-09-01,3,2,3,2,5
TACOBAMBA,consulta externa,repetidas en personas de 15 a 59 anos,2005-09-01,2,0,2,0,2
TACOPAYA,consulta externa,repetidas en personas de 15 a 59 anos,2005-09-01,0,4,0,4,4
TAPACARI,consulta externa,repetidas en personas de 15 a 59 anos,2005-09-01,10,39,10,39,49
TARABUCO,consulta externa,repetidas en personas de 15 a 59 anos,2005-09-01,21,33,21,33,54
TARACO,consulta externa,repetidas en personas de 15 a 59 anos,2005-09-01,4,0,4,0,4
TARATA,consulta externa,repetidas en personas de 15 a 59 anos,2005-09-01,5,1,5,1,6
TARIJA,consulta externa,repetidas en personas de 15 a 59 anos,2005-09-01,1886,6149,1886,6149,8035
TARVITA,consulta externa,repetidas en personas de 15 a 59 anos,2005-09-01,15,32,15,32,47
TEOPONTE,consulta externa,repetidas en personas de 15 a 59 anos,2005-09-01,4,1,4,1,5
TIAWANACU,consulta externa,repetidas en personas de 15 a 59 anos,2005-09-01,2,7,2,7,9
TINGUIPAYA,consulta externa,repetidas en personas de 15 a 59 anos,2005-09-01,4,9,4,9,13
TIPUANI,consulta externa,repetidas en personas de 15 a 59 anos,2005-09-01,9,4,9,4,13
TIQUIPAYA,consulta externa,repetidas en personas de 15 a 59 anos,2005-09-01,19,119,19,119,138
TIRAQUE (CBBA),consulta externa,repetidas en personas de 15 a 59 anos,2005-09-01,26,272,26,272,298
TITO YUPANQUI (PARQUIPUJIO),consulta externa,repetidas en personas de 15 a 59 anos,2005-09-01,0,1,0,1,1
TOCO,consulta externa,repetidas en personas de 15 a 59 anos,2005-09-01,0,3,0,3,3
TODOS SANTOS,consulta externa,repetidas en personas de 15 a 59 anos,2005-09-01,2,2,2,2,4
TOLATA,consulta externa,repetidas en personas de 15 a 59 anos,2005-09-01,6,5,6,5,11
TOLEDO,consulta externa,repetidas en personas de 15 a 59 anos,2005-09-01,8,4,8,4,12
TOMAVE,consulta externa,repetidas en personas de 15 a 59 anos,2005-09-01,8,5,8,5,13
TOMINA,consulta externa,repetidas en personas de 15 a 59 anos,2005-09-01,3,1,3,1,4
TORO TORO,consulta externa,repetidas en personas de 15 a 59 anos,2005-09-01,2,4,2,4,6
TOTORA(CBBA),consulta externa,repetidas en personas de 15 a 59 anos,2005-09-01,0,1,0,1,1
TRIGAL,consulta externa,repetidas en personas de 15 a 59 anos,2005-09-01,1,0,1,0,1
TRINIDAD,consulta externa,repetidas en personas de 15 a 59 anos,2005-09-01,210,719,210,719,929
TUPIZA,consulta externa,repetidas en personas de 15 a 59 anos,2005-09-01,174,294,174,294,468
TURCO,consulta externa,repetidas en personas de 15 a 59 anos,2005-09-01,0,5,0,5,5
UMALA,consulta externa,repetidas en personas de 15 a 59 anos,2005-09-01,1,1,1,1,2
UNCIA,consulta externa,repetidas en personas de 15 a 59 anos,2005-09-01,72,92,72,92,164
URIONDO (A. CONCEPCION),consulta externa,repetidas en personas de 15 a 59 anos,2005-09-01,5,4,5,4,9
URUBICHA,consulta externa,repetidas en personas de 15 a 59 anos,2005-09-01,3,82,3,82,85
UYUNI,consulta externa,repetidas en personas de 15 a 59 anos,2005-09-01,56,107,56,107,163
VACAS,consulta externa,repetidas en personas de 15 a 59 anos,2005-09-01,17,44,17,44,61
VALLEGRANDE,consulta externa,repetidas en personas de 15 a 59 anos,2005-09-01,75,143,75,143,218
VIACHA,consulta externa,repetidas en personas de 15 a 59 anos,2005-09-01,102,199,102,199,301
VILA VILA,consulta externa,repetidas en personas de 15 a 59 anos,2005-09-01,1,0,1,0,1
VILLA MONTES,consulta externa,repetidas en personas de 15 a 59 anos,2005-09-01,72,99,72,99,171
VILLA NUEVA (LOMA ALTA),consulta externa,repetidas en personas de 15 a 59 anos,2005-09-01,0,1,0,1,1
VILLA RIVERO,consulta externa,repetidas en personas de 15 a 59 anos,2005-09-01,5,21,5,21,26
VILLA SERRANO,consulta externa,repetidas en personas de 15 a 59 anos,2005-09-01,1,4,1,4,5
VILLA TUNARI,consulta externa,repetidas en personas de 15 a 59 anos,2005-09-01,69,114,69,114,183
VILLA VACA GUZMAN (MUYUPAMPA),consulta externa,repetidas en personas de 15 a 59 anos,2005-09-01,8,32,8,32,40
VILLAZON,consulta externa,repetidas en personas de 15 a 59 anos,2005-09-01,54,167,54,167,221
VINTO,consulta externa,repetidas en personas de 15 a 59 anos,2005-09-01,8,120,8,120,128
VITICHI,consulta externa,repetidas en personas de 15 a 59 anos,2005-09-01,3,9,3,9,12
WARNES,consulta externa,repetidas en personas de 15 a 59 anos,2005-09-01,7,89,7,89,96
YACO,consulta externa,repetidas en personas de 15 a 59 anos,2005-09-01,3,1,3,1,4
YACUIBA,consulta externa,repetidas en personas de 15 a 59 anos,2005-09-01,409,1134,409,1134,1543
YAMPARAEZ,consulta externa,repetidas en personas de 15 a 59 anos,2005-09-01,13,33,13,33,46
YANACACHI,consulta externa,repetidas en personas de 15 a 59 anos,2005-09-01,13,23,13,23,36
YAPACANI,consulta externa,repetidas en personas de 15 a 59 anos,2005-09-01,22,301,22,301,323
YOCALLA,consulta externa,repetidas en personas de 15 a 59 anos,2005-09-01,3,9,3,9,12
YOTALA,consulta externa,repetidas en personas de 15 a 59 anos,2005-09-01,12,35,12,35,47
YUNCHARA,consulta externa,repetidas en personas de 15 a 59 anos,2005-09-01,2,2,2,2,4
ZUDAÑEZ,consulta externa,repetidas en personas de 15 a 59 anos,2005-09-01,3,6,3,6,9
ACACIO,consulta externa,repetidas en personas de 15 a 59 anos,2005-10-01,0,3,0,3,3
ACHACACHI,consulta externa,repetidas en personas de 15 a 59 anos,2005-10-01,19,50,19,50,69
ACHOCALLA,consulta externa,repetidas en personas de 15 a 59 anos,2005-10-01,2,12,2,12,14
AIQUILE,consulta externa,repetidas en personas de 15 a 59 anos,2005-10-01,38,36,38,36,74
ALCALA,consulta externa,repetidas en personas de 15 a 59 anos,2005-10-01,1,0,1,0,1
ANCORAIMES,consulta externa,repetidas en personas de 15 a 59 anos,2005-10-01,11,7,11,7,18
ANDAMARCA,consulta externa,repetidas en personas de 15 a 59 anos,2005-10-01,3,2,3,2,5
ANZALDO,consulta externa,repetidas en personas de 15 a 59 anos,2005-10-01,3,13,3,13,16
APOLO,consulta externa,repetidas en personas de 15 a 59 anos,2005-10-01,9,10,9,10,19
ARAMPAMPA,consulta externa,repetidas en personas de 15 a 59 anos,2005-10-01,2,0,2,0,2
ARANI,consulta externa,repetidas en personas de 15 a 59 anos,2005-10-01,10,12,10,12,22
ARBIETO,consulta externa,repetidas en personas de 15 a 59 anos,2005-10-01,12,32,12,32,44
ARQUE,consulta externa,repetidas en personas de 15 a 59 anos,2005-10-01,3,0,3,0,3
ASCENCION DE GUARAYOS,consulta externa,repetidas en personas de 15 a 59 anos,2005-10-01,0,1,0,1,1
ATOCHA,consulta externa,repetidas en personas de 15 a 59 anos,2005-10-01,251,315,251,315,566
AUCAPATA,consulta externa,repetidas en personas de 15 a 59 anos,2005-10-01,8,9,8,9,17
AYATA,consulta externa,repetidas en personas de 15 a 59 anos,2005-10-01,9,25,9,25,34
AYO AYO,consulta externa,repetidas en personas de 15 a 59 anos,2005-10-01,4,8,4,8,12
AYOPAYA (V. DE INDEPENDENCIA),consulta externa,repetidas en personas de 15 a 59 anos,2005-10-01,4,11,4,11,15
AZURDUY,consulta externa,repetidas en personas de 15 a 59 anos,2005-10-01,0,2,0,2,2
BATALLAS,consulta externa,repetidas en personas de 15 a 59 anos,2005-10-01,3,4,3,4,7
BAURES,consulta externa,repetidas en personas de 15 a 59 anos,2005-10-01,6,19,6,19,25
BELEN DE ANDAMARCA,consulta externa,repetidas en personas de 15 a 59 anos,2005-10-01,2,2,2,2,4
BELEN DE URMIRI,consulta externa,repetidas en personas de 15 a 59 anos,2005-10-01,5,5,5,5,10
BERMEJO,consulta externa,repetidas en personas de 15 a 59 anos,2005-10-01,128,172,128,172,300
BETANZOS,consulta externa,repetidas en personas de 15 a 59 anos,2005-10-01,40,39,40,39,79
BOLIVAR,consulta externa,repetidas en personas de 15 a 59 anos,2005-10-01,2,1,2,1,3
BOLPEBRA,consulta externa,repetidas en personas de 15 a 59 anos,2005-10-01,0,1,0,1,1
BOYUIBE,consulta externa,repetidas en personas de 15 a 59 anos,2005-10-01,6,15,6,15,21
BUENA VISTA,consulta externa,repetidas en personas de 15 a 59 anos,2005-10-01,38,91,38,91,129
CABEZAS,consulta externa,repetidas en personas de 15 a 59 anos,2005-10-01,20,9,20,9,29
CAIROMA,consulta externa,repetidas en personas de 15 a 59 anos,2005-10-01,4,1,4,1,5
"CAIZA ""D""",consulta externa,repetidas en personas de 15 a 59 anos,2005-10-01,7,6,7,6,13
CAJUATA,consulta externa,repetidas en personas de 15 a 59 anos,2005-10-01,1,2,1,2,3
CALAMARCA,consulta externa,repetidas en personas de 15 a 59 anos,2005-10-01,3,10,3,10,13
CAMARGO,consulta externa,repetidas en personas de 15 a 59 anos,2005-10-01,16,43,16,43,59
CAMATAQUI (C. VILLA ABECIA),consulta externa,repetidas en personas de 15 a 59 anos,2005-10-01,3,2,3,2,5
CAMIRI,consulta externa,repetidas en personas de 15 a 59 anos,2005-10-01,62,176,62,176,238
CAPINOTA,consulta externa,repetidas en personas de 15 a 59 anos,2005-10-01,64,75,64,75,139
CAQUIAVIRI,consulta externa,repetidas en personas de 15 a 59 anos,2005-10-01,2,3,2,3,5
CARACOLLO,consulta externa,repetidas en personas de 15 a 59 anos,2005-10-01,4,18,4,18,22
CARANAVI,consulta externa,repetidas en personas de 15 a 59 anos,2005-10-01,36,65,36,65,101
CARAPARI,consulta externa,repetidas en personas de 15 a 59 anos,2005-10-01,5,0,5,0,5
CARIPUYO,consulta externa,repetidas en personas de 15 a 59 anos,2005-10-01,0,1,0,1,1
CARMEN RIVERO TORREZ,consulta externa,repetidas en personas de 15 a 59 anos,2005-10-01,1,4,1,4,5
CATACORA,consulta externa,repetidas en personas de 15 a 59 anos,2005-10-01,0,1,0,1,1
CHACARILLA,consulta externa,repetidas en personas de 15 a 59 anos,2005-10-01,0,1,0,1,1
CHALLAPATA,consulta externa,repetidas en personas de 15 a 59 anos,2005-10-01,44,110,44,110,154
CHAQUI,consulta externa,repetidas en personas de 15 a 59 anos,2005-10-01,2,4,2,4,6
CHARAGUA,consulta externa,repetidas en personas de 15 a 59 anos,2005-10-01,19,49,19,49,68
CHARAÑA,consulta externa,repetidas en personas de 15 a 59 anos,2005-10-01,1,1,1,1,2
CHAYANTA,consulta externa,repetidas en personas de 15 a 59 anos,2005-10-01,18,33,18,33,51
CHIMORE,consulta externa,repetidas en personas de 15 a 59 anos,2005-10-01,7,39,7,39,46
CHIPAYA,consulta externa,repetidas en personas de 15 a 59 anos,2005-10-01,0,1,0,1,1
CHOQUE COTA,consulta externa,repetidas en personas de 15 a 59 anos,2005-10-01,1,4,1,4,5
CHULUMANI (V. DE LA LIBERTAD),consulta externa,repetidas en personas de 15 a 59 anos,2005-10-01,33,37,33,37,70
CHUMA,consulta externa,repetidas en personas de 15 a 59 anos,2005-10-01,6,9,6,9,15
CLIZA,consulta externa,repetidas en personas de 15 a 59 anos,2005-10-01,2,4,2,4,6
COBIJA,consulta externa,repetidas en personas de 15 a 59 anos,2005-10-01,80,435,80,435,515
COCHABAMBA,consulta externa,repetidas en personas de 15 a 59 anos,2005-10-01,9050,20398,9050,20398,29448
COLCAPIRHUA,consulta externa,repetidas en personas de 15 a 59 anos,2005-10-01,145,271,145,271,416
"COLCHA ""K""",consulta externa,repetidas en personas de 15 a 59 anos,2005-10-01,2,10,2,10,12
COLLANA,consulta externa,repetidas en personas de 15 a 59 anos,2005-10-01,5,5,5,5,10
COLOMI,consulta externa,repetidas en personas de 15 a 59 anos,2005-10-01,10,13,10,13,23
COLPA BELGICA,consulta externa,repetidas en personas de 15 a 59 anos,2005-10-01,19,65,19,65,84
COLQUECHACA,consulta externa,repetidas en personas de 15 a 59 anos,2005-10-01,14,13,14,13,27
COLQUENCHA,consulta externa,repetidas en personas de 15 a 59 anos,2005-10-01,1,1,1,1,2
COLQUIRI,consulta externa,repetidas en personas de 15 a 59 anos,2005-10-01,10,7,10,7,17
COMANCHE,consulta externa,repetidas en personas de 15 a 59 anos,2005-10-01,2,3,2,3,5
COMARAPA,consulta externa,repetidas en personas de 15 a 59 anos,2005-10-01,28,35,28,35,63
COMBAYA,consulta externa,repetidas en personas de 15 a 59 anos,2005-10-01,1,3,1,3,4
CONCEPCION,consulta externa,repetidas en personas de 15 a 59 anos,2005-10-01,0,1,0,1,1
COPACABANA,consulta externa,repetidas en personas de 15 a 59 anos,2005-10-01,0,5,0,5,5
CORIPATA,consulta externa,repetidas en personas de 15 a 59 anos,2005-10-01,3,7,3,7,10
CORO CORO,consulta externa,repetidas en personas de 15 a 59 anos,2005-10-01,2,1,2,1,3
COROICO,consulta externa,repetidas en personas de 15 a 59 anos,2005-10-01,81,145,81,145,226
CORQUE,consulta externa,repetidas en personas de 15 a 59 anos,2005-10-01,25,19,25,19,44
COTAGAITA,consulta externa,repetidas en personas de 15 a 59 anos,2005-10-01,89,96,89,96,185
COTOCA,consulta externa,repetidas en personas de 15 a 59 anos,2005-10-01,1,120,1,120,121
CUATRO CAÑADAS,consulta externa,repetidas en personas de 15 a 59 anos,2005-10-01,16,80,16,80,96
CUCHUMUELA (V. G. VILLARROEL),consulta externa,repetidas en personas de 15 a 59 anos,2005-10-01,9,9,9,9,18
CUEVO,consulta externa,repetidas en personas de 15 a 59 anos,2005-10-01,2,8,2,8,10
CULPINA,consulta externa,repetidas en personas de 15 a 59 anos,2005-10-01,3,19,3,19,22
CURAHUARA DE CARANGAS,consulta externa,repetidas en personas de 15 a 59 anos,2005-10-01,2,0,2,0,2
EL ALTO,consulta externa,repetidas en personas de 15 a 59 anos,2005-10-01,3520,6196,3520,6196,9716
EL CHORO,consulta externa,repetidas en personas de 15 a 59 anos,2005-10-01,1,1,1,1,2
EL PUENTE(STC),consulta externa,repetidas en personas de 15 a 59 anos,2005-10-01,2,1,2,1,3
EL PUENTE(TJA),consulta externa,repetidas en personas de 15 a 59 anos,2005-10-01,3,11,3,11,14
EL TORNO,consulta externa,repetidas en personas de 15 a 59 anos,2005-10-01,142,247,142,247,389
EL VILLAR,consulta externa,repetidas en personas de 15 a 59 anos,2005-10-01,1,5,1,5,6
ENTRE RIOS,consulta externa,repetidas en personas de 15 a 59 anos,2005-10-01,27,29,27,29,56
ENTRE RIOS,consulta externa,repetidas en personas de 15 a 59 anos,2005-10-01,13,19,13,19,32
EUCALIPTUS,consulta externa,repetidas en personas de 15 a 59 anos,2005-10-01,2,9,2,9,11
EUREKA (SANTOS MERCADO),consulta externa,repetidas en personas de 15 a 59 anos,2005-10-01,5,1,5,1,6
EXALTACION,consulta externa,repetidas en personas de 15 a 59 anos,2005-10-01,1,13,1,13,14
FERNANDEZ ALONSO,consulta externa,repetidas en personas de 15 a 59 anos,2005-10-01,10,18,10,18,28
FILADELFIA,consulta externa,repetidas en personas de 15 a 59 anos,2005-10-01,2,3,2,3,5
GENERAL SAAVEDRA,consulta externa,repetidas en personas de 15 a 59 anos,2005-10-01,6,14,6,14,20
GRAL. J.J. PEREZ (CHARAZANI),consulta externa,repetidas en personas de 15 a 59 anos,2005-10-01,5,12,5,12,17
GUANAY,consulta externa,repetidas en personas de 15 a 59 anos,2005-10-01,4,3,4,3,7
GUAQUI,consulta externa,repetidas en personas de 15 a 59 anos,2005-10-01,6,16,6,16,22
GUAYARAMERIN,consulta externa,repetidas en personas de 15 a 59 anos,2005-10-01,178,209,178,209,387
GUTIERREZ,consulta externa,repetidas en personas de 15 a 59 anos,2005-10-01,19,21,19,21,40
HUACARETA,consulta externa,repetidas en personas de 15 a 59 anos,2005-10-01,24,38,24,38,62
HUACAYA (VILLA DE HUACAYA),consulta externa,repetidas en personas de 15 a 59 anos,2005-10-01,0,2,0,2,2
HUACHACALLA,consulta externa,repetidas en personas de 15 a 59 anos,2005-10-01,3,1,3,1,4
HUANUNI,consulta externa,repetidas en personas de 15 a 59 anos,2005-10-01,116,88,116,88,204
HUARACAJE,consulta externa,repetidas en personas de 15 a 59 anos,2005-10-01,1,4,1,4,5
HUAYLLAMARCA,consulta externa,repetidas en personas de 15 a 59 anos,2005-10-01,4,1,4,1,5
ICHOCA,consulta externa,repetidas en personas de 15 a 59 anos,2005-10-01,4,0,4,0,4
ICLA,consulta externa,repetidas en personas de 15 a 59 anos,2005-10-01,5,8,5,8,13
INCAHUASI,consulta externa,repetidas en personas de 15 a 59 anos,2005-10-01,8,14,8,14,22
INGAVI (HUMAITA),consulta externa,repetidas en personas de 15 a 59 anos,2005-10-01,0,1,0,1,1
INQUISIVI,consulta externa,repetidas en personas de 15 a 59 anos,2005-10-01,0,3,0,3,3
IRUPANA (VILLA DE LANZA),consulta externa,repetidas en personas de 15 a 59 anos,2005-10-01,8,14,8,14,22
IXIAMAS,consulta externa,repetidas en personas de 15 a 59 anos,2005-10-01,7,6,7,6,13
JESUS DE MACHACA,consulta externa,repetidas en personas de 15 a 59 anos,2005-10-01,7,17,7,17,24
LA ASUNTA,consulta externa,repetidas en personas de 15 a 59 anos,2005-10-01,1,1,1,1,2
LA GUARDIA,consulta externa,repetidas en personas de 15 a 59 anos,2005-10-01,28,180,28,180,208
LA PAZ,consulta externa,repetidas en personas de 15 a 59 anos,2005-10-01,12606,28963,12606,28963,41569
LA RIVERA,consulta externa,repetidas en personas de 15 a 59 anos,2005-10-01,1,1,1,1,2
LAGUNILLAS,consulta externa,repetidas en personas de 15 a 59 anos,2005-10-01,2,3,2,3,5
LAJA,consulta externa,repetidas en personas de 15 a 59 anos,2005-10-01,8,11,8,11,19
LAS CARRERAS,consulta externa,repetidas en personas de 15 a 59 anos,2005-10-01,6,10,6,10,16
LLALLAGUA,consulta externa,repetidas en personas de 15 a 59 anos,2005-10-01,61,139,61,139,200
LLICA,consulta externa,repetidas en personas de 15 a 59 anos,2005-10-01,12,9,12,9,21
LORETO,consulta externa,repetidas en personas de 15 a 59 anos,2005-10-01,3,18,3,18,21
LURIBAY,consulta externa,repetidas en personas de 15 a 59 anos,2005-10-01,0,3,0,3,3
MACHACAMARCA,consulta externa,repetidas en personas de 15 a 59 anos,2005-10-01,15,17,15,17,32
MACHARETI,consulta externa,repetidas en personas de 15 a 59 anos,2005-10-01,10,56,10,56,66
MAGDALENA,consulta externa,repetidas en personas de 15 a 59 anos,2005-10-01,67,101,67,101,168
MAIRANA,consulta externa,repetidas en personas de 15 a 59 anos,2005-10-01,0,3,0,3,3
MALLA,consulta externa,repetidas en personas de 15 a 59 anos,2005-10-01,1,3,1,3,4
MAPIRI,consulta externa,repetidas en personas de 15 a 59 anos,2005-10-01,0,3,0,3,3
MECAPACA,consulta externa,repetidas en personas de 15 a 59 anos,2005-10-01,29,19,29,19,48
MINEROS,consulta externa,repetidas en personas de 15 a 59 anos,2005-10-01,15,51,15,51,66
MIZQUE,consulta externa,repetidas en personas de 15 a 59 anos,2005-10-01,1,4,1,4,5
MOCOMOCO,consulta externa,repetidas en personas de 15 a 59 anos,2005-10-01,15,13,15,13,28
MOJINETE,consulta externa,repetidas en personas de 15 a 59 anos,2005-10-01,6,6,6,6,12
MOJOCOYA,consulta externa,repetidas en personas de 15 a 59 anos,2005-10-01,7,11,7,11,18
MONTEAGUDO,consulta externa,repetidas en personas de 15 a 59 anos,2005-10-01,69,317,69,317,386
MONTERO,consulta externa,repetidas en personas de 15 a 59 anos,2005-10-01,742,1559,742,1559,2301
MOROCHATA,consulta externa,repetidas en personas de 15 a 59 anos,2005-10-01,13,72,13,72,85
NACEBE (SANTA ROSA DEL ABUNA),consulta externa,repetidas en personas de 15 a 59 anos,2005-10-01,1,9,1,9,10
NAZACARA DE PACAJES,consulta externa,repetidas en personas de 15 a 59 anos,2005-10-01,1,0,1,0,1
NUEVO MANOA (NUEVA ESPERANZA),consulta externa,repetidas en personas de 15 a 59 anos,2005-10-01,1,8,1,8,9
OCURI,consulta externa,repetidas en personas de 15 a 59 anos,2005-10-01,0,2,0,2,2
OKINAWA,consulta externa,repetidas en personas de 15 a 59 anos,2005-10-01,12,76,12,76,88
OMEREQUE,consulta externa,repetidas en personas de 15 a 59 anos,2005-10-01,7,12,7,12,19
ORURO,consulta externa,repetidas en personas de 15 a 59 anos,2005-10-01,1889,4588,1889,4588,6477
PADCAYA,consulta externa,repetidas en personas de 15 a 59 anos,2005-10-01,24,19,24,19,43
PADILLA,consulta externa,repetidas en personas de 15 a 59 anos,2005-10-01,14,23,14,23,37
PAILON,consulta externa,repetidas en personas de 15 a 59 anos,2005-10-01,11,14,11,14,25
PALCA,consulta externa,repetidas en personas de 15 a 59 anos,2005-10-01,5,4,5,4,9
PALOS BLANCOS,consulta externa,repetidas en personas de 15 a 59 anos,2005-10-01,99,88,99,88,187
PAMPA AULLAGAS,consulta externa,repetidas en personas de 15 a 59 anos,2005-10-01,0,1,0,1,1
PAMPA GRANDE,consulta externa,repetidas en personas de 15 a 59 anos,2005-10-01,6,10,6,10,16
PAPEL PAMPA,consulta externa,repetidas en personas de 15 a 59 anos,2005-10-01,6,6,6,6,12
PATACAMAYA,consulta externa,repetidas en personas de 15 a 59 anos,2005-10-01,5,35,5,35,40
PAZÑA,consulta externa,repetidas en personas de 15 a 59 anos,2005-10-01,26,24,26,24,50
PELECHUCO,consulta externa,repetidas en personas de 15 a 59 anos,2005-10-01,5,0,5,0,5
POCOATA,consulta externa,repetidas en personas de 15 a 59 anos,2005-10-01,11,8,11,8,19
POCONA,consulta externa,repetidas en personas de 15 a 59 anos,2005-10-01,5,6,5,6,11
POJO (CBBA),consulta externa,repetidas en personas de 15 a 59 anos,2005-10-01,1,2,1,2,3
POOPO,consulta externa,repetidas en personas de 15 a 59 anos,2005-10-01,4,9,4,9,13
PORCO,consulta externa,repetidas en personas de 15 a 59 anos,2005-10-01,4,1,4,1,5
POROMA,consulta externa,repetidas en personas de 15 a 59 anos,2005-10-01,8,18,8,18,26
PORONGO,consulta externa,repetidas en personas de 15 a 59 anos,2005-10-01,4,10,4,10,14
PORTACHUELO,consulta externa,repetidas en personas de 15 a 59 anos,2005-10-01,26,53,26,53,79
PORVENIR,consulta externa,repetidas en personas de 15 a 59 anos,2005-10-01,1,0,1,0,1
POSTRER VALLE,consulta externa,repetidas en personas de 15 a 59 anos,2005-10-01,4,2,4,2,6
POTOSI,consulta externa,repetidas en personas de 15 a 59 anos,2005-10-01,2135,4576,2135,4576,6711
PRESTO,consulta externa,repetidas en personas de 15 a 59 anos,2005-10-01,0,4,0,4,4
PUCARA,consulta externa,repetidas en personas de 15 a 59 anos,2005-10-01,0,9,0,9,9
PUCARANI,consulta externa,repetidas en personas de 15 a 59 anos,2005-10-01,15,16,15,16,31
PUERTO ACOSTA,consulta externa,repetidas en personas de 15 a 59 anos,2005-10-01,14,68,14,68,82
PUERTO CARABUCO,consulta externa,repetidas en personas de 15 a 59 anos,2005-10-01,7,7,7,7,14
PUERTO GONZALO MORENO,consulta externa,repetidas en personas de 15 a 59 anos,2005-10-01,15,15,15,15,30
PUERTO PEREZ,consulta externa,repetidas en personas de 15 a 59 anos,2005-10-01,15,13,15,13,28
PUERTO QUIJARRO,consulta externa,repetidas en personas de 15 a 59 anos,2005-10-01,120,95,120,95,215
PUERTO RICO,consulta externa,repetidas en personas de 15 a 59 anos,2005-10-01,1,3,1,3,4
PUERTO SUAREZ,consulta externa,repetidas en personas de 15 a 59 anos,2005-10-01,27,111,27,111,138
PUERTO VILLARROEL,consulta externa,repetidas en personas de 15 a 59 anos,2005-10-01,39,65,39,65,104
PUNA,consulta externa,repetidas en personas de 15 a 59 anos,2005-10-01,7,20,7,20,27
PUNATA,consulta externa,repetidas en personas de 15 a 59 anos,2005-10-01,135,256,135,256,391
QUILLACOLLO,consulta externa,repetidas en personas de 15 a 59 anos,2005-10-01,33,230,33,230,263
QUIME,consulta externa,repetidas en personas de 15 a 59 anos,2005-10-01,7,7,7,7,14
QUIRUSILLAS,consulta externa,repetidas en personas de 15 a 59 anos,2005-10-01,0,1,0,1,1
RAVELO,consulta externa,repetidas en personas de 15 a 59 anos,2005-10-01,1,0,1,0,1
REYES,consulta externa,repetidas en personas de 15 a 59 anos,2005-10-01,18,45,18,45,63
RIBERALTA,consulta externa,repetidas en personas de 15 a 59 anos,2005-10-01,31,409,31,409,440
ROBORE,consulta externa,repetidas en personas de 15 a 59 anos,2005-10-01,27,87,27,87,114
RURRENABAQUE,consulta externa,repetidas en personas de 15 a 59 anos,2005-10-01,22,47,22,47,69
SABAYA,consulta externa,repetidas en personas de 15 a 59 anos,2005-10-01,0,1,0,1,1
SACABA,consulta externa,repetidas en personas de 15 a 59 anos,2005-10-01,178,450,178,450,628
SACABAMBA,consulta externa,repetidas en personas de 15 a 59 anos,2005-10-01,9,12,9,12,21
SACACA,consulta externa,repetidas en personas de 15 a 59 anos,2005-10-01,1,1,1,1,2
SAIPINA,consulta externa,repetidas en personas de 15 a 59 anos,2005-10-01,1,5,1,5,6
SALINAS DE GARCI MENDOZA,consulta externa,repetidas en personas de 15 a 59 anos,2005-10-01,4,6,4,6,10
SAMAIPATA,consulta externa,repetidas en personas de 15 a 59 anos,2005-10-01,2,5,2,5,7
SAN AGUSTIN,consulta externa,repetidas en personas de 15 a 59 anos,2005-10-01,0,5,0,5,5
SAN ANDRES,consulta externa,repetidas en personas de 15 a 59 anos,2005-10-01,8,8,8,8,16
SAN ANDRES DE MACHACA,consulta externa,repetidas en personas de 15 a 59 anos,2005-10-01,0,6,0,6,6
SAN ANTONIO DE ESMORUCO,consulta externa,repetidas en personas de 15 a 59 anos,2005-10-01,0,7,0,7,7
SAN BENITO,consulta externa,repetidas en personas de 15 a 59 anos,2005-10-01,11,19,11,19,30
SAN BORJA,consulta externa,repetidas en personas de 15 a 59 anos,2005-10-01,33,94,33,94,127
SAN BUENA VENTURA,consulta externa,repetidas en personas de 15 a 59 anos,2005-10-01,11,12,11,12,23
SAN CARLOS,consulta externa,repetidas en personas de 15 a 59 anos,2005-10-01,9,53,9,53,62
SAN IGNACIO,consulta externa,repetidas en personas de 15 a 59 anos,2005-10-01,24,68,24,68,92
SAN IGNACIO DE VELASCO,consulta externa,repetidas en personas de 15 a 59 anos,2005-10-01,57,149,57,149,206
SAN JAVIER(BNI),consulta externa,repetidas en personas de 15 a 59 anos,2005-10-01,2,14,2,14,16
SAN JAVIER(STC),consulta externa,repetidas en personas de 15 a 59 anos,2005-10-01,9,55,9,55,64
SAN JOAQUIN,consulta externa,repetidas en personas de 15 a 59 anos,2005-10-01,2,7,2,7,9
SAN JOSE DE CHIQUITOS,consulta externa,repetidas en personas de 15 a 59 anos,2005-10-01,17,22,17,22,39
SAN JUAN DE YAPACANI,consulta externa,repetidas en personas de 15 a 59 anos,2005-10-01,13,35,13,35,48
SAN JULIAN,consulta externa,repetidas en personas de 15 a 59 anos,2005-10-01,33,349,33,349,382
SAN LORENZO(PND),consulta externa,repetidas en personas de 15 a 59 anos,2005-10-01,2,5,2,5,7
SAN LORENZO(TJA),consulta externa,repetidas en personas de 15 a 59 anos,2005-10-01,2,20,2,20,22
SAN LUCAS,consulta externa,repetidas en personas de 15 a 59 anos,2005-10-01,11,18,11,18,29
SAN MATIAS,consulta externa,repetidas en personas de 15 a 59 anos,2005-10-01,2,61,2,61,63
SAN MIGUEL DE VELASCO,consulta externa,repetidas en personas de 15 a 59 anos,2005-10-01,27,80,27,80,107
SAN PABLO DE LIPEZ,consulta externa,repetidas en personas de 15 a 59 anos,2005-10-01,5,10,5,10,15
SAN PEDRO,consulta externa,repetidas en personas de 15 a 59 anos,2005-10-01,29,66,29,66,95
SAN PEDRO DE BUENA VISTA,consulta externa,repetidas en personas de 15 a 59 anos,2005-10-01,1,0,1,0,1
SAN PEDRO DE CURAHUARA,consulta externa,repetidas en personas de 15 a 59 anos,2005-10-01,2,4,2,4,6
SAN PEDRO DE TIQUINA,consulta externa,repetidas en personas de 15 a 59 anos,2005-10-01,3,2,3,2,5
SAN PEDRO(PND),consulta externa,repetidas en personas de 15 a 59 anos,2005-10-01,5,6,5,6,11
SAN RAFAEL,consulta externa,repetidas en personas de 15 a 59 anos,2005-10-01,8,16,8,16,24
SAN RAMON,consulta externa,repetidas en personas de 15 a 59 anos,2005-10-01,1,40,1,40,41
SAN RAMON,consulta externa,repetidas en personas de 15 a 59 anos,2005-10-01,10,97,10,97,107
SANTA ANA,consulta externa,repetidas en personas de 15 a 59 anos,2005-10-01,12,98,12,98,110
SANTA CRUZ DE LA SIERRA,consulta externa,repetidas en personas de 15 a 59 anos,2005-10-01,6570,15998,6570,15998,22568
SANTA ROSA,consulta externa,repetidas en personas de 15 a 59 anos,2005-10-01,3,20,3,20,23
SANTA ROSA DEL SARA,consulta externa,repetidas en personas de 15 a 59 anos,2005-10-01,9,30,9,30,39
SANTIAGO DE CALLAPA,consulta externa,repetidas en personas de 15 a 59 anos,2005-10-01,0,1,0,1,1
SANTIAGO DE HUARI,consulta externa,repetidas en personas de 15 a 59 anos,2005-10-01,63,26,63,26,89
SANTIAGO DE MACHACA,consulta externa,repetidas en personas de 15 a 59 anos,2005-10-01,2,1,2,1,3
SANTIVAÑES,consulta externa,repetidas en personas de 15 a 59 anos,2005-10-01,9,8,9,8,17
SAPAHAQUI,consulta externa,repetidas en personas de 15 a 59 anos,2005-10-01,1,7,1,7,8
SICA SICA (VILLA AROMA),consulta externa,repetidas en personas de 15 a 59 anos,2005-10-01,10,2,10,2,12
SICAYA,consulta externa,repetidas en personas de 15 a 59 anos,2005-10-01,3,1,3,1,4
SIPE SIPE,consulta externa,repetidas en personas de 15 a 59 anos,2005-10-01,16,142,16,142,158
SOPACHUY,consulta externa,repetidas en personas de 15 a 59 anos,2005-10-01,1,0,1,0,1
SORACACHI,consulta externa,repetidas en personas de 15 a 59 anos,2005-10-01,5,2,5,2,7
SORATA,consulta externa,repetidas en personas de 15 a 59 anos,2005-10-01,16,23,16,23,39
SUCRE,consulta externa,repetidas en personas de 15 a 59 anos,2005-10-01,2613,6901,2613,6901,9514
TACACHI,consulta externa,repetidas en personas de 15 a 59 anos,2005-10-01,10,29,10,29,39
TACACOMA,consulta externa,repetidas en personas de 15 a 59 anos,2005-10-01,1,1,1,1,2
TACOBAMBA,consulta externa,repetidas en personas de 15 a 59 anos,2005-10-01,5,3,5,3,8
TACOPAYA,consulta externa,repetidas en personas de 15 a 59 anos,2005-10-01,1,1,1,1,2
TAHUA,consulta externa,repetidas en personas de 15 a 59 anos,2005-10-01,2,2,2,2,4
TAPACARI,consulta externa,repetidas en personas de 15 a 59 anos,2005-10-01,11,58,11,58,69
TARABUCO,consulta externa,repetidas en personas de 15 a 59 anos,2005-10-01,14,31,14,31,45
TARACO,consulta externa,repetidas en personas de 15 a 59 anos,2005-10-01,1,1,1,1,2
TARATA,consulta externa,repetidas en personas de 15 a 59 anos,2005-10-01,5,7,5,7,12
TARIJA,consulta externa,repetidas en personas de 15 a 59 anos,2005-10-01,2187,5938,2187,5938,8125
TARVITA,consulta externa,repetidas en personas de 15 a 59 anos,2005-10-01,4,12,4,12,16
TEOPONTE,consulta externa,repetidas en personas de 15 a 59 anos,2005-10-01,5,6,5,6,11
TIAWANACU,consulta externa,repetidas en personas de 15 a 59 anos,2005-10-01,11,4,11,4,15
TINGUIPAYA,consulta externa,repetidas en personas de 15 a 59 anos,2005-10-01,0,5,0,5,5
TIPUANI,consulta externa,repetidas en personas de 15 a 59 anos,2005-10-01,20,31,20,31,51
TIQUIPAYA,consulta externa,repetidas en personas de 15 a 59 anos,2005-10-01,32,149,32,149,181
TIRAQUE (CBBA),consulta externa,repetidas en personas de 15 a 59 anos,2005-10-01,44,281,44,281,325
TITO YUPANQUI (PARQUIPUJIO),consulta externa,repetidas en personas de 15 a 59 anos,2005-10-01,6,3,6,3,9
TOCO,consulta externa,repetidas en personas de 15 a 59 anos,2005-10-01,2,1,2,1,3
TODOS SANTOS,consulta externa,repetidas en personas de 15 a 59 anos,2005-10-01,2,2,2,2,4
TOLATA,consulta externa,repetidas en personas de 15 a 59 anos,2005-10-01,1,7,1,7,8
TOLEDO,consulta externa,repetidas en personas de 15 a 59 anos,2005-10-01,7,10,7,10,17
TOMAVE,consulta externa,repetidas en personas de 15 a 59 anos,2005-10-01,5,10,5,10,15
TOMINA,consulta externa,repetidas en personas de 15 a 59 anos,2005-10-01,7,5,7,5,12
TORO TORO,consulta externa,repetidas en personas de 15 a 59 anos,2005-10-01,6,8,6,8,14
TOTORA(CBBA),consulta externa,repetidas en personas de 15 a 59 anos,2005-10-01,2,4,2,4,6
TOTORA(ORR),consulta externa,repetidas en personas de 15 a 59 anos,2005-10-01,1,1,1,1,2
TRIGAL,consulta externa,repetidas en personas de 15 a 59 anos,2005-10-01,2,0,2,0,2
TRINIDAD,consulta externa,repetidas en personas de 15 a 59 anos,2005-10-01,307,798,307,798,1105
TUPIZA,consulta externa,repetidas en personas de 15 a 59 anos,2005-10-01,138,235,138,235,373
TURCO,consulta externa,repetidas en personas de 15 a 59 anos,2005-10-01,2,0,2,0,2
UNCIA,consulta externa,repetidas en personas de 15 a 59 anos,2005-10-01,91,155,91,155,246
URIONDO (A. CONCEPCION),consulta externa,repetidas en personas de 15 a 59 anos,2005-10-01,4,8,4,8,12
URUBICHA,consulta externa,repetidas en personas de 15 a 59 anos,2005-10-01,0,70,0,70,70
UYUNI,consulta externa,repetidas en personas de 15 a 59 anos,2005-10-01,39,123,39,123,162
VACAS,consulta externa,repetidas en personas de 15 a 59 anos,2005-10-01,16,45,16,45,61
VALLEGRANDE,consulta externa,repetidas en personas de 15 a 59 anos,2005-10-01,66,147,66,147,213
VIACHA,consulta externa,repetidas en personas de 15 a 59 anos,2005-10-01,83,274,83,274,357
VILA VILA,consulta externa,repetidas en personas de 15 a 59 anos,2005-10-01,1,3,1,3,4
VILLA MONTES,consulta externa,repetidas en personas de 15 a 59 anos,2005-10-01,126,165,126,165,291
VILLA RIVERO,consulta externa,repetidas en personas de 15 a 59 anos,2005-10-01,2,25,2,25,27
VILLA SERRANO,consulta externa,repetidas en personas de 15 a 59 anos,2005-10-01,6,6,6,6,12
VILLA TUNARI,consulta externa,repetidas en personas de 15 a 59 anos,2005-10-01,53,94,53,94,147
VILLA VACA GUZMAN (MUYUPAMPA),consulta externa,repetidas en personas de 15 a 59 anos,2005-10-01,10,59,10,59,69
VILLAZON,consulta externa,repetidas en personas de 15 a 59 anos,2005-10-01,44,157,44,157,201
VINTO,consulta externa,repetidas en personas de 15 a 59 anos,2005-10-01,48,168,48,168,216
VITICHI,consulta externa,repetidas en personas de 15 a 59 anos,2005-10-01,9,14,9,14,23
WALDO BALLIVIAN,consulta externa,repetidas en personas de 15 a 59 anos,2005-10-01,4,1,4,1,5
WARNES,consulta externa,repetidas en personas de 15 a 59 anos,2005-10-01,15,92,15,92,107
YACUIBA,consulta externa,repetidas en personas de 15 a 59 anos,2005-10-01,311,1042,311,1042,1353
YAMPARAEZ,consulta externa,repetidas en personas de 15 a 59 anos,2005-10-01,15,29,15,29,44
YANACACHI,consulta externa,repetidas en personas de 15 a 59 anos,2005-10-01,2,13,2,13,15
YAPACANI,consulta externa,repetidas en personas de 15 a 59 anos,2005-10-01,11,287,11,287,298
YOCALLA,consulta externa,repetidas en personas de 15 a 59 anos,2005-10-01,0,2,0,2,2
YOTALA,consulta externa,repetidas en personas de 15 a 59 anos,2005-10-01,15,49,15,49,64
YUNCHARA,consulta externa,repetidas en personas de 15 a 59 anos,2005-10-01,2,1,2,1,3
ZUDAÑEZ,consulta externa,repetidas en personas de 15 a 59 anos,2005-10-01,2,13,2,13,15
ACACIO,consulta externa,repetidas en personas de 15 a 59 anos,2005-11-01,6,1,6,1,7
ACHACACHI,consulta externa,repetidas en personas de 15 a 59 anos,2005-11-01,44,37,44,37,81
ACHOCALLA,consulta externa,repetidas en personas de 15 a 59 anos,2005-11-01,7,16,7,16,23
AIQUILE,consulta externa,repetidas en personas de 15 a 59 anos,2005-11-01,58,354,58,354,412
ANCORAIMES,consulta externa,repetidas en personas de 15 a 59 anos,2005-11-01,5,12,5,12,17
ANDAMARCA,consulta externa,repetidas en personas de 15 a 59 anos,2005-11-01,3,1,3,1,4
ANTEQUERA,consulta externa,repetidas en personas de 15 a 59 anos,2005-11-01,0,6,0,6,6
ANZALDO,consulta externa,repetidas en personas de 15 a 59 anos,2005-11-01,2,1,2,1,3
APOLO,consulta externa,repetidas en personas de 15 a 59 anos,2005-11-01,12,13,12,13,25
ARANI,consulta externa,repetidas en personas de 15 a 59 anos,2005-11-01,3,5,3,5,8
ARBIETO,consulta externa,repetidas en personas de 15 a 59 anos,2005-11-01,9,29,9,29,38
ARQUE,consulta externa,repetidas en personas de 15 a 59 anos,2005-11-01,2,4,2,4,6
ATOCHA,consulta externa,repetidas en personas de 15 a 59 anos,2005-11-01,234,282,234,282,516
AUCAPATA,consulta externa,repetidas en personas de 15 a 59 anos,2005-11-01,2,5,2,5,7
AYATA,consulta externa,repetidas en personas de 15 a 59 anos,2005-11-01,1,4,1,4,5
AYO AYO,consulta externa,repetidas en personas de 15 a 59 anos,2005-11-01,4,11,4,11,15
AYOPAYA (V. DE INDEPENDENCIA),consulta externa,repetidas en personas de 15 a 59 anos,2005-11-01,4,17,4,17,21
AZURDUY,consulta externa,repetidas en personas de 15 a 59 anos,2005-11-01,0,8,0,8,8
BATALLAS,consulta externa,repetidas en personas de 15 a 59 anos,2005-11-01,4,12,4,12,16
BAURES,consulta externa,repetidas en personas de 15 a 59 anos,2005-11-01,12,14,12,14,26
BELEN DE ANDAMARCA,consulta externa,repetidas en personas de 15 a 59 anos,2005-11-01,5,5,5,5,10
BELEN DE URMIRI,consulta externa,repetidas en personas de 15 a 59 anos,2005-11-01,1,2,1,2,3
BELLA FLOR,consulta externa,repetidas en personas de 15 a 59 anos,2005-11-01,23,43,23,43,66
BERMEJO,consulta externa,repetidas en personas de 15 a 59 anos,2005-11-01,121,234,121,234,355
BETANZOS,consulta externa,repetidas en personas de 15 a 59 anos,2005-11-01,22,41,22,41,63
BOLIVAR,consulta externa,repetidas en personas de 15 a 59 anos,2005-11-01,11,7,11,7,18
BOLPEBRA,consulta externa,repetidas en personas de 15 a 59 anos,2005-11-01,3,1,3,1,4
BOYUIBE,consulta externa,repetidas en personas de 15 a 59 anos,2005-11-01,4,12,4,12,16
BUENA VISTA,consulta externa,repetidas en personas de 15 a 59 anos,2005-11-01,39,64,39,64,103
CABEZAS,consulta externa,repetidas en personas de 15 a 59 anos,2005-11-01,18,19,18,19,37
CAIROMA,consulta externa,repetidas en personas de 15 a 59 anos,2005-11-01,2,3,2,3,5
"CAIZA ""D""",consulta externa,repetidas en personas de 15 a 59 anos,2005-11-01,4,7,4,7,11
CAJUATA,consulta externa,repetidas en personas de 15 a 59 anos,2005-11-01,4,1,4,1,5
CALAMARCA,consulta externa,repetidas en personas de 15 a 59 anos,2005-11-01,6,16,6,16,22
CAMARGO,consulta externa,repetidas en personas de 15 a 59 anos,2005-11-01,13,25,13,25,38
CAMATAQUI (C. VILLA ABECIA),consulta externa,repetidas en personas de 15 a 59 anos,2005-11-01,3,2,3,2,5
CAMIRI,consulta externa,repetidas en personas de 15 a 59 anos,2005-11-01,46,110,46,110,156
CAPINOTA,consulta externa,repetidas en personas de 15 a 59 anos,2005-11-01,54,66,54,66,120
CAQUIAVIRI,consulta externa,repetidas en personas de 15 a 59 anos,2005-11-01,16,12,16,12,28
CARACOLLO,consulta externa,repetidas en personas de 15 a 59 anos,2005-11-01,1,11,1,11,12
CARANAVI,consulta externa,repetidas en personas de 15 a 59 anos,2005-11-01,17,18,17,18,35
CARAPARI,consulta externa,repetidas en personas de 15 a 59 anos,2005-11-01,4,2,4,2,6
CARIPUYO,consulta externa,repetidas en personas de 15 a 59 anos,2005-11-01,0,3,0,3,3
CARMEN RIVERO TORREZ,consulta externa,repetidas en personas de 15 a 59 anos,2005-11-01,2,3,2,3,5
CHALLAPATA,consulta externa,repetidas en personas de 15 a 59 anos,2005-11-01,38,87,38,87,125
CHAQUI,consulta externa,repetidas en personas de 15 a 59 anos,2005-11-01,0,2,0,2,2
CHARAGUA,consulta externa,repetidas en personas de 15 a 59 anos,2005-11-01,12,28,12,28,40
CHARAÑA,consulta externa,repetidas en personas de 15 a 59 anos,2005-11-01,5,2,5,2,7
CHAYANTA,consulta externa,repetidas en personas de 15 a 59 anos,2005-11-01,4,25,4,25,29
CHIMORE,consulta externa,repetidas en personas de 15 a 59 anos,2005-11-01,9,35,9,35,44
CHOQUE COTA,consulta externa,repetidas en personas de 15 a 59 anos,2005-11-01,8,11,8,11,19
CHULUMANI (V. DE LA LIBERTAD),consulta externa,repetidas en personas de 15 a 59 anos,2005-11-01,40,42,40,42,82
CHUMA,consulta externa,repetidas en personas de 15 a 59 anos,2005-11-01,10,27,10,27,37
CLIZA,consulta externa,repetidas en personas de 15 a 59 anos,2005-11-01,2,11,2,11,13
COBIJA,consulta externa,repetidas en personas de 15 a 59 anos,2005-11-01,74,497,74,497,571
COCHABAMBA,consulta externa,repetidas en personas de 15 a 59 anos,2005-11-01,7261,17208,7261,17208,24469
COLCAPIRHUA,consulta externa,repetidas en personas de 15 a 59 anos,2005-11-01,132,333,132,333,465
"COLCHA ""K""",consulta externa,repetidas en personas de 15 a 59 anos,2005-11-01,5,9,5,9,14
COLLANA,consulta externa,repetidas en personas de 15 a 59 anos,2005-11-01,12,5,12,5,17
COLOMI,consulta externa,repetidas en personas de 15 a 59 anos,2005-11-01,9,15,9,15,24
COLPA BELGICA,consulta externa,repetidas en personas de 15 a 59 anos,2005-11-01,2,38,2,38,40
COLQUECHACA,consulta externa,repetidas en personas de 15 a 59 anos,2005-11-01,33,18,33,18,51
COLQUENCHA,consulta externa,repetidas en personas de 15 a 59 anos,2005-11-01,2,0,2,0,2
COLQUIRI,consulta externa,repetidas en personas de 15 a 59 anos,2005-11-01,7,17,7,17,24
COMANCHE,consulta externa,repetidas en personas de 15 a 59 anos,2005-11-01,3,6,3,6,9
COMARAPA,consulta externa,repetidas en personas de 15 a 59 anos,2005-11-01,20,25,20,25,45
COPACABANA,consulta externa,repetidas en personas de 15 a 59 anos,2005-11-01,0,5,0,5,5
CORIPATA,consulta externa,repetidas en personas de 15 a 59 anos,2005-11-01,9,4,9,4,13
CORO CORO,consulta externa,repetidas en personas de 15 a 59 anos,2005-11-01,7,6,7,6,13
COROICO,consulta externa,repetidas en personas de 15 a 59 anos,2005-11-01,52,151,52,151,203
CORQUE,consulta externa,repetidas en personas de 15 a 59 anos,2005-11-01,14,11,14,11,25
COTAGAITA,consulta externa,repetidas en personas de 15 a 59 anos,2005-11-01,75,73,75,73,148
COTOCA,consulta externa,repetidas en personas de 15 a 59 anos,2005-11-01,0,80,0,80,80
CUATRO CAÑADAS,consulta externa,repetidas en personas de 15 a 59 anos,2005-11-01,11,94,11,94,105
CUCHUMUELA (V. G. VILLARROEL),consulta externa,repetidas en personas de 15 a 59 anos,2005-11-01,1,16,1,16,17
CUEVO,consulta externa,repetidas en personas de 15 a 59 anos,2005-11-01,3,3,3,3,6
CULPINA,consulta externa,repetidas en personas de 15 a 59 anos,2005-11-01,7,27,7,27,34
CURAHUARA DE CARANGAS,consulta externa,repetidas en personas de 15 a 59 anos,2005-11-01,3,9,3,9,12
DESAGUADERO,consulta externa,repetidas en personas de 15 a 59 anos,2005-11-01,1,0,1,0,1
EL ALTO,consulta externa,repetidas en personas de 15 a 59 anos,2005-11-01,2337,5211,2337,5211,7548
EL CHORO,consulta externa,repetidas en personas de 15 a 59 anos,2005-11-01,3,3,3,3,6
EL PUENTE(STC),consulta externa,repetidas en personas de 15 a 59 anos,2005-11-01,2,1,2,1,3
EL PUENTE(TJA),consulta externa,repetidas en personas de 15 a 59 anos,2005-11-01,4,7,4,7,11
EL TORNO,consulta externa,repetidas en personas de 15 a 59 anos,2005-11-01,152,214,152,214,366
EL VILLAR,consulta externa,repetidas en personas de 15 a 59 anos,2005-11-01,3,2,3,2,5
ENTRE RIOS,consulta externa,repetidas en personas de 15 a 59 anos,2005-11-01,19,18,19,18,37
ENTRE RIOS,consulta externa,repetidas en personas de 15 a 59 anos,2005-11-01,16,40,16,40,56
EUCALIPTUS,consulta externa,repetidas en personas de 15 a 59 anos,2005-11-01,1,3,1,3,4
EUREKA (SANTOS MERCADO),consulta externa,repetidas en personas de 15 a 59 anos,2005-11-01,2,0,2,0,2
EXALTACION,consulta externa,repetidas en personas de 15 a 59 anos,2005-11-01,1,5,1,5,6
FERNANDEZ ALONSO,consulta externa,repetidas en personas de 15 a 59 anos,2005-11-01,7,29,7,29,36
FILADELFIA,consulta externa,repetidas en personas de 15 a 59 anos,2005-11-01,1,8,1,8,9
GENERAL SAAVEDRA,consulta externa,repetidas en personas de 15 a 59 anos,2005-11-01,4,22,4,22,26
GRAL. J.J. PEREZ (CHARAZANI),consulta externa,repetidas en personas de 15 a 59 anos,2005-11-01,0,2,0,2,2
GUANAY,consulta externa,repetidas en personas de 15 a 59 anos,2005-11-01,1,3,1,3,4
GUAQUI,consulta externa,repetidas en personas de 15 a 59 anos,2005-11-01,7,18,7,18,25
GUAYARAMERIN,consulta externa,repetidas en personas de 15 a 59 anos,2005-11-01,93,132,93,132,225
GUTIERREZ,consulta externa,repetidas en personas de 15 a 59 anos,2005-11-01,14,14,14,14,28
HUACARETA,consulta externa,repetidas en personas de 15 a 59 anos,2005-11-01,17,30,17,30,47
HUACHACALLA,consulta externa,repetidas en personas de 15 a 59 anos,2005-11-01,2,2,2,2,4
HUANUNI,consulta externa,repetidas en personas de 15 a 59 anos,2005-11-01,129,135,129,135,264
HUARACAJE,consulta externa,repetidas en personas de 15 a 59 anos,2005-11-01,1,0,1,0,1
HUAYLLAMARCA,consulta externa,repetidas en personas de 15 a 59 anos,2005-11-01,0,1,0,1,1
ICHOCA,consulta externa,repetidas en personas de 15 a 59 anos,2005-11-01,3,3,3,3,6
ICLA,consulta externa,repetidas en personas de 15 a 59 anos,2005-11-01,10,5,10,5,15
INCAHUASI,consulta externa,repetidas en personas de 15 a 59 anos,2005-11-01,2,4,2,4,6
INGAVI (HUMAITA),consulta externa,repetidas en personas de 15 a 59 anos,2005-11-01,2,2,2,2,4
INQUISIVI,consulta externa,repetidas en personas de 15 a 59 anos,2005-11-01,7,3,7,3,10
IRUPANA (VILLA DE LANZA),consulta externa,repetidas en personas de 15 a 59 anos,2005-11-01,18,18,18,18,36
IXIAMAS,consulta externa,repetidas en personas de 15 a 59 anos,2005-11-01,10,13,10,13,23
JESUS DE MACHACA,consulta externa,repetidas en personas de 15 a 59 anos,2005-11-01,7,20,7,20,27
LA ASUNTA,consulta externa,repetidas en personas de 15 a 59 anos,2005-11-01,7,9,7,9,16
LA GUARDIA,consulta externa,repetidas en personas de 15 a 59 anos,2005-11-01,16,99,16,99,115
LA PAZ,consulta externa,repetidas en personas de 15 a 59 anos,2005-11-01,12147,29789,12147,29789,41936
LAGUNILLAS,consulta externa,repetidas en personas de 15 a 59 anos,2005-11-01,3,5,3,5,8
LAJA,consulta externa,repetidas en personas de 15 a 59 anos,2005-11-01,7,17,7,17,24
LAS CARRERAS,consulta externa,repetidas en personas de 15 a 59 anos,2005-11-01,1,12,1,12,13
LICOMA PAMPA,consulta externa,repetidas en personas de 15 a 59 anos,2005-11-01,1,0,1,0,1
LLALLAGUA,consulta externa,repetidas en personas de 15 a 59 anos,2005-11-01,55,97,55,97,152
LLICA,consulta externa,repetidas en personas de 15 a 59 anos,2005-11-01,6,14,6,14,20
LORETO,consulta externa,repetidas en personas de 15 a 59 anos,2005-11-01,6,10,6,10,16
LURIBAY,consulta externa,repetidas en personas de 15 a 59 anos,2005-11-01,1,2,1,2,3
MACHACAMARCA,consulta externa,repetidas en personas de 15 a 59 anos,2005-11-01,14,18,14,18,32
MACHARETI,consulta externa,repetidas en personas de 15 a 59 anos,2005-11-01,4,50,4,50,54
MAGDALENA,consulta externa,repetidas en personas de 15 a 59 anos,2005-11-01,30,92,30,92,122
MAIRANA,consulta externa,repetidas en personas de 15 a 59 anos,2005-11-01,1,4,1,4,5
MALLA,consulta externa,repetidas en personas de 15 a 59 anos,2005-11-01,2,3,2,3,5
MAPIRI,consulta externa,repetidas en personas de 15 a 59 anos,2005-11-01,1,0,1,0,1
MECAPACA,consulta externa,repetidas en personas de 15 a 59 anos,2005-11-01,28,17,28,17,45
MINEROS,consulta externa,repetidas en personas de 15 a 59 anos,2005-11-01,9,39,9,39,48
MIZQUE,consulta externa,repetidas en personas de 15 a 59 anos,2005-11-01,3,3,3,3,6
MOCOMOCO,consulta externa,repetidas en personas de 15 a 59 anos,2005-11-01,7,23,7,23,30
MOJINETE,consulta externa,repetidas en personas de 15 a 59 anos,2005-11-01,4,6,4,6,10
MOJOCOYA,consulta externa,repetidas en personas de 15 a 59 anos,2005-11-01,1,2,1,2,3
MONTEAGUDO,consulta externa,repetidas en personas de 15 a 59 anos,2005-11-01,94,249,94,249,343
MONTERO,consulta externa,repetidas en personas de 15 a 59 anos,2005-11-01,816,1552,816,1552,2368
MOROCHATA,consulta externa,repetidas en personas de 15 a 59 anos,2005-11-01,7,55,7,55,62
NACEBE (SANTA ROSA DEL ABUNA),consulta externa,repetidas en personas de 15 a 59 anos,2005-11-01,1,1,1,1,2
NUEVO MANOA (NUEVA ESPERANZA),consulta externa,repetidas en personas de 15 a 59 anos,2005-11-01,7,4,7,4,11
OCURI,consulta externa,repetidas en personas de 15 a 59 anos,2005-11-01,1,2,1,2,3
OKINAWA,consulta externa,repetidas en personas de 15 a 59 anos,2005-11-01,18,35,18,35,53
OMEREQUE,consulta externa,repetidas en personas de 15 a 59 anos,2005-11-01,1,5,1,5,6
ORURO,consulta externa,repetidas en personas de 15 a 59 anos,2005-11-01,1758,4569,1758,4569,6327
PADCAYA,consulta externa,repetidas en personas de 15 a 59 anos,2005-11-01,16,13,16,13,29
PADILLA,consulta externa,repetidas en personas de 15 a 59 anos,2005-11-01,13,22,13,22,35
PAILON,consulta externa,repetidas en personas de 15 a 59 anos,2005-11-01,0,3,0,3,3
PALCA,consulta externa,repetidas en personas de 15 a 59 anos,2005-11-01,2,6,2,6,8
PALOS BLANCOS,consulta externa,repetidas en personas de 15 a 59 anos,2005-11-01,125,70,125,70,195
PAMPA AULLAGAS,consulta externa,repetidas en personas de 15 a 59 anos,2005-11-01,1,2,1,2,3
PAMPA GRANDE,consulta externa,repetidas en personas de 15 a 59 anos,2005-11-01,0,5,0,5,5
PAPEL PAMPA,consulta externa,repetidas en personas de 15 a 59 anos,2005-11-01,3,6,3,6,9
PASORAPA,consulta externa,repetidas en personas de 15 a 59 anos,2005-11-01,0,3,0,3,3
PATACAMAYA,consulta externa,repetidas en personas de 15 a 59 anos,2005-11-01,3,8,3,8,11
PAZÑA,consulta externa,repetidas en personas de 15 a 59 anos,2005-11-01,12,36,12,36,48
PELECHUCO,consulta externa,repetidas en personas de 15 a 59 anos,2005-11-01,4,4,4,4,8
POCOATA,consulta externa,repetidas en personas de 15 a 59 anos,2005-11-01,12,6,12,6,18
POCONA,consulta externa,repetidas en personas de 15 a 59 anos,2005-11-01,9,8,9,8,17
POJO (CBBA),consulta externa,repetidas en personas de 15 a 59 anos,2005-11-01,1,0,1,0,1
POOPO,consulta externa,repetidas en personas de 15 a 59 anos,2005-11-01,11,2,11,2,13
PORCO,consulta externa,repetidas en personas de 15 a 59 anos,2005-11-01,3,3,3,3,6
POROMA,consulta externa,repetidas en personas de 15 a 59 anos,2005-11-01,2,9,2,9,11
PORONGO,consulta externa,repetidas en personas de 15 a 59 anos,2005-11-01,12,25,12,25,37
PORTACHUELO,consulta externa,repetidas en personas de 15 a 59 anos,2005-11-01,35,34,35,34,69
PORVENIR,consulta externa,repetidas en personas de 15 a 59 anos,2005-11-01,3,2,3,2,5
POSTRER VALLE,consulta externa,repetidas en personas de 15 a 59 anos,2005-11-01,7,2,7,2,9
POTOSI,consulta externa,repetidas en personas de 15 a 59 anos,2005-11-01,2425,4916,2425,4916,7341
PRESTO,consulta externa,repetidas en personas de 15 a 59 anos,2005-11-01,0,1,0,1,1
PUCARA,consulta externa,repetidas en personas de 15 a 59 anos,2005-11-01,0,1,0,1,1
PUCARANI,consulta externa,repetidas en personas de 15 a 59 anos,2005-11-01,8,9,8,9,17
PUERTO ACOSTA,consulta externa,repetidas en personas de 15 a 59 anos,2005-11-01,16,23,16,23,39
PUERTO CARABUCO,consulta externa,repetidas en personas de 15 a 59 anos,2005-11-01,8,10,8,10,18
PUERTO GONZALO MORENO,consulta externa,repetidas en personas de 15 a 59 anos,2005-11-01,4,6,4,6,10
PUERTO PEREZ,consulta externa,repetidas en personas de 15 a 59 anos,2005-11-01,11,5,11,5,16
PUERTO QUIJARRO,consulta externa,repetidas en personas de 15 a 59 anos,2005-11-01,29,79,29,79,108
PUERTO RICO,consulta externa,repetidas en personas de 15 a 59 anos,2005-11-01,5,2,5,2,7
PUERTO SILES,consulta externa,repetidas en personas de 15 a 59 anos,2005-11-01,5,5,5,5,10
PUERTO SUAREZ,consulta externa,repetidas en personas de 15 a 59 anos,2005-11-01,17,40,17,40,57
PUERTO VILLARROEL,consulta externa,repetidas en personas de 15 a 59 anos,2005-11-01,32,34,32,34,66
PUNA,consulta externa,repetidas en personas de 15 a 59 anos,2005-11-01,7,22,7,22,29
PUNATA,consulta externa,repetidas en personas de 15 a 59 anos,2005-11-01,90,217,90,217,307
QUILLACOLLO,consulta externa,repetidas en personas de 15 a 59 anos,2005-11-01,74,276,74,276,350
QUIME,consulta externa,repetidas en personas de 15 a 59 anos,2005-11-01,1,2,1,2,3
QUIRUSILLAS,consulta externa,repetidas en personas de 15 a 59 anos,2005-11-01,2,0,2,0,2
REYES,consulta externa,repetidas en personas de 15 a 59 anos,2005-11-01,16,23,16,23,39
RIBERALTA,consulta externa,repetidas en personas de 15 a 59 anos,2005-11-01,72,483,72,483,555
ROBORE,consulta externa,repetidas en personas de 15 a 59 anos,2005-11-01,18,118,18,118,136
RURRENABAQUE,consulta externa,repetidas en personas de 15 a 59 anos,2005-11-01,21,51,21,51,72
SACABA,consulta externa,repetidas en personas de 15 a 59 anos,2005-11-01,148,340,148,340,488
SACABAMBA,consulta externa,repetidas en personas de 15 a 59 anos,2005-11-01,5,7,5,7,12
SACACA,consulta externa,repetidas en personas de 15 a 59 anos,2005-11-01,1,6,1,6,7
SAIPINA,consulta externa,repetidas en personas de 15 a 59 anos,2005-11-01,36,88,36,88,124
SALINAS DE GARCI MENDOZA,consulta externa,repetidas en personas de 15 a 59 anos,2005-11-01,2,7,2,7,9
SAMAIPATA,consulta externa,repetidas en personas de 15 a 59 anos,2005-11-01,0,1,0,1,1
SAN AGUSTIN,consulta externa,repetidas en personas de 15 a 59 anos,2005-11-01,0,3,0,3,3
SAN ANDRES,consulta externa,repetidas en personas de 15 a 59 anos,2005-11-01,3,3,3,3,6
SAN ANDRES DE MACHACA,consulta externa,repetidas en personas de 15 a 59 anos,2005-11-01,2,9,2,9,11
SAN ANTONIO DE ESMORUCO,consulta externa,repetidas en personas de 15 a 59 anos,2005-11-01,2,6,2,6,8
SAN ANTONIO DE LOMERIO,consulta externa,repetidas en personas de 15 a 59 anos,2005-11-01,5,2,5,2,7
SAN BENITO,consulta externa,repetidas en personas de 15 a 59 anos,2005-11-01,9,42,9,42,51
SAN BORJA,consulta externa,repetidas en personas de 15 a 59 anos,2005-11-01,27,93,27,93,120
SAN BUENA VENTURA,consulta externa,repetidas en personas de 15 a 59 anos,2005-11-01,3,4,3,4,7
SAN CARLOS,consulta externa,repetidas en personas de 15 a 59 anos,2005-11-01,8,64,8,64,72
SAN IGNACIO,consulta externa,repetidas en personas de 15 a 59 anos,2005-11-01,23,102,23,102,125
SAN IGNACIO DE VELASCO,consulta externa,repetidas en personas de 15 a 59 anos,2005-11-01,66,131,66,131,197
SAN JAVIER(BNI),consulta externa,repetidas en personas de 15 a 59 anos,2005-11-01,2,4,2,4,6
SAN JAVIER(STC),consulta externa,repetidas en personas de 15 a 59 anos,2005-11-01,7,53,7,53,60
SAN JOAQUIN,consulta externa,repetidas en personas de 15 a 59 anos,2005-11-01,9,16,9,16,25
SAN JOSE DE CHIQUITOS,consulta externa,repetidas en personas de 15 a 59 anos,2005-11-01,4,6,4,6,10
SAN JUAN DE YAPACANI,consulta externa,repetidas en personas de 15 a 59 anos,2005-11-01,16,33,16,33,49
SAN JULIAN,consulta externa,repetidas en personas de 15 a 59 anos,2005-11-01,60,334,60,334,394
SAN LORENZO(PND),consulta externa,repetidas en personas de 15 a 59 anos,2005-11-01,1,3,1,3,4
SAN LORENZO(TJA),consulta externa,repetidas en personas de 15 a 59 anos,2005-11-01,6,16,6,16,22
SAN LUCAS,consulta externa,repetidas en personas de 15 a 59 anos,2005-11-01,16,26,16,26,42
SAN MATIAS,consulta externa,repetidas en personas de 15 a 59 anos,2005-11-01,1,67,1,67,68
SAN MIGUEL DE VELASCO,consulta externa,repetidas en personas de 15 a 59 anos,2005-11-01,30,88,30,88,118
SAN PABLO DE LIPEZ,consulta externa,repetidas en personas de 15 a 59 anos,2005-11-01,7,8,7,8,15
SAN PEDRO,consulta externa,repetidas en personas de 15 a 59 anos,2005-11-01,47,87,47,87,134
SAN PEDRO DE BUENA VISTA,consulta externa,repetidas en personas de 15 a 59 anos,2005-11-01,0,3,0,3,3
SAN PEDRO DE CURAHUARA,consulta externa,repetidas en personas de 15 a 59 anos,2005-11-01,3,3,3,3,6
SAN PEDRO DE TIQUINA,consulta externa,repetidas en personas de 15 a 59 anos,2005-11-01,3,6,3,6,9
SAN PEDRO(PND),consulta externa,repetidas en personas de 15 a 59 anos,2005-11-01,4,0,4,0,4
SAN RAFAEL,consulta externa,repetidas en personas de 15 a 59 anos,2005-11-01,2,7,2,7,9
SAN RAMON,consulta externa,repetidas en personas de 15 a 59 anos,2005-11-01,7,110,7,110,117
SAN RAMON,consulta externa,repetidas en personas de 15 a 59 anos,2005-11-01,7,17,7,17,24
SANTA ANA,consulta externa,repetidas en personas de 15 a 59 anos,2005-11-01,11,88,11,88,99
SANTA CRUZ DE LA SIERRA,consulta externa,repetidas en personas de 15 a 59 anos,2005-11-01,5356,16030,5356,16030,21386
SANTA ROSA,consulta externa,repetidas en personas de 15 a 59 anos,2005-11-01,1,6,1,6,7
SANTA ROSA DEL SARA,consulta externa,repetidas en personas de 15 a 59 anos,2005-11-01,5,31,5,31,36
SANTIAGO DE CALLAPA,consulta externa,repetidas en personas de 15 a 59 anos,2005-11-01,0,2,0,2,2
SANTIAGO DE HUARI,consulta externa,repetidas en personas de 15 a 59 anos,2005-11-01,8,22,8,22,30
SANTIAGO DE MACHACA,consulta externa,repetidas en personas de 15 a 59 anos,2005-11-01,1,6,1,6,7
SANTIVAÑES,consulta externa,repetidas en personas de 15 a 59 anos,2005-11-01,1,6,1,6,7
SANTUARIO DE QUILLACAS,consulta externa,repetidas en personas de 15 a 59 anos,2005-11-01,0,3,0,3,3
SAPAHAQUI,consulta externa,repetidas en personas de 15 a 59 anos,2005-11-01,4,13,4,13,17
SENA,consulta externa,repetidas en personas de 15 a 59 anos,2005-11-01,2,1,2,1,3
SICA SICA (VILLA AROMA),consulta externa,repetidas en personas de 15 a 59 anos,2005-11-01,1,2,1,2,3
SICAYA,consulta externa,repetidas en personas de 15 a 59 anos,2005-11-01,1,2,1,2,3
SIPE SIPE,consulta externa,repetidas en personas de 15 a 59 anos,2005-11-01,8,126,8,126,134
SOPACHUY,consulta externa,repetidas en personas de 15 a 59 anos,2005-11-01,4,10,4,10,14
SORACACHI,consulta externa,repetidas en personas de 15 a 59 anos,2005-11-01,1,11,1,11,12
SORATA,consulta externa,repetidas en personas de 15 a 59 anos,2005-11-01,14,5,14,5,19
SUCRE,consulta externa,repetidas en personas de 15 a 59 anos,2005-11-01,2500,6114,2500,6114,8614
TACACHI,consulta externa,repetidas en personas de 15 a 59 anos,2005-11-01,9,27,9,27,36
TACOBAMBA,consulta externa,repetidas en personas de 15 a 59 anos,2005-11-01,0,1,0,1,1
TACOPAYA,consulta externa,repetidas en personas de 15 a 59 anos,2005-11-01,0,1,0,1,1
TAPACARI,consulta externa,repetidas en personas de 15 a 59 anos,2005-11-01,5,49,5,49,54
TARABUCO,consulta externa,repetidas en personas de 15 a 59 anos,2005-11-01,23,35,23,35,58
TARATA,consulta externa,repetidas en personas de 15 a 59 anos,2005-11-01,4,4,4,4,8
TARIJA,consulta externa,repetidas en personas de 15 a 59 anos,2005-11-01,1869,6157,1869,6157,8026
TARVITA,consulta externa,repetidas en personas de 15 a 59 anos,2005-11-01,9,20,9,20,29
TEOPONTE,consulta externa,repetidas en personas de 15 a 59 anos,2005-11-01,1,5,1,5,6
TIAWANACU,consulta externa,repetidas en personas de 15 a 59 anos,2005-11-01,6,7,6,7,13
TINGUIPAYA,consulta externa,repetidas en personas de 15 a 59 anos,2005-11-01,2,1,2,1,3
TIPUANI,consulta externa,repetidas en personas de 15 a 59 anos,2005-11-01,7,6,7,6,13
TIQUIPAYA,consulta externa,repetidas en personas de 15 a 59 anos,2005-11-01,50,132,50,132,182
TIRAQUE (CBBA),consulta externa,repetidas en personas de 15 a 59 anos,2005-11-01,50,296,50,296,346
TITO YUPANQUI (PARQUIPUJIO),consulta externa,repetidas en personas de 15 a 59 anos,2005-11-01,0,9,0,9,9
TOCO,consulta externa,repetidas en personas de 15 a 59 anos,2005-11-01,0,7,0,7,7
TOLATA,consulta externa,repetidas en personas de 15 a 59 anos,2005-11-01,0,1,0,1,1
TOLEDO,consulta externa,repetidas en personas de 15 a 59 anos,2005-11-01,8,14,8,14,22
TOMAVE,consulta externa,repetidas en personas de 15 a 59 anos,2005-11-01,5,9,5,9,14
TOMINA,consulta externa,repetidas en personas de 15 a 59 anos,2005-11-01,1,3,1,3,4
TORO TORO,consulta externa,repetidas en personas de 15 a 59 anos,2005-11-01,2,8,2,8,10
TOTORA(CBBA),consulta externa,repetidas en personas de 15 a 59 anos,2005-11-01,2,4,2,4,6
TOTORA(ORR),consulta externa,repetidas en personas de 15 a 59 anos,2005-11-01,1,0,1,0,1
TRIGAL,consulta externa,repetidas en personas de 15 a 59 anos,2005-11-01,2,0,2,0,2
TRINIDAD,consulta externa,repetidas en personas de 15 a 59 anos,2005-11-01,283,708,283,708,991
TUPIZA,consulta externa,repetidas en personas de 15 a 59 anos,2005-11-01,134,243,134,243,377
TURCO,consulta externa,repetidas en personas de 15 a 59 anos,2005-11-01,0,1,0,1,1
UMALA,consulta externa,repetidas en personas de 15 a 59 anos,2005-11-01,2,1,2,1,3
UNCIA,consulta externa,repetidas en personas de 15 a 59 anos,2005-11-01,116,172,116,172,288
URIONDO (A. CONCEPCION),consulta externa,repetidas en personas de 15 a 59 anos,2005-11-01,8,13,8,13,21
URUBICHA,consulta externa,repetidas en personas de 15 a 59 anos,2005-11-01,0,109,0,109,109
UYUNI,consulta externa,repetidas en personas de 15 a 59 anos,2005-11-01,49,113,49,113,162
VACAS,consulta externa,repetidas en personas de 15 a 59 anos,2005-11-01,36,54,36,54,90
VALLEGRANDE,consulta externa,repetidas en personas de 15 a 59 anos,2005-11-01,46,123,46,123,169
VIACHA,consulta externa,repetidas en personas de 15 a 59 anos,2005-11-01,79,241,79,241,320
VILA VILA,consulta externa,repetidas en personas de 15 a 59 anos,2005-11-01,2,5,2,5,7
VILLA MONTES,consulta externa,repetidas en personas de 15 a 59 anos,2005-11-01,58,151,58,151,209
VILLA RIVERO,consulta externa,repetidas en personas de 15 a 59 anos,2005-11-01,4,5,4,5,9
VILLA SERRANO,consulta externa,repetidas en personas de 15 a 59 anos,2005-11-01,2,9,2,9,11
VILLA TUNARI,consulta externa,repetidas en personas de 15 a 59 anos,2005-11-01,49,130,49,130,179
VILLA VACA GUZMAN (MUYUPAMPA),consulta externa,repetidas en personas de 15 a 59 anos,2005-11-01,10,54,10,54,64
VILLAZON,consulta externa,repetidas en personas de 15 a 59 anos,2005-11-01,45,160,45,160,205
VINTO,consulta externa,repetidas en personas de 15 a 59 anos,2005-11-01,11,98,11,98,109
VITICHI,consulta externa,repetidas en personas de 15 a 59 anos,2005-11-01,4,11,4,11,15
WALDO BALLIVIAN,consulta externa,repetidas en personas de 15 a 59 anos,2005-11-01,1,1,1,1,2
WARNES,consulta externa,repetidas en personas de 15 a 59 anos,2005-11-01,20,122,20,122,142
YACO,consulta externa,repetidas en personas de 15 a 59 anos,2005-11-01,0,9,0,9,9
YACUIBA,consulta externa,repetidas en personas de 15 a 59 anos,2005-11-01,268,949,268,949,1217
YAMPARAEZ,consulta externa,repetidas en personas de 15 a 59 anos,2005-11-01,18,32,18,32,50
YANACACHI,consulta externa,repetidas en personas de 15 a 59 anos,2005-11-01,9,8,9,8,17
YAPACANI,consulta externa,repetidas en personas de 15 a 59 anos,2005-11-01,14,249,14,249,263
YOCALLA,consulta externa,repetidas en personas de 15 a 59 anos,2005-11-01,2,2,2,2,4
YOTALA,consulta externa,repetidas en personas de 15 a 59 anos,2005-11-01,9,29,9,29,38
YUNCHARA,consulta externa,repetidas en personas de 15 a 59 anos,2005-11-01,2,7,2,7,9
ZUDAÑEZ,consulta externa,repetidas en personas de 15 a 59 anos,2005-11-01,5,6,5,6,11
ACACIO,consulta externa,repetidas en personas de 15 a 59 anos,2005-12-01,4,1,4,1,5
ACHACACHI,consulta externa,repetidas en personas de 15 a 59 anos,2005-12-01,29,48,29,48,77
ACHOCALLA,consulta externa,repetidas en personas de 15 a 59 anos,2005-12-01,1,2,1,2,3
AIQUILE,consulta externa,repetidas en personas de 15 a 59 anos,2005-12-01,28,196,28,196,224
ALALAY,consulta externa,repetidas en personas de 15 a 59 anos,2005-12-01,0,2,0,2,2
ANCORAIMES,consulta externa,repetidas en personas de 15 a 59 anos,2005-12-01,5,10,5,10,15
ANDAMARCA,consulta externa,repetidas en personas de 15 a 59 anos,2005-12-01,1,4,1,4,5
ANZALDO,consulta externa,repetidas en personas de 15 a 59 anos,2005-12-01,1,20,1,20,21
APOLO,consulta externa,repetidas en personas de 15 a 59 anos,2005-12-01,11,9,11,9,20
ARANI,consulta externa,repetidas en personas de 15 a 59 anos,2005-12-01,9,12,9,12,21
ARBIETO,consulta externa,repetidas en personas de 15 a 59 anos,2005-12-01,10,15,10,15,25
ARQUE,consulta externa,repetidas en personas de 15 a 59 anos,2005-12-01,0,2,0,2,2
ASCENCION DE GUARAYOS,consulta externa,repetidas en personas de 15 a 59 anos,2005-12-01,2,4,2,4,6
ATOCHA,consulta externa,repetidas en personas de 15 a 59 anos,2005-12-01,274,353,274,353,627
AUCAPATA,consulta externa,repetidas en personas de 15 a 59 anos,2005-12-01,6,5,6,5,11
AYATA,consulta externa,repetidas en personas de 15 a 59 anos,2005-12-01,10,1,10,1,11
AYO AYO,consulta externa,repetidas en personas de 15 a 59 anos,2005-12-01,3,5,3,5,8
AYOPAYA (V. DE INDEPENDENCIA),consulta externa,repetidas en personas de 15 a 59 anos,2005-12-01,7,13,7,13,20
AZURDUY,consulta externa,repetidas en personas de 15 a 59 anos,2005-12-01,1,5,1,5,6
BATALLAS,consulta externa,repetidas en personas de 15 a 59 anos,2005-12-01,6,3,6,3,9
BAURES,consulta externa,repetidas en personas de 15 a 59 anos,2005-12-01,8,14,8,14,22
BELEN DE ANDAMARCA,consulta externa,repetidas en personas de 15 a 59 anos,2005-12-01,0,8,0,8,8
BELEN DE URMIRI,consulta externa,repetidas en personas de 15 a 59 anos,2005-12-01,0,4,0,4,4
BELLA FLOR,consulta externa,repetidas en personas de 15 a 59 anos,2005-12-01,18,29,18,29,47
BERMEJO,consulta externa,repetidas en personas de 15 a 59 anos,2005-12-01,91,156,91,156,247
BETANZOS,consulta externa,repetidas en personas de 15 a 59 anos,2005-12-01,19,29,19,29,48
BOLIVAR,consulta externa,repetidas en personas de 15 a 59 anos,2005-12-01,2,2,2,2,4
BOLPEBRA,consulta externa,repetidas en personas de 15 a 59 anos,2005-12-01,3,4,3,4,7
BOYUIBE,consulta externa,repetidas en personas de 15 a 59 anos,2005-12-01,5,15,5,15,20
BUENA VISTA,consulta externa,repetidas en personas de 15 a 59 anos,2005-12-01,35,63,35,63,98
CABEZAS,consulta externa,repetidas en personas de 15 a 59 anos,2005-12-01,8,6,8,6,14
CAIROMA,consulta externa,repetidas en personas de 15 a 59 anos,2005-12-01,9,1,9,1,10
"CAIZA ""D""",consulta externa,repetidas en personas de 15 a 59 anos,2005-12-01,6,2,6,2,8
CAJUATA,consulta externa,repetidas en personas de 15 a 59 anos,2005-12-01,4,6,4,6,10
CALACOTO,consulta externa,repetidas en personas de 15 a 59 anos,2005-12-01,1,0,1,0,1
CALAMARCA,consulta externa,repetidas en personas de 15 a 59 anos,2005-12-01,17,10,17,10,27
CAMARGO,consulta externa,repetidas en personas de 15 a 59 anos,2005-12-01,16,37,16,37,53
CAMATAQUI (C. VILLA ABECIA),consulta externa,repetidas en personas de 15 a 59 anos,2005-12-01,3,1,3,1,4
CAMIRI,consulta externa,repetidas en personas de 15 a 59 anos,2005-12-01,30,84,30,84,114
CAPINOTA,consulta externa,repetidas en personas de 15 a 59 anos,2005-12-01,43,35,43,35,78
CAQUIAVIRI,consulta externa,repetidas en personas de 15 a 59 anos,2005-12-01,4,3,4,3,7
CARACOLLO,consulta externa,repetidas en personas de 15 a 59 anos,2005-12-01,4,7,4,7,11
CARANAVI,consulta externa,repetidas en personas de 15 a 59 anos,2005-12-01,5,9,5,9,14
CARAPARI,consulta externa,repetidas en personas de 15 a 59 anos,2005-12-01,7,8,7,8,15
CARIPUYO,consulta externa,repetidas en personas de 15 a 59 anos,2005-12-01,0,3,0,3,3
CATACORA,consulta externa,repetidas en personas de 15 a 59 anos,2005-12-01,2,0,2,0,2
CHALLAPATA,consulta externa,repetidas en personas de 15 a 59 anos,2005-12-01,26,41,26,41,67
CHARAGUA,consulta externa,repetidas en personas de 15 a 59 anos,2005-12-01,10,26,10,26,36
CHARAÑA,consulta externa,repetidas en personas de 15 a 59 anos,2005-12-01,1,1,1,1,2
CHAYANTA,consulta externa,repetidas en personas de 15 a 59 anos,2005-12-01,8,13,8,13,21
CHIMORE,consulta externa,repetidas en personas de 15 a 59 anos,2005-12-01,14,37,14,37,51
CHIPAYA,consulta externa,repetidas en personas de 15 a 59 anos,2005-12-01,0,3,0,3,3
CHOQUE COTA,consulta externa,repetidas en personas de 15 a 59 anos,2005-12-01,2,2,2,2,4
CHULUMANI (V. DE LA LIBERTAD),consulta externa,repetidas en personas de 15 a 59 anos,2005-12-01,39,26,39,26,65
CHUMA,consulta externa,repetidas en personas de 15 a 59 anos,2005-12-01,8,8,8,8,16
CLIZA,consulta externa,repetidas en personas de 15 a 59 anos,2005-12-01,3,12,3,12,15
COBIJA,consulta externa,repetidas en personas de 15 a 59 anos,2005-12-01,85,356,85,356,441
COCHABAMBA,consulta externa,repetidas en personas de 15 a 59 anos,2005-12-01,7332,16820,7332,16820,24152
COLCAPIRHUA,consulta externa,repetidas en personas de 15 a 59 anos,2005-12-01,176,189,176,189,365
"COLCHA ""K""",consulta externa,repetidas en personas de 15 a 59 anos,2005-12-01,4,15,4,15,19
COLLANA,consulta externa,repetidas en personas de 15 a 59 anos,2005-12-01,4,3,4,3,7
COLOMI,consulta externa,repetidas en personas de 15 a 59 anos,2005-12-01,8,11,8,11,19
COLPA BELGICA,consulta externa,repetidas en personas de 15 a 59 anos,2005-12-01,5,29,5,29,34
COLQUECHACA,consulta externa,repetidas en personas de 15 a 59 anos,2005-12-01,5,8,5,8,13
COLQUENCHA,consulta externa,repetidas en personas de 15 a 59 anos,2005-12-01,3,5,3,5,8
COLQUIRI,consulta externa,repetidas en personas de 15 a 59 anos,2005-12-01,7,15,7,15,22
COMANCHE,consulta externa,repetidas en personas de 15 a 59 anos,2005-12-01,3,1,3,1,4
COMARAPA,consulta externa,repetidas en personas de 15 a 59 anos,2005-12-01,19,23,19,23,42
COMBAYA,consulta externa,repetidas en personas de 15 a 59 anos,2005-12-01,0,6,0,6,6
CONCEPCION,consulta externa,repetidas en personas de 15 a 59 anos,2005-12-01,2,2,2,2,4
COPACABANA,consulta externa,repetidas en personas de 15 a 59 anos,2005-12-01,0,1,0,1,1
CORIPATA,consulta externa,repetidas en personas de 15 a 59 anos,2005-12-01,1,4,1,4,5
CORO CORO,consulta externa,repetidas en personas de 15 a 59 anos,2005-12-01,0,3,0,3,3
COROICO,consulta externa,repetidas en personas de 15 a 59 anos,2005-12-01,69,124,69,124,193
CORQUE,consulta externa,repetidas en personas de 15 a 59 anos,2005-12-01,17,16,17,16,33
COTAGAITA,consulta externa,repetidas en personas de 15 a 59 anos,2005-12-01,80,83,80,83,163
COTOCA,consulta externa,repetidas en personas de 15 a 59 anos,2005-12-01,1,22,1,22,23
CUATRO CAÑADAS,consulta externa,repetidas en personas de 15 a 59 anos,2005-12-01,16,65,16,65,81
CUCHUMUELA (V. G. VILLARROEL),consulta externa,repetidas en personas de 15 a 59 anos,2005-12-01,3,2,3,2,5
CUEVO,consulta externa,repetidas en personas de 15 a 59 anos,2005-12-01,3,4,3,4,7
CULPINA,consulta externa,repetidas en personas de 15 a 59 anos,2005-12-01,3,5,3,5,8
CURAHUARA DE CARANGAS,consulta externa,repetidas en personas de 15 a 59 anos,2005-12-01,2,3,2,3,5
CURVA,consulta externa,repetidas en personas de 15 a 59 anos,2005-12-01,0,2,0,2,2
DESAGUADERO,consulta externa,repetidas en personas de 15 a 59 anos,2005-12-01,0,6,0,6,6
EL ALTO,consulta externa,repetidas en personas de 15 a 59 anos,2005-12-01,2898,6271,2898,6271,9169
EL CHORO,consulta externa,repetidas en personas de 15 a 59 anos,2005-12-01,3,0,3,0,3
EL PUENTE(STC),consulta externa,repetidas en personas de 15 a 59 anos,2005-12-01,7,2,7,2,9
EL PUENTE(TJA),consulta externa,repetidas en personas de 15 a 59 anos,2005-12-01,2,11,2,11,13
EL TORNO,consulta externa,repetidas en personas de 15 a 59 anos,2005-12-01,147,190,147,190,337
EL VILLAR,consulta externa,repetidas en personas de 15 a 59 anos,2005-12-01,1,4,1,4,5
ENTRE RIOS,consulta externa,repetidas en personas de 15 a 59 anos,2005-12-01,10,13,10,13,23
ENTRE RIOS,consulta externa,repetidas en personas de 15 a 59 anos,2005-12-01,24,11,24,11,35
EUCALIPTUS,consulta externa,repetidas en personas de 15 a 59 anos,2005-12-01,1,2,1,2,3
EUREKA (SANTOS MERCADO),consulta externa,repetidas en personas de 15 a 59 anos,2005-12-01,3,3,3,3,6
EXALTACION,consulta externa,repetidas en personas de 15 a 59 anos,2005-12-01,0,2,0,2,2
FERNANDEZ ALONSO,consulta externa,repetidas en personas de 15 a 59 anos,2005-12-01,7,48,7,48,55
FILADELFIA,consulta externa,repetidas en personas de 15 a 59 anos,2005-12-01,0,2,0,2,2
GENERAL SAAVEDRA,consulta externa,repetidas en personas de 15 a 59 anos,2005-12-01,13,22,13,22,35
GRAL. J.J. PEREZ (CHARAZANI),consulta externa,repetidas en personas de 15 a 59 anos,2005-12-01,10,4,10,4,14
GUANAY,consulta externa,repetidas en personas de 15 a 59 anos,2005-12-01,0,2,0,2,2
GUAQUI,consulta externa,repetidas en personas de 15 a 59 anos,2005-12-01,4,17,4,17,21
GUAYARAMERIN,consulta externa,repetidas en personas de 15 a 59 anos,2005-12-01,440,344,440,344,784
GUTIERREZ,consulta externa,repetidas en personas de 15 a 59 anos,2005-12-01,5,14,5,14,19
HUACARETA,consulta externa,repetidas en personas de 15 a 59 anos,2005-12-01,16,25,16,25,41
HUACAYA (VILLA DE HUACAYA),consulta externa,repetidas en personas de 15 a 59 anos,2005-12-01,0,1,0,1,1
HUANUNI,consulta externa,repetidas en personas de 15 a 59 anos,2005-12-01,107,114,107,114,221
HUAYLLAMARCA,consulta externa,repetidas en personas de 15 a 59 anos,2005-12-01,1,0,1,0,1
ICHOCA,consulta externa,repetidas en personas de 15 a 59 anos,2005-12-01,1,7,1,7,8
ICLA,consulta externa,repetidas en personas de 15 a 59 anos,2005-12-01,5,9,5,9,14
INCAHUASI,consulta externa,repetidas en personas de 15 a 59 anos,2005-12-01,0,5,0,5,5
INQUISIVI,consulta externa,repetidas en personas de 15 a 59 anos,2005-12-01,7,5,7,5,12
IRUPANA (VILLA DE LANZA),consulta externa,repetidas en personas de 15 a 59 anos,2005-12-01,14,20,14,20,34
IXIAMAS,consulta externa,repetidas en personas de 15 a 59 anos,2005-12-01,3,6,3,6,9
JESUS DE MACHACA,consulta externa,repetidas en personas de 15 a 59 anos,2005-12-01,7,18,7,18,25
LA GUARDIA,consulta externa,repetidas en personas de 15 a 59 anos,2005-12-01,23,110,23,110,133
LA PAZ,consulta externa,repetidas en personas de 15 a 59 anos,2005-12-01,11801,26322,11801,26322,38123
LAGUNILLAS,consulta externa,repetidas en personas de 15 a 59 anos,2005-12-01,0,2,0,2,2
LAJA,consulta externa,repetidas en personas de 15 a 59 anos,2005-12-01,20,5,20,5,25
LAS CARRERAS,consulta externa,repetidas en personas de 15 a 59 anos,2005-12-01,2,12,2,12,14
LICOMA PAMPA,consulta externa,repetidas en personas de 15 a 59 anos,2005-12-01,1,0,1,0,1
LLALLAGUA,consulta externa,repetidas en personas de 15 a 59 anos,2005-12-01,48,45,48,45,93
LLICA,consulta externa,repetidas en personas de 15 a 59 anos,2005-12-01,8,9,8,9,17
LORETO,consulta externa,repetidas en personas de 15 a 59 anos,2005-12-01,11,6,11,6,17
LURIBAY,consulta externa,repetidas en personas de 15 a 59 anos,2005-12-01,1,3,1,3,4
MACHACAMARCA,consulta externa,repetidas en personas de 15 a 59 anos,2005-12-01,8,13,8,13,21
MACHARETI,consulta externa,repetidas en personas de 15 a 59 anos,2005-12-01,4,23,4,23,27
MAGDALENA,consulta externa,repetidas en personas de 15 a 59 anos,2005-12-01,183,388,183,388,571
MAIRANA,consulta externa,repetidas en personas de 15 a 59 anos,2005-12-01,1,2,1,2,3
MALLA,consulta externa,repetidas en personas de 15 a 59 anos,2005-12-01,2,2,2,2,4
MAPIRI,consulta externa,repetidas en personas de 15 a 59 anos,2005-12-01,2,0,2,0,2
MECAPACA,consulta externa,repetidas en personas de 15 a 59 anos,2005-12-01,27,31,27,31,58
MINEROS,consulta externa,repetidas en personas de 15 a 59 anos,2005-12-01,10,42,10,42,52
MIZQUE,consulta externa,repetidas en personas de 15 a 59 anos,2005-12-01,10,5,10,5,15
MOCOMOCO,consulta externa,repetidas en personas de 15 a 59 anos,2005-12-01,5,14,5,14,19
MOJINETE,consulta externa,repetidas en personas de 15 a 59 anos,2005-12-01,0,2,0,2,2
MOJOCOYA,consulta externa,repetidas en personas de 15 a 59 anos,2005-12-01,4,6,4,6,10
MONTEAGUDO,consulta externa,repetidas en personas de 15 a 59 anos,2005-12-01,61,257,61,257,318
MONTERO,consulta externa,repetidas en personas de 15 a 59 anos,2005-12-01,754,1844,754,1844,2598
MORO MORO,consulta externa,repetidas en personas de 15 a 59 anos,2005-12-01,1,7,1,7,8
MOROCHATA,consulta externa,repetidas en personas de 15 a 59 anos,2005-12-01,20,51,20,51,71
NACEBE (SANTA ROSA DEL ABUNA),consulta externa,repetidas en personas de 15 a 59 anos,2005-12-01,1,1,1,1,2
NUEVO MANOA (NUEVA ESPERANZA),consulta externa,repetidas en personas de 15 a 59 anos,2005-12-01,3,8,3,8,11
OCURI,consulta externa,repetidas en personas de 15 a 59 anos,2005-12-01,2,0,2,0,2
OKINAWA,consulta externa,repetidas en personas de 15 a 59 anos,2005-12-01,10,43,10,43,53
OMEREQUE,consulta externa,repetidas en personas de 15 a 59 anos,2005-12-01,3,11,3,11,14
ORURO,consulta externa,repetidas en personas de 15 a 59 anos,2005-12-01,1676,4415,1676,4415,6091
PADCAYA,consulta externa,repetidas en personas de 15 a 59 anos,2005-12-01,10,22,10,22,32
PADILLA,consulta externa,repetidas en personas de 15 a 59 anos,2005-12-01,8,14,8,14,22
PAILON,consulta externa,repetidas en personas de 15 a 59 anos,2005-12-01,7,9,7,9,16
PALCA,consulta externa,repetidas en personas de 15 a 59 anos,2005-12-01,6,6,6,6,12
PALOS BLANCOS,consulta externa,repetidas en personas de 15 a 59 anos,2005-12-01,55,76,55,76,131
PAMPA GRANDE,consulta externa,repetidas en personas de 15 a 59 anos,2005-12-01,6,11,6,11,17
PAPEL PAMPA,consulta externa,repetidas en personas de 15 a 59 anos,2005-12-01,4,4,4,4,8
PASORAPA,consulta externa,repetidas en personas de 15 a 59 anos,2005-12-01,1,2,1,2,3
PATACAMAYA,consulta externa,repetidas en personas de 15 a 59 anos,2005-12-01,1,9,1,9,10
PAZÑA,consulta externa,repetidas en personas de 15 a 59 anos,2005-12-01,18,15,18,15,33
PELECHUCO,consulta externa,repetidas en personas de 15 a 59 anos,2005-12-01,15,1,15,1,16
POCOATA,consulta externa,repetidas en personas de 15 a 59 anos,2005-12-01,2,2,2,2,4
POCONA,consulta externa,repetidas en personas de 15 a 59 anos,2005-12-01,4,14,4,14,18
POJO (CBBA),consulta externa,repetidas en personas de 15 a 59 anos,2005-12-01,4,13,4,13,17
POOPO,consulta externa,repetidas en personas de 15 a 59 anos,2005-12-01,5,1,5,1,6
PORCO,consulta externa,repetidas en personas de 15 a 59 anos,2005-12-01,2,4,2,4,6
POROMA,consulta externa,repetidas en personas de 15 a 59 anos,2005-12-01,5,12,5,12,17
PORONGO,consulta externa,repetidas en personas de 15 a 59 anos,2005-12-01,10,9,10,9,19
PORTACHUELO,consulta externa,repetidas en personas de 15 a 59 anos,2005-12-01,28,33,28,33,61
PORVENIR,consulta externa,repetidas en personas de 15 a 59 anos,2005-12-01,4,1,4,1,5
POSTRER VALLE,consulta externa,repetidas en personas de 15 a 59 anos,2005-12-01,1,0,1,0,1
POTOSI,consulta externa,repetidas en personas de 15 a 59 anos,2005-12-01,1791,3891,1791,3891,5682
PRESTO,consulta externa,repetidas en personas de 15 a 59 anos,2005-12-01,0,1,0,1,1
PUCARA,consulta externa,repetidas en personas de 15 a 59 anos,2005-12-01,4,2,4,2,6
PUCARANI,consulta externa,repetidas en personas de 15 a 59 anos,2005-12-01,1,6,1,6,7
PUERTO ACOSTA,consulta externa,repetidas en personas de 15 a 59 anos,2005-12-01,19,7,19,7,26
PUERTO CARABUCO,consulta externa,repetidas en personas de 15 a 59 anos,2005-12-01,5,8,5,8,13
PUERTO GONZALO MORENO,consulta externa,repetidas en personas de 15 a 59 anos,2005-12-01,4,3,4,3,7
PUERTO PEREZ,consulta externa,repetidas en personas de 15 a 59 anos,2005-12-01,12,9,12,9,21
PUERTO QUIJARRO,consulta externa,repetidas en personas de 15 a 59 anos,2005-12-01,79,122,79,122,201
PUERTO RICO,consulta externa,repetidas en personas de 15 a 59 anos,2005-12-01,4,2,4,2,6
PUERTO SUAREZ,consulta externa,repetidas en personas de 15 a 59 anos,2005-12-01,9,58,9,58,67
PUERTO VILLARROEL,consulta externa,repetidas en personas de 15 a 59 anos,2005-12-01,13,22,13,22,35
PUNA,consulta externa,repetidas en personas de 15 a 59 anos,2005-12-01,6,18,6,18,24
PUNATA,consulta externa,repetidas en personas de 15 a 59 anos,2005-12-01,102,265,102,265,367
QUIABAYA,consulta externa,repetidas en personas de 15 a 59 anos,2005-12-01,0,1,0,1,1
QUILLACOLLO,consulta externa,repetidas en personas de 15 a 59 anos,2005-12-01,33,171,33,171,204
QUIME,consulta externa,repetidas en personas de 15 a 59 anos,2005-12-01,2,1,2,1,3
QUIRUSILLAS,consulta externa,repetidas en personas de 15 a 59 anos,2005-12-01,1,3,1,3,4
RAVELO,consulta externa,repetidas en personas de 15 a 59 anos,2005-12-01,1,2,1,2,3
REYES,consulta externa,repetidas en personas de 15 a 59 anos,2005-12-01,10,23,10,23,33
RIBERALTA,consulta externa,repetidas en personas de 15 a 59 anos,2005-12-01,61,502,61,502,563
ROBORE,consulta externa,repetidas en personas de 15 a 59 anos,2005-12-01,16,64,16,64,80
RURRENABAQUE,consulta externa,repetidas en personas de 15 a 59 anos,2005-12-01,15,34,15,34,49
SACABA,consulta externa,repetidas en personas de 15 a 59 anos,2005-12-01,81,461,81,461,542
SACABAMBA,consulta externa,repetidas en personas de 15 a 59 anos,2005-12-01,4,3,4,3,7
SACACA,consulta externa,repetidas en personas de 15 a 59 anos,2005-12-01,0,1,0,1,1
SAIPINA,consulta externa,repetidas en personas de 15 a 59 anos,2005-12-01,16,36,16,36,52
SALINAS DE GARCI MENDOZA,consulta externa,repetidas en personas de 15 a 59 anos,2005-12-01,2,4,2,4,6
SAMAIPATA,consulta externa,repetidas en personas de 15 a 59 anos,2005-12-01,3,1,3,1,4
SAN AGUSTIN,consulta externa,repetidas en personas de 15 a 59 anos,2005-12-01,1,0,1,0,1
SAN ANDRES,consulta externa,repetidas en personas de 15 a 59 anos,2005-12-01,2,4,2,4,6
SAN ANDRES DE MACHACA,consulta externa,repetidas en personas de 15 a 59 anos,2005-12-01,0,7,0,7,7
SAN ANTONIO DE LOMERIO,consulta externa,repetidas en personas de 15 a 59 anos,2005-12-01,1,0,1,0,1
SAN BENITO,consulta externa,repetidas en personas de 15 a 59 anos,2005-12-01,5,23,5,23,28
SAN BORJA,consulta externa,repetidas en personas de 15 a 59 anos,2005-12-01,17,58,17,58,75
SAN BUENA VENTURA,consulta externa,repetidas en personas de 15 a 59 anos,2005-12-01,10,3,10,3,13
SAN CARLOS,consulta externa,repetidas en personas de 15 a 59 anos,2005-12-01,5,87,5,87,92
SAN IGNACIO,consulta externa,repetidas en personas de 15 a 59 anos,2005-12-01,12,42,12,42,54
SAN IGNACIO DE VELASCO,consulta externa,repetidas en personas de 15 a 59 anos,2005-12-01,71,147,71,147,218
SAN JAVIER(BNI),consulta externa,repetidas en personas de 15 a 59 anos,2005-12-01,1,4,1,4,5
SAN JAVIER(STC),consulta externa,repetidas en personas de 15 a 59 anos,2005-12-01,11,77,11,77,88
SAN JOAQUIN,consulta externa,repetidas en personas de 15 a 59 anos,2005-12-01,0,19,0,19,19
SAN JOSE DE CHIQUITOS,consulta externa,repetidas en personas de 15 a 59 anos,2005-12-01,3,6,3,6,9
SAN JUAN DE YAPACANI,consulta externa,repetidas en personas de 15 a 59 anos,2005-12-01,15,25,15,25,40
SAN JULIAN,consulta externa,repetidas en personas de 15 a 59 anos,2005-12-01,19,295,19,295,314
SAN LORENZO(PND),consulta externa,repetidas en personas de 15 a 59 anos,2005-12-01,0,1,0,1,1
SAN LORENZO(TJA),consulta externa,repetidas en personas de 15 a 59 anos,2005-12-01,4,39,4,39,43
SAN LUCAS,consulta externa,repetidas en personas de 15 a 59 anos,2005-12-01,8,25,8,25,33
SAN MATIAS,consulta externa,repetidas en personas de 15 a 59 anos,2005-12-01,8,77,8,77,85
SAN MIGUEL DE VELASCO,consulta externa,repetidas en personas de 15 a 59 anos,2005-12-01,28,74,28,74,102
SAN PABLO DE LIPEZ,consulta externa,repetidas en personas de 15 a 59 anos,2005-12-01,2,14,2,14,16
SAN PEDRO,consulta externa,repetidas en personas de 15 a 59 anos,2005-12-01,37,32,37,32,69
SAN PEDRO DE BUENA VISTA,consulta externa,repetidas en personas de 15 a 59 anos,2005-12-01,0,2,0,2,2
SAN PEDRO DE CURAHUARA,consulta externa,repetidas en personas de 15 a 59 anos,2005-12-01,4,1,4,1,5
SAN PEDRO DE TIQUINA,consulta externa,repetidas en personas de 15 a 59 anos,2005-12-01,2,1,2,1,3
SAN RAFAEL,consulta externa,repetidas en personas de 15 a 59 anos,2005-12-01,4,4,4,4,8
SAN RAMON,consulta externa,repetidas en personas de 15 a 59 anos,2005-12-01,6,40,6,40,46
SAN RAMON,consulta externa,repetidas en personas de 15 a 59 anos,2005-12-01,10,86,10,86,96
SANTA ANA,consulta externa,repetidas en personas de 15 a 59 anos,2005-12-01,11,60,11,60,71
SANTA CRUZ DE LA SIERRA,consulta externa,repetidas en personas de 15 a 59 anos,2005-12-01,5459,16007,5459,16007,21466
SANTA ROSA,consulta externa,repetidas en personas de 15 a 59 anos,2005-12-01,0,7,0,7,7
SANTA ROSA DEL SARA,consulta externa,repetidas en personas de 15 a 59 anos,2005-12-01,6,23,6,23,29
SANTIAGO DE CALLAPA,consulta externa,repetidas en personas de 15 a 59 anos,2005-12-01,1,0,1,0,1
SANTIAGO DE HUARI,consulta externa,repetidas en personas de 15 a 59 anos,2005-12-01,14,12,14,12,26
SANTIAGO DE MACHACA,consulta externa,repetidas en personas de 15 a 59 anos,2005-12-01,1,2,1,2,3
SANTIVAÑES,consulta externa,repetidas en personas de 15 a 59 anos,2005-12-01,7,16,7,16,23
SANTUARIO DE QUILLACAS,consulta externa,repetidas en personas de 15 a 59 anos,2005-12-01,1,0,1,0,1
SAPAHAQUI,consulta externa,repetidas en personas de 15 a 59 anos,2005-12-01,4,1,4,1,5
SENA,consulta externa,repetidas en personas de 15 a 59 anos,2005-12-01,1,0,1,0,1
SICA SICA (VILLA AROMA),consulta externa,repetidas en personas de 15 a 59 anos,2005-12-01,2,3,2,3,5
SIPE SIPE,consulta externa,repetidas en personas de 15 a 59 anos,2005-12-01,152,167,152,167,319
SOPACHUY,consulta externa,repetidas en personas de 15 a 59 anos,2005-12-01,1,1,1,1,2
SORACACHI,consulta externa,repetidas en personas de 15 a 59 anos,2005-12-01,0,2,0,2,2
SORATA,consulta externa,repetidas en personas de 15 a 59 anos,2005-12-01,16,4,16,4,20
SUCRE,consulta externa,repetidas en personas de 15 a 59 anos,2005-12-01,2286,5166,2286,5166,7452
TACACHI,consulta externa,repetidas en personas de 15 a 59 anos,2005-12-01,6,22,6,22,28
TACACOMA,consulta externa,repetidas en personas de 15 a 59 anos,2005-12-01,1,1,1,1,2
TACOBAMBA,consulta externa,repetidas en personas de 15 a 59 anos,2005-12-01,1,0,1,0,1
TACOPAYA,consulta externa,repetidas en personas de 15 a 59 anos,2005-12-01,1,8,1,8,9
TAPACARI,consulta externa,repetidas en personas de 15 a 59 anos,2005-12-01,5,23,5,23,28
TARABUCO,consulta externa,repetidas en personas de 15 a 59 anos,2005-12-01,15,28,15,28,43
TARATA,consulta externa,repetidas en personas de 15 a 59 anos,2005-12-01,8,4,8,4,12
TARIJA,consulta externa,repetidas en personas de 15 a 59 anos,2005-12-01,1831,5412,1831,5412,7243
TARVITA,consulta externa,repetidas en personas de 15 a 59 anos,2005-12-01,3,13,3,13,16
TIAWANACU,consulta externa,repetidas en personas de 15 a 59 anos,2005-12-01,3,7,3,7,10
TINGUIPAYA,consulta externa,repetidas en personas de 15 a 59 anos,2005-12-01,0,3,0,3,3
TIPUANI,consulta externa,repetidas en personas de 15 a 59 anos,2005-12-01,9,7,9,7,16
TIQUIPAYA,consulta externa,repetidas en personas de 15 a 59 anos,2005-12-01,5,108,5,108,113
TIRAQUE (CBBA),consulta externa,repetidas en personas de 15 a 59 anos,2005-12-01,51,318,51,318,369
TITO YUPANQUI (PARQUIPUJIO),consulta externa,repetidas en personas de 15 a 59 anos,2005-12-01,1,2,1,2,3
TOLEDO,consulta externa,repetidas en personas de 15 a 59 anos,2005-12-01,7,11,7,11,18
TOMAVE,consulta externa,repetidas en personas de 15 a 59 anos,2005-12-01,3,11,3,11,14
TOMINA,consulta externa,repetidas en personas de 15 a 59 anos,2005-12-01,2,3,2,3,5
TORO TORO,consulta externa,repetidas en personas de 15 a 59 anos,2005-12-01,1,1,1,1,2
TOTORA(CBBA),consulta externa,repetidas en personas de 15 a 59 anos,2005-12-01,1,1,1,1,2
TOTORA(ORR),consulta externa,repetidas en personas de 15 a 59 anos,2005-12-01,1,1,1,1,2
TRIGAL,consulta externa,repetidas en personas de 15 a 59 anos,2005-12-01,1,0,1,0,1
TRINIDAD,consulta externa,repetidas en personas de 15 a 59 anos,2005-12-01,294,762,294,762,1056
TUPIZA,consulta externa,repetidas en personas de 15 a 59 anos,2005-12-01,153,270,153,270,423
TURCO,consulta externa,repetidas en personas de 15 a 59 anos,2005-12-01,0,1,0,1,1
UNCIA,consulta externa,repetidas en personas de 15 a 59 anos,2005-12-01,138,174,138,174,312
URIONDO (A. CONCEPCION),consulta externa,repetidas en personas de 15 a 59 anos,2005-12-01,5,8,5,8,13
URUBICHA,consulta externa,repetidas en personas de 15 a 59 anos,2005-12-01,0,95,0,95,95
UYUNI,consulta externa,repetidas en personas de 15 a 59 anos,2005-12-01,61,129,61,129,190
VACAS,consulta externa,repetidas en personas de 15 a 59 anos,2005-12-01,29,67,29,67,96
VALLEGRANDE,consulta externa,repetidas en personas de 15 a 59 anos,2005-12-01,62,166,62,166,228
VIACHA,consulta externa,repetidas en personas de 15 a 59 anos,2005-12-01,76,244,76,244,320
VILA VILA,consulta externa,repetidas en personas de 15 a 59 anos,2005-12-01,0,3,0,3,3
VILLA MONTES,consulta externa,repetidas en personas de 15 a 59 anos,2005-12-01,33,113,33,113,146
VILLA NUEVA (LOMA ALTA),consulta externa,repetidas en personas de 15 a 59 anos,2005-12-01,2,3,2,3,5
VILLA RIVERO,consulta externa,repetidas en personas de 15 a 59 anos,2005-12-01,2,23,2,23,25
VILLA SERRANO,consulta externa,repetidas en personas de 15 a 59 anos,2005-12-01,1,4,1,4,5
VILLA TUNARI,consulta externa,repetidas en personas de 15 a 59 anos,2005-12-01,75,117,75,117,192
VILLA VACA GUZMAN (MUYUPAMPA),consulta externa,repetidas en personas de 15 a 59 anos,2005-12-01,9,43,9,43,52
VILLAZON,consulta externa,repetidas en personas de 15 a 59 anos,2005-12-01,41,157,41,157,198
VINTO,consulta externa,repetidas en personas de 15 a 59 anos,2005-12-01,37,93,37,93,130
VITICHI,consulta externa,repetidas en personas de 15 a 59 anos,2005-12-01,9,13,9,13,22
WALDO BALLIVIAN,consulta externa,repetidas en personas de 15 a 59 anos,2005-12-01,1,1,1,1,2
WARNES,consulta externa,repetidas en personas de 15 a 59 anos,2005-12-01,19,143,19,143,162
YACO,consulta externa,repetidas en personas de 15 a 59 anos,2005-12-01,4,1,4,1,5
YACUIBA,consulta externa,repetidas en personas de 15 a 59 anos,2005-12-01,322,973,322,973,1295
YAMPARAEZ,consulta externa,repetidas en personas de 15 a 59 anos,2005-12-01,10,22,10,22,32
YANACACHI,consulta externa,repetidas en personas de 15 a 59 anos,2005-12-01,5,10,5,10,15
YAPACANI,consulta externa,repetidas en personas de 15 a 59 anos,2005-12-01,20,325,20,325,345
YOCALLA,consulta externa,repetidas en personas de 15 a 59 anos,2005-12-01,2,4,2,4,6
YOTALA,consulta externa,repetidas en personas de 15 a 59 anos,2005-12-01,7,33,7,33,40
YUNCHARA,consulta externa,repetidas en personas de 15 a 59 anos,2005-12-01,3,4,3,4,7
ZUDAÑEZ,consulta externa,repetidas en personas de 15 a 59 anos,2005-12-01,4,6,4,6,10
