municipality,group,variable,month,Nuevas en menores de 5 años -Hombre,Nuevas en menores de 5 años -Mujer,TOTAL-H,TOTAL-M,TOTAL
ACACIO,consulta externa,nuevas en menores de 5 anos,2006-01-01,73,75,73,75,148
ACHACACHI,consulta externa,nuevas en menores de 5 anos,2006-01-01,302,290,302,290,592
ACHOCALLA,consulta externa,nuevas en menores de 5 anos,2006-01-01,59,47,59,47,106
AIQUILE,consulta externa,nuevas en menores de 5 anos,2006-01-01,327,347,327,347,674
ALALAY,consulta externa,nuevas en menores de 5 anos,2006-01-01,25,19,25,19,44
ALCALA,consulta externa,nuevas en menores de 5 anos,2006-01-01,176,142,176,142,318
ANCORAIMES,consulta externa,nuevas en menores de 5 anos,2006-01-01,213,193,213,193,406
ANDAMARCA,consulta externa,nuevas en menores de 5 anos,2006-01-01,28,40,28,40,68
ANTEQUERA,consulta externa,nuevas en menores de 5 anos,2006-01-01,20,30,20,30,50
ANZALDO,consulta externa,nuevas en menores de 5 anos,2006-01-01,58,67,58,67,125
APOLO,consulta externa,nuevas en menores de 5 anos,2006-01-01,259,253,259,253,512
ARAMPAMPA,consulta externa,nuevas en menores de 5 anos,2006-01-01,67,71,67,71,138
ARANI,consulta externa,nuevas en menores de 5 anos,2006-01-01,73,81,73,81,154
ARBIETO,consulta externa,nuevas en menores de 5 anos,2006-01-01,57,44,57,44,101
ARQUE,consulta externa,nuevas en menores de 5 anos,2006-01-01,119,119,119,119,238
ASCENCION DE GUARAYOS,consulta externa,nuevas en menores de 5 anos,2006-01-01,406,440,406,440,846
ATOCHA,consulta externa,nuevas en menores de 5 anos,2006-01-01,284,248,284,248,532
AUCAPATA,consulta externa,nuevas en menores de 5 anos,2006-01-01,66,53,66,53,119
AYATA,consulta externa,nuevas en menores de 5 anos,2006-01-01,110,83,110,83,193
AYO AYO,consulta externa,nuevas en menores de 5 anos,2006-01-01,50,42,50,42,92
AYOPAYA (V. DE INDEPENDENCIA),consulta externa,nuevas en menores de 5 anos,2006-01-01,363,318,363,318,681
AZURDUY,consulta externa,nuevas en menores de 5 anos,2006-01-01,323,321,323,321,644
BATALLAS,consulta externa,nuevas en menores de 5 anos,2006-01-01,72,54,72,54,126
BAURES,consulta externa,nuevas en menores de 5 anos,2006-01-01,72,85,72,85,157
BELEN DE ANDAMARCA,consulta externa,nuevas en menores de 5 anos,2006-01-01,12,7,12,7,19
BELEN DE URMIRI,consulta externa,nuevas en menores de 5 anos,2006-01-01,38,44,38,44,82
BELLA FLOR,consulta externa,nuevas en menores de 5 anos,2006-01-01,118,133,118,133,251
BERMEJO,consulta externa,nuevas en menores de 5 anos,2006-01-01,654,725,654,725,1379
BETANZOS,consulta externa,nuevas en menores de 5 anos,2006-01-01,476,426,476,426,902
BOLIVAR,consulta externa,nuevas en menores de 5 anos,2006-01-01,116,142,116,142,258
BOLPEBRA,consulta externa,nuevas en menores de 5 anos,2006-01-01,38,34,38,34,72
BOYUIBE,consulta externa,nuevas en menores de 5 anos,2006-01-01,71,79,71,79,150
BUENA VISTA,consulta externa,nuevas en menores de 5 anos,2006-01-01,300,278,300,278,578
CABEZAS,consulta externa,nuevas en menores de 5 anos,2006-01-01,455,355,455,355,810
CAIROMA,consulta externa,nuevas en menores de 5 anos,2006-01-01,153,187,153,187,340
"CAIZA ""D""",consulta externa,nuevas en menores de 5 anos,2006-01-01,88,85,88,85,173
CAJUATA,consulta externa,nuevas en menores de 5 anos,2006-01-01,156,142,156,142,298
CALACOTO,consulta externa,nuevas en menores de 5 anos,2006-01-01,53,45,53,45,98
CALAMARCA,consulta externa,nuevas en menores de 5 anos,2006-01-01,155,133,155,133,288
CAMARGO,consulta externa,nuevas en menores de 5 anos,2006-01-01,469,398,469,398,867
CAMATAQUI (C. VILLA ABECIA),consulta externa,nuevas en menores de 5 anos,2006-01-01,73,47,73,47,120
CAMIRI,consulta externa,nuevas en menores de 5 anos,2006-01-01,617,627,617,627,1244
CAPINOTA,consulta externa,nuevas en menores de 5 anos,2006-01-01,339,296,339,296,635
CAQUIAVIRI,consulta externa,nuevas en menores de 5 anos,2006-01-01,59,47,59,47,106
CARACOLLO,consulta externa,nuevas en menores de 5 anos,2006-01-01,195,173,195,173,368
CARANAVI,consulta externa,nuevas en menores de 5 anos,2006-01-01,609,540,609,540,1149
CARANGAS,consulta externa,nuevas en menores de 5 anos,2006-01-01,4,3,4,3,7
CARAPARI,consulta externa,nuevas en menores de 5 anos,2006-01-01,163,172,163,172,335
CARIPUYO,consulta externa,nuevas en menores de 5 anos,2006-01-01,183,162,183,162,345
CARMEN RIVERO TORREZ,consulta externa,nuevas en menores de 5 anos,2006-01-01,74,59,74,59,133
CATACORA,consulta externa,nuevas en menores de 5 anos,2006-01-01,3,2,3,2,5
CHACARILLA,consulta externa,nuevas en menores de 5 anos,2006-01-01,3,5,3,5,8
CHALLAPATA,consulta externa,nuevas en menores de 5 anos,2006-01-01,260,243,260,243,503
CHAQUI,consulta externa,nuevas en menores de 5 anos,2006-01-01,103,87,103,87,190
CHARAGUA,consulta externa,nuevas en menores de 5 anos,2006-01-01,806,750,806,750,1556
CHARAÑA,consulta externa,nuevas en menores de 5 anos,2006-01-01,25,26,25,26,51
CHAYANTA,consulta externa,nuevas en menores de 5 anos,2006-01-01,184,158,184,158,342
CHIMORE,consulta externa,nuevas en menores de 5 anos,2006-01-01,473,419,473,419,892
CHIPAYA,consulta externa,nuevas en menores de 5 anos,2006-01-01,20,18,20,18,38
CHOQUE COTA,consulta externa,nuevas en menores de 5 anos,2006-01-01,16,12,16,12,28
CHULUMANI (V. DE LA LIBERTAD),consulta externa,nuevas en menores de 5 anos,2006-01-01,208,179,208,179,387
CHUMA,consulta externa,nuevas en menores de 5 anos,2006-01-01,145,127,145,127,272
CLIZA,consulta externa,nuevas en menores de 5 anos,2006-01-01,205,162,205,162,367
COBIJA,consulta externa,nuevas en menores de 5 anos,2006-01-01,740,615,740,615,1355
COCHABAMBA,consulta externa,nuevas en menores de 5 anos,2006-01-01,7815,7147,7815,7147,14962
COLCAPIRHUA,consulta externa,nuevas en menores de 5 anos,2006-01-01,365,332,365,332,697
"COLCHA ""K""",consulta externa,nuevas en menores de 5 anos,2006-01-01,96,98,96,98,194
COLLANA,consulta externa,nuevas en menores de 5 anos,2006-01-01,12,10,12,10,22
COLOMI,consulta externa,nuevas en menores de 5 anos,2006-01-01,226,205,226,205,431
COLPA BELGICA,consulta externa,nuevas en menores de 5 anos,2006-01-01,181,141,181,141,322
COLQUECHACA,consulta externa,nuevas en menores de 5 anos,2006-01-01,613,544,613,544,1157
COLQUENCHA,consulta externa,nuevas en menores de 5 anos,2006-01-01,60,50,60,50,110
COLQUIRI,consulta externa,nuevas en menores de 5 anos,2006-01-01,395,316,395,316,711
COMANCHE,consulta externa,nuevas en menores de 5 anos,2006-01-01,12,13,12,13,25
COMARAPA,consulta externa,nuevas en menores de 5 anos,2006-01-01,378,370,378,370,748
COMBAYA,consulta externa,nuevas en menores de 5 anos,2006-01-01,15,18,15,18,33
CONCEPCION,consulta externa,nuevas en menores de 5 anos,2006-01-01,323,282,323,282,605
COPACABANA,consulta externa,nuevas en menores de 5 anos,2006-01-01,66,60,66,60,126
CORIPATA,consulta externa,nuevas en menores de 5 anos,2006-01-01,239,185,239,185,424
CORO CORO,consulta externa,nuevas en menores de 5 anos,2006-01-01,68,60,68,60,128
COROICO,consulta externa,nuevas en menores de 5 anos,2006-01-01,187,159,187,159,346
CORQUE,consulta externa,nuevas en menores de 5 anos,2006-01-01,68,58,68,58,126
COTAGAITA,consulta externa,nuevas en menores de 5 anos,2006-01-01,506,432,506,432,938
COTOCA,consulta externa,nuevas en menores de 5 anos,2006-01-01,743,573,743,573,1316
CUATRO CAÑADAS,consulta externa,nuevas en menores de 5 anos,2006-01-01,508,442,508,442,950
CUCHUMUELA (V. G. VILLARROEL),consulta externa,nuevas en menores de 5 anos,2006-01-01,11,3,11,3,14
CUEVO,consulta externa,nuevas en menores de 5 anos,2006-01-01,84,129,84,129,213
CULPINA,consulta externa,nuevas en menores de 5 anos,2006-01-01,380,350,380,350,730
CURAHUARA DE CARANGAS,consulta externa,nuevas en menores de 5 anos,2006-01-01,45,59,45,59,104
CURVA,consulta externa,nuevas en menores de 5 anos,2006-01-01,25,14,25,14,39
DESAGUADERO,consulta externa,nuevas en menores de 5 anos,2006-01-01,38,33,38,33,71
EL ALTO,consulta externa,nuevas en menores de 5 anos,2006-01-01,8461,6878,8461,6878,15339
EL CHORO,consulta externa,nuevas en menores de 5 anos,2006-01-01,32,29,32,29,61
EL PUENTE(STC),consulta externa,nuevas en menores de 5 anos,2006-01-01,196,219,196,219,415
EL PUENTE(TJA),consulta externa,nuevas en menores de 5 anos,2006-01-01,217,181,217,181,398
EL TORNO,consulta externa,nuevas en menores de 5 anos,2006-01-01,929,931,929,931,1860
EL VILLAR,consulta externa,nuevas en menores de 5 anos,2006-01-01,173,173,173,173,346
ENTRE RIOS,consulta externa,nuevas en menores de 5 anos,2006-01-01,356,285,356,285,641
ENTRE RIOS,consulta externa,nuevas en menores de 5 anos,2006-01-01,453,398,453,398,851
ESCARA,consulta externa,nuevas en menores de 5 anos,2006-01-01,1,4,1,4,5
ESMERALDA,consulta externa,nuevas en menores de 5 anos,2006-01-01,3,3,3,3,6
EUCALIPTUS,consulta externa,nuevas en menores de 5 anos,2006-01-01,160,123,160,123,283
EUREKA (SANTOS MERCADO),consulta externa,nuevas en menores de 5 anos,2006-01-01,43,54,43,54,97
EXALTACION,consulta externa,nuevas en menores de 5 anos,2006-01-01,31,25,31,25,56
FERNANDEZ ALONSO,consulta externa,nuevas en menores de 5 anos,2006-01-01,449,377,449,377,826
FILADELFIA,consulta externa,nuevas en menores de 5 anos,2006-01-01,127,150,127,150,277
GENERAL SAAVEDRA,consulta externa,nuevas en menores de 5 anos,2006-01-01,553,498,553,498,1051
GRAL. J.J. PEREZ (CHARAZANI),consulta externa,nuevas en menores de 5 anos,2006-01-01,87,81,87,81,168
GUANAY,consulta externa,nuevas en menores de 5 anos,2006-01-01,228,224,228,224,452
GUAQUI,consulta externa,nuevas en menores de 5 anos,2006-01-01,28,26,28,26,54
GUAYARAMERIN,consulta externa,nuevas en menores de 5 anos,2006-01-01,892,899,892,899,1791
GUTIERREZ,consulta externa,nuevas en menores de 5 anos,2006-01-01,586,579,586,579,1165
HUACARETA,consulta externa,nuevas en menores de 5 anos,2006-01-01,273,223,273,223,496
HUACAYA (VILLA DE HUACAYA),consulta externa,nuevas en menores de 5 anos,2006-01-01,90,73,90,73,163
HUACHACALLA,consulta externa,nuevas en menores de 5 anos,2006-01-01,26,24,26,24,50
HUANUNI,consulta externa,nuevas en menores de 5 anos,2006-01-01,450,348,450,348,798
HUARACAJE,consulta externa,nuevas en menores de 5 anos,2006-01-01,70,68,70,68,138
HUAYLLAMARCA,consulta externa,nuevas en menores de 5 anos,2006-01-01,24,53,24,53,77
ICHOCA,consulta externa,nuevas en menores de 5 anos,2006-01-01,56,48,56,48,104
ICLA,consulta externa,nuevas en menores de 5 anos,2006-01-01,384,311,384,311,695
INCAHUASI,consulta externa,nuevas en menores de 5 anos,2006-01-01,393,400,393,400,793
INGAVI (HUMAITA),consulta externa,nuevas en menores de 5 anos,2006-01-01,40,24,40,24,64
INQUISIVI,consulta externa,nuevas en menores de 5 anos,2006-01-01,174,190,174,190,364
IRUPANA (VILLA DE LANZA),consulta externa,nuevas en menores de 5 anos,2006-01-01,255,214,255,214,469
IXIAMAS,consulta externa,nuevas en menores de 5 anos,2006-01-01,219,138,219,138,357
JESUS DE MACHACA,consulta externa,nuevas en menores de 5 anos,2006-01-01,121,111,121,111,232
LA ASUNTA,consulta externa,nuevas en menores de 5 anos,2006-01-01,418,371,418,371,789
LA GUARDIA,consulta externa,nuevas en menores de 5 anos,2006-01-01,1058,984,1058,984,2042
LA PAZ,consulta externa,nuevas en menores de 5 anos,2006-01-01,10791,10136,10791,10136,20927
LA RIVERA,consulta externa,nuevas en menores de 5 anos,2006-01-01,3,5,3,5,8
LAGUNILLAS,consulta externa,nuevas en menores de 5 anos,2006-01-01,217,220,217,220,437
LAJA,consulta externa,nuevas en menores de 5 anos,2006-01-01,86,68,86,68,154
LAS CARRERAS,consulta externa,nuevas en menores de 5 anos,2006-01-01,68,80,68,80,148
LICOMA PAMPA,consulta externa,nuevas en menores de 5 anos,2006-01-01,80,83,80,83,163
LLALLAGUA,consulta externa,nuevas en menores de 5 anos,2006-01-01,421,385,421,385,806
LLICA,consulta externa,nuevas en menores de 5 anos,2006-01-01,32,34,32,34,66
LORETO,consulta externa,nuevas en menores de 5 anos,2006-01-01,77,73,77,73,150
LURIBAY,consulta externa,nuevas en menores de 5 anos,2006-01-01,96,71,96,71,167
MACHACAMARCA,consulta externa,nuevas en menores de 5 anos,2006-01-01,29,30,29,30,59
MACHARETI,consulta externa,nuevas en menores de 5 anos,2006-01-01,226,277,226,277,503
MAGDALENA,consulta externa,nuevas en menores de 5 anos,2006-01-01,226,189,226,189,415
MAIRANA,consulta externa,nuevas en menores de 5 anos,2006-01-01,178,169,178,169,347
MALLA,consulta externa,nuevas en menores de 5 anos,2006-01-01,36,41,36,41,77
MAPIRI,consulta externa,nuevas en menores de 5 anos,2006-01-01,212,153,212,153,365
MECAPACA,consulta externa,nuevas en menores de 5 anos,2006-01-01,123,119,123,119,242
MINEROS,consulta externa,nuevas en menores de 5 anos,2006-01-01,495,422,495,422,917
MIZQUE,consulta externa,nuevas en menores de 5 anos,2006-01-01,318,314,318,314,632
MOCOMOCO,consulta externa,nuevas en menores de 5 anos,2006-01-01,83,84,83,84,167
MOJINETE,consulta externa,nuevas en menores de 5 anos,2006-01-01,11,12,11,12,23
MOJOCOYA,consulta externa,nuevas en menores de 5 anos,2006-01-01,155,126,155,126,281
MONTEAGUDO,consulta externa,nuevas en menores de 5 anos,2006-01-01,621,500,621,500,1121
MONTERO,consulta externa,nuevas en menores de 5 anos,2006-01-01,2359,2068,2359,2068,4427
MORO MORO,consulta externa,nuevas en menores de 5 anos,2006-01-01,79,53,79,53,132
MOROCHATA,consulta externa,nuevas en menores de 5 anos,2006-01-01,153,164,153,164,317
NACEBE (SANTA ROSA DEL ABUNA),consulta externa,nuevas en menores de 5 anos,2006-01-01,47,24,47,24,71
NAZACARA DE PACAJES,consulta externa,nuevas en menores de 5 anos,2006-01-01,4,2,4,2,6
NUEVO MANOA (NUEVA ESPERANZA),consulta externa,nuevas en menores de 5 anos,2006-01-01,59,53,59,53,112
OCURI,consulta externa,nuevas en menores de 5 anos,2006-01-01,328,319,328,319,647
OKINAWA,consulta externa,nuevas en menores de 5 anos,2006-01-01,400,354,400,354,754
OMEREQUE,consulta externa,nuevas en menores de 5 anos,2006-01-01,118,131,118,131,249
ORURO,consulta externa,nuevas en menores de 5 anos,2006-01-01,3808,3258,3808,3258,7066
PADCAYA,consulta externa,nuevas en menores de 5 anos,2006-01-01,352,334,352,334,686
PADILLA,consulta externa,nuevas en menores de 5 anos,2006-01-01,309,286,309,286,595
PAILON,consulta externa,nuevas en menores de 5 anos,2006-01-01,353,315,353,315,668
PALCA,consulta externa,nuevas en menores de 5 anos,2006-01-01,70,69,70,69,139
PALOS BLANCOS,consulta externa,nuevas en menores de 5 anos,2006-01-01,520,532,520,532,1052
PAMPA AULLAGAS,consulta externa,nuevas en menores de 5 anos,2006-01-01,32,28,32,28,60
PAMPA GRANDE,consulta externa,nuevas en menores de 5 anos,2006-01-01,185,189,185,189,374
PAPEL PAMPA,consulta externa,nuevas en menores de 5 anos,2006-01-01,25,30,25,30,55
PASORAPA,consulta externa,nuevas en menores de 5 anos,2006-01-01,42,21,42,21,63
PATACAMAYA,consulta externa,nuevas en menores de 5 anos,2006-01-01,177,164,177,164,341
PAZÑA,consulta externa,nuevas en menores de 5 anos,2006-01-01,106,77,106,77,183
PELECHUCO,consulta externa,nuevas en menores de 5 anos,2006-01-01,72,44,72,44,116
POCOATA,consulta externa,nuevas en menores de 5 anos,2006-01-01,298,323,298,323,621
POCONA,consulta externa,nuevas en menores de 5 anos,2006-01-01,184,133,184,133,317
POJO (CBBA),consulta externa,nuevas en menores de 5 anos,2006-01-01,65,59,65,59,124
POOPO,consulta externa,nuevas en menores de 5 anos,2006-01-01,38,50,38,50,88
PORCO,consulta externa,nuevas en menores de 5 anos,2006-01-01,112,108,112,108,220
POROMA,consulta externa,nuevas en menores de 5 anos,2006-01-01,272,256,272,256,528
PORONGO,consulta externa,nuevas en menores de 5 anos,2006-01-01,193,121,193,121,314
PORTACHUELO,consulta externa,nuevas en menores de 5 anos,2006-01-01,474,436,474,436,910
PORVENIR,consulta externa,nuevas en menores de 5 anos,2006-01-01,143,96,143,96,239
POSTRER VALLE,consulta externa,nuevas en menores de 5 anos,2006-01-01,42,39,42,39,81
POTOSI,consulta externa,nuevas en menores de 5 anos,2006-01-01,3272,2798,3272,2798,6070
PRESTO,consulta externa,nuevas en menores de 5 anos,2006-01-01,331,286,331,286,617
PUCARA,consulta externa,nuevas en menores de 5 anos,2006-01-01,32,14,32,14,46
PUCARANI,consulta externa,nuevas en menores de 5 anos,2006-01-01,148,137,148,137,285
PUERTO ACOSTA,consulta externa,nuevas en menores de 5 anos,2006-01-01,131,135,131,135,266
PUERTO CARABUCO,consulta externa,nuevas en menores de 5 anos,2006-01-01,112,107,112,107,219
PUERTO GONZALO MORENO,consulta externa,nuevas en menores de 5 anos,2006-01-01,64,58,64,58,122
PUERTO PEREZ,consulta externa,nuevas en menores de 5 anos,2006-01-01,63,35,63,35,98
PUERTO QUIJARRO,consulta externa,nuevas en menores de 5 anos,2006-01-01,179,198,179,198,377
PUERTO RICO,consulta externa,nuevas en menores de 5 anos,2006-01-01,128,145,128,145,273
PUERTO SILES,consulta externa,nuevas en menores de 5 anos,2006-01-01,12,14,12,14,26
PUERTO SUAREZ,consulta externa,nuevas en menores de 5 anos,2006-01-01,352,303,352,303,655
PUERTO VILLARROEL,consulta externa,nuevas en menores de 5 anos,2006-01-01,1040,1020,1040,1020,2060
PUNA,consulta externa,nuevas en menores de 5 anos,2006-01-01,392,348,392,348,740
PUNATA,consulta externa,nuevas en menores de 5 anos,2006-01-01,234,224,234,224,458
QUIABAYA,consulta externa,nuevas en menores de 5 anos,2006-01-01,4,1,4,1,5
QUILLACOLLO,consulta externa,nuevas en menores de 5 anos,2006-01-01,1103,876,1103,876,1979
QUIME,consulta externa,nuevas en menores de 5 anos,2006-01-01,106,101,106,101,207
QUIRUSILLAS,consulta externa,nuevas en menores de 5 anos,2006-01-01,43,31,43,31,74
RAVELO,consulta externa,nuevas en menores de 5 anos,2006-01-01,244,192,244,192,436
REYES,consulta externa,nuevas en menores de 5 anos,2006-01-01,258,269,258,269,527
RIBERALTA,consulta externa,nuevas en menores de 5 anos,2006-01-01,1734,1523,1734,1523,3257
ROBORE,consulta externa,nuevas en menores de 5 anos,2006-01-01,275,258,275,258,533
RURRENABAQUE,consulta externa,nuevas en menores de 5 anos,2006-01-01,341,284,341,284,625
SABAYA,consulta externa,nuevas en menores de 5 anos,2006-01-01,51,22,51,22,73
SACABA,consulta externa,nuevas en menores de 5 anos,2006-01-01,969,848,969,848,1817
SACABAMBA,consulta externa,nuevas en menores de 5 anos,2006-01-01,51,52,51,52,103
SACACA,consulta externa,nuevas en menores de 5 anos,2006-01-01,308,270,308,270,578
SAIPINA,consulta externa,nuevas en menores de 5 anos,2006-01-01,156,180,156,180,336
SALINAS DE GARCI MENDOZA,consulta externa,nuevas en menores de 5 anos,2006-01-01,152,143,152,143,295
SAMAIPATA,consulta externa,nuevas en menores de 5 anos,2006-01-01,148,103,148,103,251
SAN AGUSTIN,consulta externa,nuevas en menores de 5 anos,2006-01-01,37,27,37,27,64
SAN ANDRES,consulta externa,nuevas en menores de 5 anos,2006-01-01,291,261,291,261,552
SAN ANDRES DE MACHACA,consulta externa,nuevas en menores de 5 anos,2006-01-01,29,23,29,23,52
SAN ANTONIO DE ESMORUCO,consulta externa,nuevas en menores de 5 anos,2006-01-01,17,32,17,32,49
SAN ANTONIO DE LOMERIO,consulta externa,nuevas en menores de 5 anos,2006-01-01,112,112,112,112,224
SAN BENITO,consulta externa,nuevas en menores de 5 anos,2006-01-01,118,128,118,128,246
SAN BORJA,consulta externa,nuevas en menores de 5 anos,2006-01-01,479,467,479,467,946
SAN BUENA VENTURA,consulta externa,nuevas en menores de 5 anos,2006-01-01,207,211,207,211,418
SAN CARLOS,consulta externa,nuevas en menores de 5 anos,2006-01-01,366,312,366,312,678
SAN IGNACIO,consulta externa,nuevas en menores de 5 anos,2006-01-01,519,455,519,455,974
SAN IGNACIO DE VELASCO,consulta externa,nuevas en menores de 5 anos,2006-01-01,1141,1101,1141,1101,2242
SAN JAVIER(BNI),consulta externa,nuevas en menores de 5 anos,2006-01-01,37,38,37,38,75
SAN JAVIER(STC),consulta externa,nuevas en menores de 5 anos,2006-01-01,260,235,260,235,495
SAN JOAQUIN,consulta externa,nuevas en menores de 5 anos,2006-01-01,55,77,55,77,132
SAN JOSE DE CHIQUITOS,consulta externa,nuevas en menores de 5 anos,2006-01-01,341,330,341,330,671
SAN JUAN DE YAPACANI,consulta externa,nuevas en menores de 5 anos,2006-01-01,247,259,247,259,506
SAN JULIAN,consulta externa,nuevas en menores de 5 anos,2006-01-01,1034,997,1034,997,2031
SAN LORENZO(PND),consulta externa,nuevas en menores de 5 anos,2006-01-01,129,98,129,98,227
SAN LORENZO(TJA),consulta externa,nuevas en menores de 5 anos,2006-01-01,470,445,470,445,915
SAN LUCAS,consulta externa,nuevas en menores de 5 anos,2006-01-01,654,652,654,652,1306
SAN MATIAS,consulta externa,nuevas en menores de 5 anos,2006-01-01,497,181,497,181,678
SAN MIGUEL DE VELASCO,consulta externa,nuevas en menores de 5 anos,2006-01-01,194,169,194,169,363
SAN PABLO DE LIPEZ,consulta externa,nuevas en menores de 5 anos,2006-01-01,57,58,57,58,115
SAN PEDRO,consulta externa,nuevas en menores de 5 anos,2006-01-01,593,579,593,579,1172
SAN PEDRO DE BUENA VISTA,consulta externa,nuevas en menores de 5 anos,2006-01-01,284,277,284,277,561
SAN PEDRO DE CURAHUARA,consulta externa,nuevas en menores de 5 anos,2006-01-01,52,43,52,43,95
SAN PEDRO DE QUEMES,consulta externa,nuevas en menores de 5 anos,2006-01-01,1,4,1,4,5
SAN PEDRO DE TIQUINA,consulta externa,nuevas en menores de 5 anos,2006-01-01,18,23,18,23,41
SAN PEDRO(PND),consulta externa,nuevas en menores de 5 anos,2006-01-01,44,41,44,41,85
SAN RAFAEL,consulta externa,nuevas en menores de 5 anos,2006-01-01,141,124,141,124,265
SAN RAMON,consulta externa,nuevas en menores de 5 anos,2006-01-01,125,80,125,80,205
SAN RAMON,consulta externa,nuevas en menores de 5 anos,2006-01-01,157,180,157,180,337
SANTA ANA,consulta externa,nuevas en menores de 5 anos,2006-01-01,350,260,350,260,610
SANTA CRUZ DE LA SIERRA,consulta externa,nuevas en menores de 5 anos,2006-01-01,24645,21471,24645,21471,46116
SANTA ROSA,consulta externa,nuevas en menores de 5 anos,2006-01-01,157,184,157,184,341
SANTA ROSA DEL SARA,consulta externa,nuevas en menores de 5 anos,2006-01-01,688,631,688,631,1319
SANTIAGO DE CALLAPA,consulta externa,nuevas en menores de 5 anos,2006-01-01,37,32,37,32,69
SANTIAGO DE HUARI,consulta externa,nuevas en menores de 5 anos,2006-01-01,53,62,53,62,115
SANTIAGO DE MACHACA,consulta externa,nuevas en menores de 5 anos,2006-01-01,26,19,26,19,45
SANTIVAÑES,consulta externa,nuevas en menores de 5 anos,2006-01-01,117,87,117,87,204
SANTUARIO DE QUILLACAS,consulta externa,nuevas en menores de 5 anos,2006-01-01,25,24,25,24,49
SAPAHAQUI,consulta externa,nuevas en menores de 5 anos,2006-01-01,102,82,102,82,184
SENA,consulta externa,nuevas en menores de 5 anos,2006-01-01,204,171,204,171,375
SICA SICA (VILLA AROMA),consulta externa,nuevas en menores de 5 anos,2006-01-01,139,140,139,140,279
SICAYA,consulta externa,nuevas en menores de 5 anos,2006-01-01,54,32,54,32,86
SIPE SIPE,consulta externa,nuevas en menores de 5 anos,2006-01-01,405,326,405,326,731
SOPACHUY,consulta externa,nuevas en menores de 5 anos,2006-01-01,196,204,196,204,400
SORACACHI,consulta externa,nuevas en menores de 5 anos,2006-01-01,52,70,52,70,122
SORATA,consulta externa,nuevas en menores de 5 anos,2006-01-01,147,147,147,147,294
SUCRE,consulta externa,nuevas en menores de 5 anos,2006-01-01,5049,4298,5049,4298,9347
TACACHI,consulta externa,nuevas en menores de 5 anos,2006-01-01,13,7,13,7,20
TACACOMA,consulta externa,nuevas en menores de 5 anos,2006-01-01,41,39,41,39,80
TACOBAMBA,consulta externa,nuevas en menores de 5 anos,2006-01-01,76,60,76,60,136
TACOPAYA,consulta externa,nuevas en menores de 5 anos,2006-01-01,122,130,122,130,252
TAHUA,consulta externa,nuevas en menores de 5 anos,2006-01-01,18,15,18,15,33
TAPACARI,consulta externa,nuevas en menores de 5 anos,2006-01-01,286,261,286,261,547
TARABUCO,consulta externa,nuevas en menores de 5 anos,2006-01-01,664,642,664,642,1306
TARACO,consulta externa,nuevas en menores de 5 anos,2006-01-01,22,21,22,21,43
TARATA,consulta externa,nuevas en menores de 5 anos,2006-01-01,112,78,112,78,190
TARIJA,consulta externa,nuevas en menores de 5 anos,2006-01-01,4071,3827,4071,3827,7898
TARVITA,consulta externa,nuevas en menores de 5 anos,2006-01-01,412,431,412,431,843
TEOPONTE,consulta externa,nuevas en menores de 5 anos,2006-01-01,138,137,138,137,275
TIAWANACU,consulta externa,nuevas en menores de 5 anos,2006-01-01,91,75,91,75,166
TINGUIPAYA,consulta externa,nuevas en menores de 5 anos,2006-01-01,366,297,366,297,663
TIPUANI,consulta externa,nuevas en menores de 5 anos,2006-01-01,170,144,170,144,314
TIQUIPAYA,consulta externa,nuevas en menores de 5 anos,2006-01-01,468,404,468,404,872
TIRAQUE (CBBA),consulta externa,nuevas en menores de 5 anos,2006-01-01,713,604,713,604,1317
TITO YUPANQUI (PARQUIPUJIO),consulta externa,nuevas en menores de 5 anos,2006-01-01,22,18,22,18,40
TOCO,consulta externa,nuevas en menores de 5 anos,2006-01-01,42,29,42,29,71
TODOS SANTOS,consulta externa,nuevas en menores de 5 anos,2006-01-01,3,4,3,4,7
TOLATA,consulta externa,nuevas en menores de 5 anos,2006-01-01,54,42,54,42,96
TOLEDO,consulta externa,nuevas en menores de 5 anos,2006-01-01,66,45,66,45,111
TOMAVE,consulta externa,nuevas en menores de 5 anos,2006-01-01,162,138,162,138,300
TOMINA,consulta externa,nuevas en menores de 5 anos,2006-01-01,236,266,236,266,502
TORO TORO,consulta externa,nuevas en menores de 5 anos,2006-01-01,165,188,165,188,353
TOTORA(CBBA),consulta externa,nuevas en menores de 5 anos,2006-01-01,77,82,77,82,159
TOTORA(ORR),consulta externa,nuevas en menores de 5 anos,2006-01-01,50,44,50,44,94
TRIGAL,consulta externa,nuevas en menores de 5 anos,2006-01-01,43,36,43,36,79
TRINIDAD,consulta externa,nuevas en menores de 5 anos,2006-01-01,2231,2119,2231,2119,4350
TUPIZA,consulta externa,nuevas en menores de 5 anos,2006-01-01,911,972,911,972,1883
TURCO,consulta externa,nuevas en menores de 5 anos,2006-01-01,62,62,62,62,124
UMALA,consulta externa,nuevas en menores de 5 anos,2006-01-01,25,26,25,26,51
UNCIA,consulta externa,nuevas en menores de 5 anos,2006-01-01,401,360,401,360,761
URIONDO (A. CONCEPCION),consulta externa,nuevas en menores de 5 anos,2006-01-01,518,447,518,447,965
URUBICHA,consulta externa,nuevas en menores de 5 anos,2006-01-01,139,164,139,164,303
UYUNI,consulta externa,nuevas en menores de 5 anos,2006-01-01,200,180,200,180,380
VACAS,consulta externa,nuevas en menores de 5 anos,2006-01-01,117,127,117,127,244
VALLEGRANDE,consulta externa,nuevas en menores de 5 anos,2006-01-01,260,239,260,239,499
VIACHA,consulta externa,nuevas en menores de 5 anos,2006-01-01,387,310,387,310,697
VILA VILA,consulta externa,nuevas en menores de 5 anos,2006-01-01,31,22,31,22,53
VILLA MONTES,consulta externa,nuevas en menores de 5 anos,2006-01-01,643,575,643,575,1218
VILLA NUEVA (LOMA ALTA),consulta externa,nuevas en menores de 5 anos,2006-01-01,59,67,59,67,126
VILLA RIVERO,consulta externa,nuevas en menores de 5 anos,2006-01-01,26,34,26,34,60
VILLA SERRANO,consulta externa,nuevas en menores de 5 anos,2006-01-01,362,296,362,296,658
VILLA TUNARI,consulta externa,nuevas en menores de 5 anos,2006-01-01,1236,1042,1236,1042,2278
VILLA VACA GUZMAN (MUYUPAMPA),consulta externa,nuevas en menores de 5 anos,2006-01-01,319,327,319,327,646
VILLAZON,consulta externa,nuevas en menores de 5 anos,2006-01-01,815,722,815,722,1537
VINTO,consulta externa,nuevas en menores de 5 anos,2006-01-01,165,143,165,143,308
VITICHI,consulta externa,nuevas en menores de 5 anos,2006-01-01,181,164,181,164,345
WALDO BALLIVIAN,consulta externa,nuevas en menores de 5 anos,2006-01-01,5,13,5,13,18
WARNES,consulta externa,nuevas en menores de 5 anos,2006-01-01,993,1271,993,1271,2264
YACO,consulta externa,nuevas en menores de 5 anos,2006-01-01,81,78,81,78,159
YACUIBA,consulta externa,nuevas en menores de 5 anos,2006-01-01,1933,1781,1933,1781,3714
YAMPARAEZ,consulta externa,nuevas en menores de 5 anos,2006-01-01,98,93,98,93,191
YANACACHI,consulta externa,nuevas en menores de 5 anos,2006-01-01,57,65,57,65,122
YAPACANI,consulta externa,nuevas en menores de 5 anos,2006-01-01,650,608,650,608,1258
YOCALLA,consulta externa,nuevas en menores de 5 anos,2006-01-01,50,57,50,57,107
YOTALA,consulta externa,nuevas en menores de 5 anos,2006-01-01,112,110,112,110,222
YUNCHARA,consulta externa,nuevas en menores de 5 anos,2006-01-01,75,63,75,63,138
ZUDAÑEZ,consulta externa,nuevas en menores de 5 anos,2006-01-01,207,178,207,178,385
ACACIO,consulta externa,nuevas en menores de 5 anos,2006-02-01,157,137,157,137,294
ACHACACHI,consulta externa,nuevas en menores de 5 anos,2006-02-01,292,282,292,282,574
ACHOCALLA,consulta externa,nuevas en menores de 5 anos,2006-02-01,82,110,82,110,192
AIQUILE,consulta externa,nuevas en menores de 5 anos,2006-02-01,184,188,184,188,372
ALALAY,consulta externa,nuevas en menores de 5 anos,2006-02-01,38,21,38,21,59
ALCALA,consulta externa,nuevas en menores de 5 anos,2006-02-01,179,169,179,169,348
ANCORAIMES,consulta externa,nuevas en menores de 5 anos,2006-02-01,178,180,178,180,358
ANDAMARCA,consulta externa,nuevas en menores de 5 anos,2006-02-01,47,53,47,53,100
ANTEQUERA,consulta externa,nuevas en menores de 5 anos,2006-02-01,30,33,30,33,63
ANZALDO,consulta externa,nuevas en menores de 5 anos,2006-02-01,92,76,92,76,168
APOLO,consulta externa,nuevas en menores de 5 anos,2006-02-01,286,271,286,271,557
ARAMPAMPA,consulta externa,nuevas en menores de 5 anos,2006-02-01,91,61,91,61,152
ARANI,consulta externa,nuevas en menores de 5 anos,2006-02-01,57,67,57,67,124
ARBIETO,consulta externa,nuevas en menores de 5 anos,2006-02-01,82,76,82,76,158
ARQUE,consulta externa,nuevas en menores de 5 anos,2006-02-01,112,112,112,112,224
ASCENCION DE GUARAYOS,consulta externa,nuevas en menores de 5 anos,2006-02-01,675,626,675,626,1301
ATOCHA,consulta externa,nuevas en menores de 5 anos,2006-02-01,244,222,244,222,466
AUCAPATA,consulta externa,nuevas en menores de 5 anos,2006-02-01,94,85,94,85,179
AYATA,consulta externa,nuevas en menores de 5 anos,2006-02-01,102,82,102,82,184
AYO AYO,consulta externa,nuevas en menores de 5 anos,2006-02-01,56,61,56,61,117
AYOPAYA (V. DE INDEPENDENCIA),consulta externa,nuevas en menores de 5 anos,2006-02-01,470,385,470,385,855
AZURDUY,consulta externa,nuevas en menores de 5 anos,2006-02-01,398,418,398,418,816
BATALLAS,consulta externa,nuevas en menores de 5 anos,2006-02-01,69,89,69,89,158
BAURES,consulta externa,nuevas en menores de 5 anos,2006-02-01,60,79,60,79,139
BELEN DE ANDAMARCA,consulta externa,nuevas en menores de 5 anos,2006-02-01,12,6,12,6,18
BELEN DE URMIRI,consulta externa,nuevas en menores de 5 anos,2006-02-01,44,29,44,29,73
BELLA FLOR,consulta externa,nuevas en menores de 5 anos,2006-02-01,69,90,69,90,159
BERMEJO,consulta externa,nuevas en menores de 5 anos,2006-02-01,948,888,948,888,1836
BETANZOS,consulta externa,nuevas en menores de 5 anos,2006-02-01,440,427,440,427,867
BOLIVAR,consulta externa,nuevas en menores de 5 anos,2006-02-01,103,130,103,130,233
BOLPEBRA,consulta externa,nuevas en menores de 5 anos,2006-02-01,56,51,56,51,107
BOYUIBE,consulta externa,nuevas en menores de 5 anos,2006-02-01,121,99,121,99,220
BUENA VISTA,consulta externa,nuevas en menores de 5 anos,2006-02-01,283,275,283,275,558
CABEZAS,consulta externa,nuevas en menores de 5 anos,2006-02-01,408,308,408,308,716
CAIROMA,consulta externa,nuevas en menores de 5 anos,2006-02-01,178,203,178,203,381
"CAIZA ""D""",consulta externa,nuevas en menores de 5 anos,2006-02-01,99,90,99,90,189
CAJUATA,consulta externa,nuevas en menores de 5 anos,2006-02-01,148,111,148,111,259
CALACOTO,consulta externa,nuevas en menores de 5 anos,2006-02-01,63,34,63,34,97
CALAMARCA,consulta externa,nuevas en menores de 5 anos,2006-02-01,101,74,101,74,175
CAMARGO,consulta externa,nuevas en menores de 5 anos,2006-02-01,456,758,456,758,1214
CAMATAQUI (C. VILLA ABECIA),consulta externa,nuevas en menores de 5 anos,2006-02-01,62,34,62,34,96
CAMIRI,consulta externa,nuevas en menores de 5 anos,2006-02-01,1007,924,1007,924,1931
CAPINOTA,consulta externa,nuevas en menores de 5 anos,2006-02-01,347,254,347,254,601
CAQUIAVIRI,consulta externa,nuevas en menores de 5 anos,2006-02-01,83,70,83,70,153
CARACOLLO,consulta externa,nuevas en menores de 5 anos,2006-02-01,147,176,147,176,323
CARANAVI,consulta externa,nuevas en menores de 5 anos,2006-02-01,678,643,678,643,1321
CARANGAS,consulta externa,nuevas en menores de 5 anos,2006-02-01,4,1,4,1,5
CARAPARI,consulta externa,nuevas en menores de 5 anos,2006-02-01,218,170,218,170,388
CARIPUYO,consulta externa,nuevas en menores de 5 anos,2006-02-01,118,123,118,123,241
CARMEN RIVERO TORREZ,consulta externa,nuevas en menores de 5 anos,2006-02-01,70,58,70,58,128
CATACORA,consulta externa,nuevas en menores de 5 anos,2006-02-01,4,7,4,7,11
CHACARILLA,consulta externa,nuevas en menores de 5 anos,2006-02-01,23,24,23,24,47
CHALLAPATA,consulta externa,nuevas en menores de 5 anos,2006-02-01,320,284,320,284,604
CHAQUI,consulta externa,nuevas en menores de 5 anos,2006-02-01,92,78,92,78,170
CHARAGUA,consulta externa,nuevas en menores de 5 anos,2006-02-01,765,660,765,660,1425
CHARAÑA,consulta externa,nuevas en menores de 5 anos,2006-02-01,12,14,12,14,26
CHAYANTA,consulta externa,nuevas en menores de 5 anos,2006-02-01,282,289,282,289,571
CHIMORE,consulta externa,nuevas en menores de 5 anos,2006-02-01,356,395,356,395,751
CHIPAYA,consulta externa,nuevas en menores de 5 anos,2006-02-01,17,6,17,6,23
CHOQUE COTA,consulta externa,nuevas en menores de 5 anos,2006-02-01,4,14,4,14,18
CHULUMANI (V. DE LA LIBERTAD),consulta externa,nuevas en menores de 5 anos,2006-02-01,199,237,199,237,436
CHUMA,consulta externa,nuevas en menores de 5 anos,2006-02-01,121,121,121,121,242
CLIZA,consulta externa,nuevas en menores de 5 anos,2006-02-01,199,127,199,127,326
COBIJA,consulta externa,nuevas en menores de 5 anos,2006-02-01,495,535,495,535,1030
COCHABAMBA,consulta externa,nuevas en menores de 5 anos,2006-02-01,7122,6463,7122,6463,13585
COIPASA,consulta externa,nuevas en menores de 5 anos,2006-02-01,1,4,1,4,5
COLCAPIRHUA,consulta externa,nuevas en menores de 5 anos,2006-02-01,260,286,260,286,546
"COLCHA ""K""",consulta externa,nuevas en menores de 5 anos,2006-02-01,114,91,114,91,205
COLLANA,consulta externa,nuevas en menores de 5 anos,2006-02-01,15,14,15,14,29
COLOMI,consulta externa,nuevas en menores de 5 anos,2006-02-01,220,205,220,205,425
COLPA BELGICA,consulta externa,nuevas en menores de 5 anos,2006-02-01,193,168,193,168,361
COLQUECHACA,consulta externa,nuevas en menores de 5 anos,2006-02-01,914,857,914,857,1771
COLQUENCHA,consulta externa,nuevas en menores de 5 anos,2006-02-01,58,59,58,59,117
COLQUIRI,consulta externa,nuevas en menores de 5 anos,2006-02-01,356,379,356,379,735
COMANCHE,consulta externa,nuevas en menores de 5 anos,2006-02-01,22,25,22,25,47
COMARAPA,consulta externa,nuevas en menores de 5 anos,2006-02-01,311,317,311,317,628
COMBAYA,consulta externa,nuevas en menores de 5 anos,2006-02-01,25,15,25,15,40
CONCEPCION,consulta externa,nuevas en menores de 5 anos,2006-02-01,307,336,307,336,643
COPACABANA,consulta externa,nuevas en menores de 5 anos,2006-02-01,79,68,79,68,147
CORIPATA,consulta externa,nuevas en menores de 5 anos,2006-02-01,230,195,230,195,425
CORO CORO,consulta externa,nuevas en menores de 5 anos,2006-02-01,85,77,85,77,162
COROICO,consulta externa,nuevas en menores de 5 anos,2006-02-01,171,157,171,157,328
CORQUE,consulta externa,nuevas en menores de 5 anos,2006-02-01,59,39,59,39,98
COTAGAITA,consulta externa,nuevas en menores de 5 anos,2006-02-01,543,515,543,515,1058
COTOCA,consulta externa,nuevas en menores de 5 anos,2006-02-01,458,387,458,387,845
CUATRO CAÑADAS,consulta externa,nuevas en menores de 5 anos,2006-02-01,499,397,499,397,896
CUCHUMUELA (V. G. VILLARROEL),consulta externa,nuevas en menores de 5 anos,2006-02-01,25,18,25,18,43
CUEVO,consulta externa,nuevas en menores de 5 anos,2006-02-01,97,93,97,93,190
CULPINA,consulta externa,nuevas en menores de 5 anos,2006-02-01,423,334,423,334,757
CURAHUARA DE CARANGAS,consulta externa,nuevas en menores de 5 anos,2006-02-01,82,70,82,70,152
CURVA,consulta externa,nuevas en menores de 5 anos,2006-02-01,39,22,39,22,61
DESAGUADERO,consulta externa,nuevas en menores de 5 anos,2006-02-01,30,13,30,13,43
EL ALTO,consulta externa,nuevas en menores de 5 anos,2006-02-01,7060,6428,7060,6428,13488
EL CHORO,consulta externa,nuevas en menores de 5 anos,2006-02-01,46,52,46,52,98
EL PUENTE(STC),consulta externa,nuevas en menores de 5 anos,2006-02-01,373,363,373,363,736
EL PUENTE(TJA),consulta externa,nuevas en menores de 5 anos,2006-02-01,162,149,162,149,311
EL TORNO,consulta externa,nuevas en menores de 5 anos,2006-02-01,867,813,867,813,1680
EL VILLAR,consulta externa,nuevas en menores de 5 anos,2006-02-01,168,168,168,168,336
ENTRE RIOS,consulta externa,nuevas en menores de 5 anos,2006-02-01,304,286,304,286,590
ENTRE RIOS,consulta externa,nuevas en menores de 5 anos,2006-02-01,442,458,442,458,900
ESCARA,consulta externa,nuevas en menores de 5 anos,2006-02-01,3,2,3,2,5
EUCALIPTUS,consulta externa,nuevas en menores de 5 anos,2006-02-01,159,157,159,157,316
EUREKA (SANTOS MERCADO),consulta externa,nuevas en menores de 5 anos,2006-02-01,11,12,11,12,23
EXALTACION,consulta externa,nuevas en menores de 5 anos,2006-02-01,55,54,55,54,109
FERNANDEZ ALONSO,consulta externa,nuevas en menores de 5 anos,2006-02-01,395,406,395,406,801
FILADELFIA,consulta externa,nuevas en menores de 5 anos,2006-02-01,95,142,95,142,237
GENERAL SAAVEDRA,consulta externa,nuevas en menores de 5 anos,2006-02-01,470,408,470,408,878
GRAL. J.J. PEREZ (CHARAZANI),consulta externa,nuevas en menores de 5 anos,2006-02-01,122,94,122,94,216
GUANAY,consulta externa,nuevas en menores de 5 anos,2006-02-01,289,254,289,254,543
GUAQUI,consulta externa,nuevas en menores de 5 anos,2006-02-01,43,22,43,22,65
GUAYARAMERIN,consulta externa,nuevas en menores de 5 anos,2006-02-01,770,707,770,707,1477
GUTIERREZ,consulta externa,nuevas en menores de 5 anos,2006-02-01,464,463,464,463,927
HUACARETA,consulta externa,nuevas en menores de 5 anos,2006-02-01,209,185,209,185,394
HUACAYA (VILLA DE HUACAYA),consulta externa,nuevas en menores de 5 anos,2006-02-01,45,43,45,43,88
HUACHACALLA,consulta externa,nuevas en menores de 5 anos,2006-02-01,19,21,19,21,40
HUANUNI,consulta externa,nuevas en menores de 5 anos,2006-02-01,400,326,400,326,726
HUARACAJE,consulta externa,nuevas en menores de 5 anos,2006-02-01,78,55,78,55,133
HUAYLLAMARCA,consulta externa,nuevas en menores de 5 anos,2006-02-01,34,32,34,32,66
ICHOCA,consulta externa,nuevas en menores de 5 anos,2006-02-01,60,30,60,30,90
ICLA,consulta externa,nuevas en menores de 5 anos,2006-02-01,425,425,425,425,850
INCAHUASI,consulta externa,nuevas en menores de 5 anos,2006-02-01,581,644,581,644,1225
INGAVI (HUMAITA),consulta externa,nuevas en menores de 5 anos,2006-02-01,68,43,68,43,111
INQUISIVI,consulta externa,nuevas en menores de 5 anos,2006-02-01,182,178,182,178,360
IRUPANA (VILLA DE LANZA),consulta externa,nuevas en menores de 5 anos,2006-02-01,265,230,265,230,495
IXIAMAS,consulta externa,nuevas en menores de 5 anos,2006-02-01,251,155,251,155,406
JESUS DE MACHACA,consulta externa,nuevas en menores de 5 anos,2006-02-01,139,85,139,85,224
LA ASUNTA,consulta externa,nuevas en menores de 5 anos,2006-02-01,447,478,447,478,925
LA GUARDIA,consulta externa,nuevas en menores de 5 anos,2006-02-01,977,951,977,951,1928
LA PAZ,consulta externa,nuevas en menores de 5 anos,2006-02-01,9761,9524,9761,9524,19285
LA RIVERA,consulta externa,nuevas en menores de 5 anos,2006-02-01,3,2,3,2,5
LAGUNILLAS,consulta externa,nuevas en menores de 5 anos,2006-02-01,225,222,225,222,447
LAJA,consulta externa,nuevas en menores de 5 anos,2006-02-01,87,70,87,70,157
LAS CARRERAS,consulta externa,nuevas en menores de 5 anos,2006-02-01,57,53,57,53,110
LICOMA PAMPA,consulta externa,nuevas en menores de 5 anos,2006-02-01,7,12,7,12,19
LLALLAGUA,consulta externa,nuevas en menores de 5 anos,2006-02-01,434,387,434,387,821
LLICA,consulta externa,nuevas en menores de 5 anos,2006-02-01,37,33,37,33,70
LORETO,consulta externa,nuevas en menores de 5 anos,2006-02-01,101,94,101,94,195
LURIBAY,consulta externa,nuevas en menores de 5 anos,2006-02-01,96,80,96,80,176
MACHACAMARCA,consulta externa,nuevas en menores de 5 anos,2006-02-01,31,23,31,23,54
MACHARETI,consulta externa,nuevas en menores de 5 anos,2006-02-01,202,285,202,285,487
MAGDALENA,consulta externa,nuevas en menores de 5 anos,2006-02-01,179,231,179,231,410
MAIRANA,consulta externa,nuevas en menores de 5 anos,2006-02-01,139,131,139,131,270
MALLA,consulta externa,nuevas en menores de 5 anos,2006-02-01,122,42,122,42,164
MAPIRI,consulta externa,nuevas en menores de 5 anos,2006-02-01,215,187,215,187,402
MECAPACA,consulta externa,nuevas en menores de 5 anos,2006-02-01,145,121,145,121,266
MINEROS,consulta externa,nuevas en menores de 5 anos,2006-02-01,440,367,440,367,807
MIZQUE,consulta externa,nuevas en menores de 5 anos,2006-02-01,356,342,356,342,698
MOCOMOCO,consulta externa,nuevas en menores de 5 anos,2006-02-01,138,123,138,123,261
MOJINETE,consulta externa,nuevas en menores de 5 anos,2006-02-01,11,13,11,13,24
MOJOCOYA,consulta externa,nuevas en menores de 5 anos,2006-02-01,194,136,194,136,330
MONTEAGUDO,consulta externa,nuevas en menores de 5 anos,2006-02-01,572,495,572,495,1067
MONTERO,consulta externa,nuevas en menores de 5 anos,2006-02-01,1957,1675,1957,1675,3632
MORO MORO,consulta externa,nuevas en menores de 5 anos,2006-02-01,70,66,70,66,136
MOROCHATA,consulta externa,nuevas en menores de 5 anos,2006-02-01,258,267,258,267,525
NACEBE (SANTA ROSA DEL ABUNA),consulta externa,nuevas en menores de 5 anos,2006-02-01,39,32,39,32,71
NUEVO MANOA (NUEVA ESPERANZA),consulta externa,nuevas en menores de 5 anos,2006-02-01,34,22,34,22,56
OCURI,consulta externa,nuevas en menores de 5 anos,2006-02-01,309,360,309,360,669
OKINAWA,consulta externa,nuevas en menores de 5 anos,2006-02-01,454,373,454,373,827
OMEREQUE,consulta externa,nuevas en menores de 5 anos,2006-02-01,109,133,109,133,242
ORURO,consulta externa,nuevas en menores de 5 anos,2006-02-01,3206,2864,3206,2864,6070
PADCAYA,consulta externa,nuevas en menores de 5 anos,2006-02-01,347,333,347,333,680
PADILLA,consulta externa,nuevas en menores de 5 anos,2006-02-01,354,339,354,339,693
PAILON,consulta externa,nuevas en menores de 5 anos,2006-02-01,347,342,347,342,689
PALCA,consulta externa,nuevas en menores de 5 anos,2006-02-01,90,80,90,80,170
PALOS BLANCOS,consulta externa,nuevas en menores de 5 anos,2006-02-01,621,505,621,505,1126
PAMPA AULLAGAS,consulta externa,nuevas en menores de 5 anos,2006-02-01,40,26,40,26,66
PAMPA GRANDE,consulta externa,nuevas en menores de 5 anos,2006-02-01,135,133,135,133,268
PAPEL PAMPA,consulta externa,nuevas en menores de 5 anos,2006-02-01,41,35,41,35,76
PASORAPA,consulta externa,nuevas en menores de 5 anos,2006-02-01,42,43,42,43,85
PATACAMAYA,consulta externa,nuevas en menores de 5 anos,2006-02-01,220,185,220,185,405
PAZÑA,consulta externa,nuevas en menores de 5 anos,2006-02-01,85,124,85,124,209
PELECHUCO,consulta externa,nuevas en menores de 5 anos,2006-02-01,76,59,76,59,135
POCOATA,consulta externa,nuevas en menores de 5 anos,2006-02-01,304,300,304,300,604
POCONA,consulta externa,nuevas en menores de 5 anos,2006-02-01,225,153,225,153,378
POJO (CBBA),consulta externa,nuevas en menores de 5 anos,2006-02-01,66,69,66,69,135
POOPO,consulta externa,nuevas en menores de 5 anos,2006-02-01,38,23,38,23,61
PORCO,consulta externa,nuevas en menores de 5 anos,2006-02-01,103,100,103,100,203
POROMA,consulta externa,nuevas en menores de 5 anos,2006-02-01,393,337,393,337,730
PORONGO,consulta externa,nuevas en menores de 5 anos,2006-02-01,229,210,229,210,439
PORTACHUELO,consulta externa,nuevas en menores de 5 anos,2006-02-01,453,367,453,367,820
PORVENIR,consulta externa,nuevas en menores de 5 anos,2006-02-01,85,87,85,87,172
POSTRER VALLE,consulta externa,nuevas en menores de 5 anos,2006-02-01,67,51,67,51,118
POTOSI,consulta externa,nuevas en menores de 5 anos,2006-02-01,2761,2312,2761,2312,5073
PRESTO,consulta externa,nuevas en menores de 5 anos,2006-02-01,325,297,325,297,622
PUCARA,consulta externa,nuevas en menores de 5 anos,2006-02-01,63,42,63,42,105
PUCARANI,consulta externa,nuevas en menores de 5 anos,2006-02-01,139,153,139,153,292
PUERTO ACOSTA,consulta externa,nuevas en menores de 5 anos,2006-02-01,177,217,177,217,394
PUERTO CARABUCO,consulta externa,nuevas en menores de 5 anos,2006-02-01,78,54,78,54,132
PUERTO GONZALO MORENO,consulta externa,nuevas en menores de 5 anos,2006-02-01,78,69,78,69,147
PUERTO PEREZ,consulta externa,nuevas en menores de 5 anos,2006-02-01,68,53,68,53,121
PUERTO QUIJARRO,consulta externa,nuevas en menores de 5 anos,2006-02-01,231,218,231,218,449
PUERTO RICO,consulta externa,nuevas en menores de 5 anos,2006-02-01,165,185,165,185,350
PUERTO SILES,consulta externa,nuevas en menores de 5 anos,2006-02-01,39,59,39,59,98
PUERTO SUAREZ,consulta externa,nuevas en menores de 5 anos,2006-02-01,322,256,322,256,578
PUERTO VILLARROEL,consulta externa,nuevas en menores de 5 anos,2006-02-01,1115,943,1115,943,2058
PUNA,consulta externa,nuevas en menores de 5 anos,2006-02-01,448,411,448,411,859
PUNATA,consulta externa,nuevas en menores de 5 anos,2006-02-01,283,254,283,254,537
QUIABAYA,consulta externa,nuevas en menores de 5 anos,2006-02-01,30,25,30,25,55
QUILLACOLLO,consulta externa,nuevas en menores de 5 anos,2006-02-01,741,702,741,702,1443
QUIME,consulta externa,nuevas en menores de 5 anos,2006-02-01,127,100,127,100,227
QUIRUSILLAS,consulta externa,nuevas en menores de 5 anos,2006-02-01,39,37,39,37,76
RAVELO,consulta externa,nuevas en menores de 5 anos,2006-02-01,313,242,313,242,555
REYES,consulta externa,nuevas en menores de 5 anos,2006-02-01,250,202,250,202,452
RIBERALTA,consulta externa,nuevas en menores de 5 anos,2006-02-01,1507,1410,1507,1410,2917
ROBORE,consulta externa,nuevas en menores de 5 anos,2006-02-01,287,321,287,321,608
RURRENABAQUE,consulta externa,nuevas en menores de 5 anos,2006-02-01,304,338,304,338,642
SABAYA,consulta externa,nuevas en menores de 5 anos,2006-02-01,50,29,50,29,79
SACABA,consulta externa,nuevas en menores de 5 anos,2006-02-01,1003,922,1003,922,1925
SACABAMBA,consulta externa,nuevas en menores de 5 anos,2006-02-01,41,50,41,50,91
SACACA,consulta externa,nuevas en menores de 5 anos,2006-02-01,551,493,551,493,1044
SAIPINA,consulta externa,nuevas en menores de 5 anos,2006-02-01,137,126,137,126,263
SALINAS DE GARCI MENDOZA,consulta externa,nuevas en menores de 5 anos,2006-02-01,154,139,154,139,293
SAMAIPATA,consulta externa,nuevas en menores de 5 anos,2006-02-01,182,120,182,120,302
SAN AGUSTIN,consulta externa,nuevas en menores de 5 anos,2006-02-01,16,22,16,22,38
SAN ANDRES,consulta externa,nuevas en menores de 5 anos,2006-02-01,206,178,206,178,384
SAN ANDRES DE MACHACA,consulta externa,nuevas en menores de 5 anos,2006-02-01,25,16,25,16,41
SAN ANTONIO DE ESMORUCO,consulta externa,nuevas en menores de 5 anos,2006-02-01,24,18,24,18,42
SAN ANTONIO DE LOMERIO,consulta externa,nuevas en menores de 5 anos,2006-02-01,87,76,87,76,163
SAN BENITO,consulta externa,nuevas en menores de 5 anos,2006-02-01,138,100,138,100,238
SAN BORJA,consulta externa,nuevas en menores de 5 anos,2006-02-01,460,427,460,427,887
SAN BUENA VENTURA,consulta externa,nuevas en menores de 5 anos,2006-02-01,303,264,303,264,567
SAN CARLOS,consulta externa,nuevas en menores de 5 anos,2006-02-01,326,296,326,296,622
SAN IGNACIO,consulta externa,nuevas en menores de 5 anos,2006-02-01,532,519,532,519,1051
SAN IGNACIO DE VELASCO,consulta externa,nuevas en menores de 5 anos,2006-02-01,1110,1067,1110,1067,2177
SAN JAVIER(BNI),consulta externa,nuevas en menores de 5 anos,2006-02-01,32,25,32,25,57
SAN JAVIER(STC),consulta externa,nuevas en menores de 5 anos,2006-02-01,102,101,102,101,203
SAN JOAQUIN,consulta externa,nuevas en menores de 5 anos,2006-02-01,95,112,95,112,207
SAN JOSE DE CHIQUITOS,consulta externa,nuevas en menores de 5 anos,2006-02-01,529,455,529,455,984
SAN JUAN DE YAPACANI,consulta externa,nuevas en menores de 5 anos,2006-02-01,305,289,305,289,594
SAN JULIAN,consulta externa,nuevas en menores de 5 anos,2006-02-01,1848,2061,1848,2061,3909
SAN LORENZO(PND),consulta externa,nuevas en menores de 5 anos,2006-02-01,152,121,152,121,273
SAN LORENZO(TJA),consulta externa,nuevas en menores de 5 anos,2006-02-01,437,456,437,456,893
SAN LUCAS,consulta externa,nuevas en menores de 5 anos,2006-02-01,715,673,715,673,1388
SAN MATIAS,consulta externa,nuevas en menores de 5 anos,2006-02-01,194,177,194,177,371
SAN MIGUEL DE VELASCO,consulta externa,nuevas en menores de 5 anos,2006-02-01,283,240,283,240,523
SAN PABLO DE LIPEZ,consulta externa,nuevas en menores de 5 anos,2006-02-01,66,64,66,64,130
SAN PEDRO,consulta externa,nuevas en menores de 5 anos,2006-02-01,548,555,548,555,1103
SAN PEDRO DE BUENA VISTA,consulta externa,nuevas en menores de 5 anos,2006-02-01,250,249,250,249,499
SAN PEDRO DE CURAHUARA,consulta externa,nuevas en menores de 5 anos,2006-02-01,46,28,46,28,74
SAN PEDRO DE QUEMES,consulta externa,nuevas en menores de 5 anos,2006-02-01,6,9,6,9,15
SAN PEDRO DE TIQUINA,consulta externa,nuevas en menores de 5 anos,2006-02-01,31,22,31,22,53
SAN PEDRO(PND),consulta externa,nuevas en menores de 5 anos,2006-02-01,25,37,25,37,62
SAN RAFAEL,consulta externa,nuevas en menores de 5 anos,2006-02-01,61,63,61,63,124
SAN RAMON,consulta externa,nuevas en menores de 5 anos,2006-02-01,134,65,134,65,199
SAN RAMON,consulta externa,nuevas en menores de 5 anos,2006-02-01,146,156,146,156,302
SANTA ANA,consulta externa,nuevas en menores de 5 anos,2006-02-01,213,179,213,179,392
SANTA CRUZ DE LA SIERRA,consulta externa,nuevas en menores de 5 anos,2006-02-01,19847,18484,19847,18484,38331
SANTA ROSA,consulta externa,nuevas en menores de 5 anos,2006-02-01,101,98,101,98,199
SANTA ROSA DEL SARA,consulta externa,nuevas en menores de 5 anos,2006-02-01,690,624,690,624,1314
SANTIAGO DE CALLAPA,consulta externa,nuevas en menores de 5 anos,2006-02-01,40,39,40,39,79
SANTIAGO DE HUARI,consulta externa,nuevas en menores de 5 anos,2006-02-01,112,113,112,113,225
SANTIAGO DE MACHACA,consulta externa,nuevas en menores de 5 anos,2006-02-01,23,10,23,10,33
SANTIVAÑES,consulta externa,nuevas en menores de 5 anos,2006-02-01,102,82,102,82,184
SANTUARIO DE QUILLACAS,consulta externa,nuevas en menores de 5 anos,2006-02-01,29,28,29,28,57
SAPAHAQUI,consulta externa,nuevas en menores de 5 anos,2006-02-01,96,74,96,74,170
SENA,consulta externa,nuevas en menores de 5 anos,2006-02-01,64,74,64,74,138
SICA SICA (VILLA AROMA),consulta externa,nuevas en menores de 5 anos,2006-02-01,114,67,114,67,181
SICAYA,consulta externa,nuevas en menores de 5 anos,2006-02-01,28,21,28,21,49
SIPE SIPE,consulta externa,nuevas en menores de 5 anos,2006-02-01,307,297,307,297,604
SOPACHUY,consulta externa,nuevas en menores de 5 anos,2006-02-01,141,132,141,132,273
SORACACHI,consulta externa,nuevas en menores de 5 anos,2006-02-01,64,55,64,55,119
SORATA,consulta externa,nuevas en menores de 5 anos,2006-02-01,191,184,191,184,375
SUCRE,consulta externa,nuevas en menores de 5 anos,2006-02-01,4679,4409,4679,4409,9088
TACACHI,consulta externa,nuevas en menores de 5 anos,2006-02-01,9,4,9,4,13
TACACOMA,consulta externa,nuevas en menores de 5 anos,2006-02-01,55,47,55,47,102
TACOBAMBA,consulta externa,nuevas en menores de 5 anos,2006-02-01,88,56,88,56,144
TACOPAYA,consulta externa,nuevas en menores de 5 anos,2006-02-01,142,150,142,150,292
TAHUA,consulta externa,nuevas en menores de 5 anos,2006-02-01,12,15,12,15,27
TAPACARI,consulta externa,nuevas en menores de 5 anos,2006-02-01,356,307,356,307,663
TARABUCO,consulta externa,nuevas en menores de 5 anos,2006-02-01,512,433,512,433,945
TARACO,consulta externa,nuevas en menores de 5 anos,2006-02-01,30,17,30,17,47
TARATA,consulta externa,nuevas en menores de 5 anos,2006-02-01,98,86,98,86,184
TARIJA,consulta externa,nuevas en menores de 5 anos,2006-02-01,3351,3061,3351,3061,6412
TARVITA,consulta externa,nuevas en menores de 5 anos,2006-02-01,358,338,358,338,696
TEOPONTE,consulta externa,nuevas en menores de 5 anos,2006-02-01,137,160,137,160,297
TIAWANACU,consulta externa,nuevas en menores de 5 anos,2006-02-01,54,55,54,55,109
TINGUIPAYA,consulta externa,nuevas en menores de 5 anos,2006-02-01,323,286,323,286,609
TIPUANI,consulta externa,nuevas en menores de 5 anos,2006-02-01,147,119,147,119,266
TIQUIPAYA,consulta externa,nuevas en menores de 5 anos,2006-02-01,404,357,404,357,761
TIRAQUE (CBBA),consulta externa,nuevas en menores de 5 anos,2006-02-01,567,614,567,614,1181
TITO YUPANQUI (PARQUIPUJIO),consulta externa,nuevas en menores de 5 anos,2006-02-01,20,19,20,19,39
TOCO,consulta externa,nuevas en menores de 5 anos,2006-02-01,34,33,34,33,67
TODOS SANTOS,consulta externa,nuevas en menores de 5 anos,2006-02-01,2,4,2,4,6
TOLATA,consulta externa,nuevas en menores de 5 anos,2006-02-01,61,56,61,56,117
TOLEDO,consulta externa,nuevas en menores de 5 anos,2006-02-01,49,34,49,34,83
TOMAVE,consulta externa,nuevas en menores de 5 anos,2006-02-01,154,160,154,160,314
TOMINA,consulta externa,nuevas en menores de 5 anos,2006-02-01,248,251,248,251,499
TORO TORO,consulta externa,nuevas en menores de 5 anos,2006-02-01,198,194,198,194,392
TOTORA(CBBA),consulta externa,nuevas en menores de 5 anos,2006-02-01,148,149,148,149,297
TOTORA(ORR),consulta externa,nuevas en menores de 5 anos,2006-02-01,32,36,32,36,68
TRIGAL,consulta externa,nuevas en menores de 5 anos,2006-02-01,41,44,41,44,85
TRINIDAD,consulta externa,nuevas en menores de 5 anos,2006-02-01,2524,2524,2524,2524,5048
TUPIZA,consulta externa,nuevas en menores de 5 anos,2006-02-01,845,813,845,813,1658
TURCO,consulta externa,nuevas en menores de 5 anos,2006-02-01,55,61,55,61,116
UMALA,consulta externa,nuevas en menores de 5 anos,2006-02-01,48,60,48,60,108
UNCIA,consulta externa,nuevas en menores de 5 anos,2006-02-01,564,496,564,496,1060
URIONDO (A. CONCEPCION),consulta externa,nuevas en menores de 5 anos,2006-02-01,365,326,365,326,691
URUBICHA,consulta externa,nuevas en menores de 5 anos,2006-02-01,263,281,263,281,544
UYUNI,consulta externa,nuevas en menores de 5 anos,2006-02-01,214,197,214,197,411
VACAS,consulta externa,nuevas en menores de 5 anos,2006-02-01,135,119,135,119,254
VALLEGRANDE,consulta externa,nuevas en menores de 5 anos,2006-02-01,218,229,218,229,447
VIACHA,consulta externa,nuevas en menores de 5 anos,2006-02-01,381,361,381,361,742
VILA VILA,consulta externa,nuevas en menores de 5 anos,2006-02-01,48,45,48,45,93
VILLA MONTES,consulta externa,nuevas en menores de 5 anos,2006-02-01,649,586,649,586,1235
VILLA NUEVA (LOMA ALTA),consulta externa,nuevas en menores de 5 anos,2006-02-01,24,17,24,17,41
VILLA RIVERO,consulta externa,nuevas en menores de 5 anos,2006-02-01,61,63,61,63,124
VILLA SERRANO,consulta externa,nuevas en menores de 5 anos,2006-02-01,355,297,355,297,652
VILLA TUNARI,consulta externa,nuevas en menores de 5 anos,2006-02-01,1485,1396,1485,1396,2881
VILLA VACA GUZMAN (MUYUPAMPA),consulta externa,nuevas en menores de 5 anos,2006-02-01,208,231,208,231,439
VILLAZON,consulta externa,nuevas en menores de 5 anos,2006-02-01,583,553,583,553,1136
VINTO,consulta externa,nuevas en menores de 5 anos,2006-02-01,165,37,165,37,202
VITICHI,consulta externa,nuevas en menores de 5 anos,2006-02-01,185,177,185,177,362
WALDO BALLIVIAN,consulta externa,nuevas en menores de 5 anos,2006-02-01,23,30,23,30,53
WARNES,consulta externa,nuevas en menores de 5 anos,2006-02-01,921,914,921,914,1835
YACO,consulta externa,nuevas en menores de 5 anos,2006-02-01,94,82,94,82,176
YACUIBA,consulta externa,nuevas en menores de 5 anos,2006-02-01,1771,1593,1771,1593,3364
YAMPARAEZ,consulta externa,nuevas en menores de 5 anos,2006-02-01,128,105,128,105,233
YANACACHI,consulta externa,nuevas en menores de 5 anos,2006-02-01,82,63,82,63,145
YAPACANI,consulta externa,nuevas en menores de 5 anos,2006-02-01,780,640,780,640,1420
YOCALLA,consulta externa,nuevas en menores de 5 anos,2006-02-01,65,64,65,64,129
YOTALA,consulta externa,nuevas en menores de 5 anos,2006-02-01,113,117,113,117,230
YUNCHARA,consulta externa,nuevas en menores de 5 anos,2006-02-01,168,156,168,156,324
ZUDAÑEZ,consulta externa,nuevas en menores de 5 anos,2006-02-01,241,202,241,202,443
ACACIO,consulta externa,nuevas en menores de 5 anos,2006-03-01,141,128,141,128,269
ACHACACHI,consulta externa,nuevas en menores de 5 anos,2006-03-01,306,328,306,328,634
ACHOCALLA,consulta externa,nuevas en menores de 5 anos,2006-03-01,90,100,90,100,190
AIQUILE,consulta externa,nuevas en menores de 5 anos,2006-03-01,294,256,294,256,550
ALALAY,consulta externa,nuevas en menores de 5 anos,2006-03-01,70,51,70,51,121
ALCALA,consulta externa,nuevas en menores de 5 anos,2006-03-01,177,163,177,163,340
ANCORAIMES,consulta externa,nuevas en menores de 5 anos,2006-03-01,167,143,167,143,310
ANDAMARCA,consulta externa,nuevas en menores de 5 anos,2006-03-01,44,64,44,64,108
ANTEQUERA,consulta externa,nuevas en menores de 5 anos,2006-03-01,58,30,58,30,88
ANZALDO,consulta externa,nuevas en menores de 5 anos,2006-03-01,88,91,88,91,179
APOLO,consulta externa,nuevas en menores de 5 anos,2006-03-01,355,405,355,405,760
ARAMPAMPA,consulta externa,nuevas en menores de 5 anos,2006-03-01,145,130,145,130,275
ARANI,consulta externa,nuevas en menores de 5 anos,2006-03-01,164,180,164,180,344
ARBIETO,consulta externa,nuevas en menores de 5 anos,2006-03-01,86,75,86,75,161
ARQUE,consulta externa,nuevas en menores de 5 anos,2006-03-01,213,192,213,192,405
ASCENCION DE GUARAYOS,consulta externa,nuevas en menores de 5 anos,2006-03-01,718,706,718,706,1424
ATOCHA,consulta externa,nuevas en menores de 5 anos,2006-03-01,360,380,360,380,740
AUCAPATA,consulta externa,nuevas en menores de 5 anos,2006-03-01,85,66,85,66,151
AYATA,consulta externa,nuevas en menores de 5 anos,2006-03-01,138,113,138,113,251
AYO AYO,consulta externa,nuevas en menores de 5 anos,2006-03-01,53,50,53,50,103
AYOPAYA (V. DE INDEPENDENCIA),consulta externa,nuevas en menores de 5 anos,2006-03-01,567,445,567,445,1012
AZURDUY,consulta externa,nuevas en menores de 5 anos,2006-03-01,456,441,456,441,897
BATALLAS,consulta externa,nuevas en menores de 5 anos,2006-03-01,97,67,97,67,164
BAURES,consulta externa,nuevas en menores de 5 anos,2006-03-01,65,80,65,80,145
BELEN DE ANDAMARCA,consulta externa,nuevas en menores de 5 anos,2006-03-01,17,15,17,15,32
BELEN DE URMIRI,consulta externa,nuevas en menores de 5 anos,2006-03-01,58,39,58,39,97
BELLA FLOR,consulta externa,nuevas en menores de 5 anos,2006-03-01,108,131,108,131,239
BERMEJO,consulta externa,nuevas en menores de 5 anos,2006-03-01,842,845,842,845,1687
BETANZOS,consulta externa,nuevas en menores de 5 anos,2006-03-01,644,596,644,596,1240
BOLIVAR,consulta externa,nuevas en menores de 5 anos,2006-03-01,179,186,179,186,365
BOLPEBRA,consulta externa,nuevas en menores de 5 anos,2006-03-01,47,30,47,30,77
BOYUIBE,consulta externa,nuevas en menores de 5 anos,2006-03-01,154,138,154,138,292
BUENA VISTA,consulta externa,nuevas en menores de 5 anos,2006-03-01,373,360,373,360,733
CABEZAS,consulta externa,nuevas en menores de 5 anos,2006-03-01,506,423,506,423,929
CAIROMA,consulta externa,nuevas en menores de 5 anos,2006-03-01,208,157,208,157,365
"CAIZA ""D""",consulta externa,nuevas en menores de 5 anos,2006-03-01,143,106,143,106,249
CAJUATA,consulta externa,nuevas en menores de 5 anos,2006-03-01,181,136,181,136,317
CALACOTO,consulta externa,nuevas en menores de 5 anos,2006-03-01,71,95,71,95,166
CALAMARCA,consulta externa,nuevas en menores de 5 anos,2006-03-01,137,109,137,109,246
CAMARGO,consulta externa,nuevas en menores de 5 anos,2006-03-01,1065,403,1065,403,1468
CAMATAQUI (C. VILLA ABECIA),consulta externa,nuevas en menores de 5 anos,2006-03-01,52,40,52,40,92
CAMIRI,consulta externa,nuevas en menores de 5 anos,2006-03-01,950,957,950,957,1907
CAPINOTA,consulta externa,nuevas en menores de 5 anos,2006-03-01,374,351,374,351,725
CAQUIAVIRI,consulta externa,nuevas en menores de 5 anos,2006-03-01,81,101,81,101,182
CARACOLLO,consulta externa,nuevas en menores de 5 anos,2006-03-01,217,229,217,229,446
CARANAVI,consulta externa,nuevas en menores de 5 anos,2006-03-01,1333,1115,1333,1115,2448
CARANGAS,consulta externa,nuevas en menores de 5 anos,2006-03-01,0,3,0,3,3
CARAPARI,consulta externa,nuevas en menores de 5 anos,2006-03-01,208,222,208,222,430
CARIPUYO,consulta externa,nuevas en menores de 5 anos,2006-03-01,348,345,348,345,693
CARMEN RIVERO TORREZ,consulta externa,nuevas en menores de 5 anos,2006-03-01,75,60,75,60,135
CATACORA,consulta externa,nuevas en menores de 5 anos,2006-03-01,19,20,19,20,39
CHACARILLA,consulta externa,nuevas en menores de 5 anos,2006-03-01,9,7,9,7,16
CHALLAPATA,consulta externa,nuevas en menores de 5 anos,2006-03-01,423,355,423,355,778
CHAQUI,consulta externa,nuevas en menores de 5 anos,2006-03-01,130,103,130,103,233
CHARAGUA,consulta externa,nuevas en menores de 5 anos,2006-03-01,862,848,862,848,1710
CHARAÑA,consulta externa,nuevas en menores de 5 anos,2006-03-01,39,33,39,33,72
CHAYANTA,consulta externa,nuevas en menores de 5 anos,2006-03-01,199,189,199,189,388
CHIMORE,consulta externa,nuevas en menores de 5 anos,2006-03-01,601,605,601,605,1206
CHIPAYA,consulta externa,nuevas en menores de 5 anos,2006-03-01,24,26,24,26,50
CHOQUE COTA,consulta externa,nuevas en menores de 5 anos,2006-03-01,23,17,23,17,40
CHULUMANI (V. DE LA LIBERTAD),consulta externa,nuevas en menores de 5 anos,2006-03-01,299,259,299,259,558
CHUMA,consulta externa,nuevas en menores de 5 anos,2006-03-01,176,176,176,176,352
CLIZA,consulta externa,nuevas en menores de 5 anos,2006-03-01,187,207,187,207,394
COBIJA,consulta externa,nuevas en menores de 5 anos,2006-03-01,867,756,867,756,1623
COCHABAMBA,consulta externa,nuevas en menores de 5 anos,2006-03-01,10392,9752,10392,9752,20144
COIPASA,consulta externa,nuevas en menores de 5 anos,2006-03-01,5,5,5,5,10
COLCAPIRHUA,consulta externa,nuevas en menores de 5 anos,2006-03-01,500,470,500,470,970
"COLCHA ""K""",consulta externa,nuevas en menores de 5 anos,2006-03-01,163,169,163,169,332
COLLANA,consulta externa,nuevas en menores de 5 anos,2006-03-01,19,6,19,6,25
COLOMI,consulta externa,nuevas en menores de 5 anos,2006-03-01,303,256,303,256,559
COLPA BELGICA,consulta externa,nuevas en menores de 5 anos,2006-03-01,206,211,206,211,417
COLQUECHACA,consulta externa,nuevas en menores de 5 anos,2006-03-01,780,794,780,794,1574
COLQUENCHA,consulta externa,nuevas en menores de 5 anos,2006-03-01,73,81,73,81,154
COLQUIRI,consulta externa,nuevas en menores de 5 anos,2006-03-01,356,381,356,381,737
COMANCHE,consulta externa,nuevas en menores de 5 anos,2006-03-01,20,24,20,24,44
COMARAPA,consulta externa,nuevas en menores de 5 anos,2006-03-01,464,480,464,480,944
COMBAYA,consulta externa,nuevas en menores de 5 anos,2006-03-01,38,41,38,41,79
CONCEPCION,consulta externa,nuevas en menores de 5 anos,2006-03-01,531,499,531,499,1030
COPACABANA,consulta externa,nuevas en menores de 5 anos,2006-03-01,92,97,92,97,189
CORIPATA,consulta externa,nuevas en menores de 5 anos,2006-03-01,242,233,242,233,475
CORO CORO,consulta externa,nuevas en menores de 5 anos,2006-03-01,68,71,68,71,139
COROICO,consulta externa,nuevas en menores de 5 anos,2006-03-01,261,215,261,215,476
CORQUE,consulta externa,nuevas en menores de 5 anos,2006-03-01,66,59,66,59,125
COTAGAITA,consulta externa,nuevas en menores de 5 anos,2006-03-01,638,567,638,567,1205
COTOCA,consulta externa,nuevas en menores de 5 anos,2006-03-01,755,621,755,621,1376
CUATRO CAÑADAS,consulta externa,nuevas en menores de 5 anos,2006-03-01,804,695,804,695,1499
CUCHUMUELA (V. G. VILLARROEL),consulta externa,nuevas en menores de 5 anos,2006-03-01,26,17,26,17,43
CUEVO,consulta externa,nuevas en menores de 5 anos,2006-03-01,108,156,108,156,264
CULPINA,consulta externa,nuevas en menores de 5 anos,2006-03-01,470,480,470,480,950
CURAHUARA DE CARANGAS,consulta externa,nuevas en menores de 5 anos,2006-03-01,57,68,57,68,125
CURVA,consulta externa,nuevas en menores de 5 anos,2006-03-01,47,23,47,23,70
DESAGUADERO,consulta externa,nuevas en menores de 5 anos,2006-03-01,40,17,40,17,57
EL ALTO,consulta externa,nuevas en menores de 5 anos,2006-03-01,10099,9821,10099,9821,19920
EL CHORO,consulta externa,nuevas en menores de 5 anos,2006-03-01,70,62,70,62,132
EL PUENTE(STC),consulta externa,nuevas en menores de 5 anos,2006-03-01,544,501,544,501,1045
EL PUENTE(TJA),consulta externa,nuevas en menores de 5 anos,2006-03-01,245,249,245,249,494
EL TORNO,consulta externa,nuevas en menores de 5 anos,2006-03-01,1114,937,1114,937,2051
EL VILLAR,consulta externa,nuevas en menores de 5 anos,2006-03-01,196,221,196,221,417
ENTRE RIOS,consulta externa,nuevas en menores de 5 anos,2006-03-01,483,390,483,390,873
ENTRE RIOS,consulta externa,nuevas en menores de 5 anos,2006-03-01,478,555,478,555,1033
ESCARA,consulta externa,nuevas en menores de 5 anos,2006-03-01,3,3,3,3,6
EUCALIPTUS,consulta externa,nuevas en menores de 5 anos,2006-03-01,241,180,241,180,421
EUREKA (SANTOS MERCADO),consulta externa,nuevas en menores de 5 anos,2006-03-01,49,58,49,58,107
EXALTACION,consulta externa,nuevas en menores de 5 anos,2006-03-01,24,26,24,26,50
FERNANDEZ ALONSO,consulta externa,nuevas en menores de 5 anos,2006-03-01,457,472,457,472,929
FILADELFIA,consulta externa,nuevas en menores de 5 anos,2006-03-01,169,201,169,201,370
GENERAL SAAVEDRA,consulta externa,nuevas en menores de 5 anos,2006-03-01,579,497,579,497,1076
GRAL. J.J. PEREZ (CHARAZANI),consulta externa,nuevas en menores de 5 anos,2006-03-01,151,117,151,117,268
GUANAY,consulta externa,nuevas en menores de 5 anos,2006-03-01,370,326,370,326,696
GUAQUI,consulta externa,nuevas en menores de 5 anos,2006-03-01,40,32,40,32,72
GUAYARAMERIN,consulta externa,nuevas en menores de 5 anos,2006-03-01,1025,992,1025,992,2017
GUTIERREZ,consulta externa,nuevas en menores de 5 anos,2006-03-01,540,564,540,564,1104
HUACARETA,consulta externa,nuevas en menores de 5 anos,2006-03-01,201,205,201,205,406
HUACAYA (VILLA DE HUACAYA),consulta externa,nuevas en menores de 5 anos,2006-03-01,80,88,80,88,168
HUACHACALLA,consulta externa,nuevas en menores de 5 anos,2006-03-01,23,17,23,17,40
HUANUNI,consulta externa,nuevas en menores de 5 anos,2006-03-01,544,410,544,410,954
HUARACAJE,consulta externa,nuevas en menores de 5 anos,2006-03-01,95,92,95,92,187
HUAYLLAMARCA,consulta externa,nuevas en menores de 5 anos,2006-03-01,87,85,87,85,172
ICHOCA,consulta externa,nuevas en menores de 5 anos,2006-03-01,100,77,100,77,177
ICLA,consulta externa,nuevas en menores de 5 anos,2006-03-01,483,411,483,411,894
INCAHUASI,consulta externa,nuevas en menores de 5 anos,2006-03-01,465,505,465,505,970
INGAVI (HUMAITA),consulta externa,nuevas en menores de 5 anos,2006-03-01,48,20,48,20,68
INQUISIVI,consulta externa,nuevas en menores de 5 anos,2006-03-01,189,207,189,207,396
IRUPANA (VILLA DE LANZA),consulta externa,nuevas en menores de 5 anos,2006-03-01,268,257,268,257,525
IXIAMAS,consulta externa,nuevas en menores de 5 anos,2006-03-01,332,232,332,232,564
JESUS DE MACHACA,consulta externa,nuevas en menores de 5 anos,2006-03-01,143,137,143,137,280
LA ASUNTA,consulta externa,nuevas en menores de 5 anos,2006-03-01,588,620,588,620,1208
LA GUARDIA,consulta externa,nuevas en menores de 5 anos,2006-03-01,1082,1229,1082,1229,2311
LA PAZ,consulta externa,nuevas en menores de 5 anos,2006-03-01,14295,13029,14295,13029,27324
LA RIVERA,consulta externa,nuevas en menores de 5 anos,2006-03-01,1,4,1,4,5
LAGUNILLAS,consulta externa,nuevas en menores de 5 anos,2006-03-01,286,251,286,251,537
LAJA,consulta externa,nuevas en menores de 5 anos,2006-03-01,137,103,137,103,240
LAS CARRERAS,consulta externa,nuevas en menores de 5 anos,2006-03-01,77,68,77,68,145
LICOMA PAMPA,consulta externa,nuevas en menores de 5 anos,2006-03-01,28,12,28,12,40
LLALLAGUA,consulta externa,nuevas en menores de 5 anos,2006-03-01,618,522,618,522,1140
LLICA,consulta externa,nuevas en menores de 5 anos,2006-03-01,73,62,73,62,135
LORETO,consulta externa,nuevas en menores de 5 anos,2006-03-01,94,106,94,106,200
LURIBAY,consulta externa,nuevas en menores de 5 anos,2006-03-01,128,127,128,127,255
MACHACAMARCA,consulta externa,nuevas en menores de 5 anos,2006-03-01,55,63,55,63,118
MACHARETI,consulta externa,nuevas en menores de 5 anos,2006-03-01,319,322,319,322,641
MAGDALENA,consulta externa,nuevas en menores de 5 anos,2006-03-01,253,220,253,220,473
MAIRANA,consulta externa,nuevas en menores de 5 anos,2006-03-01,162,131,162,131,293
MALLA,consulta externa,nuevas en menores de 5 anos,2006-03-01,61,62,61,62,123
MAPIRI,consulta externa,nuevas en menores de 5 anos,2006-03-01,283,255,283,255,538
MECAPACA,consulta externa,nuevas en menores de 5 anos,2006-03-01,162,130,162,130,292
MINEROS,consulta externa,nuevas en menores de 5 anos,2006-03-01,570,480,570,480,1050
MIZQUE,consulta externa,nuevas en menores de 5 anos,2006-03-01,392,313,392,313,705
MOCOMOCO,consulta externa,nuevas en menores de 5 anos,2006-03-01,125,104,125,104,229
MOJINETE,consulta externa,nuevas en menores de 5 anos,2006-03-01,15,13,15,13,28
MOJOCOYA,consulta externa,nuevas en menores de 5 anos,2006-03-01,169,153,169,153,322
MONTEAGUDO,consulta externa,nuevas en menores de 5 anos,2006-03-01,721,631,721,631,1352
MONTERO,consulta externa,nuevas en menores de 5 anos,2006-03-01,3289,3073,3289,3073,6362
MORO MORO,consulta externa,nuevas en menores de 5 anos,2006-03-01,79,65,79,65,144
MOROCHATA,consulta externa,nuevas en menores de 5 anos,2006-03-01,229,210,229,210,439
NACEBE (SANTA ROSA DEL ABUNA),consulta externa,nuevas en menores de 5 anos,2006-03-01,56,40,56,40,96
NAZACARA DE PACAJES,consulta externa,nuevas en menores de 5 anos,2006-03-01,5,4,5,4,9
NUEVO MANOA (NUEVA ESPERANZA),consulta externa,nuevas en menores de 5 anos,2006-03-01,14,35,14,35,49
OCURI,consulta externa,nuevas en menores de 5 anos,2006-03-01,400,371,400,371,771
OKINAWA,consulta externa,nuevas en menores de 5 anos,2006-03-01,576,532,576,532,1108
OMEREQUE,consulta externa,nuevas en menores de 5 anos,2006-03-01,85,76,85,76,161
ORURO,consulta externa,nuevas en menores de 5 anos,2006-03-01,5446,4716,5446,4716,10162
PADCAYA,consulta externa,nuevas en menores de 5 anos,2006-03-01,428,380,428,380,808
PADILLA,consulta externa,nuevas en menores de 5 anos,2006-03-01,442,417,442,417,859
PAILON,consulta externa,nuevas en menores de 5 anos,2006-03-01,465,434,465,434,899
PALCA,consulta externa,nuevas en menores de 5 anos,2006-03-01,91,94,91,94,185
PALOS BLANCOS,consulta externa,nuevas en menores de 5 anos,2006-03-01,786,706,786,706,1492
PAMPA AULLAGAS,consulta externa,nuevas en menores de 5 anos,2006-03-01,43,39,43,39,82
PAMPA GRANDE,consulta externa,nuevas en menores de 5 anos,2006-03-01,261,232,261,232,493
PAPEL PAMPA,consulta externa,nuevas en menores de 5 anos,2006-03-01,39,40,39,40,79
PASORAPA,consulta externa,nuevas en menores de 5 anos,2006-03-01,43,32,43,32,75
PATACAMAYA,consulta externa,nuevas en menores de 5 anos,2006-03-01,252,195,252,195,447
PAZÑA,consulta externa,nuevas en menores de 5 anos,2006-03-01,108,118,108,118,226
PELECHUCO,consulta externa,nuevas en menores de 5 anos,2006-03-01,82,55,82,55,137
POCOATA,consulta externa,nuevas en menores de 5 anos,2006-03-01,383,368,383,368,751
POCONA,consulta externa,nuevas en menores de 5 anos,2006-03-01,227,167,227,167,394
POJO (CBBA),consulta externa,nuevas en menores de 5 anos,2006-03-01,242,207,242,207,449
POOPO,consulta externa,nuevas en menores de 5 anos,2006-03-01,82,70,82,70,152
PORCO,consulta externa,nuevas en menores de 5 anos,2006-03-01,131,149,131,149,280
POROMA,consulta externa,nuevas en menores de 5 anos,2006-03-01,443,434,443,434,877
PORONGO,consulta externa,nuevas en menores de 5 anos,2006-03-01,233,197,233,197,430
PORTACHUELO,consulta externa,nuevas en menores de 5 anos,2006-03-01,678,558,678,558,1236
PORVENIR,consulta externa,nuevas en menores de 5 anos,2006-03-01,167,110,167,110,277
POSTRER VALLE,consulta externa,nuevas en menores de 5 anos,2006-03-01,92,78,92,78,170
POTOSI,consulta externa,nuevas en menores de 5 anos,2006-03-01,3666,3211,3666,3211,6877
PRESTO,consulta externa,nuevas en menores de 5 anos,2006-03-01,401,376,401,376,777
PUCARA,consulta externa,nuevas en menores de 5 anos,2006-03-01,31,17,31,17,48
PUCARANI,consulta externa,nuevas en menores de 5 anos,2006-03-01,209,201,209,201,410
PUERTO ACOSTA,consulta externa,nuevas en menores de 5 anos,2006-03-01,207,183,207,183,390
PUERTO CARABUCO,consulta externa,nuevas en menores de 5 anos,2006-03-01,178,174,178,174,352
PUERTO GONZALO MORENO,consulta externa,nuevas en menores de 5 anos,2006-03-01,169,141,169,141,310
PUERTO PEREZ,consulta externa,nuevas en menores de 5 anos,2006-03-01,68,59,68,59,127
PUERTO QUIJARRO,consulta externa,nuevas en menores de 5 anos,2006-03-01,327,290,327,290,617
PUERTO RICO,consulta externa,nuevas en menores de 5 anos,2006-03-01,174,188,174,188,362
PUERTO SILES,consulta externa,nuevas en menores de 5 anos,2006-03-01,15,15,15,15,30
PUERTO SUAREZ,consulta externa,nuevas en menores de 5 anos,2006-03-01,394,352,394,352,746
PUERTO VILLARROEL,consulta externa,nuevas en menores de 5 anos,2006-03-01,1711,1499,1711,1499,3210
PUNA,consulta externa,nuevas en menores de 5 anos,2006-03-01,548,505,548,505,1053
PUNATA,consulta externa,nuevas en menores de 5 anos,2006-03-01,330,348,330,348,678
QUIABAYA,consulta externa,nuevas en menores de 5 anos,2006-03-01,18,15,18,15,33
QUILLACOLLO,consulta externa,nuevas en menores de 5 anos,2006-03-01,1470,1246,1470,1246,2716
QUIME,consulta externa,nuevas en menores de 5 anos,2006-03-01,117,118,117,118,235
QUIRUSILLAS,consulta externa,nuevas en menores de 5 anos,2006-03-01,59,25,59,25,84
RAVELO,consulta externa,nuevas en menores de 5 anos,2006-03-01,418,365,418,365,783
REYES,consulta externa,nuevas en menores de 5 anos,2006-03-01,358,343,358,343,701
RIBERALTA,consulta externa,nuevas en menores de 5 anos,2006-03-01,2218,2046,2218,2046,4264
ROBORE,consulta externa,nuevas en menores de 5 anos,2006-03-01,320,370,320,370,690
RURRENABAQUE,consulta externa,nuevas en menores de 5 anos,2006-03-01,478,396,478,396,874
SABAYA,consulta externa,nuevas en menores de 5 anos,2006-03-01,51,46,51,46,97
SACABA,consulta externa,nuevas en menores de 5 anos,2006-03-01,1410,1188,1410,1188,2598
SACABAMBA,consulta externa,nuevas en menores de 5 anos,2006-03-01,78,53,78,53,131
SACACA,consulta externa,nuevas en menores de 5 anos,2006-03-01,475,424,475,424,899
SAIPINA,consulta externa,nuevas en menores de 5 anos,2006-03-01,264,238,264,238,502
SALINAS DE GARCI MENDOZA,consulta externa,nuevas en menores de 5 anos,2006-03-01,180,153,180,153,333
SAMAIPATA,consulta externa,nuevas en menores de 5 anos,2006-03-01,182,129,182,129,311
SAN AGUSTIN,consulta externa,nuevas en menores de 5 anos,2006-03-01,45,38,45,38,83
SAN ANDRES,consulta externa,nuevas en menores de 5 anos,2006-03-01,358,301,358,301,659
SAN ANDRES DE MACHACA,consulta externa,nuevas en menores de 5 anos,2006-03-01,50,39,50,39,89
SAN ANTONIO DE ESMORUCO,consulta externa,nuevas en menores de 5 anos,2006-03-01,52,57,52,57,109
SAN ANTONIO DE LOMERIO,consulta externa,nuevas en menores de 5 anos,2006-03-01,199,173,199,173,372
SAN BENITO,consulta externa,nuevas en menores de 5 anos,2006-03-01,155,118,155,118,273
SAN BORJA,consulta externa,nuevas en menores de 5 anos,2006-03-01,768,624,768,624,1392
SAN BUENA VENTURA,consulta externa,nuevas en menores de 5 anos,2006-03-01,335,340,335,340,675
SAN CARLOS,consulta externa,nuevas en menores de 5 anos,2006-03-01,504,466,504,466,970
SAN IGNACIO,consulta externa,nuevas en menores de 5 anos,2006-03-01,631,618,631,618,1249
SAN IGNACIO DE VELASCO,consulta externa,nuevas en menores de 5 anos,2006-03-01,1692,1586,1692,1586,3278
SAN JAVIER(BNI),consulta externa,nuevas en menores de 5 anos,2006-03-01,51,55,51,55,106
SAN JAVIER(STC),consulta externa,nuevas en menores de 5 anos,2006-03-01,202,221,202,221,423
SAN JOAQUIN,consulta externa,nuevas en menores de 5 anos,2006-03-01,103,106,103,106,209
SAN JOSE DE CHIQUITOS,consulta externa,nuevas en menores de 5 anos,2006-03-01,499,457,499,457,956
SAN JUAN DE YAPACANI,consulta externa,nuevas en menores de 5 anos,2006-03-01,448,431,448,431,879
SAN JULIAN,consulta externa,nuevas en menores de 5 anos,2006-03-01,1856,1838,1856,1838,3694
SAN LORENZO(PND),consulta externa,nuevas en menores de 5 anos,2006-03-01,409,299,409,299,708
SAN LORENZO(TJA),consulta externa,nuevas en menores de 5 anos,2006-03-01,598,535,598,535,1133
SAN LUCAS,consulta externa,nuevas en menores de 5 anos,2006-03-01,883,829,883,829,1712
SAN MATIAS,consulta externa,nuevas en menores de 5 anos,2006-03-01,260,274,260,274,534
SAN MIGUEL DE VELASCO,consulta externa,nuevas en menores de 5 anos,2006-03-01,308,274,308,274,582
SAN PABLO DE LIPEZ,consulta externa,nuevas en menores de 5 anos,2006-03-01,99,125,99,125,224
SAN PEDRO,consulta externa,nuevas en menores de 5 anos,2006-03-01,766,752,766,752,1518
SAN PEDRO DE BUENA VISTA,consulta externa,nuevas en menores de 5 anos,2006-03-01,466,458,466,458,924
SAN PEDRO DE CURAHUARA,consulta externa,nuevas en menores de 5 anos,2006-03-01,102,72,102,72,174
SAN PEDRO DE TIQUINA,consulta externa,nuevas en menores de 5 anos,2006-03-01,35,24,35,24,59
SAN PEDRO(PND),consulta externa,nuevas en menores de 5 anos,2006-03-01,13,30,13,30,43
SAN RAFAEL,consulta externa,nuevas en menores de 5 anos,2006-03-01,114,95,114,95,209
SAN RAMON,consulta externa,nuevas en menores de 5 anos,2006-03-01,130,85,130,85,215
SAN RAMON,consulta externa,nuevas en menores de 5 anos,2006-03-01,251,263,251,263,514
SANTA ANA,consulta externa,nuevas en menores de 5 anos,2006-03-01,272,228,272,228,500
SANTA CRUZ DE LA SIERRA,consulta externa,nuevas en menores de 5 anos,2006-03-01,29183,24998,29183,24998,54181
SANTA ROSA,consulta externa,nuevas en menores de 5 anos,2006-03-01,304,316,304,316,620
SANTA ROSA DEL SARA,consulta externa,nuevas en menores de 5 anos,2006-03-01,792,746,792,746,1538
SANTIAGO DE CALLAPA,consulta externa,nuevas en menores de 5 anos,2006-03-01,49,46,49,46,95
SANTIAGO DE HUARI,consulta externa,nuevas en menores de 5 anos,2006-03-01,138,108,138,108,246
SANTIAGO DE MACHACA,consulta externa,nuevas en menores de 5 anos,2006-03-01,29,34,29,34,63
SANTIVAÑES,consulta externa,nuevas en menores de 5 anos,2006-03-01,113,98,113,98,211
SANTUARIO DE QUILLACAS,consulta externa,nuevas en menores de 5 anos,2006-03-01,55,51,55,51,106
SAPAHAQUI,consulta externa,nuevas en menores de 5 anos,2006-03-01,73,75,73,75,148
SENA,consulta externa,nuevas en menores de 5 anos,2006-03-01,154,115,154,115,269
SICA SICA (VILLA AROMA),consulta externa,nuevas en menores de 5 anos,2006-03-01,150,162,150,162,312
SICAYA,consulta externa,nuevas en menores de 5 anos,2006-03-01,83,51,83,51,134
SIPE SIPE,consulta externa,nuevas en menores de 5 anos,2006-03-01,497,480,497,480,977
SOPACHUY,consulta externa,nuevas en menores de 5 anos,2006-03-01,219,184,219,184,403
SORACACHI,consulta externa,nuevas en menores de 5 anos,2006-03-01,101,102,101,102,203
SORATA,consulta externa,nuevas en menores de 5 anos,2006-03-01,232,181,232,181,413
SUCRE,consulta externa,nuevas en menores de 5 anos,2006-03-01,6849,6149,6849,6149,12998
TACACHI,consulta externa,nuevas en menores de 5 anos,2006-03-01,7,11,7,11,18
TACACOMA,consulta externa,nuevas en menores de 5 anos,2006-03-01,78,78,78,78,156
TACOBAMBA,consulta externa,nuevas en menores de 5 anos,2006-03-01,114,92,114,92,206
TACOPAYA,consulta externa,nuevas en menores de 5 anos,2006-03-01,178,162,178,162,340
TAHUA,consulta externa,nuevas en menores de 5 anos,2006-03-01,13,15,13,15,28
TAPACARI,consulta externa,nuevas en menores de 5 anos,2006-03-01,669,633,669,633,1302
TARABUCO,consulta externa,nuevas en menores de 5 anos,2006-03-01,616,725,616,725,1341
TARACO,consulta externa,nuevas en menores de 5 anos,2006-03-01,23,22,23,22,45
TARATA,consulta externa,nuevas en menores de 5 anos,2006-03-01,111,105,111,105,216
TARIJA,consulta externa,nuevas en menores de 5 anos,2006-03-01,5080,3886,5080,3886,8966
TARVITA,consulta externa,nuevas en menores de 5 anos,2006-03-01,609,632,609,632,1241
TEOPONTE,consulta externa,nuevas en menores de 5 anos,2006-03-01,251,220,251,220,471
TIAWANACU,consulta externa,nuevas en menores de 5 anos,2006-03-01,102,79,102,79,181
TINGUIPAYA,consulta externa,nuevas en menores de 5 anos,2006-03-01,330,317,330,317,647
TIPUANI,consulta externa,nuevas en menores de 5 anos,2006-03-01,149,143,149,143,292
TIQUIPAYA,consulta externa,nuevas en menores de 5 anos,2006-03-01,622,443,622,443,1065
TIRAQUE (CBBA),consulta externa,nuevas en menores de 5 anos,2006-03-01,901,755,901,755,1656
TITO YUPANQUI (PARQUIPUJIO),consulta externa,nuevas en menores de 5 anos,2006-03-01,15,20,15,20,35
TOCO,consulta externa,nuevas en menores de 5 anos,2006-03-01,78,60,78,60,138
TODOS SANTOS,consulta externa,nuevas en menores de 5 anos,2006-03-01,8,2,8,2,10
TOLATA,consulta externa,nuevas en menores de 5 anos,2006-03-01,74,64,74,64,138
TOLEDO,consulta externa,nuevas en menores de 5 anos,2006-03-01,60,70,60,70,130
TOMAVE,consulta externa,nuevas en menores de 5 anos,2006-03-01,196,198,196,198,394
TOMINA,consulta externa,nuevas en menores de 5 anos,2006-03-01,282,226,282,226,508
TORO TORO,consulta externa,nuevas en menores de 5 anos,2006-03-01,278,254,278,254,532
TOTORA(CBBA),consulta externa,nuevas en menores de 5 anos,2006-03-01,146,211,146,211,357
TOTORA(ORR),consulta externa,nuevas en menores de 5 anos,2006-03-01,61,37,61,37,98
TRIGAL,consulta externa,nuevas en menores de 5 anos,2006-03-01,54,47,54,47,101
TRINIDAD,consulta externa,nuevas en menores de 5 anos,2006-03-01,3435,3169,3435,3169,6604
TUPIZA,consulta externa,nuevas en menores de 5 anos,2006-03-01,1184,1178,1184,1178,2362
TURCO,consulta externa,nuevas en menores de 5 anos,2006-03-01,87,89,87,89,176
UMALA,consulta externa,nuevas en menores de 5 anos,2006-03-01,41,32,41,32,73
UNCIA,consulta externa,nuevas en menores de 5 anos,2006-03-01,613,502,613,502,1115
URIONDO (A. CONCEPCION),consulta externa,nuevas en menores de 5 anos,2006-03-01,452,466,452,466,918
URUBICHA,consulta externa,nuevas en menores de 5 anos,2006-03-01,117,158,117,158,275
UYUNI,consulta externa,nuevas en menores de 5 anos,2006-03-01,292,273,292,273,565
VACAS,consulta externa,nuevas en menores de 5 anos,2006-03-01,184,151,184,151,335
VALLEGRANDE,consulta externa,nuevas en menores de 5 anos,2006-03-01,309,301,309,301,610
VIACHA,consulta externa,nuevas en menores de 5 anos,2006-03-01,483,404,483,404,887
VILA VILA,consulta externa,nuevas en menores de 5 anos,2006-03-01,43,59,43,59,102
VILLA MONTES,consulta externa,nuevas en menores de 5 anos,2006-03-01,773,685,773,685,1458
VILLA NUEVA (LOMA ALTA),consulta externa,nuevas en menores de 5 anos,2006-03-01,90,70,90,70,160
VILLA RIVERO,consulta externa,nuevas en menores de 5 anos,2006-03-01,60,40,60,40,100
VILLA SERRANO,consulta externa,nuevas en menores de 5 anos,2006-03-01,461,426,461,426,887
VILLA TUNARI,consulta externa,nuevas en menores de 5 anos,2006-03-01,1605,1453,1605,1453,3058
VILLA VACA GUZMAN (MUYUPAMPA),consulta externa,nuevas en menores de 5 anos,2006-03-01,380,427,380,427,807
VILLAZON,consulta externa,nuevas en menores de 5 anos,2006-03-01,957,853,957,853,1810
VINTO,consulta externa,nuevas en menores de 5 anos,2006-03-01,53,51,53,51,104
VITICHI,consulta externa,nuevas en menores de 5 anos,2006-03-01,214,206,214,206,420
WALDO BALLIVIAN,consulta externa,nuevas en menores de 5 anos,2006-03-01,37,38,37,38,75
WARNES,consulta externa,nuevas en menores de 5 anos,2006-03-01,1423,1303,1423,1303,2726
YACO,consulta externa,nuevas en menores de 5 anos,2006-03-01,77,83,77,83,160
YACUIBA,consulta externa,nuevas en menores de 5 anos,2006-03-01,2450,2311,2450,2311,4761
YAMPARAEZ,consulta externa,nuevas en menores de 5 anos,2006-03-01,135,148,135,148,283
YANACACHI,consulta externa,nuevas en menores de 5 anos,2006-03-01,69,72,69,72,141
YAPACANI,consulta externa,nuevas en menores de 5 anos,2006-03-01,827,790,827,790,1617
YOCALLA,consulta externa,nuevas en menores de 5 anos,2006-03-01,86,68,86,68,154
YOTALA,consulta externa,nuevas en menores de 5 anos,2006-03-01,197,142,197,142,339
YUNCHARA,consulta externa,nuevas en menores de 5 anos,2006-03-01,113,106,113,106,219
ZUDAÑEZ,consulta externa,nuevas en menores de 5 anos,2006-03-01,252,228,252,228,480
ACACIO,consulta externa,nuevas en menores de 5 anos,2006-04-01,146,134,146,134,280
ACHACACHI,consulta externa,nuevas en menores de 5 anos,2006-04-01,405,356,405,356,761
ACHOCALLA,consulta externa,nuevas en menores de 5 anos,2006-04-01,80,84,80,84,164
AIQUILE,consulta externa,nuevas en menores de 5 anos,2006-04-01,252,268,252,268,520
ALALAY,consulta externa,nuevas en menores de 5 anos,2006-04-01,58,26,58,26,84
ALCALA,consulta externa,nuevas en menores de 5 anos,2006-04-01,166,152,166,152,318
ANCORAIMES,consulta externa,nuevas en menores de 5 anos,2006-04-01,192,173,192,173,365
ANDAMARCA,consulta externa,nuevas en menores de 5 anos,2006-04-01,82,83,82,83,165
ANTEQUERA,consulta externa,nuevas en menores de 5 anos,2006-04-01,44,27,44,27,71
ANZALDO,consulta externa,nuevas en menores de 5 anos,2006-04-01,72,97,72,97,169
APOLO,consulta externa,nuevas en menores de 5 anos,2006-04-01,340,331,340,331,671
ARAMPAMPA,consulta externa,nuevas en menores de 5 anos,2006-04-01,123,126,123,126,249
ARANI,consulta externa,nuevas en menores de 5 anos,2006-04-01,76,83,76,83,159
ARBIETO,consulta externa,nuevas en menores de 5 anos,2006-04-01,94,82,94,82,176
ARQUE,consulta externa,nuevas en menores de 5 anos,2006-04-01,171,165,171,165,336
ASCENCION DE GUARAYOS,consulta externa,nuevas en menores de 5 anos,2006-04-01,424,414,424,414,838
ATOCHA,consulta externa,nuevas en menores de 5 anos,2006-04-01,445,322,445,322,767
AUCAPATA,consulta externa,nuevas en menores de 5 anos,2006-04-01,150,134,150,134,284
AYATA,consulta externa,nuevas en menores de 5 anos,2006-04-01,124,102,124,102,226
AYO AYO,consulta externa,nuevas en menores de 5 anos,2006-04-01,73,65,73,65,138
AYOPAYA (V. DE INDEPENDENCIA),consulta externa,nuevas en menores de 5 anos,2006-04-01,592,519,592,519,1111
AZURDUY,consulta externa,nuevas en menores de 5 anos,2006-04-01,503,449,503,449,952
BATALLAS,consulta externa,nuevas en menores de 5 anos,2006-04-01,121,76,121,76,197
BAURES,consulta externa,nuevas en menores de 5 anos,2006-04-01,112,141,112,141,253
BELEN DE ANDAMARCA,consulta externa,nuevas en menores de 5 anos,2006-04-01,25,32,25,32,57
BELEN DE URMIRI,consulta externa,nuevas en menores de 5 anos,2006-04-01,47,27,47,27,74
BELLA FLOR,consulta externa,nuevas en menores de 5 anos,2006-04-01,106,95,106,95,201
BERMEJO,consulta externa,nuevas en menores de 5 anos,2006-04-01,729,789,729,789,1518
BETANZOS,consulta externa,nuevas en menores de 5 anos,2006-04-01,508,514,508,514,1022
BOLIVAR,consulta externa,nuevas en menores de 5 anos,2006-04-01,134,128,134,128,262
BOLPEBRA,consulta externa,nuevas en menores de 5 anos,2006-04-01,39,32,39,32,71
BOYUIBE,consulta externa,nuevas en menores de 5 anos,2006-04-01,129,122,129,122,251
BUENA VISTA,consulta externa,nuevas en menores de 5 anos,2006-04-01,394,387,394,387,781
CABEZAS,consulta externa,nuevas en menores de 5 anos,2006-04-01,457,440,457,440,897
CAIROMA,consulta externa,nuevas en menores de 5 anos,2006-04-01,218,233,218,233,451
"CAIZA ""D""",consulta externa,nuevas en menores de 5 anos,2006-04-01,132,147,132,147,279
CAJUATA,consulta externa,nuevas en menores de 5 anos,2006-04-01,124,113,124,113,237
CALACOTO,consulta externa,nuevas en menores de 5 anos,2006-04-01,62,71,62,71,133
CALAMARCA,consulta externa,nuevas en menores de 5 anos,2006-04-01,172,170,172,170,342
CAMARGO,consulta externa,nuevas en menores de 5 anos,2006-04-01,412,406,412,406,818
CAMATAQUI (C. VILLA ABECIA),consulta externa,nuevas en menores de 5 anos,2006-04-01,79,70,79,70,149
CAMIRI,consulta externa,nuevas en menores de 5 anos,2006-04-01,888,812,888,812,1700
CAPINOTA,consulta externa,nuevas en menores de 5 anos,2006-04-01,349,324,349,324,673
CAQUIAVIRI,consulta externa,nuevas en menores de 5 anos,2006-04-01,97,97,97,97,194
CARACOLLO,consulta externa,nuevas en menores de 5 anos,2006-04-01,314,267,314,267,581
CARANAVI,consulta externa,nuevas en menores de 5 anos,2006-04-01,1033,987,1033,987,2020
CARANGAS,consulta externa,nuevas en menores de 5 anos,2006-04-01,4,7,4,7,11
CARAPARI,consulta externa,nuevas en menores de 5 anos,2006-04-01,196,187,196,187,383
CARIPUYO,consulta externa,nuevas en menores de 5 anos,2006-04-01,124,144,124,144,268
CARMEN RIVERO TORREZ,consulta externa,nuevas en menores de 5 anos,2006-04-01,73,66,73,66,139
CATACORA,consulta externa,nuevas en menores de 5 anos,2006-04-01,10,8,10,8,18
CHACARILLA,consulta externa,nuevas en menores de 5 anos,2006-04-01,24,32,24,32,56
CHALLAPATA,consulta externa,nuevas en menores de 5 anos,2006-04-01,517,439,517,439,956
CHAQUI,consulta externa,nuevas en menores de 5 anos,2006-04-01,91,98,91,98,189
CHARAGUA,consulta externa,nuevas en menores de 5 anos,2006-04-01,640,564,640,564,1204
CHARAÑA,consulta externa,nuevas en menores de 5 anos,2006-04-01,25,29,25,29,54
CHAYANTA,consulta externa,nuevas en menores de 5 anos,2006-04-01,321,330,321,330,651
CHIMORE,consulta externa,nuevas en menores de 5 anos,2006-04-01,525,499,525,499,1024
CHIPAYA,consulta externa,nuevas en menores de 5 anos,2006-04-01,36,33,36,33,69
CHOQUE COTA,consulta externa,nuevas en menores de 5 anos,2006-04-01,13,16,13,16,29
CHULUMANI (V. DE LA LIBERTAD),consulta externa,nuevas en menores de 5 anos,2006-04-01,335,303,335,303,638
CHUMA,consulta externa,nuevas en menores de 5 anos,2006-04-01,126,133,126,133,259
CLIZA,consulta externa,nuevas en menores de 5 anos,2006-04-01,183,186,183,186,369
COBIJA,consulta externa,nuevas en menores de 5 anos,2006-04-01,716,678,716,678,1394
COCHABAMBA,consulta externa,nuevas en menores de 5 anos,2006-04-01,8737,8218,8737,8218,16955
COIPASA,consulta externa,nuevas en menores de 5 anos,2006-04-01,10,12,10,12,22
COLCAPIRHUA,consulta externa,nuevas en menores de 5 anos,2006-04-01,459,478,459,478,937
"COLCHA ""K""",consulta externa,nuevas en menores de 5 anos,2006-04-01,137,137,137,137,274
COLLANA,consulta externa,nuevas en menores de 5 anos,2006-04-01,15,9,15,9,24
COLOMI,consulta externa,nuevas en menores de 5 anos,2006-04-01,260,213,260,213,473
COLPA BELGICA,consulta externa,nuevas en menores de 5 anos,2006-04-01,178,145,178,145,323
COLQUECHACA,consulta externa,nuevas en menores de 5 anos,2006-04-01,865,778,865,778,1643
COLQUENCHA,consulta externa,nuevas en menores de 5 anos,2006-04-01,97,76,97,76,173
COLQUIRI,consulta externa,nuevas en menores de 5 anos,2006-04-01,415,347,415,347,762
COMANCHE,consulta externa,nuevas en menores de 5 anos,2006-04-01,21,19,21,19,40
COMARAPA,consulta externa,nuevas en menores de 5 anos,2006-04-01,347,361,347,361,708
COMBAYA,consulta externa,nuevas en menores de 5 anos,2006-04-01,30,29,30,29,59
CONCEPCION,consulta externa,nuevas en menores de 5 anos,2006-04-01,272,256,272,256,528
COPACABANA,consulta externa,nuevas en menores de 5 anos,2006-04-01,125,105,125,105,230
CORIPATA,consulta externa,nuevas en menores de 5 anos,2006-04-01,228,239,228,239,467
CORO CORO,consulta externa,nuevas en menores de 5 anos,2006-04-01,94,83,94,83,177
COROICO,consulta externa,nuevas en menores de 5 anos,2006-04-01,329,267,329,267,596
CORQUE,consulta externa,nuevas en menores de 5 anos,2006-04-01,121,105,121,105,226
COTAGAITA,consulta externa,nuevas en menores de 5 anos,2006-04-01,625,554,625,554,1179
COTOCA,consulta externa,nuevas en menores de 5 anos,2006-04-01,587,469,587,469,1056
CUATRO CAÑADAS,consulta externa,nuevas en menores de 5 anos,2006-04-01,683,507,683,507,1190
CUCHUMUELA (V. G. VILLARROEL),consulta externa,nuevas en menores de 5 anos,2006-04-01,29,18,29,18,47
CUEVO,consulta externa,nuevas en menores de 5 anos,2006-04-01,86,129,86,129,215
CULPINA,consulta externa,nuevas en menores de 5 anos,2006-04-01,386,270,386,270,656
CURAHUARA DE CARANGAS,consulta externa,nuevas en menores de 5 anos,2006-04-01,120,108,120,108,228
CURVA,consulta externa,nuevas en menores de 5 anos,2006-04-01,41,31,41,31,72
DESAGUADERO,consulta externa,nuevas en menores de 5 anos,2006-04-01,47,20,47,20,67
EL ALTO,consulta externa,nuevas en menores de 5 anos,2006-04-01,9663,9956,9663,9956,19619
EL CHORO,consulta externa,nuevas en menores de 5 anos,2006-04-01,67,59,67,59,126
EL PUENTE(STC),consulta externa,nuevas en menores de 5 anos,2006-04-01,355,324,355,324,679
EL PUENTE(TJA),consulta externa,nuevas en menores de 5 anos,2006-04-01,262,223,262,223,485
EL TORNO,consulta externa,nuevas en menores de 5 anos,2006-04-01,879,813,879,813,1692
EL VILLAR,consulta externa,nuevas en menores de 5 anos,2006-04-01,205,216,205,216,421
ENTRE RIOS,consulta externa,nuevas en menores de 5 anos,2006-04-01,435,369,435,369,804
ENTRE RIOS,consulta externa,nuevas en menores de 5 anos,2006-04-01,449,439,449,439,888
ESCARA,consulta externa,nuevas en menores de 5 anos,2006-04-01,1,2,1,2,3
EUCALIPTUS,consulta externa,nuevas en menores de 5 anos,2006-04-01,297,162,297,162,459
EUREKA (SANTOS MERCADO),consulta externa,nuevas en menores de 5 anos,2006-04-01,11,21,11,21,32
EXALTACION,consulta externa,nuevas en menores de 5 anos,2006-04-01,36,40,36,40,76
FERNANDEZ ALONSO,consulta externa,nuevas en menores de 5 anos,2006-04-01,521,491,521,491,1012
FILADELFIA,consulta externa,nuevas en menores de 5 anos,2006-04-01,97,107,97,107,204
GENERAL SAAVEDRA,consulta externa,nuevas en menores de 5 anos,2006-04-01,619,501,619,501,1120
GRAL. J.J. PEREZ (CHARAZANI),consulta externa,nuevas en menores de 5 anos,2006-04-01,111,99,111,99,210
GUANAY,consulta externa,nuevas en menores de 5 anos,2006-04-01,311,298,311,298,609
GUAQUI,consulta externa,nuevas en menores de 5 anos,2006-04-01,95,57,95,57,152
GUAYARAMERIN,consulta externa,nuevas en menores de 5 anos,2006-04-01,1157,1094,1157,1094,2251
GUTIERREZ,consulta externa,nuevas en menores de 5 anos,2006-04-01,454,566,454,566,1020
HUACARETA,consulta externa,nuevas en menores de 5 anos,2006-04-01,226,218,226,218,444
HUACAYA (VILLA DE HUACAYA),consulta externa,nuevas en menores de 5 anos,2006-04-01,98,98,98,98,196
HUACHACALLA,consulta externa,nuevas en menores de 5 anos,2006-04-01,12,19,12,19,31
HUANUNI,consulta externa,nuevas en menores de 5 anos,2006-04-01,571,496,571,496,1067
HUARACAJE,consulta externa,nuevas en menores de 5 anos,2006-04-01,108,109,108,109,217
HUAYLLAMARCA,consulta externa,nuevas en menores de 5 anos,2006-04-01,56,58,56,58,114
ICHOCA,consulta externa,nuevas en menores de 5 anos,2006-04-01,90,66,90,66,156
ICLA,consulta externa,nuevas en menores de 5 anos,2006-04-01,637,563,637,563,1200
INCAHUASI,consulta externa,nuevas en menores de 5 anos,2006-04-01,667,670,667,670,1337
INGAVI (HUMAITA),consulta externa,nuevas en menores de 5 anos,2006-04-01,59,35,59,35,94
INQUISIVI,consulta externa,nuevas en menores de 5 anos,2006-04-01,205,207,205,207,412
IRUPANA (VILLA DE LANZA),consulta externa,nuevas en menores de 5 anos,2006-04-01,313,226,313,226,539
IXIAMAS,consulta externa,nuevas en menores de 5 anos,2006-04-01,223,153,223,153,376
JESUS DE MACHACA,consulta externa,nuevas en menores de 5 anos,2006-04-01,176,173,176,173,349
LA ASUNTA,consulta externa,nuevas en menores de 5 anos,2006-04-01,489,496,489,496,985
LA GUARDIA,consulta externa,nuevas en menores de 5 anos,2006-04-01,1164,1087,1164,1087,2251
LA PAZ,consulta externa,nuevas en menores de 5 anos,2006-04-01,13385,12215,13385,12215,25600
LA RIVERA,consulta externa,nuevas en menores de 5 anos,2006-04-01,2,3,2,3,5
LAGUNILLAS,consulta externa,nuevas en menores de 5 anos,2006-04-01,264,294,264,294,558
LAJA,consulta externa,nuevas en menores de 5 anos,2006-04-01,105,91,105,91,196
LAS CARRERAS,consulta externa,nuevas en menores de 5 anos,2006-04-01,64,72,64,72,136
LICOMA PAMPA,consulta externa,nuevas en menores de 5 anos,2006-04-01,34,26,34,26,60
LLALLAGUA,consulta externa,nuevas en menores de 5 anos,2006-04-01,665,608,665,608,1273
LLICA,consulta externa,nuevas en menores de 5 anos,2006-04-01,82,56,82,56,138
LORETO,consulta externa,nuevas en menores de 5 anos,2006-04-01,93,99,93,99,192
LURIBAY,consulta externa,nuevas en menores de 5 anos,2006-04-01,145,118,145,118,263
MACHACAMARCA,consulta externa,nuevas en menores de 5 anos,2006-04-01,66,74,66,74,140
MACHARETI,consulta externa,nuevas en menores de 5 anos,2006-04-01,310,337,310,337,647
MAGDALENA,consulta externa,nuevas en menores de 5 anos,2006-04-01,152,143,152,143,295
MAIRANA,consulta externa,nuevas en menores de 5 anos,2006-04-01,152,178,152,178,330
MALLA,consulta externa,nuevas en menores de 5 anos,2006-04-01,52,47,52,47,99
MAPIRI,consulta externa,nuevas en menores de 5 anos,2006-04-01,282,252,282,252,534
MECAPACA,consulta externa,nuevas en menores de 5 anos,2006-04-01,141,125,141,125,266
MINEROS,consulta externa,nuevas en menores de 5 anos,2006-04-01,581,476,581,476,1057
MIZQUE,consulta externa,nuevas en menores de 5 anos,2006-04-01,396,344,396,344,740
MOCOMOCO,consulta externa,nuevas en menores de 5 anos,2006-04-01,166,138,166,138,304
MOJINETE,consulta externa,nuevas en menores de 5 anos,2006-04-01,8,6,8,6,14
MOJOCOYA,consulta externa,nuevas en menores de 5 anos,2006-04-01,130,116,130,116,246
MONTEAGUDO,consulta externa,nuevas en menores de 5 anos,2006-04-01,619,543,619,543,1162
MONTERO,consulta externa,nuevas en menores de 5 anos,2006-04-01,2706,2372,2706,2372,5078
MORO MORO,consulta externa,nuevas en menores de 5 anos,2006-04-01,69,64,69,64,133
MOROCHATA,consulta externa,nuevas en menores de 5 anos,2006-04-01,277,229,277,229,506
NACEBE (SANTA ROSA DEL ABUNA),consulta externa,nuevas en menores de 5 anos,2006-04-01,74,64,74,64,138
NAZACARA DE PACAJES,consulta externa,nuevas en menores de 5 anos,2006-04-01,7,4,7,4,11
NUEVO MANOA (NUEVA ESPERANZA),consulta externa,nuevas en menores de 5 anos,2006-04-01,6,9,6,9,15
OCURI,consulta externa,nuevas en menores de 5 anos,2006-04-01,411,352,411,352,763
OKINAWA,consulta externa,nuevas en menores de 5 anos,2006-04-01,265,357,265,357,622
OMEREQUE,consulta externa,nuevas en menores de 5 anos,2006-04-01,175,187,175,187,362
ORURO,consulta externa,nuevas en menores de 5 anos,2006-04-01,5113,4547,5113,4547,9660
PADCAYA,consulta externa,nuevas en menores de 5 anos,2006-04-01,401,383,401,383,784
PADILLA,consulta externa,nuevas en menores de 5 anos,2006-04-01,426,399,426,399,825
PAILON,consulta externa,nuevas en menores de 5 anos,2006-04-01,428,424,428,424,852
PALCA,consulta externa,nuevas en menores de 5 anos,2006-04-01,82,96,82,96,178
PALOS BLANCOS,consulta externa,nuevas en menores de 5 anos,2006-04-01,676,543,676,543,1219
PAMPA AULLAGAS,consulta externa,nuevas en menores de 5 anos,2006-04-01,34,36,34,36,70
PAMPA GRANDE,consulta externa,nuevas en menores de 5 anos,2006-04-01,168,164,168,164,332
PAPEL PAMPA,consulta externa,nuevas en menores de 5 anos,2006-04-01,45,56,45,56,101
PASORAPA,consulta externa,nuevas en menores de 5 anos,2006-04-01,55,58,55,58,113
PATACAMAYA,consulta externa,nuevas en menores de 5 anos,2006-04-01,261,180,261,180,441
PAZÑA,consulta externa,nuevas en menores de 5 anos,2006-04-01,135,105,135,105,240
PELECHUCO,consulta externa,nuevas en menores de 5 anos,2006-04-01,75,59,75,59,134
POCOATA,consulta externa,nuevas en menores de 5 anos,2006-04-01,414,359,414,359,773
POCONA,consulta externa,nuevas en menores de 5 anos,2006-04-01,254,212,254,212,466
POJO (CBBA),consulta externa,nuevas en menores de 5 anos,2006-04-01,125,103,125,103,228
POOPO,consulta externa,nuevas en menores de 5 anos,2006-04-01,75,73,75,73,148
PORCO,consulta externa,nuevas en menores de 5 anos,2006-04-01,117,150,117,150,267
POROMA,consulta externa,nuevas en menores de 5 anos,2006-04-01,409,332,409,332,741
PORONGO,consulta externa,nuevas en menores de 5 anos,2006-04-01,294,233,294,233,527
PORTACHUELO,consulta externa,nuevas en menores de 5 anos,2006-04-01,543,459,543,459,1002
PORVENIR,consulta externa,nuevas en menores de 5 anos,2006-04-01,169,141,169,141,310
POSTRER VALLE,consulta externa,nuevas en menores de 5 anos,2006-04-01,48,63,48,63,111
POTOSI,consulta externa,nuevas en menores de 5 anos,2006-04-01,3723,3090,3723,3090,6813
PRESTO,consulta externa,nuevas en menores de 5 anos,2006-04-01,356,333,356,333,689
PUCARA,consulta externa,nuevas en menores de 5 anos,2006-04-01,57,42,57,42,99
PUCARANI,consulta externa,nuevas en menores de 5 anos,2006-04-01,221,191,221,191,412
PUERTO ACOSTA,consulta externa,nuevas en menores de 5 anos,2006-04-01,154,157,154,157,311
PUERTO CARABUCO,consulta externa,nuevas en menores de 5 anos,2006-04-01,112,122,112,122,234
PUERTO GONZALO MORENO,consulta externa,nuevas en menores de 5 anos,2006-04-01,98,93,98,93,191
PUERTO PEREZ,consulta externa,nuevas en menores de 5 anos,2006-04-01,74,79,74,79,153
PUERTO QUIJARRO,consulta externa,nuevas en menores de 5 anos,2006-04-01,320,301,320,301,621
PUERTO RICO,consulta externa,nuevas en menores de 5 anos,2006-04-01,149,145,149,145,294
PUERTO SILES,consulta externa,nuevas en menores de 5 anos,2006-04-01,38,93,38,93,131
PUERTO SUAREZ,consulta externa,nuevas en menores de 5 anos,2006-04-01,376,336,376,336,712
PUERTO VILLARROEL,consulta externa,nuevas en menores de 5 anos,2006-04-01,1304,1226,1304,1226,2530
PUNA,consulta externa,nuevas en menores de 5 anos,2006-04-01,545,547,545,547,1092
PUNATA,consulta externa,nuevas en menores de 5 anos,2006-04-01,305,328,305,328,633
QUIABAYA,consulta externa,nuevas en menores de 5 anos,2006-04-01,36,15,36,15,51
QUILLACOLLO,consulta externa,nuevas en menores de 5 anos,2006-04-01,1298,1007,1298,1007,2305
QUIME,consulta externa,nuevas en menores de 5 anos,2006-04-01,117,106,117,106,223
QUIRUSILLAS,consulta externa,nuevas en menores de 5 anos,2006-04-01,68,41,68,41,109
RAVELO,consulta externa,nuevas en menores de 5 anos,2006-04-01,1839,315,1839,315,2154
REYES,consulta externa,nuevas en menores de 5 anos,2006-04-01,283,284,283,284,567
RIBERALTA,consulta externa,nuevas en menores de 5 anos,2006-04-01,1648,1465,1648,1465,3113
ROBORE,consulta externa,nuevas en menores de 5 anos,2006-04-01,253,327,253,327,580
RURRENABAQUE,consulta externa,nuevas en menores de 5 anos,2006-04-01,402,387,402,387,789
SABAYA,consulta externa,nuevas en menores de 5 anos,2006-04-01,51,40,51,40,91
SACABA,consulta externa,nuevas en menores de 5 anos,2006-04-01,1209,1202,1209,1202,2411
SACABAMBA,consulta externa,nuevas en menores de 5 anos,2006-04-01,66,52,66,52,118
SACACA,consulta externa,nuevas en menores de 5 anos,2006-04-01,559,482,559,482,1041
SAIPINA,consulta externa,nuevas en menores de 5 anos,2006-04-01,105,75,105,75,180
SALINAS DE GARCI MENDOZA,consulta externa,nuevas en menores de 5 anos,2006-04-01,187,163,187,163,350
SAMAIPATA,consulta externa,nuevas en menores de 5 anos,2006-04-01,220,165,220,165,385
SAN AGUSTIN,consulta externa,nuevas en menores de 5 anos,2006-04-01,23,22,23,22,45
SAN ANDRES,consulta externa,nuevas en menores de 5 anos,2006-04-01,260,272,260,272,532
SAN ANDRES DE MACHACA,consulta externa,nuevas en menores de 5 anos,2006-04-01,55,28,55,28,83
SAN ANTONIO DE ESMORUCO,consulta externa,nuevas en menores de 5 anos,2006-04-01,40,39,40,39,79
SAN ANTONIO DE LOMERIO,consulta externa,nuevas en menores de 5 anos,2006-04-01,103,111,103,111,214
SAN BENITO,consulta externa,nuevas en menores de 5 anos,2006-04-01,210,157,210,157,367
SAN BORJA,consulta externa,nuevas en menores de 5 anos,2006-04-01,565,491,565,491,1056
SAN BUENA VENTURA,consulta externa,nuevas en menores de 5 anos,2006-04-01,285,295,285,295,580
SAN CARLOS,consulta externa,nuevas en menores de 5 anos,2006-04-01,445,413,445,413,858
SAN IGNACIO,consulta externa,nuevas en menores de 5 anos,2006-04-01,369,329,369,329,698
SAN IGNACIO DE VELASCO,consulta externa,nuevas en menores de 5 anos,2006-04-01,1253,1202,1253,1202,2455
SAN JAVIER(BNI),consulta externa,nuevas en menores de 5 anos,2006-04-01,85,77,85,77,162
SAN JAVIER(STC),consulta externa,nuevas en menores de 5 anos,2006-04-01,209,148,209,148,357
SAN JOAQUIN,consulta externa,nuevas en menores de 5 anos,2006-04-01,75,74,75,74,149
SAN JOSE DE CHIQUITOS,consulta externa,nuevas en menores de 5 anos,2006-04-01,454,419,454,419,873
SAN JUAN DE YAPACANI,consulta externa,nuevas en menores de 5 anos,2006-04-01,303,275,303,275,578
SAN JULIAN,consulta externa,nuevas en menores de 5 anos,2006-04-01,1540,1358,1540,1358,2898
SAN LORENZO(PND),consulta externa,nuevas en menores de 5 anos,2006-04-01,158,150,158,150,308
SAN LORENZO(TJA),consulta externa,nuevas en menores de 5 anos,2006-04-01,553,517,553,517,1070
SAN LUCAS,consulta externa,nuevas en menores de 5 anos,2006-04-01,911,836,911,836,1747
SAN MATIAS,consulta externa,nuevas en menores de 5 anos,2006-04-01,180,155,180,155,335
SAN MIGUEL DE VELASCO,consulta externa,nuevas en menores de 5 anos,2006-04-01,207,245,207,245,452
SAN PABLO DE LIPEZ,consulta externa,nuevas en menores de 5 anos,2006-04-01,96,89,96,89,185
SAN PEDRO,consulta externa,nuevas en menores de 5 anos,2006-04-01,623,587,623,587,1210
SAN PEDRO DE BUENA VISTA,consulta externa,nuevas en menores de 5 anos,2006-04-01,407,411,407,411,818
SAN PEDRO DE CURAHUARA,consulta externa,nuevas en menores de 5 anos,2006-04-01,62,51,62,51,113
SAN PEDRO DE QUEMES,consulta externa,nuevas en menores de 5 anos,2006-04-01,12,18,12,18,30
SAN PEDRO DE TIQUINA,consulta externa,nuevas en menores de 5 anos,2006-04-01,46,33,46,33,79
SAN PEDRO(PND),consulta externa,nuevas en menores de 5 anos,2006-04-01,64,69,64,69,133
SAN RAFAEL,consulta externa,nuevas en menores de 5 anos,2006-04-01,113,96,113,96,209
SAN RAMON,consulta externa,nuevas en menores de 5 anos,2006-04-01,101,78,101,78,179
SAN RAMON,consulta externa,nuevas en menores de 5 anos,2006-04-01,167,152,167,152,319
SANTA ANA,consulta externa,nuevas en menores de 5 anos,2006-04-01,256,209,256,209,465
SANTA CRUZ DE LA SIERRA,consulta externa,nuevas en menores de 5 anos,2006-04-01,23597,22130,23597,22130,45727
SANTA ROSA,consulta externa,nuevas en menores de 5 anos,2006-04-01,228,256,228,256,484
SANTA ROSA DEL SARA,consulta externa,nuevas en menores de 5 anos,2006-04-01,615,646,615,646,1261
SANTIAGO DE CALLAPA,consulta externa,nuevas en menores de 5 anos,2006-04-01,39,43,39,43,82
SANTIAGO DE HUARI,consulta externa,nuevas en menores de 5 anos,2006-04-01,89,90,89,90,179
SANTIAGO DE MACHACA,consulta externa,nuevas en menores de 5 anos,2006-04-01,21,26,21,26,47
SANTIVAÑES,consulta externa,nuevas en menores de 5 anos,2006-04-01,137,108,137,108,245
SANTUARIO DE QUILLACAS,consulta externa,nuevas en menores de 5 anos,2006-04-01,38,36,38,36,74
SAPAHAQUI,consulta externa,nuevas en menores de 5 anos,2006-04-01,109,118,109,118,227
SENA,consulta externa,nuevas en menores de 5 anos,2006-04-01,58,68,58,68,126
SICA SICA (VILLA AROMA),consulta externa,nuevas en menores de 5 anos,2006-04-01,138,141,138,141,279
SICAYA,consulta externa,nuevas en menores de 5 anos,2006-04-01,50,41,50,41,91
SIPE SIPE,consulta externa,nuevas en menores de 5 anos,2006-04-01,482,336,482,336,818
SOPACHUY,consulta externa,nuevas en menores de 5 anos,2006-04-01,142,185,142,185,327
SORACACHI,consulta externa,nuevas en menores de 5 anos,2006-04-01,92,108,92,108,200
SORATA,consulta externa,nuevas en menores de 5 anos,2006-04-01,185,190,185,190,375
SUCRE,consulta externa,nuevas en menores de 5 anos,2006-04-01,6218,5577,6218,5577,11795
TACACHI,consulta externa,nuevas en menores de 5 anos,2006-04-01,10,13,10,13,23
TACACOMA,consulta externa,nuevas en menores de 5 anos,2006-04-01,68,69,68,69,137
TACOBAMBA,consulta externa,nuevas en menores de 5 anos,2006-04-01,127,114,127,114,241
TACOPAYA,consulta externa,nuevas en menores de 5 anos,2006-04-01,309,306,309,306,615
TAHUA,consulta externa,nuevas en menores de 5 anos,2006-04-01,12,13,12,13,25
TAPACARI,consulta externa,nuevas en menores de 5 anos,2006-04-01,480,442,480,442,922
TARABUCO,consulta externa,nuevas en menores de 5 anos,2006-04-01,676,645,676,645,1321
TARACO,consulta externa,nuevas en menores de 5 anos,2006-04-01,46,29,46,29,75
TARATA,consulta externa,nuevas en menores de 5 anos,2006-04-01,95,62,95,62,157
TARIJA,consulta externa,nuevas en menores de 5 anos,2006-04-01,4211,3369,4211,3369,7580
TARVITA,consulta externa,nuevas en menores de 5 anos,2006-04-01,381,366,381,366,747
TEOPONTE,consulta externa,nuevas en menores de 5 anos,2006-04-01,175,150,175,150,325
TIAWANACU,consulta externa,nuevas en menores de 5 anos,2006-04-01,128,109,128,109,237
TINGUIPAYA,consulta externa,nuevas en menores de 5 anos,2006-04-01,396,322,396,322,718
TIPUANI,consulta externa,nuevas en menores de 5 anos,2006-04-01,102,90,102,90,192
TIQUIPAYA,consulta externa,nuevas en menores de 5 anos,2006-04-01,544,400,544,400,944
TIRAQUE (CBBA),consulta externa,nuevas en menores de 5 anos,2006-04-01,753,697,753,697,1450
TITO YUPANQUI (PARQUIPUJIO),consulta externa,nuevas en menores de 5 anos,2006-04-01,19,21,19,21,40
TOCO,consulta externa,nuevas en menores de 5 anos,2006-04-01,55,63,55,63,118
TODOS SANTOS,consulta externa,nuevas en menores de 5 anos,2006-04-01,2,2,2,2,4
TOLATA,consulta externa,nuevas en menores de 5 anos,2006-04-01,60,50,60,50,110
TOLEDO,consulta externa,nuevas en menores de 5 anos,2006-04-01,89,87,89,87,176
TOMAVE,consulta externa,nuevas en menores de 5 anos,2006-04-01,174,192,174,192,366
TOMINA,consulta externa,nuevas en menores de 5 anos,2006-04-01,212,232,212,232,444
TORO TORO,consulta externa,nuevas en menores de 5 anos,2006-04-01,226,251,226,251,477
TOTORA(CBBA),consulta externa,nuevas en menores de 5 anos,2006-04-01,234,213,234,213,447
TOTORA(ORR),consulta externa,nuevas en menores de 5 anos,2006-04-01,53,63,53,63,116
TRIGAL,consulta externa,nuevas en menores de 5 anos,2006-04-01,52,52,52,52,104
TRINIDAD,consulta externa,nuevas en menores de 5 anos,2006-04-01,1379,1996,1379,1996,3375
TUPIZA,consulta externa,nuevas en menores de 5 anos,2006-04-01,1052,1003,1052,1003,2055
TURCO,consulta externa,nuevas en menores de 5 anos,2006-04-01,75,63,75,63,138
UMALA,consulta externa,nuevas en menores de 5 anos,2006-04-01,50,48,50,48,98
UNCIA,consulta externa,nuevas en menores de 5 anos,2006-04-01,634,519,634,519,1153
URIONDO (A. CONCEPCION),consulta externa,nuevas en menores de 5 anos,2006-04-01,361,344,361,344,705
URUBICHA,consulta externa,nuevas en menores de 5 anos,2006-04-01,144,159,144,159,303
UYUNI,consulta externa,nuevas en menores de 5 anos,2006-04-01,270,237,270,237,507
VACAS,consulta externa,nuevas en menores de 5 anos,2006-04-01,231,155,231,155,386
VALLEGRANDE,consulta externa,nuevas en menores de 5 anos,2006-04-01,275,240,275,240,515
VIACHA,consulta externa,nuevas en menores de 5 anos,2006-04-01,576,549,576,549,1125
VILA VILA,consulta externa,nuevas en menores de 5 anos,2006-04-01,63,54,63,54,117
VILLA MONTES,consulta externa,nuevas en menores de 5 anos,2006-04-01,571,527,571,527,1098
VILLA NUEVA (LOMA ALTA),consulta externa,nuevas en menores de 5 anos,2006-04-01,62,38,62,38,100
VILLA RIVERO,consulta externa,nuevas en menores de 5 anos,2006-04-01,71,82,71,82,153
VILLA SERRANO,consulta externa,nuevas en menores de 5 anos,2006-04-01,442,370,442,370,812
VILLA TUNARI,consulta externa,nuevas en menores de 5 anos,2006-04-01,1700,1408,1700,1408,3108
VILLA VACA GUZMAN (MUYUPAMPA),consulta externa,nuevas en menores de 5 anos,2006-04-01,305,347,305,347,652
VILLAZON,consulta externa,nuevas en menores de 5 anos,2006-04-01,832,727,832,727,1559
VINTO,consulta externa,nuevas en menores de 5 anos,2006-04-01,173,177,173,177,350
VITICHI,consulta externa,nuevas en menores de 5 anos,2006-04-01,220,248,220,248,468
WALDO BALLIVIAN,consulta externa,nuevas en menores de 5 anos,2006-04-01,23,41,23,41,64
WARNES,consulta externa,nuevas en menores de 5 anos,2006-04-01,988,938,988,938,1926
YACO,consulta externa,nuevas en menores de 5 anos,2006-04-01,97,96,97,96,193
YACUIBA,consulta externa,nuevas en menores de 5 anos,2006-04-01,1634,1503,1634,1503,3137
YAMPARAEZ,consulta externa,nuevas en menores de 5 anos,2006-04-01,199,194,199,194,393
YANACACHI,consulta externa,nuevas en menores de 5 anos,2006-04-01,105,101,105,101,206
YAPACANI,consulta externa,nuevas en menores de 5 anos,2006-04-01,671,670,671,670,1341
YOCALLA,consulta externa,nuevas en menores de 5 anos,2006-04-01,85,64,85,64,149
YOTALA,consulta externa,nuevas en menores de 5 anos,2006-04-01,173,195,173,195,368
YUNCHARA,consulta externa,nuevas en menores de 5 anos,2006-04-01,149,148,149,148,297
ZUDAÑEZ,consulta externa,nuevas en menores de 5 anos,2006-04-01,223,207,223,207,430
ACACIO,consulta externa,nuevas en menores de 5 anos,2006-05-01,200,177,200,177,377
ACHACACHI,consulta externa,nuevas en menores de 5 anos,2006-05-01,529,494,529,494,1023
ACHOCALLA,consulta externa,nuevas en menores de 5 anos,2006-05-01,212,163,212,163,375
AIQUILE,consulta externa,nuevas en menores de 5 anos,2006-05-01,297,308,297,308,605
ALALAY,consulta externa,nuevas en menores de 5 anos,2006-05-01,60,50,60,50,110
ALCALA,consulta externa,nuevas en menores de 5 anos,2006-05-01,206,175,206,175,381
ANCORAIMES,consulta externa,nuevas en menores de 5 anos,2006-05-01,205,205,205,205,410
ANDAMARCA,consulta externa,nuevas en menores de 5 anos,2006-05-01,65,62,65,62,127
ANTEQUERA,consulta externa,nuevas en menores de 5 anos,2006-05-01,57,51,57,51,108
ANZALDO,consulta externa,nuevas en menores de 5 anos,2006-05-01,139,173,139,173,312
APOLO,consulta externa,nuevas en menores de 5 anos,2006-05-01,441,446,441,446,887
ARAMPAMPA,consulta externa,nuevas en menores de 5 anos,2006-05-01,187,151,187,151,338
ARANI,consulta externa,nuevas en menores de 5 anos,2006-05-01,45,56,45,56,101
ARBIETO,consulta externa,nuevas en menores de 5 anos,2006-05-01,68,53,68,53,121
ARQUE,consulta externa,nuevas en menores de 5 anos,2006-05-01,272,228,272,228,500
ASCENCION DE GUARAYOS,consulta externa,nuevas en menores de 5 anos,2006-05-01,4015,527,4015,527,4542
ATOCHA,consulta externa,nuevas en menores de 5 anos,2006-05-01,528,488,528,488,1016
AUCAPATA,consulta externa,nuevas en menores de 5 anos,2006-05-01,95,80,95,80,175
AYATA,consulta externa,nuevas en menores de 5 anos,2006-05-01,275,224,275,224,499
AYO AYO,consulta externa,nuevas en menores de 5 anos,2006-05-01,63,71,63,71,134
AYOPAYA (V. DE INDEPENDENCIA),consulta externa,nuevas en menores de 5 anos,2006-05-01,655,589,655,589,1244
AZURDUY,consulta externa,nuevas en menores de 5 anos,2006-05-01,555,550,555,550,1105
BATALLAS,consulta externa,nuevas en menores de 5 anos,2006-05-01,115,102,115,102,217
BAURES,consulta externa,nuevas en menores de 5 anos,2006-05-01,83,85,83,85,168
BELEN DE ANDAMARCA,consulta externa,nuevas en menores de 5 anos,2006-05-01,32,20,32,20,52
BELEN DE URMIRI,consulta externa,nuevas en menores de 5 anos,2006-05-01,88,65,88,65,153
BELLA FLOR,consulta externa,nuevas en menores de 5 anos,2006-05-01,79,99,79,99,178
BERMEJO,consulta externa,nuevas en menores de 5 anos,2006-05-01,993,918,993,918,1911
BETANZOS,consulta externa,nuevas en menores de 5 anos,2006-05-01,884,801,884,801,1685
BOLIVAR,consulta externa,nuevas en menores de 5 anos,2006-05-01,205,193,205,193,398
BOLPEBRA,consulta externa,nuevas en menores de 5 anos,2006-05-01,48,39,48,39,87
BOYUIBE,consulta externa,nuevas en menores de 5 anos,2006-05-01,161,135,161,135,296
BUENA VISTA,consulta externa,nuevas en menores de 5 anos,2006-05-01,282,244,282,244,526
CABEZAS,consulta externa,nuevas en menores de 5 anos,2006-05-01,527,467,527,467,994
CAIROMA,consulta externa,nuevas en menores de 5 anos,2006-05-01,304,277,304,277,581
"CAIZA ""D""",consulta externa,nuevas en menores de 5 anos,2006-05-01,191,175,191,175,366
CAJUATA,consulta externa,nuevas en menores de 5 anos,2006-05-01,179,139,179,139,318
CALACOTO,consulta externa,nuevas en menores de 5 anos,2006-05-01,113,105,113,105,218
CALAMARCA,consulta externa,nuevas en menores de 5 anos,2006-05-01,262,219,262,219,481
CAMARGO,consulta externa,nuevas en menores de 5 anos,2006-05-01,572,595,572,595,1167
CAMATAQUI (C. VILLA ABECIA),consulta externa,nuevas en menores de 5 anos,2006-05-01,121,88,121,88,209
CAMIRI,consulta externa,nuevas en menores de 5 anos,2006-05-01,981,928,981,928,1909
CAPINOTA,consulta externa,nuevas en menores de 5 anos,2006-05-01,370,346,370,346,716
CAQUIAVIRI,consulta externa,nuevas en menores de 5 anos,2006-05-01,113,136,113,136,249
CARACOLLO,consulta externa,nuevas en menores de 5 anos,2006-05-01,296,315,296,315,611
CARANAVI,consulta externa,nuevas en menores de 5 anos,2006-05-01,1172,1436,1172,1436,2608
CARANGAS,consulta externa,nuevas en menores de 5 anos,2006-05-01,2,5,2,5,7
CARAPARI,consulta externa,nuevas en menores de 5 anos,2006-05-01,293,256,293,256,549
CARIPUYO,consulta externa,nuevas en menores de 5 anos,2006-05-01,346,278,346,278,624
CARMEN RIVERO TORREZ,consulta externa,nuevas en menores de 5 anos,2006-05-01,47,44,47,44,91
CATACORA,consulta externa,nuevas en menores de 5 anos,2006-05-01,39,28,39,28,67
CHACARILLA,consulta externa,nuevas en menores de 5 anos,2006-05-01,23,19,23,19,42
CHALLAPATA,consulta externa,nuevas en menores de 5 anos,2006-05-01,494,410,494,410,904
CHAQUI,consulta externa,nuevas en menores de 5 anos,2006-05-01,129,124,129,124,253
CHARAGUA,consulta externa,nuevas en menores de 5 anos,2006-05-01,652,568,652,568,1220
CHARAÑA,consulta externa,nuevas en menores de 5 anos,2006-05-01,51,64,51,64,115
CHAYANTA,consulta externa,nuevas en menores de 5 anos,2006-05-01,422,379,422,379,801
CHIMORE,consulta externa,nuevas en menores de 5 anos,2006-05-01,515,458,515,458,973
CHIPAYA,consulta externa,nuevas en menores de 5 anos,2006-05-01,49,47,49,47,96
CHOQUE COTA,consulta externa,nuevas en menores de 5 anos,2006-05-01,19,31,19,31,50
CHULUMANI (V. DE LA LIBERTAD),consulta externa,nuevas en menores de 5 anos,2006-05-01,360,346,360,346,706
CHUMA,consulta externa,nuevas en menores de 5 anos,2006-05-01,182,179,182,179,361
CLIZA,consulta externa,nuevas en menores de 5 anos,2006-05-01,237,241,237,241,478
COBIJA,consulta externa,nuevas en menores de 5 anos,2006-05-01,747,681,747,681,1428
COCHABAMBA,consulta externa,nuevas en menores de 5 anos,2006-05-01,11907,10484,11907,10484,22391
COIPASA,consulta externa,nuevas en menores de 5 anos,2006-05-01,24,17,24,17,41
COLCAPIRHUA,consulta externa,nuevas en menores de 5 anos,2006-05-01,600,532,600,532,1132
"COLCHA ""K""",consulta externa,nuevas en menores de 5 anos,2006-05-01,208,199,208,199,407
COLLANA,consulta externa,nuevas en menores de 5 anos,2006-05-01,37,11,37,11,48
COLOMI,consulta externa,nuevas en menores de 5 anos,2006-05-01,276,264,276,264,540
COLPA BELGICA,consulta externa,nuevas en menores de 5 anos,2006-05-01,161,146,161,146,307
COLQUECHACA,consulta externa,nuevas en menores de 5 anos,2006-05-01,1136,1038,1136,1038,2174
COLQUENCHA,consulta externa,nuevas en menores de 5 anos,2006-05-01,124,160,124,160,284
COLQUIRI,consulta externa,nuevas en menores de 5 anos,2006-05-01,414,378,414,378,792
COMANCHE,consulta externa,nuevas en menores de 5 anos,2006-05-01,65,55,65,55,120
COMARAPA,consulta externa,nuevas en menores de 5 anos,2006-05-01,410,400,410,400,810
COMBAYA,consulta externa,nuevas en menores de 5 anos,2006-05-01,40,27,40,27,67
CONCEPCION,consulta externa,nuevas en menores de 5 anos,2006-05-01,214,172,214,172,386
COPACABANA,consulta externa,nuevas en menores de 5 anos,2006-05-01,172,155,172,155,327
CORIPATA,consulta externa,nuevas en menores de 5 anos,2006-05-01,316,300,316,300,616
CORO CORO,consulta externa,nuevas en menores de 5 anos,2006-05-01,159,147,159,147,306
COROICO,consulta externa,nuevas en menores de 5 anos,2006-05-01,257,268,257,268,525
CORQUE,consulta externa,nuevas en menores de 5 anos,2006-05-01,127,131,127,131,258
COTAGAITA,consulta externa,nuevas en menores de 5 anos,2006-05-01,821,804,821,804,1625
COTOCA,consulta externa,nuevas en menores de 5 anos,2006-05-01,601,551,601,551,1152
CUATRO CAÑADAS,consulta externa,nuevas en menores de 5 anos,2006-05-01,502,424,502,424,926
CUCHUMUELA (V. G. VILLARROEL),consulta externa,nuevas en menores de 5 anos,2006-05-01,39,18,39,18,57
CUEVO,consulta externa,nuevas en menores de 5 anos,2006-05-01,103,119,103,119,222
CULPINA,consulta externa,nuevas en menores de 5 anos,2006-05-01,480,481,480,481,961
CURAHUARA DE CARANGAS,consulta externa,nuevas en menores de 5 anos,2006-05-01,86,85,86,85,171
CURVA,consulta externa,nuevas en menores de 5 anos,2006-05-01,32,39,32,39,71
DESAGUADERO,consulta externa,nuevas en menores de 5 anos,2006-05-01,52,38,52,38,90
EL ALTO,consulta externa,nuevas en menores de 5 anos,2006-05-01,11466,11304,11466,11304,22770
EL CHORO,consulta externa,nuevas en menores de 5 anos,2006-05-01,93,64,93,64,157
EL PUENTE(STC),consulta externa,nuevas en menores de 5 anos,2006-05-01,384,514,384,514,898
EL PUENTE(TJA),consulta externa,nuevas en menores de 5 anos,2006-05-01,270,248,270,248,518
EL TORNO,consulta externa,nuevas en menores de 5 anos,2006-05-01,1016,946,1016,946,1962
EL VILLAR,consulta externa,nuevas en menores de 5 anos,2006-05-01,216,211,216,211,427
ENTRE RIOS,consulta externa,nuevas en menores de 5 anos,2006-05-01,521,462,521,462,983
ENTRE RIOS,consulta externa,nuevas en menores de 5 anos,2006-05-01,411,347,411,347,758
ESCARA,consulta externa,nuevas en menores de 5 anos,2006-05-01,3,2,3,2,5
EUCALIPTUS,consulta externa,nuevas en menores de 5 anos,2006-05-01,324,258,324,258,582
EUREKA (SANTOS MERCADO),consulta externa,nuevas en menores de 5 anos,2006-05-01,38,43,38,43,81
EXALTACION,consulta externa,nuevas en menores de 5 anos,2006-05-01,85,80,85,80,165
FERNANDEZ ALONSO,consulta externa,nuevas en menores de 5 anos,2006-05-01,412,457,412,457,869
FILADELFIA,consulta externa,nuevas en menores de 5 anos,2006-05-01,154,184,154,184,338
GENERAL SAAVEDRA,consulta externa,nuevas en menores de 5 anos,2006-05-01,460,372,460,372,832
GRAL. J.J. PEREZ (CHARAZANI),consulta externa,nuevas en menores de 5 anos,2006-05-01,183,176,183,176,359
GUANAY,consulta externa,nuevas en menores de 5 anos,2006-05-01,254,246,254,246,500
GUAQUI,consulta externa,nuevas en menores de 5 anos,2006-05-01,73,51,73,51,124
GUAYARAMERIN,consulta externa,nuevas en menores de 5 anos,2006-05-01,1075,1063,1075,1063,2138
GUTIERREZ,consulta externa,nuevas en menores de 5 anos,2006-05-01,400,412,400,412,812
HUACARETA,consulta externa,nuevas en menores de 5 anos,2006-05-01,267,274,267,274,541
HUACAYA (VILLA DE HUACAYA),consulta externa,nuevas en menores de 5 anos,2006-05-01,222,220,222,220,442
HUACHACALLA,consulta externa,nuevas en menores de 5 anos,2006-05-01,23,14,23,14,37
HUANUNI,consulta externa,nuevas en menores de 5 anos,2006-05-01,724,690,724,690,1414
HUARACAJE,consulta externa,nuevas en menores de 5 anos,2006-05-01,90,67,90,67,157
HUAYLLAMARCA,consulta externa,nuevas en menores de 5 anos,2006-05-01,103,116,103,116,219
ICHOCA,consulta externa,nuevas en menores de 5 anos,2006-05-01,145,107,145,107,252
ICLA,consulta externa,nuevas en menores de 5 anos,2006-05-01,571,553,571,553,1124
INCAHUASI,consulta externa,nuevas en menores de 5 anos,2006-05-01,541,544,541,544,1085
INGAVI (HUMAITA),consulta externa,nuevas en menores de 5 anos,2006-05-01,11,7,11,7,18
INQUISIVI,consulta externa,nuevas en menores de 5 anos,2006-05-01,338,357,338,357,695
IRUPANA (VILLA DE LANZA),consulta externa,nuevas en menores de 5 anos,2006-05-01,292,264,292,264,556
IXIAMAS,consulta externa,nuevas en menores de 5 anos,2006-05-01,307,231,307,231,538
JESUS DE MACHACA,consulta externa,nuevas en menores de 5 anos,2006-05-01,195,191,195,191,386
LA ASUNTA,consulta externa,nuevas en menores de 5 anos,2006-05-01,610,623,610,623,1233
LA GUARDIA,consulta externa,nuevas en menores de 5 anos,2006-05-01,1157,1050,1157,1050,2207
LA PAZ,consulta externa,nuevas en menores de 5 anos,2006-05-01,17773,16570,17773,16570,34343
LA RIVERA,consulta externa,nuevas en menores de 5 anos,2006-05-01,6,12,6,12,18
LAGUNILLAS,consulta externa,nuevas en menores de 5 anos,2006-05-01,224,288,224,288,512
LAJA,consulta externa,nuevas en menores de 5 anos,2006-05-01,168,144,168,144,312
LAS CARRERAS,consulta externa,nuevas en menores de 5 anos,2006-05-01,117,111,117,111,228
LICOMA PAMPA,consulta externa,nuevas en menores de 5 anos,2006-05-01,39,38,39,38,77
LLALLAGUA,consulta externa,nuevas en menores de 5 anos,2006-05-01,971,853,971,853,1824
LLICA,consulta externa,nuevas en menores de 5 anos,2006-05-01,66,81,66,81,147
LORETO,consulta externa,nuevas en menores de 5 anos,2006-05-01,122,120,122,120,242
LURIBAY,consulta externa,nuevas en menores de 5 anos,2006-05-01,215,232,215,232,447
MACHACAMARCA,consulta externa,nuevas en menores de 5 anos,2006-05-01,81,91,81,91,172
MACHARETI,consulta externa,nuevas en menores de 5 anos,2006-05-01,312,315,312,315,627
MAGDALENA,consulta externa,nuevas en menores de 5 anos,2006-05-01,180,160,180,160,340
MAIRANA,consulta externa,nuevas en menores de 5 anos,2006-05-01,155,133,155,133,288
MALLA,consulta externa,nuevas en menores de 5 anos,2006-05-01,86,65,86,65,151
MAPIRI,consulta externa,nuevas en menores de 5 anos,2006-05-01,353,307,353,307,660
MECAPACA,consulta externa,nuevas en menores de 5 anos,2006-05-01,170,165,170,165,335
MINEROS,consulta externa,nuevas en menores de 5 anos,2006-05-01,415,342,415,342,757
MIZQUE,consulta externa,nuevas en menores de 5 anos,2006-05-01,415,425,415,425,840
MOCOMOCO,consulta externa,nuevas en menores de 5 anos,2006-05-01,148,109,148,109,257
MOJINETE,consulta externa,nuevas en menores de 5 anos,2006-05-01,20,16,20,16,36
MOJOCOYA,consulta externa,nuevas en menores de 5 anos,2006-05-01,166,149,166,149,315
MONTEAGUDO,consulta externa,nuevas en menores de 5 anos,2006-05-01,747,618,747,618,1365
MONTERO,consulta externa,nuevas en menores de 5 anos,2006-05-01,2156,2013,2156,2013,4169
MORO MORO,consulta externa,nuevas en menores de 5 anos,2006-05-01,66,50,66,50,116
MOROCHATA,consulta externa,nuevas en menores de 5 anos,2006-05-01,203,171,203,171,374
NACEBE (SANTA ROSA DEL ABUNA),consulta externa,nuevas en menores de 5 anos,2006-05-01,30,33,30,33,63
NAZACARA DE PACAJES,consulta externa,nuevas en menores de 5 anos,2006-05-01,5,0,5,0,5
NUEVO MANOA (NUEVA ESPERANZA),consulta externa,nuevas en menores de 5 anos,2006-05-01,41,33,41,33,74
OCURI,consulta externa,nuevas en menores de 5 anos,2006-05-01,642,618,642,618,1260
OKINAWA,consulta externa,nuevas en menores de 5 anos,2006-05-01,302,259,302,259,561
OMEREQUE,consulta externa,nuevas en menores de 5 anos,2006-05-01,143,146,143,146,289
ORURO,consulta externa,nuevas en menores de 5 anos,2006-05-01,6263,5667,6263,5667,11930
PADCAYA,consulta externa,nuevas en menores de 5 anos,2006-05-01,435,458,435,458,893
PADILLA,consulta externa,nuevas en menores de 5 anos,2006-05-01,414,364,414,364,778
PAILON,consulta externa,nuevas en menores de 5 anos,2006-05-01,328,357,328,357,685
PALCA,consulta externa,nuevas en menores de 5 anos,2006-05-01,136,119,136,119,255
PALOS BLANCOS,consulta externa,nuevas en menores de 5 anos,2006-05-01,739,694,739,694,1433
PAMPA AULLAGAS,consulta externa,nuevas en menores de 5 anos,2006-05-01,55,43,55,43,98
PAMPA GRANDE,consulta externa,nuevas en menores de 5 anos,2006-05-01,121,161,121,161,282
PAPEL PAMPA,consulta externa,nuevas en menores de 5 anos,2006-05-01,80,61,80,61,141
PASORAPA,consulta externa,nuevas en menores de 5 anos,2006-05-01,58,52,58,52,110
PATACAMAYA,consulta externa,nuevas en menores de 5 anos,2006-05-01,345,331,345,331,676
PAZÑA,consulta externa,nuevas en menores de 5 anos,2006-05-01,129,131,129,131,260
PELECHUCO,consulta externa,nuevas en menores de 5 anos,2006-05-01,106,95,106,95,201
POCOATA,consulta externa,nuevas en menores de 5 anos,2006-05-01,530,512,530,512,1042
POCONA,consulta externa,nuevas en menores de 5 anos,2006-05-01,246,188,246,188,434
POJO (CBBA),consulta externa,nuevas en menores de 5 anos,2006-05-01,220,232,220,232,452
POOPO,consulta externa,nuevas en menores de 5 anos,2006-05-01,88,60,88,60,148
PORCO,consulta externa,nuevas en menores de 5 anos,2006-05-01,261,288,261,288,549
POROMA,consulta externa,nuevas en menores de 5 anos,2006-05-01,614,580,614,580,1194
PORONGO,consulta externa,nuevas en menores de 5 anos,2006-05-01,231,197,231,197,428
PORTACHUELO,consulta externa,nuevas en menores de 5 anos,2006-05-01,460,393,460,393,853
PORVENIR,consulta externa,nuevas en menores de 5 anos,2006-05-01,149,113,149,113,262
POSTRER VALLE,consulta externa,nuevas en menores de 5 anos,2006-05-01,60,81,60,81,141
POTOSI,consulta externa,nuevas en menores de 5 anos,2006-05-01,5147,4871,5147,4871,10018
PRESTO,consulta externa,nuevas en menores de 5 anos,2006-05-01,416,416,416,416,832
PUCARA,consulta externa,nuevas en menores de 5 anos,2006-05-01,48,37,48,37,85
PUCARANI,consulta externa,nuevas en menores de 5 anos,2006-05-01,335,260,335,260,595
PUERTO ACOSTA,consulta externa,nuevas en menores de 5 anos,2006-05-01,277,261,277,261,538
PUERTO CARABUCO,consulta externa,nuevas en menores de 5 anos,2006-05-01,191,200,191,200,391
PUERTO GONZALO MORENO,consulta externa,nuevas en menores de 5 anos,2006-05-01,124,93,124,93,217
PUERTO PEREZ,consulta externa,nuevas en menores de 5 anos,2006-05-01,67,66,67,66,133
PUERTO QUIJARRO,consulta externa,nuevas en menores de 5 anos,2006-05-01,222,228,222,228,450
PUERTO RICO,consulta externa,nuevas en menores de 5 anos,2006-05-01,184,173,184,173,357
PUERTO SILES,consulta externa,nuevas en menores de 5 anos,2006-05-01,20,27,20,27,47
PUERTO SUAREZ,consulta externa,nuevas en menores de 5 anos,2006-05-01,408,323,408,323,731
PUERTO VILLARROEL,consulta externa,nuevas en menores de 5 anos,2006-05-01,1283,1118,1283,1118,2401
PUNA,consulta externa,nuevas en menores de 5 anos,2006-05-01,741,650,741,650,1391
PUNATA,consulta externa,nuevas en menores de 5 anos,2006-05-01,336,325,336,325,661
QUIABAYA,consulta externa,nuevas en menores de 5 anos,2006-05-01,23,20,23,20,43
QUILLACOLLO,consulta externa,nuevas en menores de 5 anos,2006-05-01,972,1072,972,1072,2044
QUIME,consulta externa,nuevas en menores de 5 anos,2006-05-01,162,145,162,145,307
QUIRUSILLAS,consulta externa,nuevas en menores de 5 anos,2006-05-01,49,35,49,35,84
RAVELO,consulta externa,nuevas en menores de 5 anos,2006-05-01,634,503,634,503,1137
REYES,consulta externa,nuevas en menores de 5 anos,2006-05-01,533,522,533,522,1055
RIBERALTA,consulta externa,nuevas en menores de 5 anos,2006-05-01,1603,1489,1603,1489,3092
ROBORE,consulta externa,nuevas en menores de 5 anos,2006-05-01,237,219,237,219,456
RURRENABAQUE,consulta externa,nuevas en menores de 5 anos,2006-05-01,465,395,465,395,860
SABAYA,consulta externa,nuevas en menores de 5 anos,2006-05-01,77,58,77,58,135
SACABA,consulta externa,nuevas en menores de 5 anos,2006-05-01,1277,1094,1277,1094,2371
SACABAMBA,consulta externa,nuevas en menores de 5 anos,2006-05-01,83,56,83,56,139
SACACA,consulta externa,nuevas en menores de 5 anos,2006-05-01,708,627,708,627,1335
SAIPINA,consulta externa,nuevas en menores de 5 anos,2006-05-01,159,149,159,149,308
SALINAS DE GARCI MENDOZA,consulta externa,nuevas en menores de 5 anos,2006-05-01,310,268,310,268,578
SAMAIPATA,consulta externa,nuevas en menores de 5 anos,2006-05-01,143,102,143,102,245
SAN AGUSTIN,consulta externa,nuevas en menores de 5 anos,2006-05-01,38,33,38,33,71
SAN ANDRES,consulta externa,nuevas en menores de 5 anos,2006-05-01,298,292,298,292,590
SAN ANDRES DE MACHACA,consulta externa,nuevas en menores de 5 anos,2006-05-01,91,77,91,77,168
SAN ANTONIO DE ESMORUCO,consulta externa,nuevas en menores de 5 anos,2006-05-01,64,81,64,81,145
SAN ANTONIO DE LOMERIO,consulta externa,nuevas en menores de 5 anos,2006-05-01,92,83,92,83,175
SAN BENITO,consulta externa,nuevas en menores de 5 anos,2006-05-01,186,183,186,183,369
SAN BORJA,consulta externa,nuevas en menores de 5 anos,2006-05-01,611,502,611,502,1113
SAN BUENA VENTURA,consulta externa,nuevas en menores de 5 anos,2006-05-01,236,218,236,218,454
SAN CARLOS,consulta externa,nuevas en menores de 5 anos,2006-05-01,356,396,356,396,752
SAN IGNACIO,consulta externa,nuevas en menores de 5 anos,2006-05-01,717,662,717,662,1379
SAN IGNACIO DE VELASCO,consulta externa,nuevas en menores de 5 anos,2006-05-01,1126,993,1126,993,2119
SAN JAVIER(BNI),consulta externa,nuevas en menores de 5 anos,2006-05-01,71,52,71,52,123
SAN JAVIER(STC),consulta externa,nuevas en menores de 5 anos,2006-05-01,134,148,134,148,282
SAN JOAQUIN,consulta externa,nuevas en menores de 5 anos,2006-05-01,85,77,85,77,162
SAN JOSE DE CHIQUITOS,consulta externa,nuevas en menores de 5 anos,2006-05-01,377,331,377,331,708
SAN JUAN DE YAPACANI,consulta externa,nuevas en menores de 5 anos,2006-05-01,251,242,251,242,493
SAN JULIAN,consulta externa,nuevas en menores de 5 anos,2006-05-01,1101,1102,1101,1102,2203
SAN LORENZO(PND),consulta externa,nuevas en menores de 5 anos,2006-05-01,229,182,229,182,411
SAN LORENZO(TJA),consulta externa,nuevas en menores de 5 anos,2006-05-01,634,607,634,607,1241
SAN LUCAS,consulta externa,nuevas en menores de 5 anos,2006-05-01,1201,1255,1201,1255,2456
SAN MATIAS,consulta externa,nuevas en menores de 5 anos,2006-05-01,290,283,290,283,573
SAN MIGUEL DE VELASCO,consulta externa,nuevas en menores de 5 anos,2006-05-01,157,121,157,121,278
SAN PABLO DE LIPEZ,consulta externa,nuevas en menores de 5 anos,2006-05-01,104,93,104,93,197
SAN PEDRO,consulta externa,nuevas en menores de 5 anos,2006-05-01,494,464,494,464,958
SAN PEDRO DE BUENA VISTA,consulta externa,nuevas en menores de 5 anos,2006-05-01,782,683,782,683,1465
SAN PEDRO DE CURAHUARA,consulta externa,nuevas en menores de 5 anos,2006-05-01,107,69,107,69,176
SAN PEDRO DE QUEMES,consulta externa,nuevas en menores de 5 anos,2006-05-01,1,8,1,8,9
SAN PEDRO DE TIQUINA,consulta externa,nuevas en menores de 5 anos,2006-05-01,47,50,47,50,97
SAN PEDRO(PND),consulta externa,nuevas en menores de 5 anos,2006-05-01,14,31,14,31,45
SAN RAFAEL,consulta externa,nuevas en menores de 5 anos,2006-05-01,76,54,76,54,130
SAN RAMON,consulta externa,nuevas en menores de 5 anos,2006-05-01,141,115,141,115,256
SAN RAMON,consulta externa,nuevas en menores de 5 anos,2006-05-01,158,145,158,145,303
SANTA ANA,consulta externa,nuevas en menores de 5 anos,2006-05-01,314,316,314,316,630
SANTA CRUZ DE LA SIERRA,consulta externa,nuevas en menores de 5 anos,2006-05-01,21676,19659,21676,19659,41335
SANTA ROSA,consulta externa,nuevas en menores de 5 anos,2006-05-01,327,341,327,341,668
SANTA ROSA DEL SARA,consulta externa,nuevas en menores de 5 anos,2006-05-01,731,662,731,662,1393
SANTIAGO DE CALLAPA,consulta externa,nuevas en menores de 5 anos,2006-05-01,80,114,80,114,194
SANTIAGO DE HUARI,consulta externa,nuevas en menores de 5 anos,2006-05-01,142,126,142,126,268
SANTIAGO DE MACHACA,consulta externa,nuevas en menores de 5 anos,2006-05-01,46,36,46,36,82
SANTIVAÑES,consulta externa,nuevas en menores de 5 anos,2006-05-01,131,126,131,126,257
SANTUARIO DE QUILLACAS,consulta externa,nuevas en menores de 5 anos,2006-05-01,78,87,78,87,165
SAPAHAQUI,consulta externa,nuevas en menores de 5 anos,2006-05-01,148,132,148,132,280
SENA,consulta externa,nuevas en menores de 5 anos,2006-05-01,179,171,179,171,350
SICA SICA (VILLA AROMA),consulta externa,nuevas en menores de 5 anos,2006-05-01,205,170,205,170,375
SICAYA,consulta externa,nuevas en menores de 5 anos,2006-05-01,71,34,71,34,105
SIPE SIPE,consulta externa,nuevas en menores de 5 anos,2006-05-01,618,624,618,624,1242
SOPACHUY,consulta externa,nuevas en menores de 5 anos,2006-05-01,293,304,293,304,597
SORACACHI,consulta externa,nuevas en menores de 5 anos,2006-05-01,163,129,163,129,292
SORATA,consulta externa,nuevas en menores de 5 anos,2006-05-01,213,216,213,216,429
SUCRE,consulta externa,nuevas en menores de 5 anos,2006-05-01,8744,6800,8744,6800,15544
TACACHI,consulta externa,nuevas en menores de 5 anos,2006-05-01,14,12,14,12,26
TACACOMA,consulta externa,nuevas en menores de 5 anos,2006-05-01,115,96,115,96,211
TACOBAMBA,consulta externa,nuevas en menores de 5 anos,2006-05-01,199,158,199,158,357
TACOPAYA,consulta externa,nuevas en menores de 5 anos,2006-05-01,183,165,183,165,348
TAHUA,consulta externa,nuevas en menores de 5 anos,2006-05-01,23,16,23,16,39
TAPACARI,consulta externa,nuevas en menores de 5 anos,2006-05-01,596,535,596,535,1131
TARABUCO,consulta externa,nuevas en menores de 5 anos,2006-05-01,734,717,734,717,1451
TARACO,consulta externa,nuevas en menores de 5 anos,2006-05-01,25,29,25,29,54
TARATA,consulta externa,nuevas en menores de 5 anos,2006-05-01,110,97,110,97,207
TARIJA,consulta externa,nuevas en menores de 5 anos,2006-05-01,5224,4718,5224,4718,9942
TARVITA,consulta externa,nuevas en menores de 5 anos,2006-05-01,794,762,794,762,1556
TEOPONTE,consulta externa,nuevas en menores de 5 anos,2006-05-01,192,199,192,199,391
TIAWANACU,consulta externa,nuevas en menores de 5 anos,2006-05-01,207,144,207,144,351
TINGUIPAYA,consulta externa,nuevas en menores de 5 anos,2006-05-01,518,440,518,440,958
TIPUANI,consulta externa,nuevas en menores de 5 anos,2006-05-01,127,132,127,132,259
TIQUIPAYA,consulta externa,nuevas en menores de 5 anos,2006-05-01,994,807,994,807,1801
TIRAQUE (CBBA),consulta externa,nuevas en menores de 5 anos,2006-05-01,769,708,769,708,1477
TITO YUPANQUI (PARQUIPUJIO),consulta externa,nuevas en menores de 5 anos,2006-05-01,22,31,22,31,53
TOCO,consulta externa,nuevas en menores de 5 anos,2006-05-01,76,66,76,66,142
TODOS SANTOS,consulta externa,nuevas en menores de 5 anos,2006-05-01,7,7,7,7,14
TOLATA,consulta externa,nuevas en menores de 5 anos,2006-05-01,115,107,115,107,222
TOLEDO,consulta externa,nuevas en menores de 5 anos,2006-05-01,132,131,132,131,263
TOMAVE,consulta externa,nuevas en menores de 5 anos,2006-05-01,314,219,314,219,533
TOMINA,consulta externa,nuevas en menores de 5 anos,2006-05-01,323,300,323,300,623
TORO TORO,consulta externa,nuevas en menores de 5 anos,2006-05-01,302,302,302,302,604
TOTORA(CBBA),consulta externa,nuevas en menores de 5 anos,2006-05-01,287,260,287,260,547
TOTORA(ORR),consulta externa,nuevas en menores de 5 anos,2006-05-01,43,62,43,62,105
TRIGAL,consulta externa,nuevas en menores de 5 anos,2006-05-01,46,33,46,33,79
TRINIDAD,consulta externa,nuevas en menores de 5 anos,2006-05-01,2325,2145,2325,2145,4470
TUPIZA,consulta externa,nuevas en menores de 5 anos,2006-05-01,1238,1235,1238,1235,2473
TURCO,consulta externa,nuevas en menores de 5 anos,2006-05-01,99,101,99,101,200
UMALA,consulta externa,nuevas en menores de 5 anos,2006-05-01,91,83,91,83,174
UNCIA,consulta externa,nuevas en menores de 5 anos,2006-05-01,931,814,931,814,1745
URIONDO (A. CONCEPCION),consulta externa,nuevas en menores de 5 anos,2006-05-01,422,376,422,376,798
URUBICHA,consulta externa,nuevas en menores de 5 anos,2006-05-01,129,155,129,155,284
UYUNI,consulta externa,nuevas en menores de 5 anos,2006-05-01,382,327,382,327,709
VACAS,consulta externa,nuevas en menores de 5 anos,2006-05-01,200,170,200,170,370
VALLEGRANDE,consulta externa,nuevas en menores de 5 anos,2006-05-01,287,271,287,271,558
VIACHA,consulta externa,nuevas en menores de 5 anos,2006-05-01,758,892,758,892,1650
VILA VILA,consulta externa,nuevas en menores de 5 anos,2006-05-01,74,79,74,79,153
VILLA MONTES,consulta externa,nuevas en menores de 5 anos,2006-05-01,713,661,713,661,1374
VILLA NUEVA (LOMA ALTA),consulta externa,nuevas en menores de 5 anos,2006-05-01,78,90,78,90,168
VILLA RIVERO,consulta externa,nuevas en menores de 5 anos,2006-05-01,74,64,74,64,138
VILLA SERRANO,consulta externa,nuevas en menores de 5 anos,2006-05-01,498,476,498,476,974
VILLA TUNARI,consulta externa,nuevas en menores de 5 anos,2006-05-01,1557,1369,1557,1369,2926
VILLA VACA GUZMAN (MUYUPAMPA),consulta externa,nuevas en menores de 5 anos,2006-05-01,364,391,364,391,755
VILLAZON,consulta externa,nuevas en menores de 5 anos,2006-05-01,1087,1034,1087,1034,2121
VINTO,consulta externa,nuevas en menores de 5 anos,2006-05-01,492,430,492,430,922
VITICHI,consulta externa,nuevas en menores de 5 anos,2006-05-01,265,296,265,296,561
WALDO BALLIVIAN,consulta externa,nuevas en menores de 5 anos,2006-05-01,50,49,50,49,99
WARNES,consulta externa,nuevas en menores de 5 anos,2006-05-01,880,865,880,865,1745
YACO,consulta externa,nuevas en menores de 5 anos,2006-05-01,139,139,139,139,278
YACUIBA,consulta externa,nuevas en menores de 5 anos,2006-05-01,2065,1920,2065,1920,3985
YAMPARAEZ,consulta externa,nuevas en menores de 5 anos,2006-05-01,187,195,187,195,382
YANACACHI,consulta externa,nuevas en menores de 5 anos,2006-05-01,74,51,74,51,125
YAPACANI,consulta externa,nuevas en menores de 5 anos,2006-05-01,671,632,671,632,1303
YOCALLA,consulta externa,nuevas en menores de 5 anos,2006-05-01,91,84,91,84,175
YOTALA,consulta externa,nuevas en menores de 5 anos,2006-05-01,231,222,231,222,453
YUNCHARA,consulta externa,nuevas en menores de 5 anos,2006-05-01,100,110,100,110,210
ZUDAÑEZ,consulta externa,nuevas en menores de 5 anos,2006-05-01,341,268,341,268,609
ACACIO,consulta externa,nuevas en menores de 5 anos,2006-06-01,187,190,187,190,377
ACHACACHI,consulta externa,nuevas en menores de 5 anos,2006-06-01,456,425,456,425,881
ACHOCALLA,consulta externa,nuevas en menores de 5 anos,2006-06-01,83,72,83,72,155
AIQUILE,consulta externa,nuevas en menores de 5 anos,2006-06-01,311,253,311,253,564
ALALAY,consulta externa,nuevas en menores de 5 anos,2006-06-01,27,24,27,24,51
ALCALA,consulta externa,nuevas en menores de 5 anos,2006-06-01,177,159,177,159,336
ANCORAIMES,consulta externa,nuevas en menores de 5 anos,2006-06-01,215,180,215,180,395
ANDAMARCA,consulta externa,nuevas en menores de 5 anos,2006-06-01,74,78,74,78,152
ANTEQUERA,consulta externa,nuevas en menores de 5 anos,2006-06-01,44,44,44,44,88
ANZALDO,consulta externa,nuevas en menores de 5 anos,2006-06-01,105,81,105,81,186
APOLO,consulta externa,nuevas en menores de 5 anos,2006-06-01,304,295,304,295,599
ARAMPAMPA,consulta externa,nuevas en menores de 5 anos,2006-06-01,176,135,176,135,311
ARANI,consulta externa,nuevas en menores de 5 anos,2006-06-01,58,37,58,37,95
ARBIETO,consulta externa,nuevas en menores de 5 anos,2006-06-01,86,72,86,72,158
ARQUE,consulta externa,nuevas en menores de 5 anos,2006-06-01,155,135,155,135,290
ASCENCION DE GUARAYOS,consulta externa,nuevas en menores de 5 anos,2006-06-01,436,542,436,542,978
ATOCHA,consulta externa,nuevas en menores de 5 anos,2006-06-01,360,321,360,321,681
AUCAPATA,consulta externa,nuevas en menores de 5 anos,2006-06-01,76,74,76,74,150
AYATA,consulta externa,nuevas en menores de 5 anos,2006-06-01,155,118,155,118,273
AYO AYO,consulta externa,nuevas en menores de 5 anos,2006-06-01,79,65,79,65,144
AYOPAYA (V. DE INDEPENDENCIA),consulta externa,nuevas en menores de 5 anos,2006-06-01,576,608,576,608,1184
AZURDUY,consulta externa,nuevas en menores de 5 anos,2006-06-01,529,596,529,596,1125
BATALLAS,consulta externa,nuevas en menores de 5 anos,2006-06-01,124,88,124,88,212
BAURES,consulta externa,nuevas en menores de 5 anos,2006-06-01,115,96,115,96,211
BELEN DE ANDAMARCA,consulta externa,nuevas en menores de 5 anos,2006-06-01,18,23,18,23,41
BELEN DE URMIRI,consulta externa,nuevas en menores de 5 anos,2006-06-01,46,270,46,270,316
BELLA FLOR,consulta externa,nuevas en menores de 5 anos,2006-06-01,45,63,45,63,108
BERMEJO,consulta externa,nuevas en menores de 5 anos,2006-06-01,946,883,946,883,1829
BETANZOS,consulta externa,nuevas en menores de 5 anos,2006-06-01,895,851,895,851,1746
BOLIVAR,consulta externa,nuevas en menores de 5 anos,2006-06-01,119,126,119,126,245
BOLPEBRA,consulta externa,nuevas en menores de 5 anos,2006-06-01,49,51,49,51,100
BOYUIBE,consulta externa,nuevas en menores de 5 anos,2006-06-01,123,145,123,145,268
BUENA VISTA,consulta externa,nuevas en menores de 5 anos,2006-06-01,298,242,298,242,540
CABEZAS,consulta externa,nuevas en menores de 5 anos,2006-06-01,443,379,443,379,822
CAIROMA,consulta externa,nuevas en menores de 5 anos,2006-06-01,283,266,283,266,549
"CAIZA ""D""",consulta externa,nuevas en menores de 5 anos,2006-06-01,162,152,162,152,314
CAJUATA,consulta externa,nuevas en menores de 5 anos,2006-06-01,134,124,134,124,258
CALACOTO,consulta externa,nuevas en menores de 5 anos,2006-06-01,94,70,94,70,164
CALAMARCA,consulta externa,nuevas en menores de 5 anos,2006-06-01,228,210,228,210,438
CAMARGO,consulta externa,nuevas en menores de 5 anos,2006-06-01,547,458,547,458,1005
CAMATAQUI (C. VILLA ABECIA),consulta externa,nuevas en menores de 5 anos,2006-06-01,75,65,75,65,140
CAMIRI,consulta externa,nuevas en menores de 5 anos,2006-06-01,891,839,891,839,1730
CAPINOTA,consulta externa,nuevas en menores de 5 anos,2006-06-01,353,346,353,346,699
CAQUIAVIRI,consulta externa,nuevas en menores de 5 anos,2006-06-01,77,78,77,78,155
CARACOLLO,consulta externa,nuevas en menores de 5 anos,2006-06-01,247,201,247,201,448
CARANAVI,consulta externa,nuevas en menores de 5 anos,2006-06-01,1104,1036,1104,1036,2140
CARANGAS,consulta externa,nuevas en menores de 5 anos,2006-06-01,0,5,0,5,5
CARAPARI,consulta externa,nuevas en menores de 5 anos,2006-06-01,264,226,264,226,490
CARIPUYO,consulta externa,nuevas en menores de 5 anos,2006-06-01,193,156,193,156,349
CARMEN RIVERO TORREZ,consulta externa,nuevas en menores de 5 anos,2006-06-01,70,69,70,69,139
CATACORA,consulta externa,nuevas en menores de 5 anos,2006-06-01,12,5,12,5,17
CHACARILLA,consulta externa,nuevas en menores de 5 anos,2006-06-01,35,43,35,43,78
CHALLAPATA,consulta externa,nuevas en menores de 5 anos,2006-06-01,395,343,395,343,738
CHAQUI,consulta externa,nuevas en menores de 5 anos,2006-06-01,158,128,158,128,286
CHARAGUA,consulta externa,nuevas en menores de 5 anos,2006-06-01,654,593,654,593,1247
CHARAÑA,consulta externa,nuevas en menores de 5 anos,2006-06-01,40,59,40,59,99
CHAYANTA,consulta externa,nuevas en menores de 5 anos,2006-06-01,440,424,440,424,864
CHIMORE,consulta externa,nuevas en menores de 5 anos,2006-06-01,497,448,497,448,945
CHIPAYA,consulta externa,nuevas en menores de 5 anos,2006-06-01,30,38,30,38,68
CHOQUE COTA,consulta externa,nuevas en menores de 5 anos,2006-06-01,12,18,12,18,30
CHULUMANI (V. DE LA LIBERTAD),consulta externa,nuevas en menores de 5 anos,2006-06-01,235,215,235,215,450
CHUMA,consulta externa,nuevas en menores de 5 anos,2006-06-01,145,121,145,121,266
CLIZA,consulta externa,nuevas en menores de 5 anos,2006-06-01,249,191,249,191,440
COBIJA,consulta externa,nuevas en menores de 5 anos,2006-06-01,602,960,602,960,1562
COCHABAMBA,consulta externa,nuevas en menores de 5 anos,2006-06-01,9434,8488,9434,8488,17922
COIPASA,consulta externa,nuevas en menores de 5 anos,2006-06-01,4,2,4,2,6
COLCAPIRHUA,consulta externa,nuevas en menores de 5 anos,2006-06-01,513,430,513,430,943
"COLCHA ""K""",consulta externa,nuevas en menores de 5 anos,2006-06-01,160,143,160,143,303
COLLANA,consulta externa,nuevas en menores de 5 anos,2006-06-01,49,26,49,26,75
COLOMI,consulta externa,nuevas en menores de 5 anos,2006-06-01,246,255,246,255,501
COLPA BELGICA,consulta externa,nuevas en menores de 5 anos,2006-06-01,143,126,143,126,269
COLQUECHACA,consulta externa,nuevas en menores de 5 anos,2006-06-01,1084,992,1084,992,2076
COLQUENCHA,consulta externa,nuevas en menores de 5 anos,2006-06-01,81,84,81,84,165
COLQUIRI,consulta externa,nuevas en menores de 5 anos,2006-06-01,355,302,355,302,657
COMANCHE,consulta externa,nuevas en menores de 5 anos,2006-06-01,28,33,28,33,61
COMARAPA,consulta externa,nuevas en menores de 5 anos,2006-06-01,281,311,281,311,592
COMBAYA,consulta externa,nuevas en menores de 5 anos,2006-06-01,17,15,17,15,32
CONCEPCION,consulta externa,nuevas en menores de 5 anos,2006-06-01,316,269,316,269,585
COPACABANA,consulta externa,nuevas en menores de 5 anos,2006-06-01,120,111,120,111,231
CORIPATA,consulta externa,nuevas en menores de 5 anos,2006-06-01,267,230,267,230,497
CORO CORO,consulta externa,nuevas en menores de 5 anos,2006-06-01,95,91,95,91,186
COROICO,consulta externa,nuevas en menores de 5 anos,2006-06-01,258,227,258,227,485
CORQUE,consulta externa,nuevas en menores de 5 anos,2006-06-01,87,145,87,145,232
COTAGAITA,consulta externa,nuevas en menores de 5 anos,2006-06-01,806,804,806,804,1610
COTOCA,consulta externa,nuevas en menores de 5 anos,2006-06-01,636,637,636,637,1273
CUATRO CAÑADAS,consulta externa,nuevas en menores de 5 anos,2006-06-01,452,421,452,421,873
CUCHUMUELA (V. G. VILLARROEL),consulta externa,nuevas en menores de 5 anos,2006-06-01,12,5,12,5,17
CUEVO,consulta externa,nuevas en menores de 5 anos,2006-06-01,100,160,100,160,260
CULPINA,consulta externa,nuevas en menores de 5 anos,2006-06-01,476,405,476,405,881
CURAHUARA DE CARANGAS,consulta externa,nuevas en menores de 5 anos,2006-06-01,106,77,106,77,183
CURVA,consulta externa,nuevas en menores de 5 anos,2006-06-01,39,26,39,26,65
DESAGUADERO,consulta externa,nuevas en menores de 5 anos,2006-06-01,76,32,76,32,108
EL ALTO,consulta externa,nuevas en menores de 5 anos,2006-06-01,9940,8285,9940,8285,18225
EL CHORO,consulta externa,nuevas en menores de 5 anos,2006-06-01,47,40,47,40,87
EL PUENTE(STC),consulta externa,nuevas en menores de 5 anos,2006-06-01,335,300,335,300,635
EL PUENTE(TJA),consulta externa,nuevas en menores de 5 anos,2006-06-01,292,279,292,279,571
EL TORNO,consulta externa,nuevas en menores de 5 anos,2006-06-01,816,738,816,738,1554
EL VILLAR,consulta externa,nuevas en menores de 5 anos,2006-06-01,236,200,236,200,436
ENTRE RIOS,consulta externa,nuevas en menores de 5 anos,2006-06-01,532,491,532,491,1023
ENTRE RIOS,consulta externa,nuevas en menores de 5 anos,2006-06-01,421,392,421,392,813
ESCARA,consulta externa,nuevas en menores de 5 anos,2006-06-01,1,3,1,3,4
EUCALIPTUS,consulta externa,nuevas en menores de 5 anos,2006-06-01,201,169,201,169,370
EUREKA (SANTOS MERCADO),consulta externa,nuevas en menores de 5 anos,2006-06-01,17,15,17,15,32
EXALTACION,consulta externa,nuevas en menores de 5 anos,2006-06-01,44,61,44,61,105
FERNANDEZ ALONSO,consulta externa,nuevas en menores de 5 anos,2006-06-01,443,438,443,438,881
FILADELFIA,consulta externa,nuevas en menores de 5 anos,2006-06-01,101,117,101,117,218
GENERAL SAAVEDRA,consulta externa,nuevas en menores de 5 anos,2006-06-01,558,486,558,486,1044
GRAL. J.J. PEREZ (CHARAZANI),consulta externa,nuevas en menores de 5 anos,2006-06-01,105,94,105,94,199
GUANAY,consulta externa,nuevas en menores de 5 anos,2006-06-01,300,296,300,296,596
GUAQUI,consulta externa,nuevas en menores de 5 anos,2006-06-01,48,37,48,37,85
GUAYARAMERIN,consulta externa,nuevas en menores de 5 anos,2006-06-01,1188,1070,1188,1070,2258
GUTIERREZ,consulta externa,nuevas en menores de 5 anos,2006-06-01,501,496,501,496,997
HUACARETA,consulta externa,nuevas en menores de 5 anos,2006-06-01,219,209,219,209,428
HUACAYA (VILLA DE HUACAYA),consulta externa,nuevas en menores de 5 anos,2006-06-01,78,89,78,89,167
HUACHACALLA,consulta externa,nuevas en menores de 5 anos,2006-06-01,26,23,26,23,49
HUANUNI,consulta externa,nuevas en menores de 5 anos,2006-06-01,469,472,469,472,941
HUARACAJE,consulta externa,nuevas en menores de 5 anos,2006-06-01,98,82,98,82,180
HUAYLLAMARCA,consulta externa,nuevas en menores de 5 anos,2006-06-01,31,49,31,49,80
ICHOCA,consulta externa,nuevas en menores de 5 anos,2006-06-01,76,75,76,75,151
ICLA,consulta externa,nuevas en menores de 5 anos,2006-06-01,602,590,602,590,1192
INCAHUASI,consulta externa,nuevas en menores de 5 anos,2006-06-01,760,756,760,756,1516
INGAVI (HUMAITA),consulta externa,nuevas en menores de 5 anos,2006-06-01,59,35,59,35,94
INQUISIVI,consulta externa,nuevas en menores de 5 anos,2006-06-01,212,208,212,208,420
IRUPANA (VILLA DE LANZA),consulta externa,nuevas en menores de 5 anos,2006-06-01,435,321,435,321,756
IXIAMAS,consulta externa,nuevas en menores de 5 anos,2006-06-01,404,285,404,285,689
JESUS DE MACHACA,consulta externa,nuevas en menores de 5 anos,2006-06-01,175,170,175,170,345
LA ASUNTA,consulta externa,nuevas en menores de 5 anos,2006-06-01,538,464,538,464,1002
LA GUARDIA,consulta externa,nuevas en menores de 5 anos,2006-06-01,1057,985,1057,985,2042
LA PAZ,consulta externa,nuevas en menores de 5 anos,2006-06-01,12997,11945,12997,11945,24942
LA RIVERA,consulta externa,nuevas en menores de 5 anos,2006-06-01,3,8,3,8,11
LAGUNILLAS,consulta externa,nuevas en menores de 5 anos,2006-06-01,211,243,211,243,454
LAJA,consulta externa,nuevas en menores de 5 anos,2006-06-01,120,107,120,107,227
LAS CARRERAS,consulta externa,nuevas en menores de 5 anos,2006-06-01,153,107,153,107,260
LICOMA PAMPA,consulta externa,nuevas en menores de 5 anos,2006-06-01,35,29,35,29,64
LLALLAGUA,consulta externa,nuevas en menores de 5 anos,2006-06-01,814,689,814,689,1503
LLICA,consulta externa,nuevas en menores de 5 anos,2006-06-01,64,68,64,68,132
LORETO,consulta externa,nuevas en menores de 5 anos,2006-06-01,161,301,161,301,462
LURIBAY,consulta externa,nuevas en menores de 5 anos,2006-06-01,145,112,145,112,257
MACHACAMARCA,consulta externa,nuevas en menores de 5 anos,2006-06-01,60,37,60,37,97
MACHARETI,consulta externa,nuevas en menores de 5 anos,2006-06-01,278,342,278,342,620
MAGDALENA,consulta externa,nuevas en menores de 5 anos,2006-06-01,207,196,207,196,403
MAIRANA,consulta externa,nuevas en menores de 5 anos,2006-06-01,146,99,146,99,245
MALLA,consulta externa,nuevas en menores de 5 anos,2006-06-01,92,74,92,74,166
MAPIRI,consulta externa,nuevas en menores de 5 anos,2006-06-01,310,315,310,315,625
MECAPACA,consulta externa,nuevas en menores de 5 anos,2006-06-01,180,168,180,168,348
MINEROS,consulta externa,nuevas en menores de 5 anos,2006-06-01,434,355,434,355,789
MIZQUE,consulta externa,nuevas en menores de 5 anos,2006-06-01,358,313,358,313,671
MOCOMOCO,consulta externa,nuevas en menores de 5 anos,2006-06-01,170,162,170,162,332
MOJINETE,consulta externa,nuevas en menores de 5 anos,2006-06-01,27,17,27,17,44
MOJOCOYA,consulta externa,nuevas en menores de 5 anos,2006-06-01,255,202,255,202,457
MONTEAGUDO,consulta externa,nuevas en menores de 5 anos,2006-06-01,726,672,726,672,1398
MONTERO,consulta externa,nuevas en menores de 5 anos,2006-06-01,2135,1812,2135,1812,3947
MORO MORO,consulta externa,nuevas en menores de 5 anos,2006-06-01,30,29,30,29,59
MOROCHATA,consulta externa,nuevas en menores de 5 anos,2006-06-01,176,189,176,189,365
NACEBE (SANTA ROSA DEL ABUNA),consulta externa,nuevas en menores de 5 anos,2006-06-01,72,65,72,65,137
NAZACARA DE PACAJES,consulta externa,nuevas en menores de 5 anos,2006-06-01,7,4,7,4,11
NUEVO MANOA (NUEVA ESPERANZA),consulta externa,nuevas en menores de 5 anos,2006-06-01,5,1,5,1,6
OCURI,consulta externa,nuevas en menores de 5 anos,2006-06-01,503,430,503,430,933
OKINAWA,consulta externa,nuevas en menores de 5 anos,2006-06-01,285,284,285,284,569
OMEREQUE,consulta externa,nuevas en menores de 5 anos,2006-06-01,100,116,100,116,216
ORURO,consulta externa,nuevas en menores de 5 anos,2006-06-01,4810,4016,4810,4016,8826
PADCAYA,consulta externa,nuevas en menores de 5 anos,2006-06-01,431,447,431,447,878
PADILLA,consulta externa,nuevas en menores de 5 anos,2006-06-01,513,480,513,480,993
PAILON,consulta externa,nuevas en menores de 5 anos,2006-06-01,313,306,313,306,619
PALCA,consulta externa,nuevas en menores de 5 anos,2006-06-01,101,84,101,84,185
PALOS BLANCOS,consulta externa,nuevas en menores de 5 anos,2006-06-01,637,553,637,553,1190
PAMPA AULLAGAS,consulta externa,nuevas en menores de 5 anos,2006-06-01,51,45,51,45,96
PAMPA GRANDE,consulta externa,nuevas en menores de 5 anos,2006-06-01,134,106,134,106,240
PAPEL PAMPA,consulta externa,nuevas en menores de 5 anos,2006-06-01,50,54,50,54,104
PASORAPA,consulta externa,nuevas en menores de 5 anos,2006-06-01,56,52,56,52,108
PATACAMAYA,consulta externa,nuevas en menores de 5 anos,2006-06-01,256,237,256,237,493
PAZÑA,consulta externa,nuevas en menores de 5 anos,2006-06-01,119,86,119,86,205
PELECHUCO,consulta externa,nuevas en menores de 5 anos,2006-06-01,99,72,99,72,171
POCOATA,consulta externa,nuevas en menores de 5 anos,2006-06-01,509,470,509,470,979
POCONA,consulta externa,nuevas en menores de 5 anos,2006-06-01,179,166,179,166,345
POJO (CBBA),consulta externa,nuevas en menores de 5 anos,2006-06-01,108,110,108,110,218
POOPO,consulta externa,nuevas en menores de 5 anos,2006-06-01,69,54,69,54,123
PORCO,consulta externa,nuevas en menores de 5 anos,2006-06-01,137,137,137,137,274
POROMA,consulta externa,nuevas en menores de 5 anos,2006-06-01,374,373,374,373,747
PORONGO,consulta externa,nuevas en menores de 5 anos,2006-06-01,190,188,190,188,378
PORTACHUELO,consulta externa,nuevas en menores de 5 anos,2006-06-01,473,436,473,436,909
PORVENIR,consulta externa,nuevas en menores de 5 anos,2006-06-01,214,221,214,221,435
POSTRER VALLE,consulta externa,nuevas en menores de 5 anos,2006-06-01,55,57,55,57,112
POTOSI,consulta externa,nuevas en menores de 5 anos,2006-06-01,3958,3372,3958,3372,7330
PRESTO,consulta externa,nuevas en menores de 5 anos,2006-06-01,315,294,315,294,609
PUCARA,consulta externa,nuevas en menores de 5 anos,2006-06-01,61,50,61,50,111
PUCARANI,consulta externa,nuevas en menores de 5 anos,2006-06-01,260,202,260,202,462
PUERTO ACOSTA,consulta externa,nuevas en menores de 5 anos,2006-06-01,213,190,213,190,403
PUERTO CARABUCO,consulta externa,nuevas en menores de 5 anos,2006-06-01,116,112,116,112,228
PUERTO GONZALO MORENO,consulta externa,nuevas en menores de 5 anos,2006-06-01,161,115,161,115,276
PUERTO PEREZ,consulta externa,nuevas en menores de 5 anos,2006-06-01,59,39,59,39,98
PUERTO QUIJARRO,consulta externa,nuevas en menores de 5 anos,2006-06-01,248,275,248,275,523
PUERTO RICO,consulta externa,nuevas en menores de 5 anos,2006-06-01,203,208,203,208,411
PUERTO SILES,consulta externa,nuevas en menores de 5 anos,2006-06-01,13,27,13,27,40
PUERTO SUAREZ,consulta externa,nuevas en menores de 5 anos,2006-06-01,283,260,283,260,543
PUERTO VILLARROEL,consulta externa,nuevas en menores de 5 anos,2006-06-01,1293,1183,1293,1183,2476
PUNA,consulta externa,nuevas en menores de 5 anos,2006-06-01,801,715,801,715,1516
PUNATA,consulta externa,nuevas en menores de 5 anos,2006-06-01,323,320,323,320,643
QUIABAYA,consulta externa,nuevas en menores de 5 anos,2006-06-01,33,31,33,31,64
QUILLACOLLO,consulta externa,nuevas en menores de 5 anos,2006-06-01,750,696,750,696,1446
QUIME,consulta externa,nuevas en menores de 5 anos,2006-06-01,130,119,130,119,249
QUIRUSILLAS,consulta externa,nuevas en menores de 5 anos,2006-06-01,58,66,58,66,124
RAVELO,consulta externa,nuevas en menores de 5 anos,2006-06-01,477,426,477,426,903
REYES,consulta externa,nuevas en menores de 5 anos,2006-06-01,367,367,367,367,734
RIBERALTA,consulta externa,nuevas en menores de 5 anos,2006-06-01,2099,1871,2099,1871,3970
ROBORE,consulta externa,nuevas en menores de 5 anos,2006-06-01,361,339,361,339,700
RURRENABAQUE,consulta externa,nuevas en menores de 5 anos,2006-06-01,393,353,393,353,746
SABAYA,consulta externa,nuevas en menores de 5 anos,2006-06-01,36,51,36,51,87
SACABA,consulta externa,nuevas en menores de 5 anos,2006-06-01,1111,922,1111,922,2033
SACABAMBA,consulta externa,nuevas en menores de 5 anos,2006-06-01,57,48,57,48,105
SACACA,consulta externa,nuevas en menores de 5 anos,2006-06-01,724,640,724,640,1364
SAIPINA,consulta externa,nuevas en menores de 5 anos,2006-06-01,137,134,137,134,271
SALINAS DE GARCI MENDOZA,consulta externa,nuevas en menores de 5 anos,2006-06-01,178,160,178,160,338
SAMAIPATA,consulta externa,nuevas en menores de 5 anos,2006-06-01,153,111,153,111,264
SAN AGUSTIN,consulta externa,nuevas en menores de 5 anos,2006-06-01,40,42,40,42,82
SAN ANDRES,consulta externa,nuevas en menores de 5 anos,2006-06-01,228,230,228,230,458
SAN ANDRES DE MACHACA,consulta externa,nuevas en menores de 5 anos,2006-06-01,54,55,54,55,109
SAN ANTONIO DE ESMORUCO,consulta externa,nuevas en menores de 5 anos,2006-06-01,27,27,27,27,54
SAN ANTONIO DE LOMERIO,consulta externa,nuevas en menores de 5 anos,2006-06-01,106,82,106,82,188
SAN BENITO,consulta externa,nuevas en menores de 5 anos,2006-06-01,120,129,120,129,249
SAN BORJA,consulta externa,nuevas en menores de 5 anos,2006-06-01,599,544,599,544,1143
SAN BUENA VENTURA,consulta externa,nuevas en menores de 5 anos,2006-06-01,159,149,159,149,308
SAN CARLOS,consulta externa,nuevas en menores de 5 anos,2006-06-01,430,462,430,462,892
SAN IGNACIO,consulta externa,nuevas en menores de 5 anos,2006-06-01,624,523,624,523,1147
SAN IGNACIO DE VELASCO,consulta externa,nuevas en menores de 5 anos,2006-06-01,1081,1059,1081,1059,2140
SAN JAVIER(BNI),consulta externa,nuevas en menores de 5 anos,2006-06-01,84,64,84,64,148
SAN JAVIER(STC),consulta externa,nuevas en menores de 5 anos,2006-06-01,166,152,166,152,318
SAN JOAQUIN,consulta externa,nuevas en menores de 5 anos,2006-06-01,90,97,90,97,187
SAN JOSE DE CHIQUITOS,consulta externa,nuevas en menores de 5 anos,2006-06-01,339,318,339,318,657
SAN JUAN DE YAPACANI,consulta externa,nuevas en menores de 5 anos,2006-06-01,282,286,282,286,568
SAN JULIAN,consulta externa,nuevas en menores de 5 anos,2006-06-01,844,1078,844,1078,1922
SAN LORENZO(PND),consulta externa,nuevas en menores de 5 anos,2006-06-01,213,255,213,255,468
SAN LORENZO(TJA),consulta externa,nuevas en menores de 5 anos,2006-06-01,671,618,671,618,1289
SAN LUCAS,consulta externa,nuevas en menores de 5 anos,2006-06-01,1267,1218,1267,1218,2485
SAN MATIAS,consulta externa,nuevas en menores de 5 anos,2006-06-01,290,272,290,272,562
SAN MIGUEL DE VELASCO,consulta externa,nuevas en menores de 5 anos,2006-06-01,189,165,189,165,354
SAN PABLO DE LIPEZ,consulta externa,nuevas en menores de 5 anos,2006-06-01,96,84,96,84,180
SAN PEDRO,consulta externa,nuevas en menores de 5 anos,2006-06-01,473,478,473,478,951
SAN PEDRO DE BUENA VISTA,consulta externa,nuevas en menores de 5 anos,2006-06-01,706,587,706,587,1293
SAN PEDRO DE CURAHUARA,consulta externa,nuevas en menores de 5 anos,2006-06-01,101,79,101,79,180
SAN PEDRO DE QUEMES,consulta externa,nuevas en menores de 5 anos,2006-06-01,8,9,8,9,17
SAN PEDRO DE TIQUINA,consulta externa,nuevas en menores de 5 anos,2006-06-01,36,31,36,31,67
SAN PEDRO(PND),consulta externa,nuevas en menores de 5 anos,2006-06-01,56,90,56,90,146
SAN RAFAEL,consulta externa,nuevas en menores de 5 anos,2006-06-01,95,85,95,85,180
SAN RAMON,consulta externa,nuevas en menores de 5 anos,2006-06-01,135,95,135,95,230
SAN RAMON,consulta externa,nuevas en menores de 5 anos,2006-06-01,167,140,167,140,307
SANTA ANA,consulta externa,nuevas en menores de 5 anos,2006-06-01,473,276,473,276,749
SANTA CRUZ DE LA SIERRA,consulta externa,nuevas en menores de 5 anos,2006-06-01,18425,17523,18425,17523,35948
SANTA ROSA,consulta externa,nuevas en menores de 5 anos,2006-06-01,132,200,132,200,332
SANTA ROSA DEL SARA,consulta externa,nuevas en menores de 5 anos,2006-06-01,535,536,535,536,1071
SANTIAGO DE CALLAPA,consulta externa,nuevas en menores de 5 anos,2006-06-01,61,55,61,55,116
SANTIAGO DE HUARI,consulta externa,nuevas en menores de 5 anos,2006-06-01,130,114,130,114,244
SANTIAGO DE MACHACA,consulta externa,nuevas en menores de 5 anos,2006-06-01,31,23,31,23,54
SANTIVAÑES,consulta externa,nuevas en menores de 5 anos,2006-06-01,111,111,111,111,222
SANTUARIO DE QUILLACAS,consulta externa,nuevas en menores de 5 anos,2006-06-01,43,62,43,62,105
SAPAHAQUI,consulta externa,nuevas en menores de 5 anos,2006-06-01,110,116,110,116,226
SENA,consulta externa,nuevas en menores de 5 anos,2006-06-01,105,116,105,116,221
SICA SICA (VILLA AROMA),consulta externa,nuevas en menores de 5 anos,2006-06-01,175,146,175,146,321
SICAYA,consulta externa,nuevas en menores de 5 anos,2006-06-01,38,39,38,39,77
SIPE SIPE,consulta externa,nuevas en menores de 5 anos,2006-06-01,409,372,409,372,781
SOPACHUY,consulta externa,nuevas en menores de 5 anos,2006-06-01,344,348,344,348,692
SORACACHI,consulta externa,nuevas en menores de 5 anos,2006-06-01,98,89,98,89,187
SORATA,consulta externa,nuevas en menores de 5 anos,2006-06-01,212,225,212,225,437
SUCRE,consulta externa,nuevas en menores de 5 anos,2006-06-01,6399,5621,6399,5621,12020
TACACHI,consulta externa,nuevas en menores de 5 anos,2006-06-01,8,11,8,11,19
TACACOMA,consulta externa,nuevas en menores de 5 anos,2006-06-01,77,71,77,71,148
TACOBAMBA,consulta externa,nuevas en menores de 5 anos,2006-06-01,112,83,112,83,195
TACOPAYA,consulta externa,nuevas en menores de 5 anos,2006-06-01,145,120,145,120,265
TAHUA,consulta externa,nuevas en menores de 5 anos,2006-06-01,22,21,22,21,43
TAPACARI,consulta externa,nuevas en menores de 5 anos,2006-06-01,609,479,609,479,1088
TARABUCO,consulta externa,nuevas en menores de 5 anos,2006-06-01,756,779,756,779,1535
TARACO,consulta externa,nuevas en menores de 5 anos,2006-06-01,48,43,48,43,91
TARATA,consulta externa,nuevas en menores de 5 anos,2006-06-01,110,81,110,81,191
TARIJA,consulta externa,nuevas en menores de 5 anos,2006-06-01,4330,3888,4330,3888,8218
TARVITA,consulta externa,nuevas en menores de 5 anos,2006-06-01,641,622,641,622,1263
TEOPONTE,consulta externa,nuevas en menores de 5 anos,2006-06-01,188,156,188,156,344
TIAWANACU,consulta externa,nuevas en menores de 5 anos,2006-06-01,135,133,135,133,268
TINGUIPAYA,consulta externa,nuevas en menores de 5 anos,2006-06-01,573,486,573,486,1059
TIPUANI,consulta externa,nuevas en menores de 5 anos,2006-06-01,129,137,129,137,266
TIQUIPAYA,consulta externa,nuevas en menores de 5 anos,2006-06-01,545,433,545,433,978
TIRAQUE (CBBA),consulta externa,nuevas en menores de 5 anos,2006-06-01,713,570,713,570,1283
TITO YUPANQUI (PARQUIPUJIO),consulta externa,nuevas en menores de 5 anos,2006-06-01,27,16,27,16,43
TOCO,consulta externa,nuevas en menores de 5 anos,2006-06-01,82,73,82,73,155
TODOS SANTOS,consulta externa,nuevas en menores de 5 anos,2006-06-01,5,1,5,1,6
TOLATA,consulta externa,nuevas en menores de 5 anos,2006-06-01,65,48,65,48,113
TOLEDO,consulta externa,nuevas en menores de 5 anos,2006-06-01,89,90,89,90,179
TOMAVE,consulta externa,nuevas en menores de 5 anos,2006-06-01,185,162,185,162,347
TOMINA,consulta externa,nuevas en menores de 5 anos,2006-06-01,282,263,282,263,545
TORO TORO,consulta externa,nuevas en menores de 5 anos,2006-06-01,230,246,230,246,476
TOTORA(CBBA),consulta externa,nuevas en menores de 5 anos,2006-06-01,161,144,161,144,305
TOTORA(ORR),consulta externa,nuevas en menores de 5 anos,2006-06-01,63,87,63,87,150
TRIGAL,consulta externa,nuevas en menores de 5 anos,2006-06-01,36,29,36,29,65
TRINIDAD,consulta externa,nuevas en menores de 5 anos,2006-06-01,2721,2618,2721,2618,5339
TUPIZA,consulta externa,nuevas en menores de 5 anos,2006-06-01,1119,1191,1119,1191,2310
TURCO,consulta externa,nuevas en menores de 5 anos,2006-06-01,61,77,61,77,138
UMALA,consulta externa,nuevas en menores de 5 anos,2006-06-01,71,60,71,60,131
UNCIA,consulta externa,nuevas en menores de 5 anos,2006-06-01,588,522,588,522,1110
URIONDO (A. CONCEPCION),consulta externa,nuevas en menores de 5 anos,2006-06-01,497,428,497,428,925
URUBICHA,consulta externa,nuevas en menores de 5 anos,2006-06-01,190,195,190,195,385
UYUNI,consulta externa,nuevas en menores de 5 anos,2006-06-01,310,264,310,264,574
VACAS,consulta externa,nuevas en menores de 5 anos,2006-06-01,185,180,185,180,365
VALLEGRANDE,consulta externa,nuevas en menores de 5 anos,2006-06-01,194,175,194,175,369
VIACHA,consulta externa,nuevas en menores de 5 anos,2006-06-01,481,434,481,434,915
VILA VILA,consulta externa,nuevas en menores de 5 anos,2006-06-01,83,70,83,70,153
VILLA MONTES,consulta externa,nuevas en menores de 5 anos,2006-06-01,628,625,628,625,1253
VILLA NUEVA (LOMA ALTA),consulta externa,nuevas en menores de 5 anos,2006-06-01,18,19,18,19,37
VILLA RIVERO,consulta externa,nuevas en menores de 5 anos,2006-06-01,73,88,73,88,161
VILLA SERRANO,consulta externa,nuevas en menores de 5 anos,2006-06-01,453,432,453,432,885
VILLA TUNARI,consulta externa,nuevas en menores de 5 anos,2006-06-01,1439,1297,1439,1297,2736
VILLA VACA GUZMAN (MUYUPAMPA),consulta externa,nuevas en menores de 5 anos,2006-06-01,223,222,223,222,445
VILLAZON,consulta externa,nuevas en menores de 5 anos,2006-06-01,913,759,913,759,1672
VINTO,consulta externa,nuevas en menores de 5 anos,2006-06-01,42,41,42,41,83
VITICHI,consulta externa,nuevas en menores de 5 anos,2006-06-01,355,357,355,357,712
WALDO BALLIVIAN,consulta externa,nuevas en menores de 5 anos,2006-06-01,24,25,24,25,49
WARNES,consulta externa,nuevas en menores de 5 anos,2006-06-01,1108,976,1108,976,2084
YACO,consulta externa,nuevas en menores de 5 anos,2006-06-01,120,109,120,109,229
YACUIBA,consulta externa,nuevas en menores de 5 anos,2006-06-01,1795,1619,1795,1619,3414
YAMPARAEZ,consulta externa,nuevas en menores de 5 anos,2006-06-01,211,216,211,216,427
YANACACHI,consulta externa,nuevas en menores de 5 anos,2006-06-01,160,60,160,60,220
YAPACANI,consulta externa,nuevas en menores de 5 anos,2006-06-01,690,729,690,729,1419
YOCALLA,consulta externa,nuevas en menores de 5 anos,2006-06-01,104,101,104,101,205
YOTALA,consulta externa,nuevas en menores de 5 anos,2006-06-01,175,183,175,183,358
YUNCHARA,consulta externa,nuevas en menores de 5 anos,2006-06-01,156,123,156,123,279
ZUDAÑEZ,consulta externa,nuevas en menores de 5 anos,2006-06-01,307,255,307,255,562
ACACIO,consulta externa,nuevas en menores de 5 anos,2006-07-01,144,142,144,142,286
ACHACACHI,consulta externa,nuevas en menores de 5 anos,2006-07-01,295,303,295,303,598
ACHOCALLA,consulta externa,nuevas en menores de 5 anos,2006-07-01,78,66,78,66,144
AIQUILE,consulta externa,nuevas en menores de 5 anos,2006-07-01,195,183,195,183,378
ALALAY,consulta externa,nuevas en menores de 5 anos,2006-07-01,26,25,26,25,51
ALCALA,consulta externa,nuevas en menores de 5 anos,2006-07-01,155,127,155,127,282
ANCORAIMES,consulta externa,nuevas en menores de 5 anos,2006-07-01,140,127,140,127,267
ANDAMARCA,consulta externa,nuevas en menores de 5 anos,2006-07-01,57,63,57,63,120
ANTEQUERA,consulta externa,nuevas en menores de 5 anos,2006-07-01,26,28,26,28,54
ANZALDO,consulta externa,nuevas en menores de 5 anos,2006-07-01,76,59,76,59,135
APOLO,consulta externa,nuevas en menores de 5 anos,2006-07-01,305,295,305,295,600
ARAMPAMPA,consulta externa,nuevas en menores de 5 anos,2006-07-01,115,92,115,92,207
ARANI,consulta externa,nuevas en menores de 5 anos,2006-07-01,83,69,83,69,152
ARBIETO,consulta externa,nuevas en menores de 5 anos,2006-07-01,66,51,66,51,117
ARQUE,consulta externa,nuevas en menores de 5 anos,2006-07-01,151,128,151,128,279
ASCENCION DE GUARAYOS,consulta externa,nuevas en menores de 5 anos,2006-07-01,385,392,385,392,777
ATOCHA,consulta externa,nuevas en menores de 5 anos,2006-07-01,257,213,257,213,470
AUCAPATA,consulta externa,nuevas en menores de 5 anos,2006-07-01,48,47,48,47,95
AYATA,consulta externa,nuevas en menores de 5 anos,2006-07-01,111,92,111,92,203
AYO AYO,consulta externa,nuevas en menores de 5 anos,2006-07-01,46,48,46,48,94
AYOPAYA (V. DE INDEPENDENCIA),consulta externa,nuevas en menores de 5 anos,2006-07-01,410,417,410,417,827
AZURDUY,consulta externa,nuevas en menores de 5 anos,2006-07-01,483,445,483,445,928
BATALLAS,consulta externa,nuevas en menores de 5 anos,2006-07-01,76,65,76,65,141
BAURES,consulta externa,nuevas en menores de 5 anos,2006-07-01,121,104,121,104,225
BELEN DE ANDAMARCA,consulta externa,nuevas en menores de 5 anos,2006-07-01,12,17,12,17,29
BELEN DE URMIRI,consulta externa,nuevas en menores de 5 anos,2006-07-01,36,27,36,27,63
BELLA FLOR,consulta externa,nuevas en menores de 5 anos,2006-07-01,81,81,81,81,162
BERMEJO,consulta externa,nuevas en menores de 5 anos,2006-07-01,959,836,959,836,1795
BETANZOS,consulta externa,nuevas en menores de 5 anos,2006-07-01,606,571,606,571,1177
BOLIVAR,consulta externa,nuevas en menores de 5 anos,2006-07-01,192,174,192,174,366
BOLPEBRA,consulta externa,nuevas en menores de 5 anos,2006-07-01,61,59,61,59,120
BOYUIBE,consulta externa,nuevas en menores de 5 anos,2006-07-01,169,139,169,139,308
BUENA VISTA,consulta externa,nuevas en menores de 5 anos,2006-07-01,253,247,253,247,500
CABEZAS,consulta externa,nuevas en menores de 5 anos,2006-07-01,413,364,413,364,777
CAIROMA,consulta externa,nuevas en menores de 5 anos,2006-07-01,187,167,187,167,354
"CAIZA ""D""",consulta externa,nuevas en menores de 5 anos,2006-07-01,113,105,113,105,218
CAJUATA,consulta externa,nuevas en menores de 5 anos,2006-07-01,174,144,174,144,318
CALACOTO,consulta externa,nuevas en menores de 5 anos,2006-07-01,91,87,91,87,178
CALAMARCA,consulta externa,nuevas en menores de 5 anos,2006-07-01,154,169,154,169,323
CAMARGO,consulta externa,nuevas en menores de 5 anos,2006-07-01,461,480,461,480,941
CAMATAQUI (C. VILLA ABECIA),consulta externa,nuevas en menores de 5 anos,2006-07-01,69,44,69,44,113
CAMIRI,consulta externa,nuevas en menores de 5 anos,2006-07-01,992,999,992,999,1991
CAPINOTA,consulta externa,nuevas en menores de 5 anos,2006-07-01,283,250,283,250,533
CAQUIAVIRI,consulta externa,nuevas en menores de 5 anos,2006-07-01,56,38,56,38,94
CARACOLLO,consulta externa,nuevas en menores de 5 anos,2006-07-01,203,161,203,161,364
CARANAVI,consulta externa,nuevas en menores de 5 anos,2006-07-01,1000,894,1000,894,1894
CARANGAS,consulta externa,nuevas en menores de 5 anos,2006-07-01,5,5,5,5,10
CARAPARI,consulta externa,nuevas en menores de 5 anos,2006-07-01,217,197,217,197,414
CARIPUYO,consulta externa,nuevas en menores de 5 anos,2006-07-01,199,206,199,206,405
CARMEN RIVERO TORREZ,consulta externa,nuevas en menores de 5 anos,2006-07-01,81,63,81,63,144
CATACORA,consulta externa,nuevas en menores de 5 anos,2006-07-01,24,15,24,15,39
CHACARILLA,consulta externa,nuevas en menores de 5 anos,2006-07-01,11,17,11,17,28
CHALLAPATA,consulta externa,nuevas en menores de 5 anos,2006-07-01,307,252,307,252,559
CHAQUI,consulta externa,nuevas en menores de 5 anos,2006-07-01,116,122,116,122,238
CHARAGUA,consulta externa,nuevas en menores de 5 anos,2006-07-01,778,741,778,741,1519
CHARAÑA,consulta externa,nuevas en menores de 5 anos,2006-07-01,29,34,29,34,63
CHAYANTA,consulta externa,nuevas en menores de 5 anos,2006-07-01,374,389,374,389,763
CHIMORE,consulta externa,nuevas en menores de 5 anos,2006-07-01,476,381,476,381,857
CHIPAYA,consulta externa,nuevas en menores de 5 anos,2006-07-01,18,17,18,17,35
CHOQUE COTA,consulta externa,nuevas en menores de 5 anos,2006-07-01,29,28,29,28,57
CHULUMANI (V. DE LA LIBERTAD),consulta externa,nuevas en menores de 5 anos,2006-07-01,440,226,440,226,666
CHUMA,consulta externa,nuevas en menores de 5 anos,2006-07-01,170,158,170,158,328
CLIZA,consulta externa,nuevas en menores de 5 anos,2006-07-01,195,179,195,179,374
COBIJA,consulta externa,nuevas en menores de 5 anos,2006-07-01,973,933,973,933,1906
COCHABAMBA,consulta externa,nuevas en menores de 5 anos,2006-07-01,8478,7715,8478,7715,16193
COIPASA,consulta externa,nuevas en menores de 5 anos,2006-07-01,4,6,4,6,10
COLCAPIRHUA,consulta externa,nuevas en menores de 5 anos,2006-07-01,369,368,369,368,737
"COLCHA ""K""",consulta externa,nuevas en menores de 5 anos,2006-07-01,91,109,91,109,200
COLLANA,consulta externa,nuevas en menores de 5 anos,2006-07-01,19,9,19,9,28
COLOMI,consulta externa,nuevas en menores de 5 anos,2006-07-01,212,221,212,221,433
COLPA BELGICA,consulta externa,nuevas en menores de 5 anos,2006-07-01,164,133,164,133,297
COLQUECHACA,consulta externa,nuevas en menores de 5 anos,2006-07-01,692,593,692,593,1285
COLQUENCHA,consulta externa,nuevas en menores de 5 anos,2006-07-01,69,72,69,72,141
COLQUIRI,consulta externa,nuevas en menores de 5 anos,2006-07-01,343,325,343,325,668
COMANCHE,consulta externa,nuevas en menores de 5 anos,2006-07-01,35,20,35,20,55
COMARAPA,consulta externa,nuevas en menores de 5 anos,2006-07-01,349,333,349,333,682
COMBAYA,consulta externa,nuevas en menores de 5 anos,2006-07-01,25,21,25,21,46
CONCEPCION,consulta externa,nuevas en menores de 5 anos,2006-07-01,125,121,125,121,246
COPACABANA,consulta externa,nuevas en menores de 5 anos,2006-07-01,98,59,98,59,157
CORIPATA,consulta externa,nuevas en menores de 5 anos,2006-07-01,215,177,215,177,392
CORO CORO,consulta externa,nuevas en menores de 5 anos,2006-07-01,95,72,95,72,167
COROICO,consulta externa,nuevas en menores de 5 anos,2006-07-01,188,179,188,179,367
CORQUE,consulta externa,nuevas en menores de 5 anos,2006-07-01,61,67,61,67,128
COTAGAITA,consulta externa,nuevas en menores de 5 anos,2006-07-01,619,554,619,554,1173
COTOCA,consulta externa,nuevas en menores de 5 anos,2006-07-01,626,555,626,555,1181
CUATRO CAÑADAS,consulta externa,nuevas en menores de 5 anos,2006-07-01,548,491,548,491,1039
CUCHUMUELA (V. G. VILLARROEL),consulta externa,nuevas en menores de 5 anos,2006-07-01,24,12,24,12,36
CUEVO,consulta externa,nuevas en menores de 5 anos,2006-07-01,79,85,79,85,164
CULPINA,consulta externa,nuevas en menores de 5 anos,2006-07-01,515,519,515,519,1034
CURAHUARA DE CARANGAS,consulta externa,nuevas en menores de 5 anos,2006-07-01,44,66,44,66,110
CURVA,consulta externa,nuevas en menores de 5 anos,2006-07-01,39,26,39,26,65
DESAGUADERO,consulta externa,nuevas en menores de 5 anos,2006-07-01,46,28,46,28,74
EL ALTO,consulta externa,nuevas en menores de 5 anos,2006-07-01,8275,7677,8275,7677,15952
EL CHORO,consulta externa,nuevas en menores de 5 anos,2006-07-01,42,21,42,21,63
EL PUENTE(STC),consulta externa,nuevas en menores de 5 anos,2006-07-01,324,355,324,355,679
EL PUENTE(TJA),consulta externa,nuevas en menores de 5 anos,2006-07-01,217,196,217,196,413
EL TORNO,consulta externa,nuevas en menores de 5 anos,2006-07-01,889,751,889,751,1640
EL VILLAR,consulta externa,nuevas en menores de 5 anos,2006-07-01,179,179,179,179,358
ENTRE RIOS,consulta externa,nuevas en menores de 5 anos,2006-07-01,414,364,414,364,778
ENTRE RIOS,consulta externa,nuevas en menores de 5 anos,2006-07-01,435,398,435,398,833
ESCARA,consulta externa,nuevas en menores de 5 anos,2006-07-01,1,3,1,3,4
EUCALIPTUS,consulta externa,nuevas en menores de 5 anos,2006-07-01,160,141,160,141,301
EUREKA (SANTOS MERCADO),consulta externa,nuevas en menores de 5 anos,2006-07-01,35,30,35,30,65
EXALTACION,consulta externa,nuevas en menores de 5 anos,2006-07-01,39,39,39,39,78
FERNANDEZ ALONSO,consulta externa,nuevas en menores de 5 anos,2006-07-01,451,437,451,437,888
FILADELFIA,consulta externa,nuevas en menores de 5 anos,2006-07-01,90,102,90,102,192
GENERAL SAAVEDRA,consulta externa,nuevas en menores de 5 anos,2006-07-01,586,505,586,505,1091
GRAL. J.J. PEREZ (CHARAZANI),consulta externa,nuevas en menores de 5 anos,2006-07-01,120,107,120,107,227
GUANAY,consulta externa,nuevas en menores de 5 anos,2006-07-01,243,265,243,265,508
GUAQUI,consulta externa,nuevas en menores de 5 anos,2006-07-01,36,33,36,33,69
GUAYARAMERIN,consulta externa,nuevas en menores de 5 anos,2006-07-01,1102,1056,1102,1056,2158
GUTIERREZ,consulta externa,nuevas en menores de 5 anos,2006-07-01,454,348,454,348,802
HUACARETA,consulta externa,nuevas en menores de 5 anos,2006-07-01,178,174,178,174,352
HUACAYA (VILLA DE HUACAYA),consulta externa,nuevas en menores de 5 anos,2006-07-01,142,140,142,140,282
HUACHACALLA,consulta externa,nuevas en menores de 5 anos,2006-07-01,27,23,27,23,50
HUANUNI,consulta externa,nuevas en menores de 5 anos,2006-07-01,417,386,417,386,803
HUARACAJE,consulta externa,nuevas en menores de 5 anos,2006-07-01,71,60,71,60,131
HUAYLLAMARCA,consulta externa,nuevas en menores de 5 anos,2006-07-01,12,53,12,53,65
ICHOCA,consulta externa,nuevas en menores de 5 anos,2006-07-01,80,62,80,62,142
ICLA,consulta externa,nuevas en menores de 5 anos,2006-07-01,436,438,436,438,874
INCAHUASI,consulta externa,nuevas en menores de 5 anos,2006-07-01,450,497,450,497,947
INGAVI (HUMAITA),consulta externa,nuevas en menores de 5 anos,2006-07-01,25,18,25,18,43
INQUISIVI,consulta externa,nuevas en menores de 5 anos,2006-07-01,183,171,183,171,354
IRUPANA (VILLA DE LANZA),consulta externa,nuevas en menores de 5 anos,2006-07-01,242,218,242,218,460
IXIAMAS,consulta externa,nuevas en menores de 5 anos,2006-07-01,304,231,304,231,535
JESUS DE MACHACA,consulta externa,nuevas en menores de 5 anos,2006-07-01,175,142,175,142,317
LA ASUNTA,consulta externa,nuevas en menores de 5 anos,2006-07-01,581,454,581,454,1035
LA GUARDIA,consulta externa,nuevas en menores de 5 anos,2006-07-01,1109,949,1109,949,2058
LA PAZ,consulta externa,nuevas en menores de 5 anos,2006-07-01,12049,11432,12049,11432,23481
LA RIVERA,consulta externa,nuevas en menores de 5 anos,2006-07-01,1,2,1,2,3
LAGUNILLAS,consulta externa,nuevas en menores de 5 anos,2006-07-01,229,236,229,236,465
LAJA,consulta externa,nuevas en menores de 5 anos,2006-07-01,94,78,94,78,172
LAS CARRERAS,consulta externa,nuevas en menores de 5 anos,2006-07-01,55,57,55,57,112
LICOMA PAMPA,consulta externa,nuevas en menores de 5 anos,2006-07-01,31,22,31,22,53
LLALLAGUA,consulta externa,nuevas en menores de 5 anos,2006-07-01,614,510,614,510,1124
LLICA,consulta externa,nuevas en menores de 5 anos,2006-07-01,51,48,51,48,99
LORETO,consulta externa,nuevas en menores de 5 anos,2006-07-01,58,85,58,85,143
LURIBAY,consulta externa,nuevas en menores de 5 anos,2006-07-01,169,136,169,136,305
MACHACAMARCA,consulta externa,nuevas en menores de 5 anos,2006-07-01,39,40,39,40,79
MACHARETI,consulta externa,nuevas en menores de 5 anos,2006-07-01,245,304,245,304,549
MAGDALENA,consulta externa,nuevas en menores de 5 anos,2006-07-01,145,171,145,171,316
MAIRANA,consulta externa,nuevas en menores de 5 anos,2006-07-01,118,96,118,96,214
MALLA,consulta externa,nuevas en menores de 5 anos,2006-07-01,62,43,62,43,105
MAPIRI,consulta externa,nuevas en menores de 5 anos,2006-07-01,229,203,229,203,432
MECAPACA,consulta externa,nuevas en menores de 5 anos,2006-07-01,114,101,114,101,215
MINEROS,consulta externa,nuevas en menores de 5 anos,2006-07-01,484,443,484,443,927
MIZQUE,consulta externa,nuevas en menores de 5 anos,2006-07-01,423,411,423,411,834
MOCOMOCO,consulta externa,nuevas en menores de 5 anos,2006-07-01,112,108,112,108,220
MOJINETE,consulta externa,nuevas en menores de 5 anos,2006-07-01,20,7,20,7,27
MOJOCOYA,consulta externa,nuevas en menores de 5 anos,2006-07-01,181,126,181,126,307
MONTEAGUDO,consulta externa,nuevas en menores de 5 anos,2006-07-01,588,577,588,577,1165
MONTERO,consulta externa,nuevas en menores de 5 anos,2006-07-01,2297,2005,2297,2005,4302
MORO MORO,consulta externa,nuevas en menores de 5 anos,2006-07-01,29,28,29,28,57
MOROCHATA,consulta externa,nuevas en menores de 5 anos,2006-07-01,227,190,227,190,417
NACEBE (SANTA ROSA DEL ABUNA),consulta externa,nuevas en menores de 5 anos,2006-07-01,19,20,19,20,39
NUEVO MANOA (NUEVA ESPERANZA),consulta externa,nuevas en menores de 5 anos,2006-07-01,41,34,41,34,75
OCURI,consulta externa,nuevas en menores de 5 anos,2006-07-01,363,385,363,385,748
OKINAWA,consulta externa,nuevas en menores de 5 anos,2006-07-01,371,373,371,373,744
OMEREQUE,consulta externa,nuevas en menores de 5 anos,2006-07-01,114,125,114,125,239
ORURO,consulta externa,nuevas en menores de 5 anos,2006-07-01,4022,3508,4022,3508,7530
PADCAYA,consulta externa,nuevas en menores de 5 anos,2006-07-01,431,443,431,443,874
PADILLA,consulta externa,nuevas en menores de 5 anos,2006-07-01,389,317,389,317,706
PAILON,consulta externa,nuevas en menores de 5 anos,2006-07-01,241,301,241,301,542
PALCA,consulta externa,nuevas en menores de 5 anos,2006-07-01,107,101,107,101,208
PALOS BLANCOS,consulta externa,nuevas en menores de 5 anos,2006-07-01,538,498,538,498,1036
PAMPA AULLAGAS,consulta externa,nuevas en menores de 5 anos,2006-07-01,26,31,26,31,57
PAMPA GRANDE,consulta externa,nuevas en menores de 5 anos,2006-07-01,116,137,116,137,253
PAPEL PAMPA,consulta externa,nuevas en menores de 5 anos,2006-07-01,45,54,45,54,99
PASORAPA,consulta externa,nuevas en menores de 5 anos,2006-07-01,42,38,42,38,80
PATACAMAYA,consulta externa,nuevas en menores de 5 anos,2006-07-01,210,149,210,149,359
PAZÑA,consulta externa,nuevas en menores de 5 anos,2006-07-01,91,78,91,78,169
PELECHUCO,consulta externa,nuevas en menores de 5 anos,2006-07-01,47,47,47,47,94
POCOATA,consulta externa,nuevas en menores de 5 anos,2006-07-01,435,378,435,378,813
POCONA,consulta externa,nuevas en menores de 5 anos,2006-07-01,173,137,173,137,310
POJO (CBBA),consulta externa,nuevas en menores de 5 anos,2006-07-01,196,183,196,183,379
POOPO,consulta externa,nuevas en menores de 5 anos,2006-07-01,33,23,33,23,56
PORCO,consulta externa,nuevas en menores de 5 anos,2006-07-01,144,153,144,153,297
POROMA,consulta externa,nuevas en menores de 5 anos,2006-07-01,513,484,513,484,997
PORONGO,consulta externa,nuevas en menores de 5 anos,2006-07-01,159,161,159,161,320
PORTACHUELO,consulta externa,nuevas en menores de 5 anos,2006-07-01,545,472,545,472,1017
PORVENIR,consulta externa,nuevas en menores de 5 anos,2006-07-01,195,164,195,164,359
POSTRER VALLE,consulta externa,nuevas en menores de 5 anos,2006-07-01,62,53,62,53,115
POTOSI,consulta externa,nuevas en menores de 5 anos,2006-07-01,3847,3055,3847,3055,6902
PRESTO,consulta externa,nuevas en menores de 5 anos,2006-07-01,281,236,281,236,517
PUCARA,consulta externa,nuevas en menores de 5 anos,2006-07-01,25,13,25,13,38
PUCARANI,consulta externa,nuevas en menores de 5 anos,2006-07-01,160,154,160,154,314
PUERTO ACOSTA,consulta externa,nuevas en menores de 5 anos,2006-07-01,226,204,226,204,430
PUERTO CARABUCO,consulta externa,nuevas en menores de 5 anos,2006-07-01,143,142,143,142,285
PUERTO GONZALO MORENO,consulta externa,nuevas en menores de 5 anos,2006-07-01,177,161,177,161,338
PUERTO PEREZ,consulta externa,nuevas en menores de 5 anos,2006-07-01,47,52,47,52,99
PUERTO QUIJARRO,consulta externa,nuevas en menores de 5 anos,2006-07-01,254,252,254,252,506
PUERTO RICO,consulta externa,nuevas en menores de 5 anos,2006-07-01,166,168,166,168,334
PUERTO SILES,consulta externa,nuevas en menores de 5 anos,2006-07-01,41,45,41,45,86
PUERTO SUAREZ,consulta externa,nuevas en menores de 5 anos,2006-07-01,251,214,251,214,465
PUERTO VILLARROEL,consulta externa,nuevas en menores de 5 anos,2006-07-01,1160,1006,1160,1006,2166
PUNA,consulta externa,nuevas en menores de 5 anos,2006-07-01,529,538,529,538,1067
PUNATA,consulta externa,nuevas en menores de 5 anos,2006-07-01,320,330,320,330,650
QUIABAYA,consulta externa,nuevas en menores de 5 anos,2006-07-01,57,58,57,58,115
QUILLACOLLO,consulta externa,nuevas en menores de 5 anos,2006-07-01,714,798,714,798,1512
QUIME,consulta externa,nuevas en menores de 5 anos,2006-07-01,128,135,128,135,263
QUIRUSILLAS,consulta externa,nuevas en menores de 5 anos,2006-07-01,59,36,59,36,95
RAVELO,consulta externa,nuevas en menores de 5 anos,2006-07-01,374,344,374,344,718
REYES,consulta externa,nuevas en menores de 5 anos,2006-07-01,144,110,144,110,254
RIBERALTA,consulta externa,nuevas en menores de 5 anos,2006-07-01,1927,1747,1927,1747,3674
ROBORE,consulta externa,nuevas en menores de 5 anos,2006-07-01,269,274,269,274,543
RURRENABAQUE,consulta externa,nuevas en menores de 5 anos,2006-07-01,311,304,311,304,615
SABAYA,consulta externa,nuevas en menores de 5 anos,2006-07-01,48,30,48,30,78
SACABA,consulta externa,nuevas en menores de 5 anos,2006-07-01,904,744,904,744,1648
SACABAMBA,consulta externa,nuevas en menores de 5 anos,2006-07-01,26,32,26,32,58
SACACA,consulta externa,nuevas en menores de 5 anos,2006-07-01,546,488,546,488,1034
SAIPINA,consulta externa,nuevas en menores de 5 anos,2006-07-01,137,119,137,119,256
SALINAS DE GARCI MENDOZA,consulta externa,nuevas en menores de 5 anos,2006-07-01,215,192,215,192,407
SAMAIPATA,consulta externa,nuevas en menores de 5 anos,2006-07-01,145,96,145,96,241
SAN AGUSTIN,consulta externa,nuevas en menores de 5 anos,2006-07-01,23,30,23,30,53
SAN ANDRES,consulta externa,nuevas en menores de 5 anos,2006-07-01,333,267,333,267,600
SAN ANDRES DE MACHACA,consulta externa,nuevas en menores de 5 anos,2006-07-01,52,38,52,38,90
SAN ANTONIO DE ESMORUCO,consulta externa,nuevas en menores de 5 anos,2006-07-01,34,31,34,31,65
SAN ANTONIO DE LOMERIO,consulta externa,nuevas en menores de 5 anos,2006-07-01,104,95,104,95,199
SAN BENITO,consulta externa,nuevas en menores de 5 anos,2006-07-01,98,81,98,81,179
SAN BORJA,consulta externa,nuevas en menores de 5 anos,2006-07-01,542,483,542,483,1025
SAN BUENA VENTURA,consulta externa,nuevas en menores de 5 anos,2006-07-01,215,198,215,198,413
SAN CARLOS,consulta externa,nuevas en menores de 5 anos,2006-07-01,444,414,444,414,858
SAN IGNACIO,consulta externa,nuevas en menores de 5 anos,2006-07-01,493,454,493,454,947
SAN IGNACIO DE VELASCO,consulta externa,nuevas en menores de 5 anos,2006-07-01,1076,1002,1076,1002,2078
SAN JAVIER(BNI),consulta externa,nuevas en menores de 5 anos,2006-07-01,146,105,146,105,251
SAN JAVIER(STC),consulta externa,nuevas en menores de 5 anos,2006-07-01,203,195,203,195,398
SAN JOAQUIN,consulta externa,nuevas en menores de 5 anos,2006-07-01,86,87,86,87,173
SAN JOSE DE CHIQUITOS,consulta externa,nuevas en menores de 5 anos,2006-07-01,345,363,345,363,708
SAN JUAN DE YAPACANI,consulta externa,nuevas en menores de 5 anos,2006-07-01,288,307,288,307,595
SAN JULIAN,consulta externa,nuevas en menores de 5 anos,2006-07-01,1131,992,1131,992,2123
SAN LORENZO(PND),consulta externa,nuevas en menores de 5 anos,2006-07-01,243,222,243,222,465
SAN LORENZO(TJA),consulta externa,nuevas en menores de 5 anos,2006-07-01,580,567,580,567,1147
SAN LUCAS,consulta externa,nuevas en menores de 5 anos,2006-07-01,912,886,912,886,1798
SAN MATIAS,consulta externa,nuevas en menores de 5 anos,2006-07-01,398,271,398,271,669
SAN MIGUEL DE VELASCO,consulta externa,nuevas en menores de 5 anos,2006-07-01,185,129,185,129,314
SAN PABLO DE LIPEZ,consulta externa,nuevas en menores de 5 anos,2006-07-01,60,51,60,51,111
SAN PEDRO,consulta externa,nuevas en menores de 5 anos,2006-07-01,583,570,583,570,1153
SAN PEDRO DE BUENA VISTA,consulta externa,nuevas en menores de 5 anos,2006-07-01,491,472,491,472,963
SAN PEDRO DE CURAHUARA,consulta externa,nuevas en menores de 5 anos,2006-07-01,55,33,55,33,88
SAN PEDRO DE QUEMES,consulta externa,nuevas en menores de 5 anos,2006-07-01,7,8,7,8,15
SAN PEDRO DE TIQUINA,consulta externa,nuevas en menores de 5 anos,2006-07-01,21,23,21,23,44
SAN PEDRO(PND),consulta externa,nuevas en menores de 5 anos,2006-07-01,17,26,17,26,43
SAN RAFAEL,consulta externa,nuevas en menores de 5 anos,2006-07-01,115,90,115,90,205
SAN RAMON,consulta externa,nuevas en menores de 5 anos,2006-07-01,133,97,133,97,230
SAN RAMON,consulta externa,nuevas en menores de 5 anos,2006-07-01,199,153,199,153,352
SANTA ANA,consulta externa,nuevas en menores de 5 anos,2006-07-01,349,254,349,254,603
SANTA CRUZ DE LA SIERRA,consulta externa,nuevas en menores de 5 anos,2006-07-01,19939,18431,19939,18431,38370
SANTA ROSA,consulta externa,nuevas en menores de 5 anos,2006-07-01,106,123,106,123,229
SANTA ROSA DEL SARA,consulta externa,nuevas en menores de 5 anos,2006-07-01,623,516,623,516,1139
SANTIAGO DE CALLAPA,consulta externa,nuevas en menores de 5 anos,2006-07-01,38,33,38,33,71
SANTIAGO DE HUARI,consulta externa,nuevas en menores de 5 anos,2006-07-01,74,64,74,64,138
SANTIAGO DE MACHACA,consulta externa,nuevas en menores de 5 anos,2006-07-01,21,19,21,19,40
SANTIVAÑES,consulta externa,nuevas en menores de 5 anos,2006-07-01,73,65,73,65,138
SANTUARIO DE QUILLACAS,consulta externa,nuevas en menores de 5 anos,2006-07-01,28,23,28,23,51
SAPAHAQUI,consulta externa,nuevas en menores de 5 anos,2006-07-01,132,87,132,87,219
SENA,consulta externa,nuevas en menores de 5 anos,2006-07-01,211,198,211,198,409
SICA SICA (VILLA AROMA),consulta externa,nuevas en menores de 5 anos,2006-07-01,113,120,113,120,233
SICAYA,consulta externa,nuevas en menores de 5 anos,2006-07-01,38,35,38,35,73
SIPE SIPE,consulta externa,nuevas en menores de 5 anos,2006-07-01,337,305,337,305,642
SOPACHUY,consulta externa,nuevas en menores de 5 anos,2006-07-01,383,402,383,402,785
SORACACHI,consulta externa,nuevas en menores de 5 anos,2006-07-01,97,92,97,92,189
SORATA,consulta externa,nuevas en menores de 5 anos,2006-07-01,198,169,198,169,367
SUCRE,consulta externa,nuevas en menores de 5 anos,2006-07-01,5725,5113,5725,5113,10838
TACACHI,consulta externa,nuevas en menores de 5 anos,2006-07-01,12,6,12,6,18
TACACOMA,consulta externa,nuevas en menores de 5 anos,2006-07-01,85,62,85,62,147
TACOBAMBA,consulta externa,nuevas en menores de 5 anos,2006-07-01,121,118,121,118,239
TACOPAYA,consulta externa,nuevas en menores de 5 anos,2006-07-01,178,214,178,214,392
TAHUA,consulta externa,nuevas en menores de 5 anos,2006-07-01,11,14,11,14,25
TAPACARI,consulta externa,nuevas en menores de 5 anos,2006-07-01,560,542,560,542,1102
TARABUCO,consulta externa,nuevas en menores de 5 anos,2006-07-01,605,616,605,616,1221
TARACO,consulta externa,nuevas en menores de 5 anos,2006-07-01,21,9,21,9,30
TARATA,consulta externa,nuevas en menores de 5 anos,2006-07-01,84,105,84,105,189
TARIJA,consulta externa,nuevas en menores de 5 anos,2006-07-01,3227,2812,3227,2812,6039
TARVITA,consulta externa,nuevas en menores de 5 anos,2006-07-01,766,818,766,818,1584
TEOPONTE,consulta externa,nuevas en menores de 5 anos,2006-07-01,190,210,190,210,400
TIAWANACU,consulta externa,nuevas en menores de 5 anos,2006-07-01,110,87,110,87,197
TINGUIPAYA,consulta externa,nuevas en menores de 5 anos,2006-07-01,379,336,379,336,715
TIPUANI,consulta externa,nuevas en menores de 5 anos,2006-07-01,91,90,91,90,181
TIQUIPAYA,consulta externa,nuevas en menores de 5 anos,2006-07-01,385,314,385,314,699
TIRAQUE (CBBA),consulta externa,nuevas en menores de 5 anos,2006-07-01,715,662,715,662,1377
TITO YUPANQUI (PARQUIPUJIO),consulta externa,nuevas en menores de 5 anos,2006-07-01,30,42,30,42,72
TOCO,consulta externa,nuevas en menores de 5 anos,2006-07-01,30,26,30,26,56
TODOS SANTOS,consulta externa,nuevas en menores de 5 anos,2006-07-01,2,2,2,2,4
TOLATA,consulta externa,nuevas en menores de 5 anos,2006-07-01,67,34,67,34,101
TOLEDO,consulta externa,nuevas en menores de 5 anos,2006-07-01,80,78,80,78,158
TOMAVE,consulta externa,nuevas en menores de 5 anos,2006-07-01,156,130,156,130,286
TOMINA,consulta externa,nuevas en menores de 5 anos,2006-07-01,327,268,327,268,595
TORO TORO,consulta externa,nuevas en menores de 5 anos,2006-07-01,251,198,251,198,449
TOTORA(CBBA),consulta externa,nuevas en menores de 5 anos,2006-07-01,104,93,104,93,197
TOTORA(ORR),consulta externa,nuevas en menores de 5 anos,2006-07-01,67,81,67,81,148
TRIGAL,consulta externa,nuevas en menores de 5 anos,2006-07-01,37,34,37,34,71
TRINIDAD,consulta externa,nuevas en menores de 5 anos,2006-07-01,2154,1963,2154,1963,4117
TUPIZA,consulta externa,nuevas en menores de 5 anos,2006-07-01,907,899,907,899,1806
TURCO,consulta externa,nuevas en menores de 5 anos,2006-07-01,84,92,84,92,176
UMALA,consulta externa,nuevas en menores de 5 anos,2006-07-01,37,33,37,33,70
UNCIA,consulta externa,nuevas en menores de 5 anos,2006-07-01,749,656,749,656,1405
URIONDO (A. CONCEPCION),consulta externa,nuevas en menores de 5 anos,2006-07-01,406,386,406,386,792
URUBICHA,consulta externa,nuevas en menores de 5 anos,2006-07-01,154,180,154,180,334
UYUNI,consulta externa,nuevas en menores de 5 anos,2006-07-01,235,193,235,193,428
VACAS,consulta externa,nuevas en menores de 5 anos,2006-07-01,138,123,138,123,261
VALLEGRANDE,consulta externa,nuevas en menores de 5 anos,2006-07-01,213,218,213,218,431
VIACHA,consulta externa,nuevas en menores de 5 anos,2006-07-01,399,376,399,376,775
VILA VILA,consulta externa,nuevas en menores de 5 anos,2006-07-01,43,37,43,37,80
VILLA MONTES,consulta externa,nuevas en menores de 5 anos,2006-07-01,658,602,658,602,1260
VILLA NUEVA (LOMA ALTA),consulta externa,nuevas en menores de 5 anos,2006-07-01,50,61,50,61,111
VILLA RIVERO,consulta externa,nuevas en menores de 5 anos,2006-07-01,63,46,63,46,109
VILLA SERRANO,consulta externa,nuevas en menores de 5 anos,2006-07-01,381,382,381,382,763
VILLA TUNARI,consulta externa,nuevas en menores de 5 anos,2006-07-01,1369,1261,1369,1261,2630
VILLA VACA GUZMAN (MUYUPAMPA),consulta externa,nuevas en menores de 5 anos,2006-07-01,295,324,295,324,619
VILLAZON,consulta externa,nuevas en menores de 5 anos,2006-07-01,748,678,748,678,1426
VINTO,consulta externa,nuevas en menores de 5 anos,2006-07-01,121,95,121,95,216
VITICHI,consulta externa,nuevas en menores de 5 anos,2006-07-01,183,248,183,248,431
WALDO BALLIVIAN,consulta externa,nuevas en menores de 5 anos,2006-07-01,25,33,25,33,58
WARNES,consulta externa,nuevas en menores de 5 anos,2006-07-01,1246,1024,1246,1024,2270
YACO,consulta externa,nuevas en menores de 5 anos,2006-07-01,82,79,82,79,161
YACUIBA,consulta externa,nuevas en menores de 5 anos,2006-07-01,1589,1439,1589,1439,3028
YAMPARAEZ,consulta externa,nuevas en menores de 5 anos,2006-07-01,163,120,163,120,283
YANACACHI,consulta externa,nuevas en menores de 5 anos,2006-07-01,93,72,93,72,165
YAPACANI,consulta externa,nuevas en menores de 5 anos,2006-07-01,761,745,761,745,1506
YOCALLA,consulta externa,nuevas en menores de 5 anos,2006-07-01,66,46,66,46,112
YOTALA,consulta externa,nuevas en menores de 5 anos,2006-07-01,154,130,154,130,284
YUNCHARA,consulta externa,nuevas en menores de 5 anos,2006-07-01,112,90,112,90,202
ZUDAÑEZ,consulta externa,nuevas en menores de 5 anos,2006-07-01,308,286,308,286,594
ACACIO,consulta externa,nuevas en menores de 5 anos,2006-08-01,167,167,167,167,334
ACHACACHI,consulta externa,nuevas en menores de 5 anos,2006-08-01,394,369,394,369,763
ACHOCALLA,consulta externa,nuevas en menores de 5 anos,2006-08-01,82,52,82,52,134
AIQUILE,consulta externa,nuevas en menores de 5 anos,2006-08-01,375,376,375,376,751
ALCALA,consulta externa,nuevas en menores de 5 anos,2006-08-01,183,165,183,165,348
ANCORAIMES,consulta externa,nuevas en menores de 5 anos,2006-08-01,212,153,212,153,365
ANDAMARCA,consulta externa,nuevas en menores de 5 anos,2006-08-01,92,73,92,73,165
ANTEQUERA,consulta externa,nuevas en menores de 5 anos,2006-08-01,29,25,29,25,54
ANZALDO,consulta externa,nuevas en menores de 5 anos,2006-08-01,123,101,123,101,224
APOLO,consulta externa,nuevas en menores de 5 anos,2006-08-01,327,322,327,322,649
ARAMPAMPA,consulta externa,nuevas en menores de 5 anos,2006-08-01,203,148,203,148,351
ARANI,consulta externa,nuevas en menores de 5 anos,2006-08-01,58,46,58,46,104
ARBIETO,consulta externa,nuevas en menores de 5 anos,2006-08-01,98,75,98,75,173
ARQUE,consulta externa,nuevas en menores de 5 anos,2006-08-01,303,234,303,234,537
ASCENCION DE GUARAYOS,consulta externa,nuevas en menores de 5 anos,2006-08-01,469,396,469,396,865
ATOCHA,consulta externa,nuevas en menores de 5 anos,2006-08-01,281,261,281,261,542
AUCAPATA,consulta externa,nuevas en menores de 5 anos,2006-08-01,83,58,83,58,141
AYATA,consulta externa,nuevas en menores de 5 anos,2006-08-01,140,137,140,137,277
AYO AYO,consulta externa,nuevas en menores de 5 anos,2006-08-01,67,61,67,61,128
AYOPAYA (V. DE INDEPENDENCIA),consulta externa,nuevas en menores de 5 anos,2006-08-01,1097,439,1097,439,1536
AZURDUY,consulta externa,nuevas en menores de 5 anos,2006-08-01,624,561,624,561,1185
BATALLAS,consulta externa,nuevas en menores de 5 anos,2006-08-01,117,79,117,79,196
BAURES,consulta externa,nuevas en menores de 5 anos,2006-08-01,127,126,127,126,253
BELEN DE ANDAMARCA,consulta externa,nuevas en menores de 5 anos,2006-08-01,5,9,5,9,14
BELEN DE URMIRI,consulta externa,nuevas en menores de 5 anos,2006-08-01,65,48,65,48,113
BELLA FLOR,consulta externa,nuevas en menores de 5 anos,2006-08-01,92,109,92,109,201
BERMEJO,consulta externa,nuevas en menores de 5 anos,2006-08-01,884,773,884,773,1657
BETANZOS,consulta externa,nuevas en menores de 5 anos,2006-08-01,680,661,680,661,1341
BOLIVAR,consulta externa,nuevas en menores de 5 anos,2006-08-01,142,138,142,138,280
BOLPEBRA,consulta externa,nuevas en menores de 5 anos,2006-08-01,68,67,68,67,135
BOYUIBE,consulta externa,nuevas en menores de 5 anos,2006-08-01,144,141,144,141,285
BUENA VISTA,consulta externa,nuevas en menores de 5 anos,2006-08-01,288,217,288,217,505
CABEZAS,consulta externa,nuevas en menores de 5 anos,2006-08-01,489,378,489,378,867
CAIROMA,consulta externa,nuevas en menores de 5 anos,2006-08-01,200,119,200,119,319
"CAIZA ""D""",consulta externa,nuevas en menores de 5 anos,2006-08-01,111,121,111,121,232
CAJUATA,consulta externa,nuevas en menores de 5 anos,2006-08-01,142,133,142,133,275
CALACOTO,consulta externa,nuevas en menores de 5 anos,2006-08-01,90,88,90,88,178
CALAMARCA,consulta externa,nuevas en menores de 5 anos,2006-08-01,180,188,180,188,368
CAMARGO,consulta externa,nuevas en menores de 5 anos,2006-08-01,572,601,572,601,1173
CAMATAQUI (C. VILLA ABECIA),consulta externa,nuevas en menores de 5 anos,2006-08-01,91,69,91,69,160
CAMIRI,consulta externa,nuevas en menores de 5 anos,2006-08-01,1075,1063,1075,1063,2138
CAPINOTA,consulta externa,nuevas en menores de 5 anos,2006-08-01,346,331,346,331,677
CAQUIAVIRI,consulta externa,nuevas en menores de 5 anos,2006-08-01,90,88,90,88,178
CARACOLLO,consulta externa,nuevas en menores de 5 anos,2006-08-01,296,148,296,148,444
CARANAVI,consulta externa,nuevas en menores de 5 anos,2006-08-01,1054,998,1054,998,2052
CARANGAS,consulta externa,nuevas en menores de 5 anos,2006-08-01,10,5,10,5,15
CARAPARI,consulta externa,nuevas en menores de 5 anos,2006-08-01,236,230,236,230,466
CARIPUYO,consulta externa,nuevas en menores de 5 anos,2006-08-01,224,233,224,233,457
CARMEN RIVERO TORREZ,consulta externa,nuevas en menores de 5 anos,2006-08-01,72,60,72,60,132
CATACORA,consulta externa,nuevas en menores de 5 anos,2006-08-01,24,15,24,15,39
CHACARILLA,consulta externa,nuevas en menores de 5 anos,2006-08-01,43,40,43,40,83
CHALLAPATA,consulta externa,nuevas en menores de 5 anos,2006-08-01,348,305,348,305,653
CHAQUI,consulta externa,nuevas en menores de 5 anos,2006-08-01,111,126,111,126,237
CHARAGUA,consulta externa,nuevas en menores de 5 anos,2006-08-01,663,625,663,625,1288
CHARAÑA,consulta externa,nuevas en menores de 5 anos,2006-08-01,24,24,24,24,48
CHAYANTA,consulta externa,nuevas en menores de 5 anos,2006-08-01,415,435,415,435,850
CHIMORE,consulta externa,nuevas en menores de 5 anos,2006-08-01,435,372,435,372,807
CHIPAYA,consulta externa,nuevas en menores de 5 anos,2006-08-01,14,15,14,15,29
CHOQUE COTA,consulta externa,nuevas en menores de 5 anos,2006-08-01,34,13,34,13,47
CHULUMANI (V. DE LA LIBERTAD),consulta externa,nuevas en menores de 5 anos,2006-08-01,159,168,159,168,327
CHUMA,consulta externa,nuevas en menores de 5 anos,2006-08-01,135,99,135,99,234
CLIZA,consulta externa,nuevas en menores de 5 anos,2006-08-01,168,182,168,182,350
COBIJA,consulta externa,nuevas en menores de 5 anos,2006-08-01,1048,932,1048,932,1980
COCHABAMBA,consulta externa,nuevas en menores de 5 anos,2006-08-01,8793,7730,8793,7730,16523
COIPASA,consulta externa,nuevas en menores de 5 anos,2006-08-01,10,24,10,24,34
COLCAPIRHUA,consulta externa,nuevas en menores de 5 anos,2006-08-01,379,388,379,388,767
"COLCHA ""K""",consulta externa,nuevas en menores de 5 anos,2006-08-01,147,131,147,131,278
COLLANA,consulta externa,nuevas en menores de 5 anos,2006-08-01,30,7,30,7,37
COLOMI,consulta externa,nuevas en menores de 5 anos,2006-08-01,290,239,290,239,529
COLPA BELGICA,consulta externa,nuevas en menores de 5 anos,2006-08-01,133,108,133,108,241
COLQUECHACA,consulta externa,nuevas en menores de 5 anos,2006-08-01,620,590,620,590,1210
COLQUENCHA,consulta externa,nuevas en menores de 5 anos,2006-08-01,81,80,81,80,161
COLQUIRI,consulta externa,nuevas en menores de 5 anos,2006-08-01,271,285,271,285,556
COMANCHE,consulta externa,nuevas en menores de 5 anos,2006-08-01,29,33,29,33,62
COMARAPA,consulta externa,nuevas en menores de 5 anos,2006-08-01,288,276,288,276,564
COMBAYA,consulta externa,nuevas en menores de 5 anos,2006-08-01,22,14,22,14,36
CONCEPCION,consulta externa,nuevas en menores de 5 anos,2006-08-01,302,245,302,245,547
COPACABANA,consulta externa,nuevas en menores de 5 anos,2006-08-01,102,71,102,71,173
CORIPATA,consulta externa,nuevas en menores de 5 anos,2006-08-01,247,148,247,148,395
CORO CORO,consulta externa,nuevas en menores de 5 anos,2006-08-01,109,83,109,83,192
COROICO,consulta externa,nuevas en menores de 5 anos,2006-08-01,288,209,288,209,497
CORQUE,consulta externa,nuevas en menores de 5 anos,2006-08-01,109,108,109,108,217
COTAGAITA,consulta externa,nuevas en menores de 5 anos,2006-08-01,521,514,521,514,1035
COTOCA,consulta externa,nuevas en menores de 5 anos,2006-08-01,717,584,717,584,1301
CUATRO CAÑADAS,consulta externa,nuevas en menores de 5 anos,2006-08-01,536,403,536,403,939
CUCHUMUELA (V. G. VILLARROEL),consulta externa,nuevas en menores de 5 anos,2006-08-01,21,12,21,12,33
CUEVO,consulta externa,nuevas en menores de 5 anos,2006-08-01,92,109,92,109,201
CULPINA,consulta externa,nuevas en menores de 5 anos,2006-08-01,578,526,578,526,1104
CURAHUARA DE CARANGAS,consulta externa,nuevas en menores de 5 anos,2006-08-01,811,109,811,109,920
CURVA,consulta externa,nuevas en menores de 5 anos,2006-08-01,34,25,34,25,59
DESAGUADERO,consulta externa,nuevas en menores de 5 anos,2006-08-01,45,17,45,17,62
EL ALTO,consulta externa,nuevas en menores de 5 anos,2006-08-01,8611,9322,8611,9322,17933
EL CHORO,consulta externa,nuevas en menores de 5 anos,2006-08-01,62,49,62,49,111
EL PUENTE(STC),consulta externa,nuevas en menores de 5 anos,2006-08-01,307,295,307,295,602
EL PUENTE(TJA),consulta externa,nuevas en menores de 5 anos,2006-08-01,236,199,236,199,435
EL TORNO,consulta externa,nuevas en menores de 5 anos,2006-08-01,738,594,738,594,1332
EL VILLAR,consulta externa,nuevas en menores de 5 anos,2006-08-01,212,189,212,189,401
ENTRE RIOS,consulta externa,nuevas en menores de 5 anos,2006-08-01,447,438,447,438,885
ENTRE RIOS,consulta externa,nuevas en menores de 5 anos,2006-08-01,472,475,472,475,947
ESCARA,consulta externa,nuevas en menores de 5 anos,2006-08-01,1,3,1,3,4
ESMERALDA,consulta externa,nuevas en menores de 5 anos,2006-08-01,6,0,6,0,6
EUCALIPTUS,consulta externa,nuevas en menores de 5 anos,2006-08-01,156,99,156,99,255
EUREKA (SANTOS MERCADO),consulta externa,nuevas en menores de 5 anos,2006-08-01,56,58,56,58,114
EXALTACION,consulta externa,nuevas en menores de 5 anos,2006-08-01,49,50,49,50,99
FERNANDEZ ALONSO,consulta externa,nuevas en menores de 5 anos,2006-08-01,457,445,457,445,902
FILADELFIA,consulta externa,nuevas en menores de 5 anos,2006-08-01,96,96,96,96,192
GENERAL SAAVEDRA,consulta externa,nuevas en menores de 5 anos,2006-08-01,650,575,650,575,1225
GRAL. J.J. PEREZ (CHARAZANI),consulta externa,nuevas en menores de 5 anos,2006-08-01,128,99,128,99,227
GUANAY,consulta externa,nuevas en menores de 5 anos,2006-08-01,285,280,285,280,565
GUAQUI,consulta externa,nuevas en menores de 5 anos,2006-08-01,50,47,50,47,97
GUAYARAMERIN,consulta externa,nuevas en menores de 5 anos,2006-08-01,1187,1069,1187,1069,2256
GUTIERREZ,consulta externa,nuevas en menores de 5 anos,2006-08-01,388,445,388,445,833
HUACARETA,consulta externa,nuevas en menores de 5 anos,2006-08-01,252,221,252,221,473
HUACAYA (VILLA DE HUACAYA),consulta externa,nuevas en menores de 5 anos,2006-08-01,129,115,129,115,244
HUACHACALLA,consulta externa,nuevas en menores de 5 anos,2006-08-01,0,3,0,3,3
HUANUNI,consulta externa,nuevas en menores de 5 anos,2006-08-01,589,472,589,472,1061
HUARACAJE,consulta externa,nuevas en menores de 5 anos,2006-08-01,110,81,110,81,191
HUAYLLAMARCA,consulta externa,nuevas en menores de 5 anos,2006-08-01,44,61,44,61,105
ICHOCA,consulta externa,nuevas en menores de 5 anos,2006-08-01,51,51,51,51,102
ICLA,consulta externa,nuevas en menores de 5 anos,2006-08-01,494,466,494,466,960
INCAHUASI,consulta externa,nuevas en menores de 5 anos,2006-08-01,702,761,702,761,1463
INGAVI (HUMAITA),consulta externa,nuevas en menores de 5 anos,2006-08-01,51,38,51,38,89
INQUISIVI,consulta externa,nuevas en menores de 5 anos,2006-08-01,173,159,173,159,332
IRUPANA (VILLA DE LANZA),consulta externa,nuevas en menores de 5 anos,2006-08-01,493,188,493,188,681
IXIAMAS,consulta externa,nuevas en menores de 5 anos,2006-08-01,367,301,367,301,668
JESUS DE MACHACA,consulta externa,nuevas en menores de 5 anos,2006-08-01,168,118,168,118,286
LA ASUNTA,consulta externa,nuevas en menores de 5 anos,2006-08-01,575,508,575,508,1083
LA GUARDIA,consulta externa,nuevas en menores de 5 anos,2006-08-01,1158,981,1158,981,2139
LA PAZ,consulta externa,nuevas en menores de 5 anos,2006-08-01,11617,11127,11617,11127,22744
LA RIVERA,consulta externa,nuevas en menores de 5 anos,2006-08-01,3,5,3,5,8
LAGUNILLAS,consulta externa,nuevas en menores de 5 anos,2006-08-01,207,233,207,233,440
LAJA,consulta externa,nuevas en menores de 5 anos,2006-08-01,116,88,116,88,204
LAS CARRERAS,consulta externa,nuevas en menores de 5 anos,2006-08-01,67,72,67,72,139
LICOMA PAMPA,consulta externa,nuevas en menores de 5 anos,2006-08-01,34,39,34,39,73
LLALLAGUA,consulta externa,nuevas en menores de 5 anos,2006-08-01,571,559,571,559,1130
LLICA,consulta externa,nuevas en menores de 5 anos,2006-08-01,63,59,63,59,122
LORETO,consulta externa,nuevas en menores de 5 anos,2006-08-01,59,53,59,53,112
LURIBAY,consulta externa,nuevas en menores de 5 anos,2006-08-01,119,126,119,126,245
MACHACAMARCA,consulta externa,nuevas en menores de 5 anos,2006-08-01,30,32,30,32,62
MACHARETI,consulta externa,nuevas en menores de 5 anos,2006-08-01,333,309,333,309,642
MAGDALENA,consulta externa,nuevas en menores de 5 anos,2006-08-01,223,196,223,196,419
MAIRANA,consulta externa,nuevas en menores de 5 anos,2006-08-01,149,137,149,137,286
MALLA,consulta externa,nuevas en menores de 5 anos,2006-08-01,68,46,68,46,114
MAPIRI,consulta externa,nuevas en menores de 5 anos,2006-08-01,253,215,253,215,468
MECAPACA,consulta externa,nuevas en menores de 5 anos,2006-08-01,154,122,154,122,276
MINEROS,consulta externa,nuevas en menores de 5 anos,2006-08-01,589,456,589,456,1045
MIZQUE,consulta externa,nuevas en menores de 5 anos,2006-08-01,337,314,337,314,651
MOCOMOCO,consulta externa,nuevas en menores de 5 anos,2006-08-01,193,177,193,177,370
MOJINETE,consulta externa,nuevas en menores de 5 anos,2006-08-01,19,22,19,22,41
MOJOCOYA,consulta externa,nuevas en menores de 5 anos,2006-08-01,216,190,216,190,406
MONTEAGUDO,consulta externa,nuevas en menores de 5 anos,2006-08-01,746,665,746,665,1411
MONTERO,consulta externa,nuevas en menores de 5 anos,2006-08-01,2253,1976,2253,1976,4229
MORO MORO,consulta externa,nuevas en menores de 5 anos,2006-08-01,56,37,56,37,93
MOROCHATA,consulta externa,nuevas en menores de 5 anos,2006-08-01,207,175,207,175,382
NACEBE (SANTA ROSA DEL ABUNA),consulta externa,nuevas en menores de 5 anos,2006-08-01,31,31,31,31,62
NUEVO MANOA (NUEVA ESPERANZA),consulta externa,nuevas en menores de 5 anos,2006-08-01,18,10,18,10,28
OCURI,consulta externa,nuevas en menores de 5 anos,2006-08-01,444,393,444,393,837
OKINAWA,consulta externa,nuevas en menores de 5 anos,2006-08-01,367,374,367,374,741
OMEREQUE,consulta externa,nuevas en menores de 5 anos,2006-08-01,128,130,128,130,258
ORURO,consulta externa,nuevas en menores de 5 anos,2006-08-01,4209,3643,4209,3643,7852
PADCAYA,consulta externa,nuevas en menores de 5 anos,2006-08-01,467,429,467,429,896
PADILLA,consulta externa,nuevas en menores de 5 anos,2006-08-01,404,355,404,355,759
PAILON,consulta externa,nuevas en menores de 5 anos,2006-08-01,361,377,361,377,738
PALCA,consulta externa,nuevas en menores de 5 anos,2006-08-01,122,129,122,129,251
PALOS BLANCOS,consulta externa,nuevas en menores de 5 anos,2006-08-01,562,459,562,459,1021
PAMPA AULLAGAS,consulta externa,nuevas en menores de 5 anos,2006-08-01,41,46,41,46,87
PAMPA GRANDE,consulta externa,nuevas en menores de 5 anos,2006-08-01,154,120,154,120,274
PAPEL PAMPA,consulta externa,nuevas en menores de 5 anos,2006-08-01,59,52,59,52,111
PASORAPA,consulta externa,nuevas en menores de 5 anos,2006-08-01,60,62,60,62,122
PATACAMAYA,consulta externa,nuevas en menores de 5 anos,2006-08-01,220,161,220,161,381
PAZÑA,consulta externa,nuevas en menores de 5 anos,2006-08-01,108,110,108,110,218
PELECHUCO,consulta externa,nuevas en menores de 5 anos,2006-08-01,94,67,94,67,161
POCOATA,consulta externa,nuevas en menores de 5 anos,2006-08-01,389,424,389,424,813
POCONA,consulta externa,nuevas en menores de 5 anos,2006-08-01,182,138,182,138,320
POJO (CBBA),consulta externa,nuevas en menores de 5 anos,2006-08-01,87,84,87,84,171
POOPO,consulta externa,nuevas en menores de 5 anos,2006-08-01,61,34,61,34,95
PORCO,consulta externa,nuevas en menores de 5 anos,2006-08-01,125,114,125,114,239
POROMA,consulta externa,nuevas en menores de 5 anos,2006-08-01,471,430,471,430,901
PORONGO,consulta externa,nuevas en menores de 5 anos,2006-08-01,267,202,267,202,469
PORTACHUELO,consulta externa,nuevas en menores de 5 anos,2006-08-01,381,457,381,457,838
PORVENIR,consulta externa,nuevas en menores de 5 anos,2006-08-01,242,163,242,163,405
POSTRER VALLE,consulta externa,nuevas en menores de 5 anos,2006-08-01,55,46,55,46,101
POTOSI,consulta externa,nuevas en menores de 5 anos,2006-08-01,3308,2616,3308,2616,5924
PRESTO,consulta externa,nuevas en menores de 5 anos,2006-08-01,338,291,338,291,629
PUCARA,consulta externa,nuevas en menores de 5 anos,2006-08-01,64,50,64,50,114
PUCARANI,consulta externa,nuevas en menores de 5 anos,2006-08-01,190,179,190,179,369
PUERTO ACOSTA,consulta externa,nuevas en menores de 5 anos,2006-08-01,272,246,272,246,518
PUERTO CARABUCO,consulta externa,nuevas en menores de 5 anos,2006-08-01,127,160,127,160,287
PUERTO GONZALO MORENO,consulta externa,nuevas en menores de 5 anos,2006-08-01,141,126,141,126,267
PUERTO PEREZ,consulta externa,nuevas en menores de 5 anos,2006-08-01,39,34,39,34,73
PUERTO QUIJARRO,consulta externa,nuevas en menores de 5 anos,2006-08-01,261,227,261,227,488
PUERTO RICO,consulta externa,nuevas en menores de 5 anos,2006-08-01,315,243,315,243,558
PUERTO SILES,consulta externa,nuevas en menores de 5 anos,2006-08-01,14,32,14,32,46
PUERTO SUAREZ,consulta externa,nuevas en menores de 5 anos,2006-08-01,253,207,253,207,460
PUERTO VILLARROEL,consulta externa,nuevas en menores de 5 anos,2006-08-01,1088,1042,1088,1042,2130
PUNA,consulta externa,nuevas en menores de 5 anos,2006-08-01,684,570,684,570,1254
PUNATA,consulta externa,nuevas en menores de 5 anos,2006-08-01,314,320,314,320,634
QUIABAYA,consulta externa,nuevas en menores de 5 anos,2006-08-01,46,40,46,40,86
QUILLACOLLO,consulta externa,nuevas en menores de 5 anos,2006-08-01,753,735,753,735,1488
QUIME,consulta externa,nuevas en menores de 5 anos,2006-08-01,84,90,84,90,174
QUIRUSILLAS,consulta externa,nuevas en menores de 5 anos,2006-08-01,58,41,58,41,99
RAVELO,consulta externa,nuevas en menores de 5 anos,2006-08-01,443,361,443,361,804
REYES,consulta externa,nuevas en menores de 5 anos,2006-08-01,101,95,101,95,196
RIBERALTA,consulta externa,nuevas en menores de 5 anos,2006-08-01,1870,1829,1870,1829,3699
ROBORE,consulta externa,nuevas en menores de 5 anos,2006-08-01,293,311,293,311,604
RURRENABAQUE,consulta externa,nuevas en menores de 5 anos,2006-08-01,346,353,346,353,699
SABAYA,consulta externa,nuevas en menores de 5 anos,2006-08-01,48,52,48,52,100
SACABA,consulta externa,nuevas en menores de 5 anos,2006-08-01,939,833,939,833,1772
SACABAMBA,consulta externa,nuevas en menores de 5 anos,2006-08-01,47,31,47,31,78
SACACA,consulta externa,nuevas en menores de 5 anos,2006-08-01,796,708,796,708,1504
SAIPINA,consulta externa,nuevas en menores de 5 anos,2006-08-01,80,71,80,71,151
SALINAS DE GARCI MENDOZA,consulta externa,nuevas en menores de 5 anos,2006-08-01,196,125,196,125,321
SAMAIPATA,consulta externa,nuevas en menores de 5 anos,2006-08-01,191,127,191,127,318
SAN AGUSTIN,consulta externa,nuevas en menores de 5 anos,2006-08-01,56,71,56,71,127
SAN ANDRES,consulta externa,nuevas en menores de 5 anos,2006-08-01,311,295,311,295,606
SAN ANDRES DE MACHACA,consulta externa,nuevas en menores de 5 anos,2006-08-01,47,26,47,26,73
SAN ANTONIO DE ESMORUCO,consulta externa,nuevas en menores de 5 anos,2006-08-01,27,30,27,30,57
SAN ANTONIO DE LOMERIO,consulta externa,nuevas en menores de 5 anos,2006-08-01,118,89,118,89,207
SAN BENITO,consulta externa,nuevas en menores de 5 anos,2006-08-01,134,124,134,124,258
SAN BORJA,consulta externa,nuevas en menores de 5 anos,2006-08-01,668,579,668,579,1247
SAN BUENA VENTURA,consulta externa,nuevas en menores de 5 anos,2006-08-01,344,322,344,322,666
SAN CARLOS,consulta externa,nuevas en menores de 5 anos,2006-08-01,526,475,526,475,1001
SAN IGNACIO,consulta externa,nuevas en menores de 5 anos,2006-08-01,600,541,600,541,1141
SAN IGNACIO DE VELASCO,consulta externa,nuevas en menores de 5 anos,2006-08-01,1146,1076,1146,1076,2222
SAN JAVIER(BNI),consulta externa,nuevas en menores de 5 anos,2006-08-01,137,109,137,109,246
SAN JAVIER(STC),consulta externa,nuevas en menores de 5 anos,2006-08-01,169,132,169,132,301
SAN JOAQUIN,consulta externa,nuevas en menores de 5 anos,2006-08-01,66,73,66,73,139
SAN JOSE DE CHIQUITOS,consulta externa,nuevas en menores de 5 anos,2006-08-01,345,381,345,381,726
SAN JUAN DE YAPACANI,consulta externa,nuevas en menores de 5 anos,2006-08-01,391,324,391,324,715
SAN JULIAN,consulta externa,nuevas en menores de 5 anos,2006-08-01,1121,990,1121,990,2111
SAN LORENZO(PND),consulta externa,nuevas en menores de 5 anos,2006-08-01,221,184,221,184,405
SAN LORENZO(TJA),consulta externa,nuevas en menores de 5 anos,2006-08-01,528,472,528,472,1000
SAN LUCAS,consulta externa,nuevas en menores de 5 anos,2006-08-01,1051,988,1051,988,2039
SAN MATIAS,consulta externa,nuevas en menores de 5 anos,2006-08-01,1678,254,1678,254,1932
SAN MIGUEL DE VELASCO,consulta externa,nuevas en menores de 5 anos,2006-08-01,169,142,169,142,311
SAN PABLO DE LIPEZ,consulta externa,nuevas en menores de 5 anos,2006-08-01,91,95,91,95,186
SAN PEDRO,consulta externa,nuevas en menores de 5 anos,2006-08-01,510,498,510,498,1008
SAN PEDRO DE BUENA VISTA,consulta externa,nuevas en menores de 5 anos,2006-08-01,701,646,701,646,1347
SAN PEDRO DE CURAHUARA,consulta externa,nuevas en menores de 5 anos,2006-08-01,67,34,67,34,101
SAN PEDRO DE QUEMES,consulta externa,nuevas en menores de 5 anos,2006-08-01,8,11,8,11,19
SAN PEDRO DE TIQUINA,consulta externa,nuevas en menores de 5 anos,2006-08-01,42,40,42,40,82
SAN PEDRO(PND),consulta externa,nuevas en menores de 5 anos,2006-08-01,52,91,52,91,143
SAN RAFAEL,consulta externa,nuevas en menores de 5 anos,2006-08-01,87,77,87,77,164
SAN RAMON,consulta externa,nuevas en menores de 5 anos,2006-08-01,122,72,122,72,194
SAN RAMON,consulta externa,nuevas en menores de 5 anos,2006-08-01,200,122,200,122,322
SANTA ANA,consulta externa,nuevas en menores de 5 anos,2006-08-01,299,290,299,290,589
SANTA CRUZ DE LA SIERRA,consulta externa,nuevas en menores de 5 anos,2006-08-01,21378,19514,21378,19514,40892
SANTA ROSA,consulta externa,nuevas en menores de 5 anos,2006-08-01,228,220,228,220,448
SANTA ROSA DEL SARA,consulta externa,nuevas en menores de 5 anos,2006-08-01,523,535,523,535,1058
SANTIAGO DE CALLAPA,consulta externa,nuevas en menores de 5 anos,2006-08-01,35,48,35,48,83
SANTIAGO DE HUARI,consulta externa,nuevas en menores de 5 anos,2006-08-01,107,86,107,86,193
SANTIAGO DE MACHACA,consulta externa,nuevas en menores de 5 anos,2006-08-01,40,31,40,31,71
SANTIVAÑES,consulta externa,nuevas en menores de 5 anos,2006-08-01,145,136,145,136,281
SANTUARIO DE QUILLACAS,consulta externa,nuevas en menores de 5 anos,2006-08-01,33,43,33,43,76
SAPAHAQUI,consulta externa,nuevas en menores de 5 anos,2006-08-01,119,112,119,112,231
SENA,consulta externa,nuevas en menores de 5 anos,2006-08-01,145,141,145,141,286
SICA SICA (VILLA AROMA),consulta externa,nuevas en menores de 5 anos,2006-08-01,140,152,140,152,292
SICAYA,consulta externa,nuevas en menores de 5 anos,2006-08-01,57,36,57,36,93
SIPE SIPE,consulta externa,nuevas en menores de 5 anos,2006-08-01,365,307,365,307,672
SOPACHUY,consulta externa,nuevas en menores de 5 anos,2006-08-01,333,325,333,325,658
SORACACHI,consulta externa,nuevas en menores de 5 anos,2006-08-01,104,98,104,98,202
SORATA,consulta externa,nuevas en menores de 5 anos,2006-08-01,215,184,215,184,399
SUCRE,consulta externa,nuevas en menores de 5 anos,2006-08-01,5444,4900,5444,4900,10344
TACACHI,consulta externa,nuevas en menores de 5 anos,2006-08-01,9,8,9,8,17
TACACOMA,consulta externa,nuevas en menores de 5 anos,2006-08-01,60,62,60,62,122
TACOBAMBA,consulta externa,nuevas en menores de 5 anos,2006-08-01,141,123,141,123,264
TACOPAYA,consulta externa,nuevas en menores de 5 anos,2006-08-01,131,144,131,144,275
TAHUA,consulta externa,nuevas en menores de 5 anos,2006-08-01,20,14,20,14,34
TAPACARI,consulta externa,nuevas en menores de 5 anos,2006-08-01,525,444,525,444,969
TARABUCO,consulta externa,nuevas en menores de 5 anos,2006-08-01,613,538,613,538,1151
TARACO,consulta externa,nuevas en menores de 5 anos,2006-08-01,18,11,18,11,29
TARATA,consulta externa,nuevas en menores de 5 anos,2006-08-01,128,129,128,129,257
TARIJA,consulta externa,nuevas en menores de 5 anos,2006-08-01,2946,2637,2946,2637,5583
TARVITA,consulta externa,nuevas en menores de 5 anos,2006-08-01,583,589,583,589,1172
TEOPONTE,consulta externa,nuevas en menores de 5 anos,2006-08-01,198,154,198,154,352
TIAWANACU,consulta externa,nuevas en menores de 5 anos,2006-08-01,93,94,93,94,187
TINGUIPAYA,consulta externa,nuevas en menores de 5 anos,2006-08-01,402,418,402,418,820
TIPUANI,consulta externa,nuevas en menores de 5 anos,2006-08-01,119,122,119,122,241
TIQUIPAYA,consulta externa,nuevas en menores de 5 anos,2006-08-01,517,415,517,415,932
TIRAQUE (CBBA),consulta externa,nuevas en menores de 5 anos,2006-08-01,834,811,834,811,1645
TITO YUPANQUI (PARQUIPUJIO),consulta externa,nuevas en menores de 5 anos,2006-08-01,32,25,32,25,57
TOCO,consulta externa,nuevas en menores de 5 anos,2006-08-01,58,54,58,54,112
TOLATA,consulta externa,nuevas en menores de 5 anos,2006-08-01,70,49,70,49,119
TOLEDO,consulta externa,nuevas en menores de 5 anos,2006-08-01,123,95,123,95,218
TOMAVE,consulta externa,nuevas en menores de 5 anos,2006-08-01,232,187,232,187,419
TOMINA,consulta externa,nuevas en menores de 5 anos,2006-08-01,315,276,315,276,591
TORO TORO,consulta externa,nuevas en menores de 5 anos,2006-08-01,269,281,269,281,550
TOTORA(CBBA),consulta externa,nuevas en menores de 5 anos,2006-08-01,286,224,286,224,510
TOTORA(ORR),consulta externa,nuevas en menores de 5 anos,2006-08-01,67,81,67,81,148
TRIGAL,consulta externa,nuevas en menores de 5 anos,2006-08-01,47,54,47,54,101
TRINIDAD,consulta externa,nuevas en menores de 5 anos,2006-08-01,2096,1891,2096,1891,3987
TUPIZA,consulta externa,nuevas en menores de 5 anos,2006-08-01,956,895,956,895,1851
TURCO,consulta externa,nuevas en menores de 5 anos,2006-08-01,72,67,72,67,139
UMALA,consulta externa,nuevas en menores de 5 anos,2006-08-01,33,31,33,31,64
UNCIA,consulta externa,nuevas en menores de 5 anos,2006-08-01,588,555,588,555,1143
URIONDO (A. CONCEPCION),consulta externa,nuevas en menores de 5 anos,2006-08-01,405,365,405,365,770
URUBICHA,consulta externa,nuevas en menores de 5 anos,2006-08-01,247,181,247,181,428
UYUNI,consulta externa,nuevas en menores de 5 anos,2006-08-01,268,192,268,192,460
VACAS,consulta externa,nuevas en menores de 5 anos,2006-08-01,173,143,173,143,316
VALLEGRANDE,consulta externa,nuevas en menores de 5 anos,2006-08-01,295,254,295,254,549
VIACHA,consulta externa,nuevas en menores de 5 anos,2006-08-01,400,342,400,342,742
VILA VILA,consulta externa,nuevas en menores de 5 anos,2006-08-01,42,48,42,48,90
VILLA MONTES,consulta externa,nuevas en menores de 5 anos,2006-08-01,734,612,734,612,1346
VILLA NUEVA (LOMA ALTA),consulta externa,nuevas en menores de 5 anos,2006-08-01,72,72,72,72,144
VILLA RIVERO,consulta externa,nuevas en menores de 5 anos,2006-08-01,117,132,117,132,249
VILLA SERRANO,consulta externa,nuevas en menores de 5 anos,2006-08-01,433,418,433,418,851
VILLA TUNARI,consulta externa,nuevas en menores de 5 anos,2006-08-01,1592,1417,1592,1417,3009
VILLA VACA GUZMAN (MUYUPAMPA),consulta externa,nuevas en menores de 5 anos,2006-08-01,264,290,264,290,554
VILLAZON,consulta externa,nuevas en menores de 5 anos,2006-08-01,716,708,716,708,1424
VINTO,consulta externa,nuevas en menores de 5 anos,2006-08-01,193,113,193,113,306
VITICHI,consulta externa,nuevas en menores de 5 anos,2006-08-01,230,235,230,235,465
WALDO BALLIVIAN,consulta externa,nuevas en menores de 5 anos,2006-08-01,31,19,31,19,50
WARNES,consulta externa,nuevas en menores de 5 anos,2006-08-01,1317,1206,1317,1206,2523
YACO,consulta externa,nuevas en menores de 5 anos,2006-08-01,119,105,119,105,224
YACUIBA,consulta externa,nuevas en menores de 5 anos,2006-08-01,1962,1776,1962,1776,3738
YAMPARAEZ,consulta externa,nuevas en menores de 5 anos,2006-08-01,149,128,149,128,277
YANACACHI,consulta externa,nuevas en menores de 5 anos,2006-08-01,66,64,66,64,130
YAPACANI,consulta externa,nuevas en menores de 5 anos,2006-08-01,818,783,818,783,1601
YOCALLA,consulta externa,nuevas en menores de 5 anos,2006-08-01,111,73,111,73,184
YOTALA,consulta externa,nuevas en menores de 5 anos,2006-08-01,123,116,123,116,239
YUNCHARA,consulta externa,nuevas en menores de 5 anos,2006-08-01,165,150,165,150,315
ZUDAÑEZ,consulta externa,nuevas en menores de 5 anos,2006-08-01,294,328,294,328,622
ACACIO,consulta externa,nuevas en menores de 5 anos,2006-09-01,150,128,150,128,278
ACHACACHI,consulta externa,nuevas en menores de 5 anos,2006-09-01,357,282,357,282,639
ACHOCALLA,consulta externa,nuevas en menores de 5 anos,2006-09-01,60,42,60,42,102
AIQUILE,consulta externa,nuevas en menores de 5 anos,2006-09-01,382,295,382,295,677
ALCALA,consulta externa,nuevas en menores de 5 anos,2006-09-01,177,157,177,157,334
ANCORAIMES,consulta externa,nuevas en menores de 5 anos,2006-09-01,171,137,171,137,308
ANDAMARCA,consulta externa,nuevas en menores de 5 anos,2006-09-01,55,67,55,67,122
ANTEQUERA,consulta externa,nuevas en menores de 5 anos,2006-09-01,39,29,39,29,68
ANZALDO,consulta externa,nuevas en menores de 5 anos,2006-09-01,131,132,131,132,263
APOLO,consulta externa,nuevas en menores de 5 anos,2006-09-01,327,337,327,337,664
ARAMPAMPA,consulta externa,nuevas en menores de 5 anos,2006-09-01,150,144,150,144,294
ARANI,consulta externa,nuevas en menores de 5 anos,2006-09-01,68,53,68,53,121
ARBIETO,consulta externa,nuevas en menores de 5 anos,2006-09-01,73,71,73,71,144
ARQUE,consulta externa,nuevas en menores de 5 anos,2006-09-01,203,177,203,177,380
ASCENCION DE GUARAYOS,consulta externa,nuevas en menores de 5 anos,2006-09-01,396,394,396,394,790
ATOCHA,consulta externa,nuevas en menores de 5 anos,2006-09-01,303,246,303,246,549
AUCAPATA,consulta externa,nuevas en menores de 5 anos,2006-09-01,80,76,80,76,156
AYATA,consulta externa,nuevas en menores de 5 anos,2006-09-01,146,126,146,126,272
AYO AYO,consulta externa,nuevas en menores de 5 anos,2006-09-01,45,41,45,41,86
AYOPAYA (V. DE INDEPENDENCIA),consulta externa,nuevas en menores de 5 anos,2006-09-01,449,452,449,452,901
AZURDUY,consulta externa,nuevas en menores de 5 anos,2006-09-01,540,489,540,489,1029
BATALLAS,consulta externa,nuevas en menores de 5 anos,2006-09-01,84,71,84,71,155
BAURES,consulta externa,nuevas en menores de 5 anos,2006-09-01,83,88,83,88,171
BELEN DE ANDAMARCA,consulta externa,nuevas en menores de 5 anos,2006-09-01,20,18,20,18,38
BELEN DE URMIRI,consulta externa,nuevas en menores de 5 anos,2006-09-01,59,33,59,33,92
BELLA FLOR,consulta externa,nuevas en menores de 5 anos,2006-09-01,26,32,26,32,58
BERMEJO,consulta externa,nuevas en menores de 5 anos,2006-09-01,1038,1010,1038,1010,2048
BETANZOS,consulta externa,nuevas en menores de 5 anos,2006-09-01,633,594,633,594,1227
BOLIVAR,consulta externa,nuevas en menores de 5 anos,2006-09-01,218,227,218,227,445
BOLPEBRA,consulta externa,nuevas en menores de 5 anos,2006-09-01,47,42,47,42,89
BOYUIBE,consulta externa,nuevas en menores de 5 anos,2006-09-01,132,116,132,116,248
BUENA VISTA,consulta externa,nuevas en menores de 5 anos,2006-09-01,266,218,266,218,484
CABEZAS,consulta externa,nuevas en menores de 5 anos,2006-09-01,490,362,490,362,852
CAIROMA,consulta externa,nuevas en menores de 5 anos,2006-09-01,197,139,197,139,336
"CAIZA ""D""",consulta externa,nuevas en menores de 5 anos,2006-09-01,118,132,118,132,250
CAJUATA,consulta externa,nuevas en menores de 5 anos,2006-09-01,159,154,159,154,313
CALACOTO,consulta externa,nuevas en menores de 5 anos,2006-09-01,53,52,53,52,105
CALAMARCA,consulta externa,nuevas en menores de 5 anos,2006-09-01,156,144,156,144,300
CAMARGO,consulta externa,nuevas en menores de 5 anos,2006-09-01,442,456,442,456,898
CAMATAQUI (C. VILLA ABECIA),consulta externa,nuevas en menores de 5 anos,2006-09-01,66,61,66,61,127
CAMIRI,consulta externa,nuevas en menores de 5 anos,2006-09-01,999,947,999,947,1946
CAPINOTA,consulta externa,nuevas en menores de 5 anos,2006-09-01,348,315,348,315,663
CAQUIAVIRI,consulta externa,nuevas en menores de 5 anos,2006-09-01,63,68,63,68,131
CARACOLLO,consulta externa,nuevas en menores de 5 anos,2006-09-01,141,147,141,147,288
CARANAVI,consulta externa,nuevas en menores de 5 anos,2006-09-01,1103,944,1103,944,2047
CARANGAS,consulta externa,nuevas en menores de 5 anos,2006-09-01,5,5,5,5,10
CARAPARI,consulta externa,nuevas en menores de 5 anos,2006-09-01,241,192,241,192,433
CARIPUYO,consulta externa,nuevas en menores de 5 anos,2006-09-01,233,184,233,184,417
CARMEN RIVERO TORREZ,consulta externa,nuevas en menores de 5 anos,2006-09-01,77,68,77,68,145
CATACORA,consulta externa,nuevas en menores de 5 anos,2006-09-01,21,29,21,29,50
CHACARILLA,consulta externa,nuevas en menores de 5 anos,2006-09-01,31,23,31,23,54
CHALLAPATA,consulta externa,nuevas en menores de 5 anos,2006-09-01,296,271,296,271,567
CHAQUI,consulta externa,nuevas en menores de 5 anos,2006-09-01,107,98,107,98,205
CHARAGUA,consulta externa,nuevas en menores de 5 anos,2006-09-01,658,634,658,634,1292
CHARAÑA,consulta externa,nuevas en menores de 5 anos,2006-09-01,11,16,11,16,27
CHAYANTA,consulta externa,nuevas en menores de 5 anos,2006-09-01,388,357,388,357,745
CHIMORE,consulta externa,nuevas en menores de 5 anos,2006-09-01,472,460,472,460,932
CHIPAYA,consulta externa,nuevas en menores de 5 anos,2006-09-01,23,31,23,31,54
CHOQUE COTA,consulta externa,nuevas en menores de 5 anos,2006-09-01,360,46,360,46,406
CHULUMANI (V. DE LA LIBERTAD),consulta externa,nuevas en menores de 5 anos,2006-09-01,208,224,208,224,432
CHUMA,consulta externa,nuevas en menores de 5 anos,2006-09-01,245,188,245,188,433
CLIZA,consulta externa,nuevas en menores de 5 anos,2006-09-01,162,181,162,181,343
COBIJA,consulta externa,nuevas en menores de 5 anos,2006-09-01,727,751,727,751,1478
COCHABAMBA,consulta externa,nuevas en menores de 5 anos,2006-09-01,7822,6994,7822,6994,14816
COIPASA,consulta externa,nuevas en menores de 5 anos,2006-09-01,8,9,8,9,17
COLCAPIRHUA,consulta externa,nuevas en menores de 5 anos,2006-09-01,369,382,369,382,751
"COLCHA ""K""",consulta externa,nuevas en menores de 5 anos,2006-09-01,130,137,130,137,267
COLLANA,consulta externa,nuevas en menores de 5 anos,2006-09-01,23,14,23,14,37
COLOMI,consulta externa,nuevas en menores de 5 anos,2006-09-01,295,293,295,293,588
COLPA BELGICA,consulta externa,nuevas en menores de 5 anos,2006-09-01,129,110,129,110,239
COLQUECHACA,consulta externa,nuevas en menores de 5 anos,2006-09-01,779,729,779,729,1508
COLQUENCHA,consulta externa,nuevas en menores de 5 anos,2006-09-01,69,63,69,63,132
COLQUIRI,consulta externa,nuevas en menores de 5 anos,2006-09-01,389,337,389,337,726
COMANCHE,consulta externa,nuevas en menores de 5 anos,2006-09-01,28,27,28,27,55
COMARAPA,consulta externa,nuevas en menores de 5 anos,2006-09-01,342,327,342,327,669
COMBAYA,consulta externa,nuevas en menores de 5 anos,2006-09-01,31,25,31,25,56
CONCEPCION,consulta externa,nuevas en menores de 5 anos,2006-09-01,240,141,240,141,381
COPACABANA,consulta externa,nuevas en menores de 5 anos,2006-09-01,81,67,81,67,148
CORIPATA,consulta externa,nuevas en menores de 5 anos,2006-09-01,258,217,258,217,475
CORO CORO,consulta externa,nuevas en menores de 5 anos,2006-09-01,70,67,70,67,137
COROICO,consulta externa,nuevas en menores de 5 anos,2006-09-01,252,220,252,220,472
CORQUE,consulta externa,nuevas en menores de 5 anos,2006-09-01,78,78,78,78,156
COTAGAITA,consulta externa,nuevas en menores de 5 anos,2006-09-01,499,470,499,470,969
COTOCA,consulta externa,nuevas en menores de 5 anos,2006-09-01,482,462,482,462,944
CUATRO CAÑADAS,consulta externa,nuevas en menores de 5 anos,2006-09-01,395,356,395,356,751
CUCHUMUELA (V. G. VILLARROEL),consulta externa,nuevas en menores de 5 anos,2006-09-01,22,11,22,11,33
CUEVO,consulta externa,nuevas en menores de 5 anos,2006-09-01,85,120,85,120,205
CULPINA,consulta externa,nuevas en menores de 5 anos,2006-09-01,518,454,518,454,972
CURAHUARA DE CARANGAS,consulta externa,nuevas en menores de 5 anos,2006-09-01,489,83,489,83,572
CURVA,consulta externa,nuevas en menores de 5 anos,2006-09-01,52,29,52,29,81
DESAGUADERO,consulta externa,nuevas en menores de 5 anos,2006-09-01,50,24,50,24,74
EL ALTO,consulta externa,nuevas en menores de 5 anos,2006-09-01,8683,8088,8683,8088,16771
EL CHORO,consulta externa,nuevas en menores de 5 anos,2006-09-01,53,52,53,52,105
EL PUENTE(STC),consulta externa,nuevas en menores de 5 anos,2006-09-01,270,272,270,272,542
EL PUENTE(TJA),consulta externa,nuevas en menores de 5 anos,2006-09-01,243,214,243,214,457
EL TORNO,consulta externa,nuevas en menores de 5 anos,2006-09-01,826,728,826,728,1554
EL VILLAR,consulta externa,nuevas en menores de 5 anos,2006-09-01,130,155,130,155,285
ENTRE RIOS,consulta externa,nuevas en menores de 5 anos,2006-09-01,486,451,486,451,937
ENTRE RIOS,consulta externa,nuevas en menores de 5 anos,2006-09-01,436,375,436,375,811
ESCARA,consulta externa,nuevas en menores de 5 anos,2006-09-01,3,6,3,6,9
ESMERALDA,consulta externa,nuevas en menores de 5 anos,2006-09-01,5,4,5,4,9
EUCALIPTUS,consulta externa,nuevas en menores de 5 anos,2006-09-01,1401,138,1401,138,1539
EUREKA (SANTOS MERCADO),consulta externa,nuevas en menores de 5 anos,2006-09-01,28,55,28,55,83
EXALTACION,consulta externa,nuevas en menores de 5 anos,2006-09-01,65,65,65,65,130
FERNANDEZ ALONSO,consulta externa,nuevas en menores de 5 anos,2006-09-01,354,378,354,378,732
FILADELFIA,consulta externa,nuevas en menores de 5 anos,2006-09-01,94,97,94,97,191
GENERAL SAAVEDRA,consulta externa,nuevas en menores de 5 anos,2006-09-01,541,490,541,490,1031
GRAL. J.J. PEREZ (CHARAZANI),consulta externa,nuevas en menores de 5 anos,2006-09-01,199,184,199,184,383
GUANAY,consulta externa,nuevas en menores de 5 anos,2006-09-01,331,259,331,259,590
GUAQUI,consulta externa,nuevas en menores de 5 anos,2006-09-01,32,40,32,40,72
GUAYARAMERIN,consulta externa,nuevas en menores de 5 anos,2006-09-01,1044,1035,1044,1035,2079
GUTIERREZ,consulta externa,nuevas en menores de 5 anos,2006-09-01,347,339,347,339,686
HUACARETA,consulta externa,nuevas en menores de 5 anos,2006-09-01,214,199,214,199,413
HUACAYA (VILLA DE HUACAYA),consulta externa,nuevas en menores de 5 anos,2006-09-01,108,106,108,106,214
HUACHACALLA,consulta externa,nuevas en menores de 5 anos,2006-09-01,29,18,29,18,47
HUANUNI,consulta externa,nuevas en menores de 5 anos,2006-09-01,517,440,517,440,957
HUARACAJE,consulta externa,nuevas en menores de 5 anos,2006-09-01,92,62,92,62,154
HUAYLLAMARCA,consulta externa,nuevas en menores de 5 anos,2006-09-01,451,89,451,89,540
ICHOCA,consulta externa,nuevas en menores de 5 anos,2006-09-01,73,76,73,76,149
ICLA,consulta externa,nuevas en menores de 5 anos,2006-09-01,349,326,349,326,675
INCAHUASI,consulta externa,nuevas en menores de 5 anos,2006-09-01,584,570,584,570,1154
INGAVI (HUMAITA),consulta externa,nuevas en menores de 5 anos,2006-09-01,27,19,27,19,46
INQUISIVI,consulta externa,nuevas en menores de 5 anos,2006-09-01,170,169,170,169,339
IRUPANA (VILLA DE LANZA),consulta externa,nuevas en menores de 5 anos,2006-09-01,296,252,296,252,548
IXIAMAS,consulta externa,nuevas en menores de 5 anos,2006-09-01,239,252,239,252,491
JESUS DE MACHACA,consulta externa,nuevas en menores de 5 anos,2006-09-01,132,115,132,115,247
LA ASUNTA,consulta externa,nuevas en menores de 5 anos,2006-09-01,546,527,546,527,1073
LA GUARDIA,consulta externa,nuevas en menores de 5 anos,2006-09-01,1129,1009,1129,1009,2138
LA PAZ,consulta externa,nuevas en menores de 5 anos,2006-09-01,12491,12314,12491,12314,24805
LA RIVERA,consulta externa,nuevas en menores de 5 anos,2006-09-01,2,2,2,2,4
LAGUNILLAS,consulta externa,nuevas en menores de 5 anos,2006-09-01,209,237,209,237,446
LAJA,consulta externa,nuevas en menores de 5 anos,2006-09-01,114,113,114,113,227
LAS CARRERAS,consulta externa,nuevas en menores de 5 anos,2006-09-01,86,54,86,54,140
LICOMA PAMPA,consulta externa,nuevas en menores de 5 anos,2006-09-01,36,40,36,40,76
LLALLAGUA,consulta externa,nuevas en menores de 5 anos,2006-09-01,696,642,696,642,1338
LLICA,consulta externa,nuevas en menores de 5 anos,2006-09-01,46,38,46,38,84
LORETO,consulta externa,nuevas en menores de 5 anos,2006-09-01,73,94,73,94,167
LURIBAY,consulta externa,nuevas en menores de 5 anos,2006-09-01,150,144,150,144,294
MACHACAMARCA,consulta externa,nuevas en menores de 5 anos,2006-09-01,33,27,33,27,60
MACHARETI,consulta externa,nuevas en menores de 5 anos,2006-09-01,267,270,267,270,537
MAGDALENA,consulta externa,nuevas en menores de 5 anos,2006-09-01,190,178,190,178,368
MAIRANA,consulta externa,nuevas en menores de 5 anos,2006-09-01,127,130,127,130,257
MALLA,consulta externa,nuevas en menores de 5 anos,2006-09-01,55,24,55,24,79
MAPIRI,consulta externa,nuevas en menores de 5 anos,2006-09-01,226,191,226,191,417
MECAPACA,consulta externa,nuevas en menores de 5 anos,2006-09-01,152,135,152,135,287
MINEROS,consulta externa,nuevas en menores de 5 anos,2006-09-01,436,383,436,383,819
MIZQUE,consulta externa,nuevas en menores de 5 anos,2006-09-01,391,382,391,382,773
MOCOMOCO,consulta externa,nuevas en menores de 5 anos,2006-09-01,136,129,136,129,265
MOJINETE,consulta externa,nuevas en menores de 5 anos,2006-09-01,25,18,25,18,43
MOJOCOYA,consulta externa,nuevas en menores de 5 anos,2006-09-01,151,143,151,143,294
MONTEAGUDO,consulta externa,nuevas en menores de 5 anos,2006-09-01,685,624,685,624,1309
MONTERO,consulta externa,nuevas en menores de 5 anos,2006-09-01,2258,1911,2258,1911,4169
MORO MORO,consulta externa,nuevas en menores de 5 anos,2006-09-01,38,34,38,34,72
MOROCHATA,consulta externa,nuevas en menores de 5 anos,2006-09-01,247,202,247,202,449
NACEBE (SANTA ROSA DEL ABUNA),consulta externa,nuevas en menores de 5 anos,2006-09-01,33,34,33,34,67
NUEVO MANOA (NUEVA ESPERANZA),consulta externa,nuevas en menores de 5 anos,2006-09-01,48,44,48,44,92
OCURI,consulta externa,nuevas en menores de 5 anos,2006-09-01,404,390,404,390,794
OKINAWA,consulta externa,nuevas en menores de 5 anos,2006-09-01,339,348,339,348,687
OMEREQUE,consulta externa,nuevas en menores de 5 anos,2006-09-01,92,96,92,96,188
ORURO,consulta externa,nuevas en menores de 5 anos,2006-09-01,4036,3632,4036,3632,7668
PADCAYA,consulta externa,nuevas en menores de 5 anos,2006-09-01,441,429,441,429,870
PADILLA,consulta externa,nuevas en menores de 5 anos,2006-09-01,351,268,351,268,619
PAILON,consulta externa,nuevas en menores de 5 anos,2006-09-01,265,251,265,251,516
PALCA,consulta externa,nuevas en menores de 5 anos,2006-09-01,100,99,100,99,199
PALOS BLANCOS,consulta externa,nuevas en menores de 5 anos,2006-09-01,598,498,598,498,1096
PAMPA AULLAGAS,consulta externa,nuevas en menores de 5 anos,2006-09-01,38,33,38,33,71
PAMPA GRANDE,consulta externa,nuevas en menores de 5 anos,2006-09-01,128,111,128,111,239
PAPEL PAMPA,consulta externa,nuevas en menores de 5 anos,2006-09-01,45,47,45,47,92
PASORAPA,consulta externa,nuevas en menores de 5 anos,2006-09-01,37,40,37,40,77
PATACAMAYA,consulta externa,nuevas en menores de 5 anos,2006-09-01,231,184,231,184,415
PAZÑA,consulta externa,nuevas en menores de 5 anos,2006-09-01,122,116,122,116,238
PELECHUCO,consulta externa,nuevas en menores de 5 anos,2006-09-01,65,63,65,63,128
POCOATA,consulta externa,nuevas en menores de 5 anos,2006-09-01,440,429,440,429,869
POCONA,consulta externa,nuevas en menores de 5 anos,2006-09-01,178,162,178,162,340
POJO (CBBA),consulta externa,nuevas en menores de 5 anos,2006-09-01,197,192,197,192,389
POOPO,consulta externa,nuevas en menores de 5 anos,2006-09-01,25,35,25,35,60
PORCO,consulta externa,nuevas en menores de 5 anos,2006-09-01,111,116,111,116,227
POROMA,consulta externa,nuevas en menores de 5 anos,2006-09-01,494,471,494,471,965
PORONGO,consulta externa,nuevas en menores de 5 anos,2006-09-01,161,159,161,159,320
PORTACHUELO,consulta externa,nuevas en menores de 5 anos,2006-09-01,352,358,352,358,710
PORVENIR,consulta externa,nuevas en menores de 5 anos,2006-09-01,132,115,132,115,247
POSTRER VALLE,consulta externa,nuevas en menores de 5 anos,2006-09-01,43,45,43,45,88
POTOSI,consulta externa,nuevas en menores de 5 anos,2006-09-01,3082,2697,3082,2697,5779
PRESTO,consulta externa,nuevas en menores de 5 anos,2006-09-01,273,243,273,243,516
PUCARA,consulta externa,nuevas en menores de 5 anos,2006-09-01,33,23,33,23,56
PUCARANI,consulta externa,nuevas en menores de 5 anos,2006-09-01,188,178,188,178,366
PUERTO ACOSTA,consulta externa,nuevas en menores de 5 anos,2006-09-01,262,252,262,252,514
PUERTO CARABUCO,consulta externa,nuevas en menores de 5 anos,2006-09-01,143,162,143,162,305
PUERTO GONZALO MORENO,consulta externa,nuevas en menores de 5 anos,2006-09-01,79,80,79,80,159
PUERTO PEREZ,consulta externa,nuevas en menores de 5 anos,2006-09-01,90,76,90,76,166
PUERTO QUIJARRO,consulta externa,nuevas en menores de 5 anos,2006-09-01,244,273,244,273,517
PUERTO RICO,consulta externa,nuevas en menores de 5 anos,2006-09-01,164,172,164,172,336
PUERTO SILES,consulta externa,nuevas en menores de 5 anos,2006-09-01,39,56,39,56,95
PUERTO SUAREZ,consulta externa,nuevas en menores de 5 anos,2006-09-01,366,349,366,349,715
PUERTO VILLARROEL,consulta externa,nuevas en menores de 5 anos,2006-09-01,1211,1134,1211,1134,2345
PUNA,consulta externa,nuevas en menores de 5 anos,2006-09-01,648,554,648,554,1202
PUNATA,consulta externa,nuevas en menores de 5 anos,2006-09-01,349,331,349,331,680
QUIABAYA,consulta externa,nuevas en menores de 5 anos,2006-09-01,50,50,50,50,100
QUILLACOLLO,consulta externa,nuevas en menores de 5 anos,2006-09-01,813,735,813,735,1548
QUIME,consulta externa,nuevas en menores de 5 anos,2006-09-01,89,81,89,81,170
QUIRUSILLAS,consulta externa,nuevas en menores de 5 anos,2006-09-01,35,27,35,27,62
RAVELO,consulta externa,nuevas en menores de 5 anos,2006-09-01,400,357,400,357,757
REYES,consulta externa,nuevas en menores de 5 anos,2006-09-01,270,252,270,252,522
RIBERALTA,consulta externa,nuevas en menores de 5 anos,2006-09-01,2323,2266,2323,2266,4589
ROBORE,consulta externa,nuevas en menores de 5 anos,2006-09-01,201,226,201,226,427
RURRENABAQUE,consulta externa,nuevas en menores de 5 anos,2006-09-01,328,336,328,336,664
SABAYA,consulta externa,nuevas en menores de 5 anos,2006-09-01,52,43,52,43,95
SACABA,consulta externa,nuevas en menores de 5 anos,2006-09-01,1115,868,1115,868,1983
SACABAMBA,consulta externa,nuevas en menores de 5 anos,2006-09-01,53,49,53,49,102
SACACA,consulta externa,nuevas en menores de 5 anos,2006-09-01,709,684,709,684,1393
SAIPINA,consulta externa,nuevas en menores de 5 anos,2006-09-01,114,125,114,125,239
SALINAS DE GARCI MENDOZA,consulta externa,nuevas en menores de 5 anos,2006-09-01,275,212,275,212,487
SAMAIPATA,consulta externa,nuevas en menores de 5 anos,2006-09-01,137,92,137,92,229
SAN AGUSTIN,consulta externa,nuevas en menores de 5 anos,2006-09-01,32,38,32,38,70
SAN ANDRES,consulta externa,nuevas en menores de 5 anos,2006-09-01,309,270,309,270,579
SAN ANDRES DE MACHACA,consulta externa,nuevas en menores de 5 anos,2006-09-01,65,59,65,59,124
SAN ANTONIO DE ESMORUCO,consulta externa,nuevas en menores de 5 anos,2006-09-01,45,50,45,50,95
SAN ANTONIO DE LOMERIO,consulta externa,nuevas en menores de 5 anos,2006-09-01,110,122,110,122,232
SAN BENITO,consulta externa,nuevas en menores de 5 anos,2006-09-01,145,111,145,111,256
SAN BORJA,consulta externa,nuevas en menores de 5 anos,2006-09-01,532,446,532,446,978
SAN BUENA VENTURA,consulta externa,nuevas en menores de 5 anos,2006-09-01,256,229,256,229,485
SAN CARLOS,consulta externa,nuevas en menores de 5 anos,2006-09-01,380,332,380,332,712
SAN IGNACIO,consulta externa,nuevas en menores de 5 anos,2006-09-01,745,604,745,604,1349
SAN IGNACIO DE VELASCO,consulta externa,nuevas en menores de 5 anos,2006-09-01,1200,1048,1200,1048,2248
SAN JAVIER(BNI),consulta externa,nuevas en menores de 5 anos,2006-09-01,81,69,81,69,150
SAN JAVIER(STC),consulta externa,nuevas en menores de 5 anos,2006-09-01,151,128,151,128,279
SAN JOAQUIN,consulta externa,nuevas en menores de 5 anos,2006-09-01,243,165,243,165,408
SAN JOSE DE CHIQUITOS,consulta externa,nuevas en menores de 5 anos,2006-09-01,287,332,287,332,619
SAN JUAN DE YAPACANI,consulta externa,nuevas en menores de 5 anos,2006-09-01,298,272,298,272,570
SAN JULIAN,consulta externa,nuevas en menores de 5 anos,2006-09-01,993,878,993,878,1871
SAN LORENZO(PND),consulta externa,nuevas en menores de 5 anos,2006-09-01,101,76,101,76,177
SAN LORENZO(TJA),consulta externa,nuevas en menores de 5 anos,2006-09-01,509,477,509,477,986
SAN LUCAS,consulta externa,nuevas en menores de 5 anos,2006-09-01,1156,1077,1156,1077,2233
SAN MATIAS,consulta externa,nuevas en menores de 5 anos,2006-09-01,306,230,306,230,536
SAN MIGUEL DE VELASCO,consulta externa,nuevas en menores de 5 anos,2006-09-01,172,129,172,129,301
SAN PABLO DE LIPEZ,consulta externa,nuevas en menores de 5 anos,2006-09-01,63,77,63,77,140
SAN PEDRO,consulta externa,nuevas en menores de 5 anos,2006-09-01,513,516,513,516,1029
SAN PEDRO DE BUENA VISTA,consulta externa,nuevas en menores de 5 anos,2006-09-01,645,558,645,558,1203
SAN PEDRO DE CURAHUARA,consulta externa,nuevas en menores de 5 anos,2006-09-01,47,33,47,33,80
SAN PEDRO DE QUEMES,consulta externa,nuevas en menores de 5 anos,2006-09-01,7,12,7,12,19
SAN PEDRO DE TIQUINA,consulta externa,nuevas en menores de 5 anos,2006-09-01,23,19,23,19,42
SAN PEDRO(PND),consulta externa,nuevas en menores de 5 anos,2006-09-01,17,12,17,12,29
SAN RAFAEL,consulta externa,nuevas en menores de 5 anos,2006-09-01,103,70,103,70,173
SAN RAMON,consulta externa,nuevas en menores de 5 anos,2006-09-01,100,102,100,102,202
SAN RAMON,consulta externa,nuevas en menores de 5 anos,2006-09-01,239,192,239,192,431
SANTA ANA,consulta externa,nuevas en menores de 5 anos,2006-09-01,297,266,297,266,563
SANTA CRUZ DE LA SIERRA,consulta externa,nuevas en menores de 5 anos,2006-09-01,19674,17569,19674,17569,37243
SANTA ROSA,consulta externa,nuevas en menores de 5 anos,2006-09-01,382,379,382,379,761
SANTA ROSA DEL SARA,consulta externa,nuevas en menores de 5 anos,2006-09-01,600,578,600,578,1178
SANTIAGO DE CALLAPA,consulta externa,nuevas en menores de 5 anos,2006-09-01,42,42,42,42,84
SANTIAGO DE HUARI,consulta externa,nuevas en menores de 5 anos,2006-09-01,102,75,102,75,177
SANTIAGO DE MACHACA,consulta externa,nuevas en menores de 5 anos,2006-09-01,29,16,29,16,45
SANTIVAÑES,consulta externa,nuevas en menores de 5 anos,2006-09-01,151,146,151,146,297
SANTUARIO DE QUILLACAS,consulta externa,nuevas en menores de 5 anos,2006-09-01,37,32,37,32,69
SAPAHAQUI,consulta externa,nuevas en menores de 5 anos,2006-09-01,153,130,153,130,283
SENA,consulta externa,nuevas en menores de 5 anos,2006-09-01,150,121,150,121,271
SICA SICA (VILLA AROMA),consulta externa,nuevas en menores de 5 anos,2006-09-01,193,171,193,171,364
SICAYA,consulta externa,nuevas en menores de 5 anos,2006-09-01,63,50,63,50,113
SIPE SIPE,consulta externa,nuevas en menores de 5 anos,2006-09-01,363,349,363,349,712
SOPACHUY,consulta externa,nuevas en menores de 5 anos,2006-09-01,253,262,253,262,515
SORACACHI,consulta externa,nuevas en menores de 5 anos,2006-09-01,264,136,264,136,400
SORATA,consulta externa,nuevas en menores de 5 anos,2006-09-01,200,203,200,203,403
SUCRE,consulta externa,nuevas en menores de 5 anos,2006-09-01,5336,5019,5336,5019,10355
TACACHI,consulta externa,nuevas en menores de 5 anos,2006-09-01,13,12,13,12,25
TACACOMA,consulta externa,nuevas en menores de 5 anos,2006-09-01,104,114,104,114,218
TACOBAMBA,consulta externa,nuevas en menores de 5 anos,2006-09-01,118,95,118,95,213
TACOPAYA,consulta externa,nuevas en menores de 5 anos,2006-09-01,179,142,179,142,321
TAHUA,consulta externa,nuevas en menores de 5 anos,2006-09-01,19,21,19,21,40
TAPACARI,consulta externa,nuevas en menores de 5 anos,2006-09-01,476,411,476,411,887
TARABUCO,consulta externa,nuevas en menores de 5 anos,2006-09-01,602,522,602,522,1124
TARACO,consulta externa,nuevas en menores de 5 anos,2006-09-01,15,22,15,22,37
TARATA,consulta externa,nuevas en menores de 5 anos,2006-09-01,117,126,117,126,243
TARIJA,consulta externa,nuevas en menores de 5 anos,2006-09-01,3436,3249,3436,3249,6685
TARVITA,consulta externa,nuevas en menores de 5 anos,2006-09-01,737,749,737,749,1486
TEOPONTE,consulta externa,nuevas en menores de 5 anos,2006-09-01,173,152,173,152,325
TIAWANACU,consulta externa,nuevas en menores de 5 anos,2006-09-01,135,101,135,101,236
TINGUIPAYA,consulta externa,nuevas en menores de 5 anos,2006-09-01,406,385,406,385,791
TIPUANI,consulta externa,nuevas en menores de 5 anos,2006-09-01,90,90,90,90,180
TIQUIPAYA,consulta externa,nuevas en menores de 5 anos,2006-09-01,411,382,411,382,793
TIRAQUE (CBBA),consulta externa,nuevas en menores de 5 anos,2006-09-01,766,620,766,620,1386
TITO YUPANQUI (PARQUIPUJIO),consulta externa,nuevas en menores de 5 anos,2006-09-01,24,26,24,26,50
TOCO,consulta externa,nuevas en menores de 5 anos,2006-09-01,62,45,62,45,107
TODOS SANTOS,consulta externa,nuevas en menores de 5 anos,2006-09-01,3,3,3,3,6
TOLATA,consulta externa,nuevas en menores de 5 anos,2006-09-01,65,51,65,51,116
TOLEDO,consulta externa,nuevas en menores de 5 anos,2006-09-01,77,84,77,84,161
TOMAVE,consulta externa,nuevas en menores de 5 anos,2006-09-01,140,129,140,129,269
TOMINA,consulta externa,nuevas en menores de 5 anos,2006-09-01,311,240,311,240,551
TORO TORO,consulta externa,nuevas en menores de 5 anos,2006-09-01,314,311,314,311,625
TOTORA(CBBA),consulta externa,nuevas en menores de 5 anos,2006-09-01,155,122,155,122,277
TOTORA(ORR),consulta externa,nuevas en menores de 5 anos,2006-09-01,265,77,265,77,342
TRIGAL,consulta externa,nuevas en menores de 5 anos,2006-09-01,26,31,26,31,57
TRINIDAD,consulta externa,nuevas en menores de 5 anos,2006-09-01,2086,1917,2086,1917,4003
TUPIZA,consulta externa,nuevas en menores de 5 anos,2006-09-01,882,895,882,895,1777
TURCO,consulta externa,nuevas en menores de 5 anos,2006-09-01,95,96,95,96,191
UMALA,consulta externa,nuevas en menores de 5 anos,2006-09-01,40,33,40,33,73
UNCIA,consulta externa,nuevas en menores de 5 anos,2006-09-01,734,605,734,605,1339
URIONDO (A. CONCEPCION),consulta externa,nuevas en menores de 5 anos,2006-09-01,422,372,422,372,794
URUBICHA,consulta externa,nuevas en menores de 5 anos,2006-09-01,138,151,138,151,289
UYUNI,consulta externa,nuevas en menores de 5 anos,2006-09-01,243,212,243,212,455
VACAS,consulta externa,nuevas en menores de 5 anos,2006-09-01,162,123,162,123,285
VALLEGRANDE,consulta externa,nuevas en menores de 5 anos,2006-09-01,296,269,296,269,565
VIACHA,consulta externa,nuevas en menores de 5 anos,2006-09-01,468,414,468,414,882
VILA VILA,consulta externa,nuevas en menores de 5 anos,2006-09-01,40,54,40,54,94
VILLA MONTES,consulta externa,nuevas en menores de 5 anos,2006-09-01,688,611,688,611,1299
VILLA NUEVA (LOMA ALTA),consulta externa,nuevas en menores de 5 anos,2006-09-01,109,127,109,127,236
VILLA RIVERO,consulta externa,nuevas en menores de 5 anos,2006-09-01,46,54,46,54,100
VILLA SERRANO,consulta externa,nuevas en menores de 5 anos,2006-09-01,423,438,423,438,861
VILLA TUNARI,consulta externa,nuevas en menores de 5 anos,2006-09-01,1411,1128,1411,1128,2539
VILLA VACA GUZMAN (MUYUPAMPA),consulta externa,nuevas en menores de 5 anos,2006-09-01,368,403,368,403,771
VILLAZON,consulta externa,nuevas en menores de 5 anos,2006-09-01,686,636,686,636,1322
VINTO,consulta externa,nuevas en menores de 5 anos,2006-09-01,161,145,161,145,306
VITICHI,consulta externa,nuevas en menores de 5 anos,2006-09-01,273,275,273,275,548
WALDO BALLIVIAN,consulta externa,nuevas en menores de 5 anos,2006-09-01,29,28,29,28,57
WARNES,consulta externa,nuevas en menores de 5 anos,2006-09-01,1179,1061,1179,1061,2240
YACO,consulta externa,nuevas en menores de 5 anos,2006-09-01,115,119,115,119,234
YACUIBA,consulta externa,nuevas en menores de 5 anos,2006-09-01,2269,1989,2269,1989,4258
YAMPARAEZ,consulta externa,nuevas en menores de 5 anos,2006-09-01,199,145,199,145,344
YANACACHI,consulta externa,nuevas en menores de 5 anos,2006-09-01,61,66,61,66,127
YAPACANI,consulta externa,nuevas en menores de 5 anos,2006-09-01,718,656,718,656,1374
YOCALLA,consulta externa,nuevas en menores de 5 anos,2006-09-01,67,63,67,63,130
YOTALA,consulta externa,nuevas en menores de 5 anos,2006-09-01,101,73,101,73,174
YUNCHARA,consulta externa,nuevas en menores de 5 anos,2006-09-01,112,95,112,95,207
ZUDAÑEZ,consulta externa,nuevas en menores de 5 anos,2006-09-01,287,283,287,283,570
ACACIO,consulta externa,nuevas en menores de 5 anos,2006-10-01,193,193,193,193,386
ACHACACHI,consulta externa,nuevas en menores de 5 anos,2006-10-01,438,340,438,340,778
ACHOCALLA,consulta externa,nuevas en menores de 5 anos,2006-10-01,48,63,48,63,111
AIQUILE,consulta externa,nuevas en menores de 5 anos,2006-10-01,445,318,445,318,763
ALCALA,consulta externa,nuevas en menores de 5 anos,2006-10-01,170,128,170,128,298
ANCORAIMES,consulta externa,nuevas en menores de 5 anos,2006-10-01,165,164,165,164,329
ANDAMARCA,consulta externa,nuevas en menores de 5 anos,2006-10-01,84,75,84,75,159
ANTEQUERA,consulta externa,nuevas en menores de 5 anos,2006-10-01,57,58,57,58,115
ANZALDO,consulta externa,nuevas en menores de 5 anos,2006-10-01,89,100,89,100,189
APOLO,consulta externa,nuevas en menores de 5 anos,2006-10-01,351,338,351,338,689
ARAMPAMPA,consulta externa,nuevas en menores de 5 anos,2006-10-01,157,135,157,135,292
ARANI,consulta externa,nuevas en menores de 5 anos,2006-10-01,110,126,110,126,236
ARBIETO,consulta externa,nuevas en menores de 5 anos,2006-10-01,104,99,104,99,203
ARQUE,consulta externa,nuevas en menores de 5 anos,2006-10-01,181,183,181,183,364
ASCENCION DE GUARAYOS,consulta externa,nuevas en menores de 5 anos,2006-10-01,459,497,459,497,956
ATOCHA,consulta externa,nuevas en menores de 5 anos,2006-10-01,300,280,300,280,580
AUCAPATA,consulta externa,nuevas en menores de 5 anos,2006-10-01,88,72,88,72,160
AYATA,consulta externa,nuevas en menores de 5 anos,2006-10-01,185,149,185,149,334
AYO AYO,consulta externa,nuevas en menores de 5 anos,2006-10-01,70,61,70,61,131
AYOPAYA (V. DE INDEPENDENCIA),consulta externa,nuevas en menores de 5 anos,2006-10-01,585,592,585,592,1177
AZURDUY,consulta externa,nuevas en menores de 5 anos,2006-10-01,550,544,550,544,1094
BATALLAS,consulta externa,nuevas en menores de 5 anos,2006-10-01,93,78,93,78,171
BAURES,consulta externa,nuevas en menores de 5 anos,2006-10-01,85,88,85,88,173
BELEN DE ANDAMARCA,consulta externa,nuevas en menores de 5 anos,2006-10-01,28,19,28,19,47
BELEN DE URMIRI,consulta externa,nuevas en menores de 5 anos,2006-10-01,37,42,37,42,79
BELLA FLOR,consulta externa,nuevas en menores de 5 anos,2006-10-01,116,100,116,100,216
BERMEJO,consulta externa,nuevas en menores de 5 anos,2006-10-01,1061,900,1061,900,1961
BETANZOS,consulta externa,nuevas en menores de 5 anos,2006-10-01,694,645,694,645,1339
BOLIVAR,consulta externa,nuevas en menores de 5 anos,2006-10-01,146,174,146,174,320
BOLPEBRA,consulta externa,nuevas en menores de 5 anos,2006-10-01,85,75,85,75,160
BOYUIBE,consulta externa,nuevas en menores de 5 anos,2006-10-01,141,103,141,103,244
BUENA VISTA,consulta externa,nuevas en menores de 5 anos,2006-10-01,238,203,238,203,441
CABEZAS,consulta externa,nuevas en menores de 5 anos,2006-10-01,406,358,406,358,764
CAIROMA,consulta externa,nuevas en menores de 5 anos,2006-10-01,165,142,165,142,307
"CAIZA ""D""",consulta externa,nuevas en menores de 5 anos,2006-10-01,145,141,145,141,286
CAJUATA,consulta externa,nuevas en menores de 5 anos,2006-10-01,166,137,166,137,303
CALACOTO,consulta externa,nuevas en menores de 5 anos,2006-10-01,70,72,70,72,142
CALAMARCA,consulta externa,nuevas en menores de 5 anos,2006-10-01,198,182,198,182,380
CAMARGO,consulta externa,nuevas en menores de 5 anos,2006-10-01,471,499,471,499,970
CAMATAQUI (C. VILLA ABECIA),consulta externa,nuevas en menores de 5 anos,2006-10-01,83,74,83,74,157
CAMIRI,consulta externa,nuevas en menores de 5 anos,2006-10-01,1144,1061,1144,1061,2205
CAPINOTA,consulta externa,nuevas en menores de 5 anos,2006-10-01,363,315,363,315,678
CAQUIAVIRI,consulta externa,nuevas en menores de 5 anos,2006-10-01,71,95,71,95,166
CARACOLLO,consulta externa,nuevas en menores de 5 anos,2006-10-01,1099,196,1099,196,1295
CARANAVI,consulta externa,nuevas en menores de 5 anos,2006-10-01,1222,1222,1222,1222,2444
CARANGAS,consulta externa,nuevas en menores de 5 anos,2006-10-01,4,11,4,11,15
CARAPARI,consulta externa,nuevas en menores de 5 anos,2006-10-01,240,234,240,234,474
CARIPUYO,consulta externa,nuevas en menores de 5 anos,2006-10-01,203,179,203,179,382
CARMEN RIVERO TORREZ,consulta externa,nuevas en menores de 5 anos,2006-10-01,75,57,75,57,132
CATACORA,consulta externa,nuevas en menores de 5 anos,2006-10-01,6,5,6,5,11
CHACARILLA,consulta externa,nuevas en menores de 5 anos,2006-10-01,26,46,26,46,72
CHALLAPATA,consulta externa,nuevas en menores de 5 anos,2006-10-01,463,393,463,393,856
CHAQUI,consulta externa,nuevas en menores de 5 anos,2006-10-01,105,92,105,92,197
CHARAGUA,consulta externa,nuevas en menores de 5 anos,2006-10-01,716,733,716,733,1449
CHARAÑA,consulta externa,nuevas en menores de 5 anos,2006-10-01,16,33,16,33,49
CHAYANTA,consulta externa,nuevas en menores de 5 anos,2006-10-01,429,416,429,416,845
CHIMORE,consulta externa,nuevas en menores de 5 anos,2006-10-01,451,456,451,456,907
CHIPAYA,consulta externa,nuevas en menores de 5 anos,2006-10-01,10,20,10,20,30
CHOQUE COTA,consulta externa,nuevas en menores de 5 anos,2006-10-01,9,10,9,10,19
CHULUMANI (V. DE LA LIBERTAD),consulta externa,nuevas en menores de 5 anos,2006-10-01,244,270,244,270,514
CHUMA,consulta externa,nuevas en menores de 5 anos,2006-10-01,146,128,146,128,274
CLIZA,consulta externa,nuevas en menores de 5 anos,2006-10-01,273,232,273,232,505
COBIJA,consulta externa,nuevas en menores de 5 anos,2006-10-01,779,715,779,715,1494
COCHABAMBA,consulta externa,nuevas en menores de 5 anos,2006-10-01,8945,8124,8945,8124,17069
COIPASA,consulta externa,nuevas en menores de 5 anos,2006-10-01,2,3,2,3,5
COLCAPIRHUA,consulta externa,nuevas en menores de 5 anos,2006-10-01,494,457,494,457,951
"COLCHA ""K""",consulta externa,nuevas en menores de 5 anos,2006-10-01,151,132,151,132,283
COLLANA,consulta externa,nuevas en menores de 5 anos,2006-10-01,29,19,29,19,48
COLOMI,consulta externa,nuevas en menores de 5 anos,2006-10-01,323,268,323,268,591
COLPA BELGICA,consulta externa,nuevas en menores de 5 anos,2006-10-01,169,131,169,131,300
COLQUECHACA,consulta externa,nuevas en menores de 5 anos,2006-10-01,761,744,761,744,1505
COLQUENCHA,consulta externa,nuevas en menores de 5 anos,2006-10-01,96,90,96,90,186
COLQUIRI,consulta externa,nuevas en menores de 5 anos,2006-10-01,417,367,417,367,784
COMANCHE,consulta externa,nuevas en menores de 5 anos,2006-10-01,25,24,25,24,49
COMARAPA,consulta externa,nuevas en menores de 5 anos,2006-10-01,344,318,344,318,662
COMBAYA,consulta externa,nuevas en menores de 5 anos,2006-10-01,25,22,25,22,47
CONCEPCION,consulta externa,nuevas en menores de 5 anos,2006-10-01,299,295,299,295,594
COPACABANA,consulta externa,nuevas en menores de 5 anos,2006-10-01,122,105,122,105,227
CORIPATA,consulta externa,nuevas en menores de 5 anos,2006-10-01,264,225,264,225,489
CORO CORO,consulta externa,nuevas en menores de 5 anos,2006-10-01,95,106,95,106,201
COROICO,consulta externa,nuevas en menores de 5 anos,2006-10-01,245,180,245,180,425
CORQUE,consulta externa,nuevas en menores de 5 anos,2006-10-01,93,80,93,80,173
COTAGAITA,consulta externa,nuevas en menores de 5 anos,2006-10-01,578,600,578,600,1178
COTOCA,consulta externa,nuevas en menores de 5 anos,2006-10-01,672,687,672,687,1359
CUATRO CAÑADAS,consulta externa,nuevas en menores de 5 anos,2006-10-01,453,390,453,390,843
CUCHUMUELA (V. G. VILLARROEL),consulta externa,nuevas en menores de 5 anos,2006-10-01,27,14,27,14,41
CUEVO,consulta externa,nuevas en menores de 5 anos,2006-10-01,99,143,99,143,242
CULPINA,consulta externa,nuevas en menores de 5 anos,2006-10-01,483,436,483,436,919
CURAHUARA DE CARANGAS,consulta externa,nuevas en menores de 5 anos,2006-10-01,114,113,114,113,227
CURVA,consulta externa,nuevas en menores de 5 anos,2006-10-01,51,23,51,23,74
DESAGUADERO,consulta externa,nuevas en menores de 5 anos,2006-10-01,56,27,56,27,83
EL ALTO,consulta externa,nuevas en menores de 5 anos,2006-10-01,9568,8886,9568,8886,18454
EL CHORO,consulta externa,nuevas en menores de 5 anos,2006-10-01,91,94,91,94,185
EL PUENTE(STC),consulta externa,nuevas en menores de 5 anos,2006-10-01,331,291,331,291,622
EL PUENTE(TJA),consulta externa,nuevas en menores de 5 anos,2006-10-01,206,175,206,175,381
EL TORNO,consulta externa,nuevas en menores de 5 anos,2006-10-01,747,702,747,702,1449
EL VILLAR,consulta externa,nuevas en menores de 5 anos,2006-10-01,237,204,237,204,441
ENTRE RIOS,consulta externa,nuevas en menores de 5 anos,2006-10-01,448,436,448,436,884
ENTRE RIOS,consulta externa,nuevas en menores de 5 anos,2006-10-01,525,485,525,485,1010
ESCARA,consulta externa,nuevas en menores de 5 anos,2006-10-01,4,2,4,2,6
ESMERALDA,consulta externa,nuevas en menores de 5 anos,2006-10-01,6,6,6,6,12
EUCALIPTUS,consulta externa,nuevas en menores de 5 anos,2006-10-01,108,89,108,89,197
EUREKA (SANTOS MERCADO),consulta externa,nuevas en menores de 5 anos,2006-10-01,14,16,14,16,30
EXALTACION,consulta externa,nuevas en menores de 5 anos,2006-10-01,31,32,31,32,63
FERNANDEZ ALONSO,consulta externa,nuevas en menores de 5 anos,2006-10-01,480,452,480,452,932
FILADELFIA,consulta externa,nuevas en menores de 5 anos,2006-10-01,106,124,106,124,230
GENERAL SAAVEDRA,consulta externa,nuevas en menores de 5 anos,2006-10-01,693,555,693,555,1248
GRAL. J.J. PEREZ (CHARAZANI),consulta externa,nuevas en menores de 5 anos,2006-10-01,118,109,118,109,227
GUANAY,consulta externa,nuevas en menores de 5 anos,2006-10-01,330,331,330,331,661
GUAQUI,consulta externa,nuevas en menores de 5 anos,2006-10-01,65,46,65,46,111
GUAYARAMERIN,consulta externa,nuevas en menores de 5 anos,2006-10-01,1141,1132,1141,1132,2273
GUTIERREZ,consulta externa,nuevas en menores de 5 anos,2006-10-01,449,430,449,430,879
HUACARETA,consulta externa,nuevas en menores de 5 anos,2006-10-01,326,295,326,295,621
HUACAYA (VILLA DE HUACAYA),consulta externa,nuevas en menores de 5 anos,2006-10-01,83,94,83,94,177
HUACHACALLA,consulta externa,nuevas en menores de 5 anos,2006-10-01,14,11,14,11,25
HUANUNI,consulta externa,nuevas en menores de 5 anos,2006-10-01,334,312,334,312,646
HUARACAJE,consulta externa,nuevas en menores de 5 anos,2006-10-01,85,84,85,84,169
HUAYLLAMARCA,consulta externa,nuevas en menores de 5 anos,2006-10-01,54,58,54,58,112
ICHOCA,consulta externa,nuevas en menores de 5 anos,2006-10-01,59,63,59,63,122
ICLA,consulta externa,nuevas en menores de 5 anos,2006-10-01,482,477,482,477,959
INCAHUASI,consulta externa,nuevas en menores de 5 anos,2006-10-01,696,714,696,714,1410
INGAVI (HUMAITA),consulta externa,nuevas en menores de 5 anos,2006-10-01,60,42,60,42,102
INQUISIVI,consulta externa,nuevas en menores de 5 anos,2006-10-01,287,238,287,238,525
IRUPANA (VILLA DE LANZA),consulta externa,nuevas en menores de 5 anos,2006-10-01,446,238,446,238,684
IXIAMAS,consulta externa,nuevas en menores de 5 anos,2006-10-01,367,301,367,301,668
JESUS DE MACHACA,consulta externa,nuevas en menores de 5 anos,2006-10-01,159,129,159,129,288
LA ASUNTA,consulta externa,nuevas en menores de 5 anos,2006-10-01,595,551,595,551,1146
LA GUARDIA,consulta externa,nuevas en menores de 5 anos,2006-10-01,1203,1106,1203,1106,2309
LA PAZ,consulta externa,nuevas en menores de 5 anos,2006-10-01,13398,12907,13398,12907,26305
LA RIVERA,consulta externa,nuevas en menores de 5 anos,2006-10-01,2,1,2,1,3
LAGUNILLAS,consulta externa,nuevas en menores de 5 anos,2006-10-01,211,239,211,239,450
LAJA,consulta externa,nuevas en menores de 5 anos,2006-10-01,98,79,98,79,177
LAS CARRERAS,consulta externa,nuevas en menores de 5 anos,2006-10-01,74,59,74,59,133
LICOMA PAMPA,consulta externa,nuevas en menores de 5 anos,2006-10-01,27,40,27,40,67
LLALLAGUA,consulta externa,nuevas en menores de 5 anos,2006-10-01,749,637,749,637,1386
LLICA,consulta externa,nuevas en menores de 5 anos,2006-10-01,69,46,69,46,115
LORETO,consulta externa,nuevas en menores de 5 anos,2006-10-01,87,80,87,80,167
LURIBAY,consulta externa,nuevas en menores de 5 anos,2006-10-01,119,104,119,104,223
MACHACAMARCA,consulta externa,nuevas en menores de 5 anos,2006-10-01,42,15,42,15,57
MACHARETI,consulta externa,nuevas en menores de 5 anos,2006-10-01,312,302,312,302,614
MAGDALENA,consulta externa,nuevas en menores de 5 anos,2006-10-01,204,147,204,147,351
MAIRANA,consulta externa,nuevas en menores de 5 anos,2006-10-01,182,169,182,169,351
MALLA,consulta externa,nuevas en menores de 5 anos,2006-10-01,46,27,46,27,73
MAPIRI,consulta externa,nuevas en menores de 5 anos,2006-10-01,294,229,294,229,523
MECAPACA,consulta externa,nuevas en menores de 5 anos,2006-10-01,125,131,125,131,256
MINEROS,consulta externa,nuevas en menores de 5 anos,2006-10-01,552,467,552,467,1019
MIZQUE,consulta externa,nuevas en menores de 5 anos,2006-10-01,431,440,431,440,871
MOCOMOCO,consulta externa,nuevas en menores de 5 anos,2006-10-01,145,156,145,156,301
MOJINETE,consulta externa,nuevas en menores de 5 anos,2006-10-01,11,11,11,11,22
MOJOCOYA,consulta externa,nuevas en menores de 5 anos,2006-10-01,217,184,217,184,401
MONTEAGUDO,consulta externa,nuevas en menores de 5 anos,2006-10-01,710,686,710,686,1396
MONTERO,consulta externa,nuevas en menores de 5 anos,2006-10-01,2672,2244,2672,2244,4916
MORO MORO,consulta externa,nuevas en menores de 5 anos,2006-10-01,62,52,62,52,114
MOROCHATA,consulta externa,nuevas en menores de 5 anos,2006-10-01,220,197,220,197,417
NACEBE (SANTA ROSA DEL ABUNA),consulta externa,nuevas en menores de 5 anos,2006-10-01,1,2,1,2,3
NUEVO MANOA (NUEVA ESPERANZA),consulta externa,nuevas en menores de 5 anos,2006-10-01,46,51,46,51,97
OCURI,consulta externa,nuevas en menores de 5 anos,2006-10-01,473,460,473,460,933
OKINAWA,consulta externa,nuevas en menores de 5 anos,2006-10-01,422,461,422,461,883
OMEREQUE,consulta externa,nuevas en menores de 5 anos,2006-10-01,101,107,101,107,208
ORURO,consulta externa,nuevas en menores de 5 anos,2006-10-01,4709,4023,4709,4023,8732
PADCAYA,consulta externa,nuevas en menores de 5 anos,2006-10-01,483,491,483,491,974
PADILLA,consulta externa,nuevas en menores de 5 anos,2006-10-01,371,382,371,382,753
PAILON,consulta externa,nuevas en menores de 5 anos,2006-10-01,435,343,435,343,778
PALCA,consulta externa,nuevas en menores de 5 anos,2006-10-01,95,88,95,88,183
PALOS BLANCOS,consulta externa,nuevas en menores de 5 anos,2006-10-01,671,724,671,724,1395
PAMPA AULLAGAS,consulta externa,nuevas en menores de 5 anos,2006-10-01,52,41,52,41,93
PAMPA GRANDE,consulta externa,nuevas en menores de 5 anos,2006-10-01,145,154,145,154,299
PAPEL PAMPA,consulta externa,nuevas en menores de 5 anos,2006-10-01,42,47,42,47,89
PASORAPA,consulta externa,nuevas en menores de 5 anos,2006-10-01,50,59,50,59,109
PATACAMAYA,consulta externa,nuevas en menores de 5 anos,2006-10-01,261,232,261,232,493
PAZÑA,consulta externa,nuevas en menores de 5 anos,2006-10-01,114,112,114,112,226
PELECHUCO,consulta externa,nuevas en menores de 5 anos,2006-10-01,95,79,95,79,174
POCOATA,consulta externa,nuevas en menores de 5 anos,2006-10-01,414,500,414,500,914
POCONA,consulta externa,nuevas en menores de 5 anos,2006-10-01,226,201,226,201,427
POJO (CBBA),consulta externa,nuevas en menores de 5 anos,2006-10-01,94,76,94,76,170
POOPO,consulta externa,nuevas en menores de 5 anos,2006-10-01,57,38,57,38,95
PORCO,consulta externa,nuevas en menores de 5 anos,2006-10-01,134,144,134,144,278
POROMA,consulta externa,nuevas en menores de 5 anos,2006-10-01,405,325,405,325,730
PORONGO,consulta externa,nuevas en menores de 5 anos,2006-10-01,176,175,176,175,351
PORTACHUELO,consulta externa,nuevas en menores de 5 anos,2006-10-01,551,525,551,525,1076
PORVENIR,consulta externa,nuevas en menores de 5 anos,2006-10-01,207,140,207,140,347
POSTRER VALLE,consulta externa,nuevas en menores de 5 anos,2006-10-01,43,41,43,41,84
POTOSI,consulta externa,nuevas en menores de 5 anos,2006-10-01,3603,3097,3603,3097,6700
PRESTO,consulta externa,nuevas en menores de 5 anos,2006-10-01,333,261,333,261,594
PUCARA,consulta externa,nuevas en menores de 5 anos,2006-10-01,70,60,70,60,130
PUCARANI,consulta externa,nuevas en menores de 5 anos,2006-10-01,194,227,194,227,421
PUERTO ACOSTA,consulta externa,nuevas en menores de 5 anos,2006-10-01,183,167,183,167,350
PUERTO CARABUCO,consulta externa,nuevas en menores de 5 anos,2006-10-01,118,117,118,117,235
PUERTO GONZALO MORENO,consulta externa,nuevas en menores de 5 anos,2006-10-01,186,186,186,186,372
PUERTO PEREZ,consulta externa,nuevas en menores de 5 anos,2006-10-01,71,61,71,61,132
PUERTO QUIJARRO,consulta externa,nuevas en menores de 5 anos,2006-10-01,288,227,288,227,515
PUERTO RICO,consulta externa,nuevas en menores de 5 anos,2006-10-01,191,161,191,161,352
PUERTO SILES,consulta externa,nuevas en menores de 5 anos,2006-10-01,22,23,22,23,45
PUERTO SUAREZ,consulta externa,nuevas en menores de 5 anos,2006-10-01,288,259,288,259,547
PUERTO VILLARROEL,consulta externa,nuevas en menores de 5 anos,2006-10-01,1377,1215,1377,1215,2592
PUNA,consulta externa,nuevas en menores de 5 anos,2006-10-01,632,554,632,554,1186
PUNATA,consulta externa,nuevas en menores de 5 anos,2006-10-01,348,334,348,334,682
QUIABAYA,consulta externa,nuevas en menores de 5 anos,2006-10-01,54,54,54,54,108
QUILLACOLLO,consulta externa,nuevas en menores de 5 anos,2006-10-01,1064,1057,1064,1057,2121
QUIME,consulta externa,nuevas en menores de 5 anos,2006-10-01,119,106,119,106,225
QUIRUSILLAS,consulta externa,nuevas en menores de 5 anos,2006-10-01,40,32,40,32,72
RAVELO,consulta externa,nuevas en menores de 5 anos,2006-10-01,570,463,570,463,1033
REYES,consulta externa,nuevas en menores de 5 anos,2006-10-01,327,231,327,231,558
RIBERALTA,consulta externa,nuevas en menores de 5 anos,2006-10-01,2548,2324,2548,2324,4872
ROBORE,consulta externa,nuevas en menores de 5 anos,2006-10-01,347,315,347,315,662
RURRENABAQUE,consulta externa,nuevas en menores de 5 anos,2006-10-01,402,408,402,408,810
SABAYA,consulta externa,nuevas en menores de 5 anos,2006-10-01,54,47,54,47,101
SACABA,consulta externa,nuevas en menores de 5 anos,2006-10-01,1140,957,1140,957,2097
SACABAMBA,consulta externa,nuevas en menores de 5 anos,2006-10-01,100,53,100,53,153
SACACA,consulta externa,nuevas en menores de 5 anos,2006-10-01,602,568,602,568,1170
SAIPINA,consulta externa,nuevas en menores de 5 anos,2006-10-01,211,172,211,172,383
SALINAS DE GARCI MENDOZA,consulta externa,nuevas en menores de 5 anos,2006-10-01,180,155,180,155,335
SAMAIPATA,consulta externa,nuevas en menores de 5 anos,2006-10-01,149,106,149,106,255
SAN AGUSTIN,consulta externa,nuevas en menores de 5 anos,2006-10-01,52,38,52,38,90
SAN ANDRES,consulta externa,nuevas en menores de 5 anos,2006-10-01,189,202,189,202,391
SAN ANDRES DE MACHACA,consulta externa,nuevas en menores de 5 anos,2006-10-01,54,41,54,41,95
SAN ANTONIO DE ESMORUCO,consulta externa,nuevas en menores de 5 anos,2006-10-01,61,76,61,76,137
SAN ANTONIO DE LOMERIO,consulta externa,nuevas en menores de 5 anos,2006-10-01,172,142,172,142,314
SAN BENITO,consulta externa,nuevas en menores de 5 anos,2006-10-01,157,146,157,146,303
SAN BORJA,consulta externa,nuevas en menores de 5 anos,2006-10-01,583,516,583,516,1099
SAN BUENA VENTURA,consulta externa,nuevas en menores de 5 anos,2006-10-01,267,242,267,242,509
SAN CARLOS,consulta externa,nuevas en menores de 5 anos,2006-10-01,451,414,451,414,865
SAN IGNACIO,consulta externa,nuevas en menores de 5 anos,2006-10-01,521,484,521,484,1005
SAN IGNACIO DE VELASCO,consulta externa,nuevas en menores de 5 anos,2006-10-01,969,854,969,854,1823
SAN JAVIER(BNI),consulta externa,nuevas en menores de 5 anos,2006-10-01,49,53,49,53,102
SAN JAVIER(STC),consulta externa,nuevas en menores de 5 anos,2006-10-01,231,233,231,233,464
SAN JOAQUIN,consulta externa,nuevas en menores de 5 anos,2006-10-01,64,58,64,58,122
SAN JOSE DE CHIQUITOS,consulta externa,nuevas en menores de 5 anos,2006-10-01,390,379,390,379,769
SAN JUAN DE YAPACANI,consulta externa,nuevas en menores de 5 anos,2006-10-01,282,249,282,249,531
SAN JULIAN,consulta externa,nuevas en menores de 5 anos,2006-10-01,1072,1053,1072,1053,2125
SAN LORENZO(PND),consulta externa,nuevas en menores de 5 anos,2006-10-01,184,136,184,136,320
SAN LORENZO(TJA),consulta externa,nuevas en menores de 5 anos,2006-10-01,591,526,591,526,1117
SAN LUCAS,consulta externa,nuevas en menores de 5 anos,2006-10-01,945,885,945,885,1830
SAN MATIAS,consulta externa,nuevas en menores de 5 anos,2006-10-01,581,239,581,239,820
SAN MIGUEL DE VELASCO,consulta externa,nuevas en menores de 5 anos,2006-10-01,178,172,178,172,350
SAN PABLO DE LIPEZ,consulta externa,nuevas en menores de 5 anos,2006-10-01,80,70,80,70,150
SAN PEDRO,consulta externa,nuevas en menores de 5 anos,2006-10-01,613,557,613,557,1170
SAN PEDRO DE BUENA VISTA,consulta externa,nuevas en menores de 5 anos,2006-10-01,613,583,613,583,1196
SAN PEDRO DE CURAHUARA,consulta externa,nuevas en menores de 5 anos,2006-10-01,56,27,56,27,83
SAN PEDRO DE QUEMES,consulta externa,nuevas en menores de 5 anos,2006-10-01,9,20,9,20,29
SAN PEDRO DE TIQUINA,consulta externa,nuevas en menores de 5 anos,2006-10-01,13,17,13,17,30
SAN PEDRO(PND),consulta externa,nuevas en menores de 5 anos,2006-10-01,60,78,60,78,138
SAN RAFAEL,consulta externa,nuevas en menores de 5 anos,2006-10-01,76,60,76,60,136
SAN RAMON,consulta externa,nuevas en menores de 5 anos,2006-10-01,84,78,84,78,162
SAN RAMON,consulta externa,nuevas en menores de 5 anos,2006-10-01,175,226,175,226,401
SANTA ANA,consulta externa,nuevas en menores de 5 anos,2006-10-01,347,262,347,262,609
SANTA CRUZ DE LA SIERRA,consulta externa,nuevas en menores de 5 anos,2006-10-01,24755,20115,24755,20115,44870
SANTA ROSA,consulta externa,nuevas en menores de 5 anos,2006-10-01,342,257,342,257,599
SANTA ROSA DEL SARA,consulta externa,nuevas en menores de 5 anos,2006-10-01,796,744,796,744,1540
SANTIAGO DE CALLAPA,consulta externa,nuevas en menores de 5 anos,2006-10-01,50,45,50,45,95
SANTIAGO DE HUARI,consulta externa,nuevas en menores de 5 anos,2006-10-01,120,120,120,120,240
SANTIAGO DE MACHACA,consulta externa,nuevas en menores de 5 anos,2006-10-01,21,24,21,24,45
SANTIVAÑES,consulta externa,nuevas en menores de 5 anos,2006-10-01,75,78,75,78,153
SANTUARIO DE QUILLACAS,consulta externa,nuevas en menores de 5 anos,2006-10-01,38,36,38,36,74
SAPAHAQUI,consulta externa,nuevas en menores de 5 anos,2006-10-01,114,112,114,112,226
SENA,consulta externa,nuevas en menores de 5 anos,2006-10-01,111,84,111,84,195
SICA SICA (VILLA AROMA),consulta externa,nuevas en menores de 5 anos,2006-10-01,189,166,189,166,355
SICAYA,consulta externa,nuevas en menores de 5 anos,2006-10-01,57,37,57,37,94
SIPE SIPE,consulta externa,nuevas en menores de 5 anos,2006-10-01,361,289,361,289,650
SOPACHUY,consulta externa,nuevas en menores de 5 anos,2006-10-01,432,467,432,467,899
SORACACHI,consulta externa,nuevas en menores de 5 anos,2006-10-01,88,90,88,90,178
SORATA,consulta externa,nuevas en menores de 5 anos,2006-10-01,229,226,229,226,455
SUCRE,consulta externa,nuevas en menores de 5 anos,2006-10-01,6312,6208,6312,6208,12520
TACACHI,consulta externa,nuevas en menores de 5 anos,2006-10-01,9,15,9,15,24
TACACOMA,consulta externa,nuevas en menores de 5 anos,2006-10-01,78,53,78,53,131
TACOBAMBA,consulta externa,nuevas en menores de 5 anos,2006-10-01,135,106,135,106,241
TACOPAYA,consulta externa,nuevas en menores de 5 anos,2006-10-01,255,218,255,218,473
TAHUA,consulta externa,nuevas en menores de 5 anos,2006-10-01,19,15,19,15,34
TAPACARI,consulta externa,nuevas en menores de 5 anos,2006-10-01,651,484,651,484,1135
TARABUCO,consulta externa,nuevas en menores de 5 anos,2006-10-01,667,580,667,580,1247
TARACO,consulta externa,nuevas en menores de 5 anos,2006-10-01,31,29,31,29,60
TARATA,consulta externa,nuevas en menores de 5 anos,2006-10-01,165,144,165,144,309
TARIJA,consulta externa,nuevas en menores de 5 anos,2006-10-01,4131,3684,4131,3684,7815
TARVITA,consulta externa,nuevas en menores de 5 anos,2006-10-01,560,548,560,548,1108
TEOPONTE,consulta externa,nuevas en menores de 5 anos,2006-10-01,177,182,177,182,359
TIAWANACU,consulta externa,nuevas en menores de 5 anos,2006-10-01,100,112,100,112,212
TINGUIPAYA,consulta externa,nuevas en menores de 5 anos,2006-10-01,375,273,375,273,648
TIPUANI,consulta externa,nuevas en menores de 5 anos,2006-10-01,132,147,132,147,279
TIQUIPAYA,consulta externa,nuevas en menores de 5 anos,2006-10-01,762,600,762,600,1362
TIRAQUE (CBBA),consulta externa,nuevas en menores de 5 anos,2006-10-01,806,712,806,712,1518
TITO YUPANQUI (PARQUIPUJIO),consulta externa,nuevas en menores de 5 anos,2006-10-01,26,53,26,53,79
TOCO,consulta externa,nuevas en menores de 5 anos,2006-10-01,83,80,83,80,163
TODOS SANTOS,consulta externa,nuevas en menores de 5 anos,2006-10-01,3,2,3,2,5
TOLATA,consulta externa,nuevas en menores de 5 anos,2006-10-01,66,64,66,64,130
TOLEDO,consulta externa,nuevas en menores de 5 anos,2006-10-01,93,66,93,66,159
TOMAVE,consulta externa,nuevas en menores de 5 anos,2006-10-01,133,121,133,121,254
TOMINA,consulta externa,nuevas en menores de 5 anos,2006-10-01,282,247,282,247,529
TORO TORO,consulta externa,nuevas en menores de 5 anos,2006-10-01,272,242,272,242,514
TOTORA(CBBA),consulta externa,nuevas en menores de 5 anos,2006-10-01,180,134,180,134,314
TOTORA(ORR),consulta externa,nuevas en menores de 5 anos,2006-10-01,74,75,74,75,149
TRIGAL,consulta externa,nuevas en menores de 5 anos,2006-10-01,36,28,36,28,64
TRINIDAD,consulta externa,nuevas en menores de 5 anos,2006-10-01,2041,1920,2041,1920,3961
TUPIZA,consulta externa,nuevas en menores de 5 anos,2006-10-01,974,954,974,954,1928
TURCO,consulta externa,nuevas en menores de 5 anos,2006-10-01,67,59,67,59,126
UMALA,consulta externa,nuevas en menores de 5 anos,2006-10-01,46,39,46,39,85
UNCIA,consulta externa,nuevas en menores de 5 anos,2006-10-01,584,513,584,513,1097
URIONDO (A. CONCEPCION),consulta externa,nuevas en menores de 5 anos,2006-10-01,522,516,522,516,1038
URUBICHA,consulta externa,nuevas en menores de 5 anos,2006-10-01,192,213,192,213,405
UYUNI,consulta externa,nuevas en menores de 5 anos,2006-10-01,236,254,236,254,490
VACAS,consulta externa,nuevas en menores de 5 anos,2006-10-01,171,173,171,173,344
VALLEGRANDE,consulta externa,nuevas en menores de 5 anos,2006-10-01,302,260,302,260,562
VIACHA,consulta externa,nuevas en menores de 5 anos,2006-10-01,456,430,456,430,886
VILA VILA,consulta externa,nuevas en menores de 5 anos,2006-10-01,62,81,62,81,143
VILLA MONTES,consulta externa,nuevas en menores de 5 anos,2006-10-01,822,709,822,709,1531
VILLA NUEVA (LOMA ALTA),consulta externa,nuevas en menores de 5 anos,2006-10-01,81,84,81,84,165
VILLA RIVERO,consulta externa,nuevas en menores de 5 anos,2006-10-01,100,94,100,94,194
VILLA SERRANO,consulta externa,nuevas en menores de 5 anos,2006-10-01,410,414,410,414,824
VILLA TUNARI,consulta externa,nuevas en menores de 5 anos,2006-10-01,1767,1556,1767,1556,3323
VILLA VACA GUZMAN (MUYUPAMPA),consulta externa,nuevas en menores de 5 anos,2006-10-01,293,309,293,309,602
VILLAZON,consulta externa,nuevas en menores de 5 anos,2006-10-01,796,764,796,764,1560
VINTO,consulta externa,nuevas en menores de 5 anos,2006-10-01,174,147,174,147,321
VITICHI,consulta externa,nuevas en menores de 5 anos,2006-10-01,244,257,244,257,501
WALDO BALLIVIAN,consulta externa,nuevas en menores de 5 anos,2006-10-01,49,52,49,52,101
WARNES,consulta externa,nuevas en menores de 5 anos,2006-10-01,1314,1177,1314,1177,2491
YACO,consulta externa,nuevas en menores de 5 anos,2006-10-01,154,149,154,149,303
YACUIBA,consulta externa,nuevas en menores de 5 anos,2006-10-01,2233,1936,2233,1936,4169
YAMPARAEZ,consulta externa,nuevas en menores de 5 anos,2006-10-01,172,166,172,166,338
YANACACHI,consulta externa,nuevas en menores de 5 anos,2006-10-01,72,71,72,71,143
YAPACANI,consulta externa,nuevas en menores de 5 anos,2006-10-01,908,860,908,860,1768
YOCALLA,consulta externa,nuevas en menores de 5 anos,2006-10-01,93,92,93,92,185
YOTALA,consulta externa,nuevas en menores de 5 anos,2006-10-01,113,104,113,104,217
YUNCHARA,consulta externa,nuevas en menores de 5 anos,2006-10-01,114,123,114,123,237
ZUDAÑEZ,consulta externa,nuevas en menores de 5 anos,2006-10-01,278,249,278,249,527
ACACIO,consulta externa,nuevas en menores de 5 anos,2006-11-01,146,159,146,159,305
ACHACACHI,consulta externa,nuevas en menores de 5 anos,2006-11-01,382,372,382,372,754
ACHOCALLA,consulta externa,nuevas en menores de 5 anos,2006-11-01,107,98,107,98,205
AIQUILE,consulta externa,nuevas en menores de 5 anos,2006-11-01,274,341,274,341,615
ALCALA,consulta externa,nuevas en menores de 5 anos,2006-11-01,182,150,182,150,332
ANCORAIMES,consulta externa,nuevas en menores de 5 anos,2006-11-01,239,189,239,189,428
ANDAMARCA,consulta externa,nuevas en menores de 5 anos,2006-11-01,81,68,81,68,149
ANTEQUERA,consulta externa,nuevas en menores de 5 anos,2006-11-01,87,48,87,48,135
ANZALDO,consulta externa,nuevas en menores de 5 anos,2006-11-01,97,102,97,102,199
APOLO,consulta externa,nuevas en menores de 5 anos,2006-11-01,367,340,367,340,707
ARAMPAMPA,consulta externa,nuevas en menores de 5 anos,2006-11-01,186,153,186,153,339
ARANI,consulta externa,nuevas en menores de 5 anos,2006-11-01,142,93,142,93,235
ARBIETO,consulta externa,nuevas en menores de 5 anos,2006-11-01,108,96,108,96,204
ARQUE,consulta externa,nuevas en menores de 5 anos,2006-11-01,242,222,242,222,464
ASCENCION DE GUARAYOS,consulta externa,nuevas en menores de 5 anos,2006-11-01,502,448,502,448,950
ATOCHA,consulta externa,nuevas en menores de 5 anos,2006-11-01,370,336,370,336,706
AUCAPATA,consulta externa,nuevas en menores de 5 anos,2006-11-01,104,76,104,76,180
AYATA,consulta externa,nuevas en menores de 5 anos,2006-11-01,124,103,124,103,227
AYO AYO,consulta externa,nuevas en menores de 5 anos,2006-11-01,57,68,57,68,125
AYOPAYA (V. DE INDEPENDENCIA),consulta externa,nuevas en menores de 5 anos,2006-11-01,528,495,528,495,1023
AZURDUY,consulta externa,nuevas en menores de 5 anos,2006-11-01,537,495,537,495,1032
BATALLAS,consulta externa,nuevas en menores de 5 anos,2006-11-01,106,86,106,86,192
BAURES,consulta externa,nuevas en menores de 5 anos,2006-11-01,74,76,74,76,150
BELEN DE ANDAMARCA,consulta externa,nuevas en menores de 5 anos,2006-11-01,29,21,29,21,50
BELEN DE URMIRI,consulta externa,nuevas en menores de 5 anos,2006-11-01,52,49,52,49,101
BELLA FLOR,consulta externa,nuevas en menores de 5 anos,2006-11-01,73,63,73,63,136
BERMEJO,consulta externa,nuevas en menores de 5 anos,2006-11-01,918,875,918,875,1793
BETANZOS,consulta externa,nuevas en menores de 5 anos,2006-11-01,842,803,842,803,1645
BOLIVAR,consulta externa,nuevas en menores de 5 anos,2006-11-01,244,230,244,230,474
BOLPEBRA,consulta externa,nuevas en menores de 5 anos,2006-11-01,79,72,79,72,151
BOYUIBE,consulta externa,nuevas en menores de 5 anos,2006-11-01,85,87,85,87,172
BUENA VISTA,consulta externa,nuevas en menores de 5 anos,2006-11-01,270,206,270,206,476
CABEZAS,consulta externa,nuevas en menores de 5 anos,2006-11-01,592,377,592,377,969
CAIROMA,consulta externa,nuevas en menores de 5 anos,2006-11-01,143,157,143,157,300
"CAIZA ""D""",consulta externa,nuevas en menores de 5 anos,2006-11-01,208,147,208,147,355
CAJUATA,consulta externa,nuevas en menores de 5 anos,2006-11-01,183,142,183,142,325
CALACOTO,consulta externa,nuevas en menores de 5 anos,2006-11-01,82,79,82,79,161
CALAMARCA,consulta externa,nuevas en menores de 5 anos,2006-11-01,194,162,194,162,356
CAMARGO,consulta externa,nuevas en menores de 5 anos,2006-11-01,399,364,399,364,763
CAMATAQUI (C. VILLA ABECIA),consulta externa,nuevas en menores de 5 anos,2006-11-01,152,100,152,100,252
CAMIRI,consulta externa,nuevas en menores de 5 anos,2006-11-01,1233,1153,1233,1153,2386
CAPINOTA,consulta externa,nuevas en menores de 5 anos,2006-11-01,433,428,433,428,861
CAQUIAVIRI,consulta externa,nuevas en menores de 5 anos,2006-11-01,96,105,96,105,201
CARACOLLO,consulta externa,nuevas en menores de 5 anos,2006-11-01,165,163,165,163,328
CARANAVI,consulta externa,nuevas en menores de 5 anos,2006-11-01,1345,1221,1345,1221,2566
CARANGAS,consulta externa,nuevas en menores de 5 anos,2006-11-01,6,3,6,3,9
CARAPARI,consulta externa,nuevas en menores de 5 anos,2006-11-01,260,214,260,214,474
CARIPUYO,consulta externa,nuevas en menores de 5 anos,2006-11-01,259,236,259,236,495
CARMEN RIVERO TORREZ,consulta externa,nuevas en menores de 5 anos,2006-11-01,89,79,89,79,168
CATACORA,consulta externa,nuevas en menores de 5 anos,2006-11-01,7,12,7,12,19
CHACARILLA,consulta externa,nuevas en menores de 5 anos,2006-11-01,26,22,26,22,48
CHALLAPATA,consulta externa,nuevas en menores de 5 anos,2006-11-01,457,374,457,374,831
CHAQUI,consulta externa,nuevas en menores de 5 anos,2006-11-01,136,121,136,121,257
CHARAGUA,consulta externa,nuevas en menores de 5 anos,2006-11-01,787,854,787,854,1641
CHARAÑA,consulta externa,nuevas en menores de 5 anos,2006-11-01,25,38,25,38,63
CHAYANTA,consulta externa,nuevas en menores de 5 anos,2006-11-01,418,409,418,409,827
CHIMORE,consulta externa,nuevas en menores de 5 anos,2006-11-01,465,413,465,413,878
CHIPAYA,consulta externa,nuevas en menores de 5 anos,2006-11-01,29,35,29,35,64
CHOQUE COTA,consulta externa,nuevas en menores de 5 anos,2006-11-01,27,24,27,24,51
CHULUMANI (V. DE LA LIBERTAD),consulta externa,nuevas en menores de 5 anos,2006-11-01,214,252,214,252,466
CHUMA,consulta externa,nuevas en menores de 5 anos,2006-11-01,169,170,169,170,339
CLIZA,consulta externa,nuevas en menores de 5 anos,2006-11-01,278,230,278,230,508
COBIJA,consulta externa,nuevas en menores de 5 anos,2006-11-01,951,904,951,904,1855
COCHABAMBA,consulta externa,nuevas en menores de 5 anos,2006-11-01,8659,7744,8659,7744,16403
COIPASA,consulta externa,nuevas en menores de 5 anos,2006-11-01,8,19,8,19,27
COLCAPIRHUA,consulta externa,nuevas en menores de 5 anos,2006-11-01,431,438,431,438,869
"COLCHA ""K""",consulta externa,nuevas en menores de 5 anos,2006-11-01,163,154,163,154,317
COLLANA,consulta externa,nuevas en menores de 5 anos,2006-11-01,34,14,34,14,48
COLOMI,consulta externa,nuevas en menores de 5 anos,2006-11-01,323,268,323,268,591
COLPA BELGICA,consulta externa,nuevas en menores de 5 anos,2006-11-01,155,128,155,128,283
COLQUECHACA,consulta externa,nuevas en menores de 5 anos,2006-11-01,903,832,903,832,1735
COLQUENCHA,consulta externa,nuevas en menores de 5 anos,2006-11-01,108,90,108,90,198
COLQUIRI,consulta externa,nuevas en menores de 5 anos,2006-11-01,397,385,397,385,782
COMANCHE,consulta externa,nuevas en menores de 5 anos,2006-11-01,29,28,29,28,57
COMARAPA,consulta externa,nuevas en menores de 5 anos,2006-11-01,361,320,361,320,681
COMBAYA,consulta externa,nuevas en menores de 5 anos,2006-11-01,41,26,41,26,67
CONCEPCION,consulta externa,nuevas en menores de 5 anos,2006-11-01,173,145,173,145,318
COPACABANA,consulta externa,nuevas en menores de 5 anos,2006-11-01,99,94,99,94,193
CORIPATA,consulta externa,nuevas en menores de 5 anos,2006-11-01,218,231,218,231,449
CORO CORO,consulta externa,nuevas en menores de 5 anos,2006-11-01,124,119,124,119,243
COROICO,consulta externa,nuevas en menores de 5 anos,2006-11-01,260,207,260,207,467
CORQUE,consulta externa,nuevas en menores de 5 anos,2006-11-01,95,82,95,82,177
COTAGAITA,consulta externa,nuevas en menores de 5 anos,2006-11-01,478,485,478,485,963
COTOCA,consulta externa,nuevas en menores de 5 anos,2006-11-01,950,772,950,772,1722
CUATRO CAÑADAS,consulta externa,nuevas en menores de 5 anos,2006-11-01,415,433,415,433,848
CUCHUMUELA (V. G. VILLARROEL),consulta externa,nuevas en menores de 5 anos,2006-11-01,32,326,32,326,358
CUEVO,consulta externa,nuevas en menores de 5 anos,2006-11-01,84,114,84,114,198
CULPINA,consulta externa,nuevas en menores de 5 anos,2006-11-01,610,571,610,571,1181
CURAHUARA DE CARANGAS,consulta externa,nuevas en menores de 5 anos,2006-11-01,130,97,130,97,227
CURVA,consulta externa,nuevas en menores de 5 anos,2006-11-01,31,18,31,18,49
DESAGUADERO,consulta externa,nuevas en menores de 5 anos,2006-11-01,37,18,37,18,55
EL ALTO,consulta externa,nuevas en menores de 5 anos,2006-11-01,9420,9079,9420,9079,18499
EL CHORO,consulta externa,nuevas en menores de 5 anos,2006-11-01,67,84,67,84,151
EL PUENTE(STC),consulta externa,nuevas en menores de 5 anos,2006-11-01,359,315,359,315,674
EL PUENTE(TJA),consulta externa,nuevas en menores de 5 anos,2006-11-01,249,222,249,222,471
EL TORNO,consulta externa,nuevas en menores de 5 anos,2006-11-01,1116,980,1116,980,2096
EL VILLAR,consulta externa,nuevas en menores de 5 anos,2006-11-01,169,163,169,163,332
ENTRE RIOS,consulta externa,nuevas en menores de 5 anos,2006-11-01,446,412,446,412,858
ENTRE RIOS,consulta externa,nuevas en menores de 5 anos,2006-11-01,654,539,654,539,1193
ESCARA,consulta externa,nuevas en menores de 5 anos,2006-11-01,3,3,3,3,6
ESMERALDA,consulta externa,nuevas en menores de 5 anos,2006-11-01,3,4,3,4,7
EUCALIPTUS,consulta externa,nuevas en menores de 5 anos,2006-11-01,210,181,210,181,391
EUREKA (SANTOS MERCADO),consulta externa,nuevas en menores de 5 anos,2006-11-01,42,56,42,56,98
EXALTACION,consulta externa,nuevas en menores de 5 anos,2006-11-01,63,71,63,71,134
FERNANDEZ ALONSO,consulta externa,nuevas en menores de 5 anos,2006-11-01,1003,907,1003,907,1910
FILADELFIA,consulta externa,nuevas en menores de 5 anos,2006-11-01,124,133,124,133,257
GENERAL SAAVEDRA,consulta externa,nuevas en menores de 5 anos,2006-11-01,548,607,548,607,1155
GRAL. J.J. PEREZ (CHARAZANI),consulta externa,nuevas en menores de 5 anos,2006-11-01,173,162,173,162,335
GUANAY,consulta externa,nuevas en menores de 5 anos,2006-11-01,411,412,411,412,823
GUAQUI,consulta externa,nuevas en menores de 5 anos,2006-11-01,60,34,60,34,94
GUAYARAMERIN,consulta externa,nuevas en menores de 5 anos,2006-11-01,1321,1232,1321,1232,2553
GUTIERREZ,consulta externa,nuevas en menores de 5 anos,2006-11-01,849,347,849,347,1196
HUACARETA,consulta externa,nuevas en menores de 5 anos,2006-11-01,273,243,273,243,516
HUACAYA (VILLA DE HUACAYA),consulta externa,nuevas en menores de 5 anos,2006-11-01,156,117,156,117,273
HUACHACALLA,consulta externa,nuevas en menores de 5 anos,2006-11-01,63,46,63,46,109
HUANUNI,consulta externa,nuevas en menores de 5 anos,2006-11-01,499,381,499,381,880
HUARACAJE,consulta externa,nuevas en menores de 5 anos,2006-11-01,76,55,76,55,131
HUAYLLAMARCA,consulta externa,nuevas en menores de 5 anos,2006-11-01,70,94,70,94,164
ICHOCA,consulta externa,nuevas en menores de 5 anos,2006-11-01,84,80,84,80,164
ICLA,consulta externa,nuevas en menores de 5 anos,2006-11-01,414,352,414,352,766
INCAHUASI,consulta externa,nuevas en menores de 5 anos,2006-11-01,528,599,528,599,1127
INGAVI (HUMAITA),consulta externa,nuevas en menores de 5 anos,2006-11-01,17,12,17,12,29
INQUISIVI,consulta externa,nuevas en menores de 5 anos,2006-11-01,208,200,208,200,408
IRUPANA (VILLA DE LANZA),consulta externa,nuevas en menores de 5 anos,2006-11-01,239,202,239,202,441
IXIAMAS,consulta externa,nuevas en menores de 5 anos,2006-11-01,338,278,338,278,616
JESUS DE MACHACA,consulta externa,nuevas en menores de 5 anos,2006-11-01,161,106,161,106,267
LA ASUNTA,consulta externa,nuevas en menores de 5 anos,2006-11-01,729,665,729,665,1394
LA GUARDIA,consulta externa,nuevas en menores de 5 anos,2006-11-01,1276,1156,1276,1156,2432
LA PAZ,consulta externa,nuevas en menores de 5 anos,2006-11-01,13464,12870,13464,12870,26334
LA RIVERA,consulta externa,nuevas en menores de 5 anos,2006-11-01,4,4,4,4,8
LAGUNILLAS,consulta externa,nuevas en menores de 5 anos,2006-11-01,223,236,223,236,459
LAJA,consulta externa,nuevas en menores de 5 anos,2006-11-01,114,78,114,78,192
LAS CARRERAS,consulta externa,nuevas en menores de 5 anos,2006-11-01,81,103,81,103,184
LICOMA PAMPA,consulta externa,nuevas en menores de 5 anos,2006-11-01,38,35,38,35,73
LLALLAGUA,consulta externa,nuevas en menores de 5 anos,2006-11-01,670,604,670,604,1274
LLICA,consulta externa,nuevas en menores de 5 anos,2006-11-01,63,39,63,39,102
LORETO,consulta externa,nuevas en menores de 5 anos,2006-11-01,110,113,110,113,223
LURIBAY,consulta externa,nuevas en menores de 5 anos,2006-11-01,135,139,135,139,274
MACHACAMARCA,consulta externa,nuevas en menores de 5 anos,2006-11-01,86,51,86,51,137
MACHARETI,consulta externa,nuevas en menores de 5 anos,2006-11-01,277,269,277,269,546
MAGDALENA,consulta externa,nuevas en menores de 5 anos,2006-11-01,184,177,184,177,361
MAIRANA,consulta externa,nuevas en menores de 5 anos,2006-11-01,162,142,162,142,304
MALLA,consulta externa,nuevas en menores de 5 anos,2006-11-01,52,45,52,45,97
MAPIRI,consulta externa,nuevas en menores de 5 anos,2006-11-01,296,254,296,254,550
MECAPACA,consulta externa,nuevas en menores de 5 anos,2006-11-01,190,118,190,118,308
MINEROS,consulta externa,nuevas en menores de 5 anos,2006-11-01,613,467,613,467,1080
MIZQUE,consulta externa,nuevas en menores de 5 anos,2006-11-01,354,352,354,352,706
MOCOMOCO,consulta externa,nuevas en menores de 5 anos,2006-11-01,149,118,149,118,267
MOJINETE,consulta externa,nuevas en menores de 5 anos,2006-11-01,17,29,17,29,46
MOJOCOYA,consulta externa,nuevas en menores de 5 anos,2006-11-01,205,143,205,143,348
MONTEAGUDO,consulta externa,nuevas en menores de 5 anos,2006-11-01,691,738,691,738,1429
MONTERO,consulta externa,nuevas en menores de 5 anos,2006-11-01,2544,2240,2544,2240,4784
MORO MORO,consulta externa,nuevas en menores de 5 anos,2006-11-01,61,67,61,67,128
MOROCHATA,consulta externa,nuevas en menores de 5 anos,2006-11-01,250,251,250,251,501
NACEBE (SANTA ROSA DEL ABUNA),consulta externa,nuevas en menores de 5 anos,2006-11-01,42,47,42,47,89
NUEVO MANOA (NUEVA ESPERANZA),consulta externa,nuevas en menores de 5 anos,2006-11-01,48,56,48,56,104
OCURI,consulta externa,nuevas en menores de 5 anos,2006-11-01,481,450,481,450,931
OKINAWA,consulta externa,nuevas en menores de 5 anos,2006-11-01,440,404,440,404,844
OMEREQUE,consulta externa,nuevas en menores de 5 anos,2006-11-01,121,109,121,109,230
ORURO,consulta externa,nuevas en menores de 5 anos,2006-11-01,4591,4134,4591,4134,8725
PADCAYA,consulta externa,nuevas en menores de 5 anos,2006-11-01,478,431,478,431,909
PADILLA,consulta externa,nuevas en menores de 5 anos,2006-11-01,402,408,402,408,810
PAILON,consulta externa,nuevas en menores de 5 anos,2006-11-01,404,429,404,429,833
PALCA,consulta externa,nuevas en menores de 5 anos,2006-11-01,131,129,131,129,260
PALOS BLANCOS,consulta externa,nuevas en menores de 5 anos,2006-11-01,715,688,715,688,1403
PAMPA AULLAGAS,consulta externa,nuevas en menores de 5 anos,2006-11-01,52,55,52,55,107
PAMPA GRANDE,consulta externa,nuevas en menores de 5 anos,2006-11-01,128,110,128,110,238
PAPEL PAMPA,consulta externa,nuevas en menores de 5 anos,2006-11-01,52,51,52,51,103
PASORAPA,consulta externa,nuevas en menores de 5 anos,2006-11-01,33,13,33,13,46
PATACAMAYA,consulta externa,nuevas en menores de 5 anos,2006-11-01,63,66,63,66,129
PAZÑA,consulta externa,nuevas en menores de 5 anos,2006-11-01,97,109,97,109,206
PELECHUCO,consulta externa,nuevas en menores de 5 anos,2006-11-01,124,92,124,92,216
POCOATA,consulta externa,nuevas en menores de 5 anos,2006-11-01,458,398,458,398,856
POCONA,consulta externa,nuevas en menores de 5 anos,2006-11-01,202,202,202,202,404
POJO (CBBA),consulta externa,nuevas en menores de 5 anos,2006-11-01,208,215,208,215,423
POOPO,consulta externa,nuevas en menores de 5 anos,2006-11-01,54,32,54,32,86
PORCO,consulta externa,nuevas en menores de 5 anos,2006-11-01,126,116,126,116,242
POROMA,consulta externa,nuevas en menores de 5 anos,2006-11-01,437,388,437,388,825
PORONGO,consulta externa,nuevas en menores de 5 anos,2006-11-01,189,174,189,174,363
PORTACHUELO,consulta externa,nuevas en menores de 5 anos,2006-11-01,546,471,546,471,1017
PORVENIR,consulta externa,nuevas en menores de 5 anos,2006-11-01,182,167,182,167,349
POSTRER VALLE,consulta externa,nuevas en menores de 5 anos,2006-11-01,47,47,47,47,94
POTOSI,consulta externa,nuevas en menores de 5 anos,2006-11-01,3272,3212,3272,3212,6484
PRESTO,consulta externa,nuevas en menores de 5 anos,2006-11-01,409,347,409,347,756
PUCARA,consulta externa,nuevas en menores de 5 anos,2006-11-01,31,30,31,30,61
PUCARANI,consulta externa,nuevas en menores de 5 anos,2006-11-01,247,205,247,205,452
PUERTO ACOSTA,consulta externa,nuevas en menores de 5 anos,2006-11-01,272,252,272,252,524
PUERTO CARABUCO,consulta externa,nuevas en menores de 5 anos,2006-11-01,171,161,171,161,332
PUERTO GONZALO MORENO,consulta externa,nuevas en menores de 5 anos,2006-11-01,140,123,140,123,263
PUERTO PEREZ,consulta externa,nuevas en menores de 5 anos,2006-11-01,81,74,81,74,155
PUERTO QUIJARRO,consulta externa,nuevas en menores de 5 anos,2006-11-01,300,264,300,264,564
PUERTO RICO,consulta externa,nuevas en menores de 5 anos,2006-11-01,89,112,89,112,201
PUERTO SILES,consulta externa,nuevas en menores de 5 anos,2006-11-01,111,124,111,124,235
PUERTO SUAREZ,consulta externa,nuevas en menores de 5 anos,2006-11-01,241,217,241,217,458
PUERTO VILLARROEL,consulta externa,nuevas en menores de 5 anos,2006-11-01,1319,1215,1319,1215,2534
PUNA,consulta externa,nuevas en menores de 5 anos,2006-11-01,753,665,753,665,1418
PUNATA,consulta externa,nuevas en menores de 5 anos,2006-11-01,362,357,362,357,719
QUIABAYA,consulta externa,nuevas en menores de 5 anos,2006-11-01,51,33,51,33,84
QUILLACOLLO,consulta externa,nuevas en menores de 5 anos,2006-11-01,534,396,534,396,930
QUIME,consulta externa,nuevas en menores de 5 anos,2006-11-01,127,99,127,99,226
QUIRUSILLAS,consulta externa,nuevas en menores de 5 anos,2006-11-01,41,26,41,26,67
RAVELO,consulta externa,nuevas en menores de 5 anos,2006-11-01,504,438,504,438,942
REYES,consulta externa,nuevas en menores de 5 anos,2006-11-01,245,243,245,243,488
RIBERALTA,consulta externa,nuevas en menores de 5 anos,2006-11-01,2194,2167,2194,2167,4361
ROBORE,consulta externa,nuevas en menores de 5 anos,2006-11-01,360,382,360,382,742
RURRENABAQUE,consulta externa,nuevas en menores de 5 anos,2006-11-01,361,308,361,308,669
SABAYA,consulta externa,nuevas en menores de 5 anos,2006-11-01,55,48,55,48,103
SACABA,consulta externa,nuevas en menores de 5 anos,2006-11-01,1111,1057,1111,1057,2168
SACABAMBA,consulta externa,nuevas en menores de 5 anos,2006-11-01,85,56,85,56,141
SACACA,consulta externa,nuevas en menores de 5 anos,2006-11-01,709,635,709,635,1344
SAIPINA,consulta externa,nuevas en menores de 5 anos,2006-11-01,183,159,183,159,342
SALINAS DE GARCI MENDOZA,consulta externa,nuevas en menores de 5 anos,2006-11-01,265,219,265,219,484
SAMAIPATA,consulta externa,nuevas en menores de 5 anos,2006-11-01,143,113,143,113,256
SAN AGUSTIN,consulta externa,nuevas en menores de 5 anos,2006-11-01,26,44,26,44,70
SAN ANDRES,consulta externa,nuevas en menores de 5 anos,2006-11-01,393,352,393,352,745
SAN ANDRES DE MACHACA,consulta externa,nuevas en menores de 5 anos,2006-11-01,64,63,64,63,127
SAN ANTONIO DE ESMORUCO,consulta externa,nuevas en menores de 5 anos,2006-11-01,33,48,33,48,81
SAN ANTONIO DE LOMERIO,consulta externa,nuevas en menores de 5 anos,2006-11-01,122,125,122,125,247
SAN BENITO,consulta externa,nuevas en menores de 5 anos,2006-11-01,170,124,170,124,294
SAN BORJA,consulta externa,nuevas en menores de 5 anos,2006-11-01,704,632,704,632,1336
SAN BUENA VENTURA,consulta externa,nuevas en menores de 5 anos,2006-11-01,301,324,301,324,625
SAN CARLOS,consulta externa,nuevas en menores de 5 anos,2006-11-01,701,485,701,485,1186
SAN IGNACIO,consulta externa,nuevas en menores de 5 anos,2006-11-01,735,608,735,608,1343
SAN IGNACIO DE VELASCO,consulta externa,nuevas en menores de 5 anos,2006-11-01,1293,1247,1293,1247,2540
SAN JAVIER(BNI),consulta externa,nuevas en menores de 5 anos,2006-11-01,57,57,57,57,114
SAN JAVIER(STC),consulta externa,nuevas en menores de 5 anos,2006-11-01,2872,330,2872,330,3202
SAN JOAQUIN,consulta externa,nuevas en menores de 5 anos,2006-11-01,72,82,72,82,154
SAN JOSE DE CHIQUITOS,consulta externa,nuevas en menores de 5 anos,2006-11-01,452,418,452,418,870
SAN JUAN DE YAPACANI,consulta externa,nuevas en menores de 5 anos,2006-11-01,458,444,458,444,902
SAN JULIAN,consulta externa,nuevas en menores de 5 anos,2006-11-01,1049,1014,1049,1014,2063
SAN LORENZO(PND),consulta externa,nuevas en menores de 5 anos,2006-11-01,199,200,199,200,399
SAN LORENZO(TJA),consulta externa,nuevas en menores de 5 anos,2006-11-01,509,517,509,517,1026
SAN LUCAS,consulta externa,nuevas en menores de 5 anos,2006-11-01,1111,1120,1111,1120,2231
SAN MATIAS,consulta externa,nuevas en menores de 5 anos,2006-11-01,342,288,342,288,630
SAN MIGUEL DE VELASCO,consulta externa,nuevas en menores de 5 anos,2006-11-01,241,177,241,177,418
SAN PABLO DE LIPEZ,consulta externa,nuevas en menores de 5 anos,2006-11-01,72,86,72,86,158
SAN PEDRO,consulta externa,nuevas en menores de 5 anos,2006-11-01,600,594,600,594,1194
SAN PEDRO DE BUENA VISTA,consulta externa,nuevas en menores de 5 anos,2006-11-01,756,686,756,686,1442
SAN PEDRO DE CURAHUARA,consulta externa,nuevas en menores de 5 anos,2006-11-01,79,59,79,59,138
SAN PEDRO DE QUEMES,consulta externa,nuevas en menores de 5 anos,2006-11-01,8,13,8,13,21
SAN PEDRO DE TIQUINA,consulta externa,nuevas en menores de 5 anos,2006-11-01,29,38,29,38,67
SAN PEDRO(PND),consulta externa,nuevas en menores de 5 anos,2006-11-01,30,25,30,25,55
SAN RAFAEL,consulta externa,nuevas en menores de 5 anos,2006-11-01,117,85,117,85,202
SAN RAMON,consulta externa,nuevas en menores de 5 anos,2006-11-01,129,100,129,100,229
SAN RAMON,consulta externa,nuevas en menores de 5 anos,2006-11-01,228,204,228,204,432
SANTA ANA,consulta externa,nuevas en menores de 5 anos,2006-11-01,275,236,275,236,511
SANTA CRUZ DE LA SIERRA,consulta externa,nuevas en menores de 5 anos,2006-11-01,23775,20054,23775,20054,43829
SANTA ROSA,consulta externa,nuevas en menores de 5 anos,2006-11-01,225,226,225,226,451
SANTA ROSA DEL SARA,consulta externa,nuevas en menores de 5 anos,2006-11-01,650,671,650,671,1321
SANTIAGO DE CALLAPA,consulta externa,nuevas en menores de 5 anos,2006-11-01,69,63,69,63,132
SANTIAGO DE HUARI,consulta externa,nuevas en menores de 5 anos,2006-11-01,138,79,138,79,217
SANTIAGO DE MACHACA,consulta externa,nuevas en menores de 5 anos,2006-11-01,45,26,45,26,71
SANTIVAÑES,consulta externa,nuevas en menores de 5 anos,2006-11-01,130,112,130,112,242
SANTUARIO DE QUILLACAS,consulta externa,nuevas en menores de 5 anos,2006-11-01,40,37,40,37,77
SAPAHAQUI,consulta externa,nuevas en menores de 5 anos,2006-11-01,196,206,196,206,402
SENA,consulta externa,nuevas en menores de 5 anos,2006-11-01,173,174,173,174,347
SICA SICA (VILLA AROMA),consulta externa,nuevas en menores de 5 anos,2006-11-01,211,166,211,166,377
SICAYA,consulta externa,nuevas en menores de 5 anos,2006-11-01,48,51,48,51,99
SIPE SIPE,consulta externa,nuevas en menores de 5 anos,2006-11-01,351,302,351,302,653
SOPACHUY,consulta externa,nuevas en menores de 5 anos,2006-11-01,382,371,382,371,753
SORACACHI,consulta externa,nuevas en menores de 5 anos,2006-11-01,3379,125,3379,125,3504
SORATA,consulta externa,nuevas en menores de 5 anos,2006-11-01,219,207,219,207,426
SUCRE,consulta externa,nuevas en menores de 5 anos,2006-11-01,5743,5670,5743,5670,11413
TACACHI,consulta externa,nuevas en menores de 5 anos,2006-11-01,8,11,8,11,19
TACACOMA,consulta externa,nuevas en menores de 5 anos,2006-11-01,88,60,88,60,148
TACOBAMBA,consulta externa,nuevas en menores de 5 anos,2006-11-01,112,107,112,107,219
TACOPAYA,consulta externa,nuevas en menores de 5 anos,2006-11-01,184,147,184,147,331
TAHUA,consulta externa,nuevas en menores de 5 anos,2006-11-01,16,9,16,9,25
TAPACARI,consulta externa,nuevas en menores de 5 anos,2006-11-01,674,591,674,591,1265
TARABUCO,consulta externa,nuevas en menores de 5 anos,2006-11-01,844,869,844,869,1713
TARACO,consulta externa,nuevas en menores de 5 anos,2006-11-01,42,37,42,37,79
TARATA,consulta externa,nuevas en menores de 5 anos,2006-11-01,109,133,109,133,242
TARIJA,consulta externa,nuevas en menores de 5 anos,2006-11-01,3527,3119,3527,3119,6646
TARVITA,consulta externa,nuevas en menores de 5 anos,2006-11-01,708,713,708,713,1421
TEOPONTE,consulta externa,nuevas en menores de 5 anos,2006-11-01,157,183,157,183,340
TIAWANACU,consulta externa,nuevas en menores de 5 anos,2006-11-01,113,96,113,96,209
TINGUIPAYA,consulta externa,nuevas en menores de 5 anos,2006-11-01,557,430,557,430,987
TIPUANI,consulta externa,nuevas en menores de 5 anos,2006-11-01,160,162,160,162,322
TIQUIPAYA,consulta externa,nuevas en menores de 5 anos,2006-11-01,702,644,702,644,1346
TIRAQUE (CBBA),consulta externa,nuevas en menores de 5 anos,2006-11-01,824,827,824,827,1651
TITO YUPANQUI (PARQUIPUJIO),consulta externa,nuevas en menores de 5 anos,2006-11-01,15,37,15,37,52
TOCO,consulta externa,nuevas en menores de 5 anos,2006-11-01,68,26,68,26,94
TODOS SANTOS,consulta externa,nuevas en menores de 5 anos,2006-11-01,2,1,2,1,3
TOLATA,consulta externa,nuevas en menores de 5 anos,2006-11-01,59,45,59,45,104
TOLEDO,consulta externa,nuevas en menores de 5 anos,2006-11-01,123,108,123,108,231
TOMAVE,consulta externa,nuevas en menores de 5 anos,2006-11-01,201,166,201,166,367
TOMINA,consulta externa,nuevas en menores de 5 anos,2006-11-01,286,244,286,244,530
TORO TORO,consulta externa,nuevas en menores de 5 anos,2006-11-01,317,318,317,318,635
TOTORA(CBBA),consulta externa,nuevas en menores de 5 anos,2006-11-01,197,162,197,162,359
TOTORA(ORR),consulta externa,nuevas en menores de 5 anos,2006-11-01,156,68,156,68,224
TRIGAL,consulta externa,nuevas en menores de 5 anos,2006-11-01,41,24,41,24,65
TRINIDAD,consulta externa,nuevas en menores de 5 anos,2006-11-01,1988,1682,1988,1682,3670
TUPIZA,consulta externa,nuevas en menores de 5 anos,2006-11-01,941,942,941,942,1883
TURCO,consulta externa,nuevas en menores de 5 anos,2006-11-01,105,106,105,106,211
UMALA,consulta externa,nuevas en menores de 5 anos,2006-11-01,37,27,37,27,64
UNCIA,consulta externa,nuevas en menores de 5 anos,2006-11-01,804,822,804,822,1626
URIONDO (A. CONCEPCION),consulta externa,nuevas en menores de 5 anos,2006-11-01,470,501,470,501,971
URUBICHA,consulta externa,nuevas en menores de 5 anos,2006-11-01,155,168,155,168,323
UYUNI,consulta externa,nuevas en menores de 5 anos,2006-11-01,283,299,283,299,582
VACAS,consulta externa,nuevas en menores de 5 anos,2006-11-01,212,209,212,209,421
VALLEGRANDE,consulta externa,nuevas en menores de 5 anos,2006-11-01,274,262,274,262,536
VIACHA,consulta externa,nuevas en menores de 5 anos,2006-11-01,480,476,480,476,956
VILA VILA,consulta externa,nuevas en menores de 5 anos,2006-11-01,41,30,41,30,71
VILLA MONTES,consulta externa,nuevas en menores de 5 anos,2006-11-01,689,750,689,750,1439
VILLA NUEVA (LOMA ALTA),consulta externa,nuevas en menores de 5 anos,2006-11-01,49,60,49,60,109
VILLA RIVERO,consulta externa,nuevas en menores de 5 anos,2006-11-01,61,111,61,111,172
VILLA SERRANO,consulta externa,nuevas en menores de 5 anos,2006-11-01,480,467,480,467,947
VILLA TUNARI,consulta externa,nuevas en menores de 5 anos,2006-11-01,1624,1540,1624,1540,3164
VILLA VACA GUZMAN (MUYUPAMPA),consulta externa,nuevas en menores de 5 anos,2006-11-01,393,418,393,418,811
VILLAZON,consulta externa,nuevas en menores de 5 anos,2006-11-01,772,691,772,691,1463
VINTO,consulta externa,nuevas en menores de 5 anos,2006-11-01,186,176,186,176,362
VITICHI,consulta externa,nuevas en menores de 5 anos,2006-11-01,236,258,236,258,494
WALDO BALLIVIAN,consulta externa,nuevas en menores de 5 anos,2006-11-01,26,36,26,36,62
WARNES,consulta externa,nuevas en menores de 5 anos,2006-11-01,1439,1272,1439,1272,2711
YACO,consulta externa,nuevas en menores de 5 anos,2006-11-01,139,138,139,138,277
YACUIBA,consulta externa,nuevas en menores de 5 anos,2006-11-01,2226,2050,2226,2050,4276
YAMPARAEZ,consulta externa,nuevas en menores de 5 anos,2006-11-01,177,181,177,181,358
YANACACHI,consulta externa,nuevas en menores de 5 anos,2006-11-01,78,78,78,78,156
YAPACANI,consulta externa,nuevas en menores de 5 anos,2006-11-01,738,1143,738,1143,1881
YOCALLA,consulta externa,nuevas en menores de 5 anos,2006-11-01,108,73,108,73,181
YOTALA,consulta externa,nuevas en menores de 5 anos,2006-11-01,281,200,281,200,481
YUNCHARA,consulta externa,nuevas en menores de 5 anos,2006-11-01,141,129,141,129,270
ZUDAÑEZ,consulta externa,nuevas en menores de 5 anos,2006-11-01,323,342,323,342,665
ACACIO,consulta externa,nuevas en menores de 5 anos,2006-12-01,163,168,163,168,331
ACHACACHI,consulta externa,nuevas en menores de 5 anos,2006-12-01,304,243,304,243,547
ACHOCALLA,consulta externa,nuevas en menores de 5 anos,2006-12-01,86,80,86,80,166
AIQUILE,consulta externa,nuevas en menores de 5 anos,2006-12-01,302,296,302,296,598
ALALAY,consulta externa,nuevas en menores de 5 anos,2006-12-01,1,1,1,1,2
ALCALA,consulta externa,nuevas en menores de 5 anos,2006-12-01,140,160,140,160,300
ANCORAIMES,consulta externa,nuevas en menores de 5 anos,2006-12-01,143,120,143,120,263
ANDAMARCA,consulta externa,nuevas en menores de 5 anos,2006-12-01,90,90,90,90,180
ANTEQUERA,consulta externa,nuevas en menores de 5 anos,2006-12-01,62,41,62,41,103
ANZALDO,consulta externa,nuevas en menores de 5 anos,2006-12-01,58,74,58,74,132
APOLO,consulta externa,nuevas en menores de 5 anos,2006-12-01,315,323,315,323,638
ARAMPAMPA,consulta externa,nuevas en menores de 5 anos,2006-12-01,180,170,180,170,350
ARANI,consulta externa,nuevas en menores de 5 anos,2006-12-01,74,57,74,57,131
ARBIETO,consulta externa,nuevas en menores de 5 anos,2006-12-01,65,55,65,55,120
ARQUE,consulta externa,nuevas en menores de 5 anos,2006-12-01,146,141,146,141,287
ASCENCION DE GUARAYOS,consulta externa,nuevas en menores de 5 anos,2006-12-01,374,354,374,354,728
ATOCHA,consulta externa,nuevas en menores de 5 anos,2006-12-01,282,243,282,243,525
AUCAPATA,consulta externa,nuevas en menores de 5 anos,2006-12-01,77,69,77,69,146
AYATA,consulta externa,nuevas en menores de 5 anos,2006-12-01,141,108,141,108,249
AYO AYO,consulta externa,nuevas en menores de 5 anos,2006-12-01,58,73,58,73,131
AYOPAYA (V. DE INDEPENDENCIA),consulta externa,nuevas en menores de 5 anos,2006-12-01,449,452,449,452,901
AZURDUY,consulta externa,nuevas en menores de 5 anos,2006-12-01,518,508,518,508,1026
BATALLAS,consulta externa,nuevas en menores de 5 anos,2006-12-01,95,98,95,98,193
BAURES,consulta externa,nuevas en menores de 5 anos,2006-12-01,96,104,96,104,200
BELEN DE ANDAMARCA,consulta externa,nuevas en menores de 5 anos,2006-12-01,26,22,26,22,48
BELEN DE URMIRI,consulta externa,nuevas en menores de 5 anos,2006-12-01,29,39,29,39,68
BELLA FLOR,consulta externa,nuevas en menores de 5 anos,2006-12-01,63,57,63,57,120
BERMEJO,consulta externa,nuevas en menores de 5 anos,2006-12-01,714,697,714,697,1411
BETANZOS,consulta externa,nuevas en menores de 5 anos,2006-12-01,653,644,653,644,1297
BOLIVAR,consulta externa,nuevas en menores de 5 anos,2006-12-01,143,124,143,124,267
BOLPEBRA,consulta externa,nuevas en menores de 5 anos,2006-12-01,25,36,25,36,61
BOYUIBE,consulta externa,nuevas en menores de 5 anos,2006-12-01,81,63,81,63,144
BUENA VISTA,consulta externa,nuevas en menores de 5 anos,2006-12-01,243,202,243,202,445
CABEZAS,consulta externa,nuevas en menores de 5 anos,2006-12-01,464,382,464,382,846
CAIROMA,consulta externa,nuevas en menores de 5 anos,2006-12-01,140,140,140,140,280
"CAIZA ""D""",consulta externa,nuevas en menores de 5 anos,2006-12-01,144,130,144,130,274
CAJUATA,consulta externa,nuevas en menores de 5 anos,2006-12-01,109,100,109,100,209
CALACOTO,consulta externa,nuevas en menores de 5 anos,2006-12-01,37,46,37,46,83
CALAMARCA,consulta externa,nuevas en menores de 5 anos,2006-12-01,157,152,157,152,309
CAMARGO,consulta externa,nuevas en menores de 5 anos,2006-12-01,315,321,315,321,636
CAMATAQUI (C. VILLA ABECIA),consulta externa,nuevas en menores de 5 anos,2006-12-01,87,88,87,88,175
CAMIRI,consulta externa,nuevas en menores de 5 anos,2006-12-01,905,754,905,754,1659
CAPINOTA,consulta externa,nuevas en menores de 5 anos,2006-12-01,329,320,329,320,649
CAQUIAVIRI,consulta externa,nuevas en menores de 5 anos,2006-12-01,49,69,49,69,118
CARACOLLO,consulta externa,nuevas en menores de 5 anos,2006-12-01,1110,246,1110,246,1356
CARANAVI,consulta externa,nuevas en menores de 5 anos,2006-12-01,992,999,992,999,1991
CARANGAS,consulta externa,nuevas en menores de 5 anos,2006-12-01,5,6,5,6,11
CARAPARI,consulta externa,nuevas en menores de 5 anos,2006-12-01,197,227,197,227,424
CARIPUYO,consulta externa,nuevas en menores de 5 anos,2006-12-01,326,295,326,295,621
CARMEN RIVERO TORREZ,consulta externa,nuevas en menores de 5 anos,2006-12-01,68,67,68,67,135
CATACORA,consulta externa,nuevas en menores de 5 anos,2006-12-01,10,6,10,6,16
CHACARILLA,consulta externa,nuevas en menores de 5 anos,2006-12-01,21,41,21,41,62
CHALLAPATA,consulta externa,nuevas en menores de 5 anos,2006-12-01,425,442,425,442,867
CHAQUI,consulta externa,nuevas en menores de 5 anos,2006-12-01,153,112,153,112,265
CHARAGUA,consulta externa,nuevas en menores de 5 anos,2006-12-01,571,651,571,651,1222
CHARAÑA,consulta externa,nuevas en menores de 5 anos,2006-12-01,17,24,17,24,41
CHAYANTA,consulta externa,nuevas en menores de 5 anos,2006-12-01,357,357,357,357,714
CHIMORE,consulta externa,nuevas en menores de 5 anos,2006-12-01,557,521,557,521,1078
CHIPAYA,consulta externa,nuevas en menores de 5 anos,2006-12-01,27,30,27,30,57
CHOQUE COTA,consulta externa,nuevas en menores de 5 anos,2006-12-01,17,14,17,14,31
CHULUMANI (V. DE LA LIBERTAD),consulta externa,nuevas en menores de 5 anos,2006-12-01,199,194,199,194,393
CHUMA,consulta externa,nuevas en menores de 5 anos,2006-12-01,100,100,100,100,200
CLIZA,consulta externa,nuevas en menores de 5 anos,2006-12-01,195,242,195,242,437
COBIJA,consulta externa,nuevas en menores de 5 anos,2006-12-01,764,695,764,695,1459
COCHABAMBA,consulta externa,nuevas en menores de 5 anos,2006-12-01,8010,7299,8010,7299,15309
COIPASA,consulta externa,nuevas en menores de 5 anos,2006-12-01,4,11,4,11,15
COLCAPIRHUA,consulta externa,nuevas en menores de 5 anos,2006-12-01,411,379,411,379,790
"COLCHA ""K""",consulta externa,nuevas en menores de 5 anos,2006-12-01,121,111,121,111,232
COLLANA,consulta externa,nuevas en menores de 5 anos,2006-12-01,21,18,21,18,39
COLOMI,consulta externa,nuevas en menores de 5 anos,2006-12-01,267,231,267,231,498
COLPA BELGICA,consulta externa,nuevas en menores de 5 anos,2006-12-01,114,95,114,95,209
COLQUECHACA,consulta externa,nuevas en menores de 5 anos,2006-12-01,969,805,969,805,1774
COLQUENCHA,consulta externa,nuevas en menores de 5 anos,2006-12-01,75,101,75,101,176
COLQUIRI,consulta externa,nuevas en menores de 5 anos,2006-12-01,284,222,284,222,506
COMANCHE,consulta externa,nuevas en menores de 5 anos,2006-12-01,28,16,28,16,44
COMARAPA,consulta externa,nuevas en menores de 5 anos,2006-12-01,259,246,259,246,505
COMBAYA,consulta externa,nuevas en menores de 5 anos,2006-12-01,10,13,10,13,23
CONCEPCION,consulta externa,nuevas en menores de 5 anos,2006-12-01,264,226,264,226,490
COPACABANA,consulta externa,nuevas en menores de 5 anos,2006-12-01,92,89,92,89,181
CORIPATA,consulta externa,nuevas en menores de 5 anos,2006-12-01,170,194,170,194,364
CORO CORO,consulta externa,nuevas en menores de 5 anos,2006-12-01,66,67,66,67,133
COROICO,consulta externa,nuevas en menores de 5 anos,2006-12-01,188,154,188,154,342
CORQUE,consulta externa,nuevas en menores de 5 anos,2006-12-01,63,59,63,59,122
COTAGAITA,consulta externa,nuevas en menores de 5 anos,2006-12-01,532,499,532,499,1031
COTOCA,consulta externa,nuevas en menores de 5 anos,2006-12-01,505,480,505,480,985
CUATRO CAÑADAS,consulta externa,nuevas en menores de 5 anos,2006-12-01,393,403,393,403,796
CUCHUMUELA (V. G. VILLARROEL),consulta externa,nuevas en menores de 5 anos,2006-12-01,7,9,7,9,16
CUEVO,consulta externa,nuevas en menores de 5 anos,2006-12-01,95,122,95,122,217
CULPINA,consulta externa,nuevas en menores de 5 anos,2006-12-01,510,437,510,437,947
CURAHUARA DE CARANGAS,consulta externa,nuevas en menores de 5 anos,2006-12-01,124,98,124,98,222
CURVA,consulta externa,nuevas en menores de 5 anos,2006-12-01,35,27,35,27,62
DESAGUADERO,consulta externa,nuevas en menores de 5 anos,2006-12-01,44,18,44,18,62
EL ALTO,consulta externa,nuevas en menores de 5 anos,2006-12-01,7928,7372,7928,7372,15300
EL CHORO,consulta externa,nuevas en menores de 5 anos,2006-12-01,82,59,82,59,141
EL PUENTE(STC),consulta externa,nuevas en menores de 5 anos,2006-12-01,268,291,268,291,559
EL PUENTE(TJA),consulta externa,nuevas en menores de 5 anos,2006-12-01,231,197,231,197,428
EL TORNO,consulta externa,nuevas en menores de 5 anos,2006-12-01,754,659,754,659,1413
EL VILLAR,consulta externa,nuevas en menores de 5 anos,2006-12-01,195,172,195,172,367
ENTRE RIOS,consulta externa,nuevas en menores de 5 anos,2006-12-01,425,394,425,394,819
ENTRE RIOS,consulta externa,nuevas en menores de 5 anos,2006-12-01,518,490,518,490,1008
ESCARA,consulta externa,nuevas en menores de 5 anos,2006-12-01,1,0,1,0,1
ESMERALDA,consulta externa,nuevas en menores de 5 anos,2006-12-01,9,7,9,7,16
EUCALIPTUS,consulta externa,nuevas en menores de 5 anos,2006-12-01,124,112,124,112,236
EUREKA (SANTOS MERCADO),consulta externa,nuevas en menores de 5 anos,2006-12-01,11,21,11,21,32
EXALTACION,consulta externa,nuevas en menores de 5 anos,2006-12-01,23,21,23,21,44
FERNANDEZ ALONSO,consulta externa,nuevas en menores de 5 anos,2006-12-01,882,780,882,780,1662
FILADELFIA,consulta externa,nuevas en menores de 5 anos,2006-12-01,48,45,48,45,93
GENERAL SAAVEDRA,consulta externa,nuevas en menores de 5 anos,2006-12-01,453,357,453,357,810
GRAL. J.J. PEREZ (CHARAZANI),consulta externa,nuevas en menores de 5 anos,2006-12-01,85,81,85,81,166
GUANAY,consulta externa,nuevas en menores de 5 anos,2006-12-01,318,310,318,310,628
GUAQUI,consulta externa,nuevas en menores de 5 anos,2006-12-01,58,42,58,42,100
GUAYARAMERIN,consulta externa,nuevas en menores de 5 anos,2006-12-01,2383,1046,2383,1046,3429
GUTIERREZ,consulta externa,nuevas en menores de 5 anos,2006-12-01,461,389,461,389,850
HUACARETA,consulta externa,nuevas en menores de 5 anos,2006-12-01,218,213,218,213,431
HUACAYA (VILLA DE HUACAYA),consulta externa,nuevas en menores de 5 anos,2006-12-01,61,61,61,61,122
HUACHACALLA,consulta externa,nuevas en menores de 5 anos,2006-12-01,23,20,23,20,43
HUANUNI,consulta externa,nuevas en menores de 5 anos,2006-12-01,477,402,477,402,879
HUARACAJE,consulta externa,nuevas en menores de 5 anos,2006-12-01,125,113,125,113,238
HUAYLLAMARCA,consulta externa,nuevas en menores de 5 anos,2006-12-01,28,30,28,30,58
ICHOCA,consulta externa,nuevas en menores de 5 anos,2006-12-01,65,69,65,69,134
ICLA,consulta externa,nuevas en menores de 5 anos,2006-12-01,470,493,470,493,963
INCAHUASI,consulta externa,nuevas en menores de 5 anos,2006-12-01,697,693,697,693,1390
INGAVI (HUMAITA),consulta externa,nuevas en menores de 5 anos,2006-12-01,27,17,27,17,44
INQUISIVI,consulta externa,nuevas en menores de 5 anos,2006-12-01,196,184,196,184,380
IRUPANA (VILLA DE LANZA),consulta externa,nuevas en menores de 5 anos,2006-12-01,229,245,229,245,474
IXIAMAS,consulta externa,nuevas en menores de 5 anos,2006-12-01,250,196,250,196,446
JESUS DE MACHACA,consulta externa,nuevas en menores de 5 anos,2006-12-01,170,121,170,121,291
LA ASUNTA,consulta externa,nuevas en menores de 5 anos,2006-12-01,539,485,539,485,1024
LA GUARDIA,consulta externa,nuevas en menores de 5 anos,2006-12-01,1096,996,1096,996,2092
LA PAZ,consulta externa,nuevas en menores de 5 anos,2006-12-01,11531,10552,11531,10552,22083
LA RIVERA,consulta externa,nuevas en menores de 5 anos,2006-12-01,2,4,2,4,6
LAGUNILLAS,consulta externa,nuevas en menores de 5 anos,2006-12-01,176,164,176,164,340
LAJA,consulta externa,nuevas en menores de 5 anos,2006-12-01,102,91,102,91,193
LAS CARRERAS,consulta externa,nuevas en menores de 5 anos,2006-12-01,71,72,71,72,143
LICOMA PAMPA,consulta externa,nuevas en menores de 5 anos,2006-12-01,22,25,22,25,47
LLALLAGUA,consulta externa,nuevas en menores de 5 anos,2006-12-01,607,509,607,509,1116
LLICA,consulta externa,nuevas en menores de 5 anos,2006-12-01,46,86,46,86,132
LORETO,consulta externa,nuevas en menores de 5 anos,2006-12-01,60,60,60,60,120
LURIBAY,consulta externa,nuevas en menores de 5 anos,2006-12-01,118,103,118,103,221
MACHACAMARCA,consulta externa,nuevas en menores de 5 anos,2006-12-01,68,70,68,70,138
MACHARETI,consulta externa,nuevas en menores de 5 anos,2006-12-01,261,266,261,266,527
MAGDALENA,consulta externa,nuevas en menores de 5 anos,2006-12-01,158,155,158,155,313
MAIRANA,consulta externa,nuevas en menores de 5 anos,2006-12-01,152,129,152,129,281
MALLA,consulta externa,nuevas en menores de 5 anos,2006-12-01,41,22,41,22,63
MAPIRI,consulta externa,nuevas en menores de 5 anos,2006-12-01,187,154,187,154,341
MECAPACA,consulta externa,nuevas en menores de 5 anos,2006-12-01,125,114,125,114,239
MINEROS,consulta externa,nuevas en menores de 5 anos,2006-12-01,422,394,422,394,816
MIZQUE,consulta externa,nuevas en menores de 5 anos,2006-12-01,265,265,265,265,530
MOCOMOCO,consulta externa,nuevas en menores de 5 anos,2006-12-01,139,113,139,113,252
MOJINETE,consulta externa,nuevas en menores de 5 anos,2006-12-01,12,19,12,19,31
MOJOCOYA,consulta externa,nuevas en menores de 5 anos,2006-12-01,157,123,157,123,280
MONTEAGUDO,consulta externa,nuevas en menores de 5 anos,2006-12-01,720,621,720,621,1341
MONTERO,consulta externa,nuevas en menores de 5 anos,2006-12-01,2196,1966,2196,1966,4162
MORO MORO,consulta externa,nuevas en menores de 5 anos,2006-12-01,67,51,67,51,118
MOROCHATA,consulta externa,nuevas en menores de 5 anos,2006-12-01,192,172,192,172,364
NACEBE (SANTA ROSA DEL ABUNA),consulta externa,nuevas en menores de 5 anos,2006-12-01,22,24,22,24,46
NAZACARA DE PACAJES,consulta externa,nuevas en menores de 5 anos,2006-12-01,3,3,3,3,6
NUEVO MANOA (NUEVA ESPERANZA),consulta externa,nuevas en menores de 5 anos,2006-12-01,7,14,7,14,21
OCURI,consulta externa,nuevas en menores de 5 anos,2006-12-01,470,489,470,489,959
OKINAWA,consulta externa,nuevas en menores de 5 anos,2006-12-01,320,306,320,306,626
OMEREQUE,consulta externa,nuevas en menores de 5 anos,2006-12-01,85,102,85,102,187
ORURO,consulta externa,nuevas en menores de 5 anos,2006-12-01,4325,3968,4325,3968,8293
PADCAYA,consulta externa,nuevas en menores de 5 anos,2006-12-01,353,312,353,312,665
PADILLA,consulta externa,nuevas en menores de 5 anos,2006-12-01,438,367,438,367,805
PAILON,consulta externa,nuevas en menores de 5 anos,2006-12-01,266,304,266,304,570
PALCA,consulta externa,nuevas en menores de 5 anos,2006-12-01,110,108,110,108,218
PALOS BLANCOS,consulta externa,nuevas en menores de 5 anos,2006-12-01,541,442,541,442,983
PAMPA AULLAGAS,consulta externa,nuevas en menores de 5 anos,2006-12-01,60,76,60,76,136
PAMPA GRANDE,consulta externa,nuevas en menores de 5 anos,2006-12-01,87,87,87,87,174
PAPEL PAMPA,consulta externa,nuevas en menores de 5 anos,2006-12-01,28,35,28,35,63
PASORAPA,consulta externa,nuevas en menores de 5 anos,2006-12-01,25,30,25,30,55
PATACAMAYA,consulta externa,nuevas en menores de 5 anos,2006-12-01,249,207,249,207,456
PAZÑA,consulta externa,nuevas en menores de 5 anos,2006-12-01,144,102,144,102,246
PELECHUCO,consulta externa,nuevas en menores de 5 anos,2006-12-01,95,74,95,74,169
POCOATA,consulta externa,nuevas en menores de 5 anos,2006-12-01,451,450,451,450,901
POCONA,consulta externa,nuevas en menores de 5 anos,2006-12-01,185,158,185,158,343
POJO (CBBA),consulta externa,nuevas en menores de 5 anos,2006-12-01,87,81,87,81,168
POOPO,consulta externa,nuevas en menores de 5 anos,2006-12-01,54,40,54,40,94
PORCO,consulta externa,nuevas en menores de 5 anos,2006-12-01,115,108,115,108,223
POROMA,consulta externa,nuevas en menores de 5 anos,2006-12-01,309,291,309,291,600
PORONGO,consulta externa,nuevas en menores de 5 anos,2006-12-01,178,132,178,132,310
PORTACHUELO,consulta externa,nuevas en menores de 5 anos,2006-12-01,479,414,479,414,893
PORVENIR,consulta externa,nuevas en menores de 5 anos,2006-12-01,189,144,189,144,333
POSTRER VALLE,consulta externa,nuevas en menores de 5 anos,2006-12-01,36,35,36,35,71
POTOSI,consulta externa,nuevas en menores de 5 anos,2006-12-01,3175,2965,3175,2965,6140
PRESTO,consulta externa,nuevas en menores de 5 anos,2006-12-01,274,227,274,227,501
PUCARA,consulta externa,nuevas en menores de 5 anos,2006-12-01,35,32,35,32,67
PUCARANI,consulta externa,nuevas en menores de 5 anos,2006-12-01,217,178,217,178,395
PUERTO ACOSTA,consulta externa,nuevas en menores de 5 anos,2006-12-01,152,134,152,134,286
PUERTO CARABUCO,consulta externa,nuevas en menores de 5 anos,2006-12-01,95,96,95,96,191
PUERTO GONZALO MORENO,consulta externa,nuevas en menores de 5 anos,2006-12-01,136,112,136,112,248
PUERTO PEREZ,consulta externa,nuevas en menores de 5 anos,2006-12-01,40,46,40,46,86
PUERTO QUIJARRO,consulta externa,nuevas en menores de 5 anos,2006-12-01,249,226,249,226,475
PUERTO RICO,consulta externa,nuevas en menores de 5 anos,2006-12-01,188,135,188,135,323
PUERTO SILES,consulta externa,nuevas en menores de 5 anos,2006-12-01,24,23,24,23,47
PUERTO SUAREZ,consulta externa,nuevas en menores de 5 anos,2006-12-01,232,209,232,209,441
PUERTO VILLARROEL,consulta externa,nuevas en menores de 5 anos,2006-12-01,1283,1229,1283,1229,2512
PUNA,consulta externa,nuevas en menores de 5 anos,2006-12-01,671,588,671,588,1259
PUNATA,consulta externa,nuevas en menores de 5 anos,2006-12-01,352,320,352,320,672
QUIABAYA,consulta externa,nuevas en menores de 5 anos,2006-12-01,69,71,69,71,140
QUILLACOLLO,consulta externa,nuevas en menores de 5 anos,2006-12-01,1011,904,1011,904,1915
QUIME,consulta externa,nuevas en menores de 5 anos,2006-12-01,116,113,116,113,229
QUIRUSILLAS,consulta externa,nuevas en menores de 5 anos,2006-12-01,51,36,51,36,87
RAVELO,consulta externa,nuevas en menores de 5 anos,2006-12-01,386,312,386,312,698
REYES,consulta externa,nuevas en menores de 5 anos,2006-12-01,200,189,200,189,389
RIBERALTA,consulta externa,nuevas en menores de 5 anos,2006-12-01,1950,1922,1950,1922,3872
ROBORE,consulta externa,nuevas en menores de 5 anos,2006-12-01,257,230,257,230,487
RURRENABAQUE,consulta externa,nuevas en menores de 5 anos,2006-12-01,321,345,321,345,666
SABAYA,consulta externa,nuevas en menores de 5 anos,2006-12-01,88,66,88,66,154
SACABA,consulta externa,nuevas en menores de 5 anos,2006-12-01,993,942,993,942,1935
SACABAMBA,consulta externa,nuevas en menores de 5 anos,2006-12-01,45,34,45,34,79
SACACA,consulta externa,nuevas en menores de 5 anos,2006-12-01,701,644,701,644,1345
SAIPINA,consulta externa,nuevas en menores de 5 anos,2006-12-01,96,109,96,109,205
SALINAS DE GARCI MENDOZA,consulta externa,nuevas en menores de 5 anos,2006-12-01,193,164,193,164,357
SAMAIPATA,consulta externa,nuevas en menores de 5 anos,2006-12-01,129,83,129,83,212
SAN AGUSTIN,consulta externa,nuevas en menores de 5 anos,2006-12-01,31,27,31,27,58
SAN ANDRES,consulta externa,nuevas en menores de 5 anos,2006-12-01,186,162,186,162,348
SAN ANDRES DE MACHACA,consulta externa,nuevas en menores de 5 anos,2006-12-01,22,18,22,18,40
SAN ANTONIO DE ESMORUCO,consulta externa,nuevas en menores de 5 anos,2006-12-01,42,31,42,31,73
SAN ANTONIO DE LOMERIO,consulta externa,nuevas en menores de 5 anos,2006-12-01,89,69,89,69,158
SAN BENITO,consulta externa,nuevas en menores de 5 anos,2006-12-01,99,84,99,84,183
SAN BORJA,consulta externa,nuevas en menores de 5 anos,2006-12-01,581,557,581,557,1138
SAN BUENA VENTURA,consulta externa,nuevas en menores de 5 anos,2006-12-01,316,308,316,308,624
SAN CARLOS,consulta externa,nuevas en menores de 5 anos,2006-12-01,474,442,474,442,916
SAN IGNACIO,consulta externa,nuevas en menores de 5 anos,2006-12-01,448,406,448,406,854
SAN IGNACIO DE VELASCO,consulta externa,nuevas en menores de 5 anos,2006-12-01,1191,1169,1191,1169,2360
SAN JAVIER(BNI),consulta externa,nuevas en menores de 5 anos,2006-12-01,33,42,33,42,75
SAN JAVIER(STC),consulta externa,nuevas en menores de 5 anos,2006-12-01,348,244,348,244,592
SAN JOAQUIN,consulta externa,nuevas en menores de 5 anos,2006-12-01,96,99,96,99,195
SAN JOSE DE CHIQUITOS,consulta externa,nuevas en menores de 5 anos,2006-12-01,277,279,277,279,556
SAN JUAN DE YAPACANI,consulta externa,nuevas en menores de 5 anos,2006-12-01,273,290,273,290,563
SAN JULIAN,consulta externa,nuevas en menores de 5 anos,2006-12-01,836,741,836,741,1577
SAN LORENZO(PND),consulta externa,nuevas en menores de 5 anos,2006-12-01,66,52,66,52,118
SAN LORENZO(TJA),consulta externa,nuevas en menores de 5 anos,2006-12-01,475,512,475,512,987
SAN LUCAS,consulta externa,nuevas en menores de 5 anos,2006-12-01,825,695,825,695,1520
SAN MATIAS,consulta externa,nuevas en menores de 5 anos,2006-12-01,854,163,854,163,1017
SAN MIGUEL DE VELASCO,consulta externa,nuevas en menores de 5 anos,2006-12-01,216,176,216,176,392
SAN PABLO DE LIPEZ,consulta externa,nuevas en menores de 5 anos,2006-12-01,59,56,59,56,115
SAN PEDRO,consulta externa,nuevas en menores de 5 anos,2006-12-01,521,1994,521,1994,2515
SAN PEDRO DE BUENA VISTA,consulta externa,nuevas en menores de 5 anos,2006-12-01,631,594,631,594,1225
SAN PEDRO DE CURAHUARA,consulta externa,nuevas en menores de 5 anos,2006-12-01,56,36,56,36,92
SAN PEDRO DE QUEMES,consulta externa,nuevas en menores de 5 anos,2006-12-01,4,13,4,13,17
SAN PEDRO DE TIQUINA,consulta externa,nuevas en menores de 5 anos,2006-12-01,51,61,51,61,112
SAN PEDRO(PND),consulta externa,nuevas en menores de 5 anos,2006-12-01,38,24,38,24,62
SAN RAFAEL,consulta externa,nuevas en menores de 5 anos,2006-12-01,68,55,68,55,123
SAN RAMON,consulta externa,nuevas en menores de 5 anos,2006-12-01,132,104,132,104,236
SAN RAMON,consulta externa,nuevas en menores de 5 anos,2006-12-01,149,181,149,181,330
SANTA ANA,consulta externa,nuevas en menores de 5 anos,2006-12-01,213,204,213,204,417
SANTA CRUZ DE LA SIERRA,consulta externa,nuevas en menores de 5 anos,2006-12-01,16589,15382,16589,15382,31971
SANTA ROSA,consulta externa,nuevas en menores de 5 anos,2006-12-01,156,165,156,165,321
SANTA ROSA DEL SARA,consulta externa,nuevas en menores de 5 anos,2006-12-01,540,542,540,542,1082
SANTIAGO DE CALLAPA,consulta externa,nuevas en menores de 5 anos,2006-12-01,27,39,27,39,66
SANTIAGO DE HUARI,consulta externa,nuevas en menores de 5 anos,2006-12-01,139,139,139,139,278
SANTIAGO DE MACHACA,consulta externa,nuevas en menores de 5 anos,2006-12-01,20,26,20,26,46
SANTIVAÑES,consulta externa,nuevas en menores de 5 anos,2006-12-01,84,84,84,84,168
SANTUARIO DE QUILLACAS,consulta externa,nuevas en menores de 5 anos,2006-12-01,50,45,50,45,95
SAPAHAQUI,consulta externa,nuevas en menores de 5 anos,2006-12-01,136,117,136,117,253
SENA,consulta externa,nuevas en menores de 5 anos,2006-12-01,112,117,112,117,229
SICA SICA (VILLA AROMA),consulta externa,nuevas en menores de 5 anos,2006-12-01,164,133,164,133,297
SICAYA,consulta externa,nuevas en menores de 5 anos,2006-12-01,28,27,28,27,55
SIPE SIPE,consulta externa,nuevas en menores de 5 anos,2006-12-01,331,307,331,307,638
SOPACHUY,consulta externa,nuevas en menores de 5 anos,2006-12-01,383,405,383,405,788
SORACACHI,consulta externa,nuevas en menores de 5 anos,2006-12-01,575,149,575,149,724
SORATA,consulta externa,nuevas en menores de 5 anos,2006-12-01,203,187,203,187,390
SUCRE,consulta externa,nuevas en menores de 5 anos,2006-12-01,4850,4389,4850,4389,9239
TACACHI,consulta externa,nuevas en menores de 5 anos,2006-12-01,7,7,7,7,14
TACACOMA,consulta externa,nuevas en menores de 5 anos,2006-12-01,62,64,62,64,126
TACOBAMBA,consulta externa,nuevas en menores de 5 anos,2006-12-01,100,95,100,95,195
TACOPAYA,consulta externa,nuevas en menores de 5 anos,2006-12-01,209,203,209,203,412
TAHUA,consulta externa,nuevas en menores de 5 anos,2006-12-01,16,24,16,24,40
TAPACARI,consulta externa,nuevas en menores de 5 anos,2006-12-01,407,367,407,367,774
TARABUCO,consulta externa,nuevas en menores de 5 anos,2006-12-01,681,683,681,683,1364
TARACO,consulta externa,nuevas en menores de 5 anos,2006-12-01,30,24,30,24,54
TARATA,consulta externa,nuevas en menores de 5 anos,2006-12-01,134,132,134,132,266
TARIJA,consulta externa,nuevas en menores de 5 anos,2006-12-01,2935,2535,2935,2535,5470
TARVITA,consulta externa,nuevas en menores de 5 anos,2006-12-01,491,478,491,478,969
TEOPONTE,consulta externa,nuevas en menores de 5 anos,2006-12-01,153,152,153,152,305
TIAWANACU,consulta externa,nuevas en menores de 5 anos,2006-12-01,72,86,72,86,158
TINGUIPAYA,consulta externa,nuevas en menores de 5 anos,2006-12-01,352,271,352,271,623
TIPUANI,consulta externa,nuevas en menores de 5 anos,2006-12-01,106,96,106,96,202
TIQUIPAYA,consulta externa,nuevas en menores de 5 anos,2006-12-01,485,463,485,463,948
TIRAQUE (CBBA),consulta externa,nuevas en menores de 5 anos,2006-12-01,687,646,687,646,1333
TITO YUPANQUI (PARQUIPUJIO),consulta externa,nuevas en menores de 5 anos,2006-12-01,27,14,27,14,41
TOCO,consulta externa,nuevas en menores de 5 anos,2006-12-01,63,55,63,55,118
TODOS SANTOS,consulta externa,nuevas en menores de 5 anos,2006-12-01,10,9,10,9,19
TOLATA,consulta externa,nuevas en menores de 5 anos,2006-12-01,31,51,31,51,82
TOLEDO,consulta externa,nuevas en menores de 5 anos,2006-12-01,104,63,104,63,167
TOMAVE,consulta externa,nuevas en menores de 5 anos,2006-12-01,222,248,222,248,470
TOMINA,consulta externa,nuevas en menores de 5 anos,2006-12-01,279,227,279,227,506
TORO TORO,consulta externa,nuevas en menores de 5 anos,2006-12-01,201,209,201,209,410
TOTORA(CBBA),consulta externa,nuevas en menores de 5 anos,2006-12-01,73,74,73,74,147
TOTORA(ORR),consulta externa,nuevas en menores de 5 anos,2006-12-01,127,72,127,72,199
TRIGAL,consulta externa,nuevas en menores de 5 anos,2006-12-01,32,37,32,37,69
TRINIDAD,consulta externa,nuevas en menores de 5 anos,2006-12-01,1642,1497,1642,1497,3139
TUPIZA,consulta externa,nuevas en menores de 5 anos,2006-12-01,983,951,983,951,1934
TURCO,consulta externa,nuevas en menores de 5 anos,2006-12-01,59,56,59,56,115
UMALA,consulta externa,nuevas en menores de 5 anos,2006-12-01,49,36,49,36,85
UNCIA,consulta externa,nuevas en menores de 5 anos,2006-12-01,562,498,562,498,1060
URIONDO (A. CONCEPCION),consulta externa,nuevas en menores de 5 anos,2006-12-01,391,373,391,373,764
URUBICHA,consulta externa,nuevas en menores de 5 anos,2006-12-01,182,163,182,163,345
UYUNI,consulta externa,nuevas en menores de 5 anos,2006-12-01,229,252,229,252,481
VACAS,consulta externa,nuevas en menores de 5 anos,2006-12-01,226,196,226,196,422
VALLEGRANDE,consulta externa,nuevas en menores de 5 anos,2006-12-01,254,210,254,210,464
VIACHA,consulta externa,nuevas en menores de 5 anos,2006-12-01,397,397,397,397,794
VILA VILA,consulta externa,nuevas en menores de 5 anos,2006-12-01,16,29,16,29,45
VILLA MONTES,consulta externa,nuevas en menores de 5 anos,2006-12-01,733,639,733,639,1372
VILLA NUEVA (LOMA ALTA),consulta externa,nuevas en menores de 5 anos,2006-12-01,32,43,32,43,75
VILLA RIVERO,consulta externa,nuevas en menores de 5 anos,2006-12-01,45,47,45,47,92
VILLA SERRANO,consulta externa,nuevas en menores de 5 anos,2006-12-01,360,371,360,371,731
VILLA TUNARI,consulta externa,nuevas en menores de 5 anos,2006-12-01,1679,1521,1679,1521,3200
VILLA VACA GUZMAN (MUYUPAMPA),consulta externa,nuevas en menores de 5 anos,2006-12-01,284,227,284,227,511
VILLAZON,consulta externa,nuevas en menores de 5 anos,2006-12-01,750,618,750,618,1368
VINTO,consulta externa,nuevas en menores de 5 anos,2006-12-01,117,103,117,103,220
VITICHI,consulta externa,nuevas en menores de 5 anos,2006-12-01,178,179,178,179,357
WALDO BALLIVIAN,consulta externa,nuevas en menores de 5 anos,2006-12-01,16,19,16,19,35
WARNES,consulta externa,nuevas en menores de 5 anos,2006-12-01,1198,1039,1198,1039,2237
YACO,consulta externa,nuevas en menores de 5 anos,2006-12-01,123,138,123,138,261
YACUIBA,consulta externa,nuevas en menores de 5 anos,2006-12-01,1949,1913,1949,1913,3862
YAMPARAEZ,consulta externa,nuevas en menores de 5 anos,2006-12-01,187,184,187,184,371
YANACACHI,consulta externa,nuevas en menores de 5 anos,2006-12-01,42,45,42,45,87
YAPACANI,consulta externa,nuevas en menores de 5 anos,2006-12-01,636,621,636,621,1257
YOCALLA,consulta externa,nuevas en menores de 5 anos,2006-12-01,101,65,101,65,166
YOTALA,consulta externa,nuevas en menores de 5 anos,2006-12-01,126,129,126,129,255
YUNCHARA,consulta externa,nuevas en menores de 5 anos,2006-12-01,129,135,129,135,264
ZUDAÑEZ,consulta externa,nuevas en menores de 5 anos,2006-12-01,310,298,310,298,608
