municipality,group,variable,month,Nuevas en personas de 60 años o más -Hombre,Nuevas en personas de 60 años o más -Mujer,TOTAL-H,TOTAL-M,TOTAL
ACACIO,consulta externa,nuevas en personas de 60 anos o mas,2006-01-01,19,33,19,33,52
ACHACACHI,consulta externa,nuevas en personas de 60 anos o mas,2006-01-01,133,124,133,124,257
ACHOCALLA,consulta externa,nuevas en personas de 60 anos o mas,2006-01-01,13,10,13,10,23
AIQUILE,consulta externa,nuevas en personas de 60 anos o mas,2006-01-01,68,97,68,97,165
ALALAY,consulta externa,nuevas en personas de 60 anos o mas,2006-01-01,1,6,1,6,7
ALCALA,consulta externa,nuevas en personas de 60 anos o mas,2006-01-01,24,37,24,37,61
ANCORAIMES,consulta externa,nuevas en personas de 60 anos o mas,2006-01-01,35,46,35,46,81
ANDAMARCA,consulta externa,nuevas en personas de 60 anos o mas,2006-01-01,23,25,23,25,48
ANTEQUERA,consulta externa,nuevas en personas de 60 anos o mas,2006-01-01,7,1,7,1,8
ANZALDO,consulta externa,nuevas en personas de 60 anos o mas,2006-01-01,25,21,25,21,46
APOLO,consulta externa,nuevas en personas de 60 anos o mas,2006-01-01,40,32,40,32,72
ARAMPAMPA,consulta externa,nuevas en personas de 60 anos o mas,2006-01-01,6,13,6,13,19
ARANI,consulta externa,nuevas en personas de 60 anos o mas,2006-01-01,8,17,8,17,25
ARBIETO,consulta externa,nuevas en personas de 60 anos o mas,2006-01-01,14,16,14,16,30
ARQUE,consulta externa,nuevas en personas de 60 anos o mas,2006-01-01,10,28,10,28,38
ASCENCION DE GUARAYOS,consulta externa,nuevas en personas de 60 anos o mas,2006-01-01,21,45,21,45,66
ATOCHA,consulta externa,nuevas en personas de 60 anos o mas,2006-01-01,83,101,83,101,184
AUCAPATA,consulta externa,nuevas en personas de 60 anos o mas,2006-01-01,14,22,14,22,36
AYATA,consulta externa,nuevas en personas de 60 anos o mas,2006-01-01,17,20,17,20,37
AYO AYO,consulta externa,nuevas en personas de 60 anos o mas,2006-01-01,13,7,13,7,20
AYOPAYA (V. DE INDEPENDENCIA),consulta externa,nuevas en personas de 60 anos o mas,2006-01-01,37,51,37,51,88
AZURDUY,consulta externa,nuevas en personas de 60 anos o mas,2006-01-01,38,49,38,49,87
BATALLAS,consulta externa,nuevas en personas de 60 anos o mas,2006-01-01,58,34,58,34,92
BAURES,consulta externa,nuevas en personas de 60 anos o mas,2006-01-01,15,16,15,16,31
BELEN DE ANDAMARCA,consulta externa,nuevas en personas de 60 anos o mas,2006-01-01,10,9,10,9,19
BELEN DE URMIRI,consulta externa,nuevas en personas de 60 anos o mas,2006-01-01,25,27,25,27,52
BELLA FLOR,consulta externa,nuevas en personas de 60 anos o mas,2006-01-01,20,7,20,7,27
BERMEJO,consulta externa,nuevas en personas de 60 anos o mas,2006-01-01,60,54,60,54,114
BETANZOS,consulta externa,nuevas en personas de 60 anos o mas,2006-01-01,150,213,150,213,363
BOLIVAR,consulta externa,nuevas en personas de 60 anos o mas,2006-01-01,24,15,24,15,39
BOLPEBRA,consulta externa,nuevas en personas de 60 anos o mas,2006-01-01,7,5,7,5,12
BOYUIBE,consulta externa,nuevas en personas de 60 anos o mas,2006-01-01,4,17,4,17,21
BUENA VISTA,consulta externa,nuevas en personas de 60 anos o mas,2006-01-01,101,77,101,77,178
CABEZAS,consulta externa,nuevas en personas de 60 anos o mas,2006-01-01,22,32,22,32,54
CAIROMA,consulta externa,nuevas en personas de 60 anos o mas,2006-01-01,28,19,28,19,47
"CAIZA ""D""",consulta externa,nuevas en personas de 60 anos o mas,2006-01-01,32,80,32,80,112
CAJUATA,consulta externa,nuevas en personas de 60 anos o mas,2006-01-01,31,30,31,30,61
CALACOTO,consulta externa,nuevas en personas de 60 anos o mas,2006-01-01,27,34,27,34,61
CALAMARCA,consulta externa,nuevas en personas de 60 anos o mas,2006-01-01,19,20,19,20,39
CAMARGO,consulta externa,nuevas en personas de 60 anos o mas,2006-01-01,215,358,215,358,573
CAMATAQUI (C. VILLA ABECIA),consulta externa,nuevas en personas de 60 anos o mas,2006-01-01,13,22,13,22,35
CAMIRI,consulta externa,nuevas en personas de 60 anos o mas,2006-01-01,578,768,578,768,1346
CAPINOTA,consulta externa,nuevas en personas de 60 anos o mas,2006-01-01,49,66,49,66,115
CAQUIAVIRI,consulta externa,nuevas en personas de 60 anos o mas,2006-01-01,30,37,30,37,67
CARACOLLO,consulta externa,nuevas en personas de 60 anos o mas,2006-01-01,74,56,74,56,130
CARANAVI,consulta externa,nuevas en personas de 60 anos o mas,2006-01-01,223,119,223,119,342
CARANGAS,consulta externa,nuevas en personas de 60 anos o mas,2006-01-01,0,1,0,1,1
CARAPARI,consulta externa,nuevas en personas de 60 anos o mas,2006-01-01,47,33,47,33,80
CARIPUYO,consulta externa,nuevas en personas de 60 anos o mas,2006-01-01,15,18,15,18,33
CARMEN RIVERO TORREZ,consulta externa,nuevas en personas de 60 anos o mas,2006-01-01,1,2,1,2,3
CATACORA,consulta externa,nuevas en personas de 60 anos o mas,2006-01-01,1,2,1,2,3
CHACARILLA,consulta externa,nuevas en personas de 60 anos o mas,2006-01-01,1,1,1,1,2
CHALLAPATA,consulta externa,nuevas en personas de 60 anos o mas,2006-01-01,114,78,114,78,192
CHAQUI,consulta externa,nuevas en personas de 60 anos o mas,2006-01-01,30,44,30,44,74
CHARAGUA,consulta externa,nuevas en personas de 60 anos o mas,2006-01-01,51,48,51,48,99
CHARAÑA,consulta externa,nuevas en personas de 60 anos o mas,2006-01-01,9,4,9,4,13
CHAYANTA,consulta externa,nuevas en personas de 60 anos o mas,2006-01-01,42,52,42,52,94
CHIMORE,consulta externa,nuevas en personas de 60 anos o mas,2006-01-01,19,14,19,14,33
CHIPAYA,consulta externa,nuevas en personas de 60 anos o mas,2006-01-01,7,3,7,3,10
CHOQUE COTA,consulta externa,nuevas en personas de 60 anos o mas,2006-01-01,10,9,10,9,19
CHULUMANI (V. DE LA LIBERTAD),consulta externa,nuevas en personas de 60 anos o mas,2006-01-01,49,32,49,32,81
CHUMA,consulta externa,nuevas en personas de 60 anos o mas,2006-01-01,25,58,25,58,83
CLIZA,consulta externa,nuevas en personas de 60 anos o mas,2006-01-01,14,33,14,33,47
COBIJA,consulta externa,nuevas en personas de 60 anos o mas,2006-01-01,359,440,359,440,799
COCHABAMBA,consulta externa,nuevas en personas de 60 anos o mas,2006-01-01,3499,5876,3499,5876,9375
COLCAPIRHUA,consulta externa,nuevas en personas de 60 anos o mas,2006-01-01,122,221,122,221,343
"COLCHA ""K""",consulta externa,nuevas en personas de 60 anos o mas,2006-01-01,72,96,72,96,168
COLLANA,consulta externa,nuevas en personas de 60 anos o mas,2006-01-01,13,12,13,12,25
COLOMI,consulta externa,nuevas en personas de 60 anos o mas,2006-01-01,8,12,8,12,20
COLPA BELGICA,consulta externa,nuevas en personas de 60 anos o mas,2006-01-01,48,17,48,17,65
COLQUECHACA,consulta externa,nuevas en personas de 60 anos o mas,2006-01-01,100,142,100,142,242
COLQUENCHA,consulta externa,nuevas en personas de 60 anos o mas,2006-01-01,23,40,23,40,63
COLQUIRI,consulta externa,nuevas en personas de 60 anos o mas,2006-01-01,67,49,67,49,116
COMANCHE,consulta externa,nuevas en personas de 60 anos o mas,2006-01-01,11,5,11,5,16
COMARAPA,consulta externa,nuevas en personas de 60 anos o mas,2006-01-01,128,151,128,151,279
COMBAYA,consulta externa,nuevas en personas de 60 anos o mas,2006-01-01,3,11,3,11,14
CONCEPCION,consulta externa,nuevas en personas de 60 anos o mas,2006-01-01,58,61,58,61,119
COPACABANA,consulta externa,nuevas en personas de 60 anos o mas,2006-01-01,30,26,30,26,56
CORIPATA,consulta externa,nuevas en personas de 60 anos o mas,2006-01-01,32,23,32,23,55
CORO CORO,consulta externa,nuevas en personas de 60 anos o mas,2006-01-01,21,29,21,29,50
COROICO,consulta externa,nuevas en personas de 60 anos o mas,2006-01-01,68,54,68,54,122
CORQUE,consulta externa,nuevas en personas de 60 anos o mas,2006-01-01,33,32,33,32,65
COTAGAITA,consulta externa,nuevas en personas de 60 anos o mas,2006-01-01,187,388,187,388,575
COTOCA,consulta externa,nuevas en personas de 60 anos o mas,2006-01-01,74,87,74,87,161
CUATRO CAÑADAS,consulta externa,nuevas en personas de 60 anos o mas,2006-01-01,25,28,25,28,53
CUCHUMUELA (V. G. VILLARROEL),consulta externa,nuevas en personas de 60 anos o mas,2006-01-01,3,2,3,2,5
CUEVO,consulta externa,nuevas en personas de 60 anos o mas,2006-01-01,15,39,15,39,54
CULPINA,consulta externa,nuevas en personas de 60 anos o mas,2006-01-01,35,60,35,60,95
CURAHUARA DE CARANGAS,consulta externa,nuevas en personas de 60 anos o mas,2006-01-01,16,29,16,29,45
CURVA,consulta externa,nuevas en personas de 60 anos o mas,2006-01-01,3,7,3,7,10
DESAGUADERO,consulta externa,nuevas en personas de 60 anos o mas,2006-01-01,14,15,14,15,29
EL ALTO,consulta externa,nuevas en personas de 60 anos o mas,2006-01-01,1161,1266,1161,1266,2427
EL CHORO,consulta externa,nuevas en personas de 60 anos o mas,2006-01-01,24,33,24,33,57
EL PUENTE(STC),consulta externa,nuevas en personas de 60 anos o mas,2006-01-01,7,9,7,9,16
EL PUENTE(TJA),consulta externa,nuevas en personas de 60 anos o mas,2006-01-01,35,74,35,74,109
EL TORNO,consulta externa,nuevas en personas de 60 anos o mas,2006-01-01,213,181,213,181,394
EL VILLAR,consulta externa,nuevas en personas de 60 anos o mas,2006-01-01,28,42,28,42,70
ENTRE RIOS,consulta externa,nuevas en personas de 60 anos o mas,2006-01-01,54,59,54,59,113
ENTRE RIOS,consulta externa,nuevas en personas de 60 anos o mas,2006-01-01,10,5,10,5,15
ESCARA,consulta externa,nuevas en personas de 60 anos o mas,2006-01-01,2,2,2,2,4
ESMERALDA,consulta externa,nuevas en personas de 60 anos o mas,2006-01-01,6,7,6,7,13
EUCALIPTUS,consulta externa,nuevas en personas de 60 anos o mas,2006-01-01,79,75,79,75,154
EUREKA (SANTOS MERCADO),consulta externa,nuevas en personas de 60 anos o mas,2006-01-01,1,2,1,2,3
EXALTACION,consulta externa,nuevas en personas de 60 anos o mas,2006-01-01,9,4,9,4,13
FERNANDEZ ALONSO,consulta externa,nuevas en personas de 60 anos o mas,2006-01-01,13,17,13,17,30
FILADELFIA,consulta externa,nuevas en personas de 60 anos o mas,2006-01-01,14,14,14,14,28
GENERAL SAAVEDRA,consulta externa,nuevas en personas de 60 anos o mas,2006-01-01,28,22,28,22,50
GRAL. J.J. PEREZ (CHARAZANI),consulta externa,nuevas en personas de 60 anos o mas,2006-01-01,12,16,12,16,28
GUANAY,consulta externa,nuevas en personas de 60 anos o mas,2006-01-01,74,41,74,41,115
GUAQUI,consulta externa,nuevas en personas de 60 anos o mas,2006-01-01,23,20,23,20,43
GUAYARAMERIN,consulta externa,nuevas en personas de 60 anos o mas,2006-01-01,542,510,542,510,1052
GUTIERREZ,consulta externa,nuevas en personas de 60 anos o mas,2006-01-01,35,44,35,44,79
HUACARETA,consulta externa,nuevas en personas de 60 anos o mas,2006-01-01,54,51,54,51,105
HUACAYA (VILLA DE HUACAYA),consulta externa,nuevas en personas de 60 anos o mas,2006-01-01,4,27,4,27,31
HUACHACALLA,consulta externa,nuevas en personas de 60 anos o mas,2006-01-01,6,4,6,4,10
HUANUNI,consulta externa,nuevas en personas de 60 anos o mas,2006-01-01,117,123,117,123,240
HUARACAJE,consulta externa,nuevas en personas de 60 anos o mas,2006-01-01,6,6,6,6,12
HUAYLLAMARCA,consulta externa,nuevas en personas de 60 anos o mas,2006-01-01,33,40,33,40,73
ICHOCA,consulta externa,nuevas en personas de 60 anos o mas,2006-01-01,17,8,17,8,25
ICLA,consulta externa,nuevas en personas de 60 anos o mas,2006-01-01,13,47,13,47,60
INCAHUASI,consulta externa,nuevas en personas de 60 anos o mas,2006-01-01,30,68,30,68,98
INGAVI (HUMAITA),consulta externa,nuevas en personas de 60 anos o mas,2006-01-01,4,1,4,1,5
INQUISIVI,consulta externa,nuevas en personas de 60 anos o mas,2006-01-01,27,28,27,28,55
IRUPANA (VILLA DE LANZA),consulta externa,nuevas en personas de 60 anos o mas,2006-01-01,39,45,39,45,84
IXIAMAS,consulta externa,nuevas en personas de 60 anos o mas,2006-01-01,10,6,10,6,16
JESUS DE MACHACA,consulta externa,nuevas en personas de 60 anos o mas,2006-01-01,58,46,58,46,104
LA ASUNTA,consulta externa,nuevas en personas de 60 anos o mas,2006-01-01,9,6,9,6,15
LA GUARDIA,consulta externa,nuevas en personas de 60 anos o mas,2006-01-01,43,56,43,56,99
LA PAZ,consulta externa,nuevas en personas de 60 anos o mas,2006-01-01,8522,9763,8522,9763,18285
LAGUNILLAS,consulta externa,nuevas en personas de 60 anos o mas,2006-01-01,23,28,23,28,51
LAJA,consulta externa,nuevas en personas de 60 anos o mas,2006-01-01,25,27,25,27,52
LAS CARRERAS,consulta externa,nuevas en personas de 60 anos o mas,2006-01-01,28,36,28,36,64
LICOMA PAMPA,consulta externa,nuevas en personas de 60 anos o mas,2006-01-01,10,3,10,3,13
LLALLAGUA,consulta externa,nuevas en personas de 60 anos o mas,2006-01-01,161,239,161,239,400
LLICA,consulta externa,nuevas en personas de 60 anos o mas,2006-01-01,34,42,34,42,76
LORETO,consulta externa,nuevas en personas de 60 anos o mas,2006-01-01,5,7,5,7,12
LURIBAY,consulta externa,nuevas en personas de 60 anos o mas,2006-01-01,24,19,24,19,43
MACHACAMARCA,consulta externa,nuevas en personas de 60 anos o mas,2006-01-01,66,60,66,60,126
MACHARETI,consulta externa,nuevas en personas de 60 anos o mas,2006-01-01,52,39,52,39,91
MAGDALENA,consulta externa,nuevas en personas de 60 anos o mas,2006-01-01,33,38,33,38,71
MAIRANA,consulta externa,nuevas en personas de 60 anos o mas,2006-01-01,43,70,43,70,113
MALLA,consulta externa,nuevas en personas de 60 anos o mas,2006-01-01,7,11,7,11,18
MAPIRI,consulta externa,nuevas en personas de 60 anos o mas,2006-01-01,26,24,26,24,50
MECAPACA,consulta externa,nuevas en personas de 60 anos o mas,2006-01-01,41,29,41,29,70
MINEROS,consulta externa,nuevas en personas de 60 anos o mas,2006-01-01,116,13,116,13,129
MIZQUE,consulta externa,nuevas en personas de 60 anos o mas,2006-01-01,16,22,16,22,38
MOCOMOCO,consulta externa,nuevas en personas de 60 anos o mas,2006-01-01,25,37,25,37,62
MOJINETE,consulta externa,nuevas en personas de 60 anos o mas,2006-01-01,5,15,5,15,20
MOJOCOYA,consulta externa,nuevas en personas de 60 anos o mas,2006-01-01,26,31,26,31,57
MONTEAGUDO,consulta externa,nuevas en personas de 60 anos o mas,2006-01-01,247,222,247,222,469
MONTERO,consulta externa,nuevas en personas de 60 anos o mas,2006-01-01,384,498,384,498,882
MORO MORO,consulta externa,nuevas en personas de 60 anos o mas,2006-01-01,19,41,19,41,60
MOROCHATA,consulta externa,nuevas en personas de 60 anos o mas,2006-01-01,13,19,13,19,32
NACEBE (SANTA ROSA DEL ABUNA),consulta externa,nuevas en personas de 60 anos o mas,2006-01-01,3,3,3,3,6
NAZACARA DE PACAJES,consulta externa,nuevas en personas de 60 anos o mas,2006-01-01,1,1,1,1,2
NUEVO MANOA (NUEVA ESPERANZA),consulta externa,nuevas en personas de 60 anos o mas,2006-01-01,4,6,4,6,10
OCURI,consulta externa,nuevas en personas de 60 anos o mas,2006-01-01,61,83,61,83,144
OKINAWA,consulta externa,nuevas en personas de 60 anos o mas,2006-01-01,61,61,61,61,122
OMEREQUE,consulta externa,nuevas en personas de 60 anos o mas,2006-01-01,6,16,6,16,22
ORURO,consulta externa,nuevas en personas de 60 anos o mas,2006-01-01,2504,2947,2504,2947,5451
PADCAYA,consulta externa,nuevas en personas de 60 anos o mas,2006-01-01,74,117,74,117,191
PADILLA,consulta externa,nuevas en personas de 60 anos o mas,2006-01-01,102,150,102,150,252
PAILON,consulta externa,nuevas en personas de 60 anos o mas,2006-01-01,12,16,12,16,28
PALCA,consulta externa,nuevas en personas de 60 anos o mas,2006-01-01,16,22,16,22,38
PALOS BLANCOS,consulta externa,nuevas en personas de 60 anos o mas,2006-01-01,35,18,35,18,53
PAMPA AULLAGAS,consulta externa,nuevas en personas de 60 anos o mas,2006-01-01,7,5,7,5,12
PAMPA GRANDE,consulta externa,nuevas en personas de 60 anos o mas,2006-01-01,25,34,25,34,59
PAPEL PAMPA,consulta externa,nuevas en personas de 60 anos o mas,2006-01-01,17,14,17,14,31
PASORAPA,consulta externa,nuevas en personas de 60 anos o mas,2006-01-01,4,15,4,15,19
PATACAMAYA,consulta externa,nuevas en personas de 60 anos o mas,2006-01-01,28,20,28,20,48
PAZÑA,consulta externa,nuevas en personas de 60 anos o mas,2006-01-01,42,49,42,49,91
PELECHUCO,consulta externa,nuevas en personas de 60 anos o mas,2006-01-01,23,19,23,19,42
POCOATA,consulta externa,nuevas en personas de 60 anos o mas,2006-01-01,60,103,60,103,163
POCONA,consulta externa,nuevas en personas de 60 anos o mas,2006-01-01,26,48,26,48,74
POJO (CBBA),consulta externa,nuevas en personas de 60 anos o mas,2006-01-01,8,7,8,7,15
POOPO,consulta externa,nuevas en personas de 60 anos o mas,2006-01-01,38,75,38,75,113
PORCO,consulta externa,nuevas en personas de 60 anos o mas,2006-01-01,8,18,8,18,26
POROMA,consulta externa,nuevas en personas de 60 anos o mas,2006-01-01,24,58,24,58,82
PORONGO,consulta externa,nuevas en personas de 60 anos o mas,2006-01-01,23,18,23,18,41
PORTACHUELO,consulta externa,nuevas en personas de 60 anos o mas,2006-01-01,139,125,139,125,264
PORVENIR,consulta externa,nuevas en personas de 60 anos o mas,2006-01-01,11,13,11,13,24
POSTRER VALLE,consulta externa,nuevas en personas de 60 anos o mas,2006-01-01,26,21,26,21,47
POTOSI,consulta externa,nuevas en personas de 60 anos o mas,2006-01-01,1873,1861,1873,1861,3734
PRESTO,consulta externa,nuevas en personas de 60 anos o mas,2006-01-01,14,38,14,38,52
PUCARA,consulta externa,nuevas en personas de 60 anos o mas,2006-01-01,18,37,18,37,55
PUCARANI,consulta externa,nuevas en personas de 60 anos o mas,2006-01-01,39,31,39,31,70
PUERTO ACOSTA,consulta externa,nuevas en personas de 60 anos o mas,2006-01-01,119,85,119,85,204
PUERTO CARABUCO,consulta externa,nuevas en personas de 60 anos o mas,2006-01-01,44,59,44,59,103
PUERTO GONZALO MORENO,consulta externa,nuevas en personas de 60 anos o mas,2006-01-01,14,11,14,11,25
PUERTO PEREZ,consulta externa,nuevas en personas de 60 anos o mas,2006-01-01,44,48,44,48,92
PUERTO QUIJARRO,consulta externa,nuevas en personas de 60 anos o mas,2006-01-01,88,65,88,65,153
PUERTO RICO,consulta externa,nuevas en personas de 60 anos o mas,2006-01-01,21,5,21,5,26
PUERTO SUAREZ,consulta externa,nuevas en personas de 60 anos o mas,2006-01-01,77,109,77,109,186
PUERTO VILLARROEL,consulta externa,nuevas en personas de 60 anos o mas,2006-01-01,35,24,35,24,59
PUNA,consulta externa,nuevas en personas de 60 anos o mas,2006-01-01,95,193,95,193,288
PUNATA,consulta externa,nuevas en personas de 60 anos o mas,2006-01-01,143,181,143,181,324
QUIABAYA,consulta externa,nuevas en personas de 60 anos o mas,2006-01-01,6,5,6,5,11
QUILLACOLLO,consulta externa,nuevas en personas de 60 anos o mas,2006-01-01,48,592,48,592,640
QUIME,consulta externa,nuevas en personas de 60 anos o mas,2006-01-01,21,22,21,22,43
QUIRUSILLAS,consulta externa,nuevas en personas de 60 anos o mas,2006-01-01,7,4,7,4,11
RAVELO,consulta externa,nuevas en personas de 60 anos o mas,2006-01-01,29,42,29,42,71
REYES,consulta externa,nuevas en personas de 60 anos o mas,2006-01-01,70,62,70,62,132
RIBERALTA,consulta externa,nuevas en personas de 60 anos o mas,2006-01-01,115,181,115,181,296
ROBORE,consulta externa,nuevas en personas de 60 anos o mas,2006-01-01,31,59,31,59,90
RURRENABAQUE,consulta externa,nuevas en personas de 60 anos o mas,2006-01-01,154,136,154,136,290
SABAYA,consulta externa,nuevas en personas de 60 anos o mas,2006-01-01,23,35,23,35,58
SACABA,consulta externa,nuevas en personas de 60 anos o mas,2006-01-01,136,195,136,195,331
SACABAMBA,consulta externa,nuevas en personas de 60 anos o mas,2006-01-01,8,9,8,9,17
SACACA,consulta externa,nuevas en personas de 60 anos o mas,2006-01-01,19,35,19,35,54
SAIPINA,consulta externa,nuevas en personas de 60 anos o mas,2006-01-01,56,92,56,92,148
SALINAS DE GARCI MENDOZA,consulta externa,nuevas en personas de 60 anos o mas,2006-01-01,61,51,61,51,112
SAMAIPATA,consulta externa,nuevas en personas de 60 anos o mas,2006-01-01,60,75,60,75,135
SAN AGUSTIN,consulta externa,nuevas en personas de 60 anos o mas,2006-01-01,12,8,12,8,20
SAN ANDRES,consulta externa,nuevas en personas de 60 anos o mas,2006-01-01,26,15,26,15,41
SAN ANDRES DE MACHACA,consulta externa,nuevas en personas de 60 anos o mas,2006-01-01,19,37,19,37,56
SAN ANTONIO DE ESMORUCO,consulta externa,nuevas en personas de 60 anos o mas,2006-01-01,8,6,8,6,14
SAN ANTONIO DE LOMERIO,consulta externa,nuevas en personas de 60 anos o mas,2006-01-01,12,16,12,16,28
SAN BENITO,consulta externa,nuevas en personas de 60 anos o mas,2006-01-01,14,40,14,40,54
SAN BORJA,consulta externa,nuevas en personas de 60 anos o mas,2006-01-01,141,111,141,111,252
SAN BUENA VENTURA,consulta externa,nuevas en personas de 60 anos o mas,2006-01-01,6,9,6,9,15
SAN CARLOS,consulta externa,nuevas en personas de 60 anos o mas,2006-01-01,102,84,102,84,186
SAN IGNACIO,consulta externa,nuevas en personas de 60 anos o mas,2006-01-01,95,79,95,79,174
SAN IGNACIO DE VELASCO,consulta externa,nuevas en personas de 60 anos o mas,2006-01-01,272,280,272,280,552
SAN JAVIER(BNI),consulta externa,nuevas en personas de 60 anos o mas,2006-01-01,11,11,11,11,22
SAN JAVIER(STC),consulta externa,nuevas en personas de 60 anos o mas,2006-01-01,12,18,12,18,30
SAN JOAQUIN,consulta externa,nuevas en personas de 60 anos o mas,2006-01-01,60,62,60,62,122
SAN JOSE DE CHIQUITOS,consulta externa,nuevas en personas de 60 anos o mas,2006-01-01,91,92,91,92,183
SAN JUAN DE YAPACANI,consulta externa,nuevas en personas de 60 anos o mas,2006-01-01,37,20,37,20,57
SAN JULIAN,consulta externa,nuevas en personas de 60 anos o mas,2006-01-01,53,58,53,58,111
SAN LORENZO(PND),consulta externa,nuevas en personas de 60 anos o mas,2006-01-01,5,3,5,3,8
SAN LORENZO(TJA),consulta externa,nuevas en personas de 60 anos o mas,2006-01-01,43,65,43,65,108
SAN LUCAS,consulta externa,nuevas en personas de 60 anos o mas,2006-01-01,141,231,141,231,372
SAN MATIAS,consulta externa,nuevas en personas de 60 anos o mas,2006-01-01,21,11,21,11,32
SAN MIGUEL DE VELASCO,consulta externa,nuevas en personas de 60 anos o mas,2006-01-01,33,43,33,43,76
SAN PABLO DE LIPEZ,consulta externa,nuevas en personas de 60 anos o mas,2006-01-01,18,23,18,23,41
SAN PEDRO,consulta externa,nuevas en personas de 60 anos o mas,2006-01-01,39,38,39,38,77
SAN PEDRO DE BUENA VISTA,consulta externa,nuevas en personas de 60 anos o mas,2006-01-01,23,37,23,37,60
SAN PEDRO DE CURAHUARA,consulta externa,nuevas en personas de 60 anos o mas,2006-01-01,14,22,14,22,36
SAN PEDRO DE TIQUINA,consulta externa,nuevas en personas de 60 anos o mas,2006-01-01,19,16,19,16,35
SAN PEDRO(PND),consulta externa,nuevas en personas de 60 anos o mas,2006-01-01,1,4,1,4,5
SAN RAFAEL,consulta externa,nuevas en personas de 60 anos o mas,2006-01-01,9,13,9,13,22
SAN RAMON,consulta externa,nuevas en personas de 60 anos o mas,2006-01-01,54,76,54,76,130
SAN RAMON,consulta externa,nuevas en personas de 60 anos o mas,2006-01-01,14,21,14,21,35
SANTA ANA,consulta externa,nuevas en personas de 60 anos o mas,2006-01-01,105,119,105,119,224
SANTA CRUZ DE LA SIERRA,consulta externa,nuevas en personas de 60 anos o mas,2006-01-01,7323,10938,7323,10938,18261
SANTA ROSA,consulta externa,nuevas en personas de 60 anos o mas,2006-01-01,45,29,45,29,74
SANTA ROSA DEL SARA,consulta externa,nuevas en personas de 60 anos o mas,2006-01-01,40,26,40,26,66
SANTIAGO DE CALLAPA,consulta externa,nuevas en personas de 60 anos o mas,2006-01-01,19,11,19,11,30
SANTIAGO DE HUARI,consulta externa,nuevas en personas de 60 anos o mas,2006-01-01,67,50,67,50,117
SANTIAGO DE MACHACA,consulta externa,nuevas en personas de 60 anos o mas,2006-01-01,18,28,18,28,46
SANTIVAÑES,consulta externa,nuevas en personas de 60 anos o mas,2006-01-01,16,47,16,47,63
SANTUARIO DE QUILLACAS,consulta externa,nuevas en personas de 60 anos o mas,2006-01-01,15,12,15,12,27
SAPAHAQUI,consulta externa,nuevas en personas de 60 anos o mas,2006-01-01,29,37,29,37,66
SENA,consulta externa,nuevas en personas de 60 anos o mas,2006-01-01,21,9,21,9,30
SICA SICA (VILLA AROMA),consulta externa,nuevas en personas de 60 anos o mas,2006-01-01,38,57,38,57,95
SICAYA,consulta externa,nuevas en personas de 60 anos o mas,2006-01-01,2,2,2,2,4
SIPE SIPE,consulta externa,nuevas en personas de 60 anos o mas,2006-01-01,30,49,30,49,79
SOPACHUY,consulta externa,nuevas en personas de 60 anos o mas,2006-01-01,30,44,30,44,74
SORACACHI,consulta externa,nuevas en personas de 60 anos o mas,2006-01-01,8,6,8,6,14
SORATA,consulta externa,nuevas en personas de 60 anos o mas,2006-01-01,37,43,37,43,80
SUCRE,consulta externa,nuevas en personas de 60 anos o mas,2006-01-01,2181,3125,2181,3125,5306
TACACHI,consulta externa,nuevas en personas de 60 anos o mas,2006-01-01,2,10,2,10,12
TACACOMA,consulta externa,nuevas en personas de 60 anos o mas,2006-01-01,10,5,10,5,15
TACOBAMBA,consulta externa,nuevas en personas de 60 anos o mas,2006-01-01,15,38,15,38,53
TACOPAYA,consulta externa,nuevas en personas de 60 anos o mas,2006-01-01,11,24,11,24,35
TAHUA,consulta externa,nuevas en personas de 60 anos o mas,2006-01-01,4,1,4,1,5
TAPACARI,consulta externa,nuevas en personas de 60 anos o mas,2006-01-01,38,49,38,49,87
TARABUCO,consulta externa,nuevas en personas de 60 anos o mas,2006-01-01,45,79,45,79,124
TARACO,consulta externa,nuevas en personas de 60 anos o mas,2006-01-01,10,23,10,23,33
TARATA,consulta externa,nuevas en personas de 60 anos o mas,2006-01-01,12,14,12,14,26
TARIJA,consulta externa,nuevas en personas de 60 anos o mas,2006-01-01,1745,2165,1745,2165,3910
TARVITA,consulta externa,nuevas en personas de 60 anos o mas,2006-01-01,66,77,66,77,143
TEOPONTE,consulta externa,nuevas en personas de 60 anos o mas,2006-01-01,54,35,54,35,89
TIAWANACU,consulta externa,nuevas en personas de 60 anos o mas,2006-01-01,22,33,22,33,55
TINGUIPAYA,consulta externa,nuevas en personas de 60 anos o mas,2006-01-01,53,81,53,81,134
TIPUANI,consulta externa,nuevas en personas de 60 anos o mas,2006-01-01,5,8,5,8,13
TIQUIPAYA,consulta externa,nuevas en personas de 60 anos o mas,2006-01-01,30,27,30,27,57
TIRAQUE (CBBA),consulta externa,nuevas en personas de 60 anos o mas,2006-01-01,72,59,72,59,131
TITO YUPANQUI (PARQUIPUJIO),consulta externa,nuevas en personas de 60 anos o mas,2006-01-01,5,22,5,22,27
TOCO,consulta externa,nuevas en personas de 60 anos o mas,2006-01-01,11,12,11,12,23
TODOS SANTOS,consulta externa,nuevas en personas de 60 anos o mas,2006-01-01,1,0,1,0,1
TOLATA,consulta externa,nuevas en personas de 60 anos o mas,2006-01-01,6,12,6,12,18
TOLEDO,consulta externa,nuevas en personas de 60 anos o mas,2006-01-01,27,27,27,27,54
TOMAVE,consulta externa,nuevas en personas de 60 anos o mas,2006-01-01,43,93,43,93,136
TOMINA,consulta externa,nuevas en personas de 60 anos o mas,2006-01-01,44,56,44,56,100
TORO TORO,consulta externa,nuevas en personas de 60 anos o mas,2006-01-01,21,36,21,36,57
TOTORA(CBBA),consulta externa,nuevas en personas de 60 anos o mas,2006-01-01,8,21,8,21,29
TOTORA(ORR),consulta externa,nuevas en personas de 60 anos o mas,2006-01-01,17,14,17,14,31
TRIGAL,consulta externa,nuevas en personas de 60 anos o mas,2006-01-01,18,45,18,45,63
TRINIDAD,consulta externa,nuevas en personas de 60 anos o mas,2006-01-01,783,950,783,950,1733
TUPIZA,consulta externa,nuevas en personas de 60 anos o mas,2006-01-01,349,531,349,531,880
TURCO,consulta externa,nuevas en personas de 60 anos o mas,2006-01-01,24,27,24,27,51
UMALA,consulta externa,nuevas en personas de 60 anos o mas,2006-01-01,3,11,3,11,14
UNCIA,consulta externa,nuevas en personas de 60 anos o mas,2006-01-01,130,167,130,167,297
URIONDO (A. CONCEPCION),consulta externa,nuevas en personas de 60 anos o mas,2006-01-01,33,72,33,72,105
URUBICHA,consulta externa,nuevas en personas de 60 anos o mas,2006-01-01,1,5,1,5,6
UYUNI,consulta externa,nuevas en personas de 60 anos o mas,2006-01-01,127,157,127,157,284
VACAS,consulta externa,nuevas en personas de 60 anos o mas,2006-01-01,29,48,29,48,77
VALLEGRANDE,consulta externa,nuevas en personas de 60 anos o mas,2006-01-01,267,348,267,348,615
VIACHA,consulta externa,nuevas en personas de 60 anos o mas,2006-01-01,316,257,316,257,573
VILA VILA,consulta externa,nuevas en personas de 60 anos o mas,2006-01-01,3,6,3,6,9
VILLA MONTES,consulta externa,nuevas en personas de 60 anos o mas,2006-01-01,112,136,112,136,248
VILLA NUEVA (LOMA ALTA),consulta externa,nuevas en personas de 60 anos o mas,2006-01-01,3,2,3,2,5
VILLA RIVERO,consulta externa,nuevas en personas de 60 anos o mas,2006-01-01,8,11,8,11,19
VILLA SERRANO,consulta externa,nuevas en personas de 60 anos o mas,2006-01-01,28,47,28,47,75
VILLA TUNARI,consulta externa,nuevas en personas de 60 anos o mas,2006-01-01,153,132,153,132,285
VILLA VACA GUZMAN (MUYUPAMPA),consulta externa,nuevas en personas de 60 anos o mas,2006-01-01,71,77,71,77,148
VILLAZON,consulta externa,nuevas en personas de 60 anos o mas,2006-01-01,190,427,190,427,617
VINTO,consulta externa,nuevas en personas de 60 anos o mas,2006-01-01,11,15,11,15,26
VITICHI,consulta externa,nuevas en personas de 60 anos o mas,2006-01-01,50,106,50,106,156
WALDO BALLIVIAN,consulta externa,nuevas en personas de 60 anos o mas,2006-01-01,2,1,2,1,3
WARNES,consulta externa,nuevas en personas de 60 anos o mas,2006-01-01,56,79,56,79,135
YACO,consulta externa,nuevas en personas de 60 anos o mas,2006-01-01,16,22,16,22,38
YACUIBA,consulta externa,nuevas en personas de 60 anos o mas,2006-01-01,470,646,470,646,1116
YAMPARAEZ,consulta externa,nuevas en personas de 60 anos o mas,2006-01-01,31,37,31,37,68
YANACACHI,consulta externa,nuevas en personas de 60 anos o mas,2006-01-01,13,18,13,18,31
YAPACANI,consulta externa,nuevas en personas de 60 anos o mas,2006-01-01,105,79,105,79,184
YOCALLA,consulta externa,nuevas en personas de 60 anos o mas,2006-01-01,43,41,43,41,84
YOTALA,consulta externa,nuevas en personas de 60 anos o mas,2006-01-01,24,31,24,31,55
YUNCHARA,consulta externa,nuevas en personas de 60 anos o mas,2006-01-01,4,8,4,8,12
ZUDAÑEZ,consulta externa,nuevas en personas de 60 anos o mas,2006-01-01,30,31,30,31,61
ACACIO,consulta externa,nuevas en personas de 60 anos o mas,2006-02-01,24,30,24,30,54
ACHACACHI,consulta externa,nuevas en personas de 60 anos o mas,2006-02-01,301,318,301,318,619
ACHOCALLA,consulta externa,nuevas en personas de 60 anos o mas,2006-02-01,13,14,13,14,27
AIQUILE,consulta externa,nuevas en personas de 60 anos o mas,2006-02-01,75,90,75,90,165
ALALAY,consulta externa,nuevas en personas de 60 anos o mas,2006-02-01,3,10,3,10,13
ALCALA,consulta externa,nuevas en personas de 60 anos o mas,2006-02-01,21,44,21,44,65
ANCORAIMES,consulta externa,nuevas en personas de 60 anos o mas,2006-02-01,100,104,100,104,204
ANDAMARCA,consulta externa,nuevas en personas de 60 anos o mas,2006-02-01,41,58,41,58,99
ANTEQUERA,consulta externa,nuevas en personas de 60 anos o mas,2006-02-01,4,5,4,5,9
ANZALDO,consulta externa,nuevas en personas de 60 anos o mas,2006-02-01,21,18,21,18,39
APOLO,consulta externa,nuevas en personas de 60 anos o mas,2006-02-01,27,41,27,41,68
ARAMPAMPA,consulta externa,nuevas en personas de 60 anos o mas,2006-02-01,10,10,10,10,20
ARANI,consulta externa,nuevas en personas de 60 anos o mas,2006-02-01,7,15,7,15,22
ARBIETO,consulta externa,nuevas en personas de 60 anos o mas,2006-02-01,21,22,21,22,43
ARQUE,consulta externa,nuevas en personas de 60 anos o mas,2006-02-01,9,27,9,27,36
ASCENCION DE GUARAYOS,consulta externa,nuevas en personas de 60 anos o mas,2006-02-01,24,47,24,47,71
ATOCHA,consulta externa,nuevas en personas de 60 anos o mas,2006-02-01,63,110,63,110,173
AUCAPATA,consulta externa,nuevas en personas de 60 anos o mas,2006-02-01,42,34,42,34,76
AYATA,consulta externa,nuevas en personas de 60 anos o mas,2006-02-01,17,25,17,25,42
AYO AYO,consulta externa,nuevas en personas de 60 anos o mas,2006-02-01,9,8,9,8,17
AYOPAYA (V. DE INDEPENDENCIA),consulta externa,nuevas en personas de 60 anos o mas,2006-02-01,45,76,45,76,121
AZURDUY,consulta externa,nuevas en personas de 60 anos o mas,2006-02-01,28,27,28,27,55
BATALLAS,consulta externa,nuevas en personas de 60 anos o mas,2006-02-01,36,27,36,27,63
BAURES,consulta externa,nuevas en personas de 60 anos o mas,2006-02-01,55,49,55,49,104
BELEN DE ANDAMARCA,consulta externa,nuevas en personas de 60 anos o mas,2006-02-01,15,5,15,5,20
BELEN DE URMIRI,consulta externa,nuevas en personas de 60 anos o mas,2006-02-01,11,12,11,12,23
BELLA FLOR,consulta externa,nuevas en personas de 60 anos o mas,2006-02-01,4,4,4,4,8
BERMEJO,consulta externa,nuevas en personas de 60 anos o mas,2006-02-01,448,434,448,434,882
BETANZOS,consulta externa,nuevas en personas de 60 anos o mas,2006-02-01,133,201,133,201,334
BOLIVAR,consulta externa,nuevas en personas de 60 anos o mas,2006-02-01,16,30,16,30,46
BOLPEBRA,consulta externa,nuevas en personas de 60 anos o mas,2006-02-01,14,6,14,6,20
BOYUIBE,consulta externa,nuevas en personas de 60 anos o mas,2006-02-01,24,26,24,26,50
BUENA VISTA,consulta externa,nuevas en personas de 60 anos o mas,2006-02-01,114,97,114,97,211
CABEZAS,consulta externa,nuevas en personas de 60 anos o mas,2006-02-01,29,39,29,39,68
CAIROMA,consulta externa,nuevas en personas de 60 anos o mas,2006-02-01,30,31,30,31,61
"CAIZA ""D""",consulta externa,nuevas en personas de 60 anos o mas,2006-02-01,74,91,74,91,165
CAJUATA,consulta externa,nuevas en personas de 60 anos o mas,2006-02-01,40,20,40,20,60
CALACOTO,consulta externa,nuevas en personas de 60 anos o mas,2006-02-01,41,44,41,44,85
CALAMARCA,consulta externa,nuevas en personas de 60 anos o mas,2006-02-01,50,54,50,54,104
CAMARGO,consulta externa,nuevas en personas de 60 anos o mas,2006-02-01,150,280,150,280,430
CAMATAQUI (C. VILLA ABECIA),consulta externa,nuevas en personas de 60 anos o mas,2006-02-01,14,21,14,21,35
CAMIRI,consulta externa,nuevas en personas de 60 anos o mas,2006-02-01,513,687,513,687,1200
CAPINOTA,consulta externa,nuevas en personas de 60 anos o mas,2006-02-01,52,89,52,89,141
CAQUIAVIRI,consulta externa,nuevas en personas de 60 anos o mas,2006-02-01,36,54,36,54,90
CARACOLLO,consulta externa,nuevas en personas de 60 anos o mas,2006-02-01,63,59,63,59,122
CARANAVI,consulta externa,nuevas en personas de 60 anos o mas,2006-02-01,431,229,431,229,660
CARAPARI,consulta externa,nuevas en personas de 60 anos o mas,2006-02-01,44,59,44,59,103
CARIPUYO,consulta externa,nuevas en personas de 60 anos o mas,2006-02-01,10,18,10,18,28
CARMEN RIVERO TORREZ,consulta externa,nuevas en personas de 60 anos o mas,2006-02-01,2,4,2,4,6
CATACORA,consulta externa,nuevas en personas de 60 anos o mas,2006-02-01,2,6,2,6,8
CHACARILLA,consulta externa,nuevas en personas de 60 anos o mas,2006-02-01,13,12,13,12,25
CHALLAPATA,consulta externa,nuevas en personas de 60 anos o mas,2006-02-01,79,91,79,91,170
CHAQUI,consulta externa,nuevas en personas de 60 anos o mas,2006-02-01,14,38,14,38,52
CHARAGUA,consulta externa,nuevas en personas de 60 anos o mas,2006-02-01,41,47,41,47,88
CHARAÑA,consulta externa,nuevas en personas de 60 anos o mas,2006-02-01,4,9,4,9,13
CHAYANTA,consulta externa,nuevas en personas de 60 anos o mas,2006-02-01,38,85,38,85,123
CHIMORE,consulta externa,nuevas en personas de 60 anos o mas,2006-02-01,13,8,13,8,21
CHIPAYA,consulta externa,nuevas en personas de 60 anos o mas,2006-02-01,15,8,15,8,23
CHOQUE COTA,consulta externa,nuevas en personas de 60 anos o mas,2006-02-01,7,7,7,7,14
CHULUMANI (V. DE LA LIBERTAD),consulta externa,nuevas en personas de 60 anos o mas,2006-02-01,44,57,44,57,101
CHUMA,consulta externa,nuevas en personas de 60 anos o mas,2006-02-01,32,37,32,37,69
CLIZA,consulta externa,nuevas en personas de 60 anos o mas,2006-02-01,16,25,16,25,41
COBIJA,consulta externa,nuevas en personas de 60 anos o mas,2006-02-01,160,269,160,269,429
COCHABAMBA,consulta externa,nuevas en personas de 60 anos o mas,2006-02-01,2896,4764,2896,4764,7660
COIPASA,consulta externa,nuevas en personas de 60 anos o mas,2006-02-01,2,1,2,1,3
COLCAPIRHUA,consulta externa,nuevas en personas de 60 anos o mas,2006-02-01,98,148,98,148,246
"COLCHA ""K""",consulta externa,nuevas en personas de 60 anos o mas,2006-02-01,54,69,54,69,123
COLLANA,consulta externa,nuevas en personas de 60 anos o mas,2006-02-01,12,20,12,20,32
COLOMI,consulta externa,nuevas en personas de 60 anos o mas,2006-02-01,16,9,16,9,25
COLPA BELGICA,consulta externa,nuevas en personas de 60 anos o mas,2006-02-01,80,68,80,68,148
COLQUECHACA,consulta externa,nuevas en personas de 60 anos o mas,2006-02-01,77,105,77,105,182
COLQUENCHA,consulta externa,nuevas en personas de 60 anos o mas,2006-02-01,16,33,16,33,49
COLQUIRI,consulta externa,nuevas en personas de 60 anos o mas,2006-02-01,61,67,61,67,128
COMANCHE,consulta externa,nuevas en personas de 60 anos o mas,2006-02-01,16,9,16,9,25
COMARAPA,consulta externa,nuevas en personas de 60 anos o mas,2006-02-01,90,115,90,115,205
COMBAYA,consulta externa,nuevas en personas de 60 anos o mas,2006-02-01,0,1,0,1,1
CONCEPCION,consulta externa,nuevas en personas de 60 anos o mas,2006-02-01,64,62,64,62,126
COPACABANA,consulta externa,nuevas en personas de 60 anos o mas,2006-02-01,40,37,40,37,77
CORIPATA,consulta externa,nuevas en personas de 60 anos o mas,2006-02-01,21,32,21,32,53
CORO CORO,consulta externa,nuevas en personas de 60 anos o mas,2006-02-01,68,67,68,67,135
COROICO,consulta externa,nuevas en personas de 60 anos o mas,2006-02-01,73,77,73,77,150
CORQUE,consulta externa,nuevas en personas de 60 anos o mas,2006-02-01,46,42,46,42,88
COTAGAITA,consulta externa,nuevas en personas de 60 anos o mas,2006-02-01,176,320,176,320,496
COTOCA,consulta externa,nuevas en personas de 60 anos o mas,2006-02-01,57,54,57,54,111
CUATRO CAÑADAS,consulta externa,nuevas en personas de 60 anos o mas,2006-02-01,56,37,56,37,93
CUCHUMUELA (V. G. VILLARROEL),consulta externa,nuevas en personas de 60 anos o mas,2006-02-01,6,8,6,8,14
CUEVO,consulta externa,nuevas en personas de 60 anos o mas,2006-02-01,19,18,19,18,37
CULPINA,consulta externa,nuevas en personas de 60 anos o mas,2006-02-01,34,51,34,51,85
CURAHUARA DE CARANGAS,consulta externa,nuevas en personas de 60 anos o mas,2006-02-01,53,53,53,53,106
CURVA,consulta externa,nuevas en personas de 60 anos o mas,2006-02-01,9,8,9,8,17
DESAGUADERO,consulta externa,nuevas en personas de 60 anos o mas,2006-02-01,48,57,48,57,105
EL ALTO,consulta externa,nuevas en personas de 60 anos o mas,2006-02-01,1245,1059,1245,1059,2304
EL CHORO,consulta externa,nuevas en personas de 60 anos o mas,2006-02-01,41,38,41,38,79
EL PUENTE(STC),consulta externa,nuevas en personas de 60 anos o mas,2006-02-01,61,59,61,59,120
EL PUENTE(TJA),consulta externa,nuevas en personas de 60 anos o mas,2006-02-01,30,52,30,52,82
EL TORNO,consulta externa,nuevas en personas de 60 anos o mas,2006-02-01,152,151,152,151,303
EL VILLAR,consulta externa,nuevas en personas de 60 anos o mas,2006-02-01,11,28,11,28,39
ENTRE RIOS,consulta externa,nuevas en personas de 60 anos o mas,2006-02-01,62,85,62,85,147
ENTRE RIOS,consulta externa,nuevas en personas de 60 anos o mas,2006-02-01,13,9,13,9,22
ESCARA,consulta externa,nuevas en personas de 60 anos o mas,2006-02-01,2,2,2,2,4
ESMERALDA,consulta externa,nuevas en personas de 60 anos o mas,2006-02-01,3,0,3,0,3
EUCALIPTUS,consulta externa,nuevas en personas de 60 anos o mas,2006-02-01,38,41,38,41,79
EXALTACION,consulta externa,nuevas en personas de 60 anos o mas,2006-02-01,5,9,5,9,14
FERNANDEZ ALONSO,consulta externa,nuevas en personas de 60 anos o mas,2006-02-01,23,18,23,18,41
FILADELFIA,consulta externa,nuevas en personas de 60 anos o mas,2006-02-01,24,9,24,9,33
GENERAL SAAVEDRA,consulta externa,nuevas en personas de 60 anos o mas,2006-02-01,27,19,27,19,46
GRAL. J.J. PEREZ (CHARAZANI),consulta externa,nuevas en personas de 60 anos o mas,2006-02-01,37,53,37,53,90
GUANAY,consulta externa,nuevas en personas de 60 anos o mas,2006-02-01,34,50,34,50,84
GUAQUI,consulta externa,nuevas en personas de 60 anos o mas,2006-02-01,15,18,15,18,33
GUAYARAMERIN,consulta externa,nuevas en personas de 60 anos o mas,2006-02-01,359,419,359,419,778
GUTIERREZ,consulta externa,nuevas en personas de 60 anos o mas,2006-02-01,46,56,46,56,102
HUACARETA,consulta externa,nuevas en personas de 60 anos o mas,2006-02-01,64,81,64,81,145
HUACAYA (VILLA DE HUACAYA),consulta externa,nuevas en personas de 60 anos o mas,2006-02-01,1,2,1,2,3
HUACHACALLA,consulta externa,nuevas en personas de 60 anos o mas,2006-02-01,6,3,6,3,9
HUANUNI,consulta externa,nuevas en personas de 60 anos o mas,2006-02-01,109,119,109,119,228
HUARACAJE,consulta externa,nuevas en personas de 60 anos o mas,2006-02-01,29,38,29,38,67
HUAYLLAMARCA,consulta externa,nuevas en personas de 60 anos o mas,2006-02-01,33,33,33,33,66
ICHOCA,consulta externa,nuevas en personas de 60 anos o mas,2006-02-01,15,12,15,12,27
ICLA,consulta externa,nuevas en personas de 60 anos o mas,2006-02-01,30,70,30,70,100
INCAHUASI,consulta externa,nuevas en personas de 60 anos o mas,2006-02-01,56,74,56,74,130
INGAVI (HUMAITA),consulta externa,nuevas en personas de 60 anos o mas,2006-02-01,3,1,3,1,4
INQUISIVI,consulta externa,nuevas en personas de 60 anos o mas,2006-02-01,45,36,45,36,81
IRUPANA (VILLA DE LANZA),consulta externa,nuevas en personas de 60 anos o mas,2006-02-01,42,42,42,42,84
IXIAMAS,consulta externa,nuevas en personas de 60 anos o mas,2006-02-01,39,30,39,30,69
JESUS DE MACHACA,consulta externa,nuevas en personas de 60 anos o mas,2006-02-01,50,46,50,46,96
LA ASUNTA,consulta externa,nuevas en personas de 60 anos o mas,2006-02-01,17,20,17,20,37
LA GUARDIA,consulta externa,nuevas en personas de 60 anos o mas,2006-02-01,33,44,33,44,77
LA PAZ,consulta externa,nuevas en personas de 60 anos o mas,2006-02-01,7106,9026,7106,9026,16132
LA RIVERA,consulta externa,nuevas en personas de 60 anos o mas,2006-02-01,4,1,4,1,5
LAGUNILLAS,consulta externa,nuevas en personas de 60 anos o mas,2006-02-01,32,36,32,36,68
LAJA,consulta externa,nuevas en personas de 60 anos o mas,2006-02-01,18,20,18,20,38
LAS CARRERAS,consulta externa,nuevas en personas de 60 anos o mas,2006-02-01,19,35,19,35,54
LICOMA PAMPA,consulta externa,nuevas en personas de 60 anos o mas,2006-02-01,5,2,5,2,7
LLALLAGUA,consulta externa,nuevas en personas de 60 anos o mas,2006-02-01,143,280,143,280,423
LLICA,consulta externa,nuevas en personas de 60 anos o mas,2006-02-01,35,41,35,41,76
LORETO,consulta externa,nuevas en personas de 60 anos o mas,2006-02-01,31,22,31,22,53
LURIBAY,consulta externa,nuevas en personas de 60 anos o mas,2006-02-01,53,49,53,49,102
MACHACAMARCA,consulta externa,nuevas en personas de 60 anos o mas,2006-02-01,59,58,59,58,117
MACHARETI,consulta externa,nuevas en personas de 60 anos o mas,2006-02-01,61,48,61,48,109
MAGDALENA,consulta externa,nuevas en personas de 60 anos o mas,2006-02-01,28,31,28,31,59
MAIRANA,consulta externa,nuevas en personas de 60 anos o mas,2006-02-01,47,80,47,80,127
MALLA,consulta externa,nuevas en personas de 60 anos o mas,2006-02-01,12,14,12,14,26
MAPIRI,consulta externa,nuevas en personas de 60 anos o mas,2006-02-01,48,35,48,35,83
MECAPACA,consulta externa,nuevas en personas de 60 anos o mas,2006-02-01,80,58,80,58,138
MINEROS,consulta externa,nuevas en personas de 60 anos o mas,2006-02-01,93,78,93,78,171
MIZQUE,consulta externa,nuevas en personas de 60 anos o mas,2006-02-01,44,70,44,70,114
MOCOMOCO,consulta externa,nuevas en personas de 60 anos o mas,2006-02-01,47,57,47,57,104
MOJINETE,consulta externa,nuevas en personas de 60 anos o mas,2006-02-01,15,33,15,33,48
MOJOCOYA,consulta externa,nuevas en personas de 60 anos o mas,2006-02-01,17,24,17,24,41
MONTEAGUDO,consulta externa,nuevas en personas de 60 anos o mas,2006-02-01,191,250,191,250,441
MONTERO,consulta externa,nuevas en personas de 60 anos o mas,2006-02-01,200,280,200,280,480
MORO MORO,consulta externa,nuevas en personas de 60 anos o mas,2006-02-01,23,38,23,38,61
MOROCHATA,consulta externa,nuevas en personas de 60 anos o mas,2006-02-01,6,15,6,15,21
NACEBE (SANTA ROSA DEL ABUNA),consulta externa,nuevas en personas de 60 anos o mas,2006-02-01,5,4,5,4,9
NUEVO MANOA (NUEVA ESPERANZA),consulta externa,nuevas en personas de 60 anos o mas,2006-02-01,2,1,2,1,3
OCURI,consulta externa,nuevas en personas de 60 anos o mas,2006-02-01,34,68,34,68,102
OKINAWA,consulta externa,nuevas en personas de 60 anos o mas,2006-02-01,87,77,87,77,164
OMEREQUE,consulta externa,nuevas en personas de 60 anos o mas,2006-02-01,11,30,11,30,41
ORURO,consulta externa,nuevas en personas de 60 anos o mas,2006-02-01,2381,2611,2381,2611,4992
PADCAYA,consulta externa,nuevas en personas de 60 anos o mas,2006-02-01,92,117,92,117,209
PADILLA,consulta externa,nuevas en personas de 60 anos o mas,2006-02-01,122,172,122,172,294
PAILON,consulta externa,nuevas en personas de 60 anos o mas,2006-02-01,26,27,26,27,53
PALCA,consulta externa,nuevas en personas de 60 anos o mas,2006-02-01,25,17,25,17,42
PALOS BLANCOS,consulta externa,nuevas en personas de 60 anos o mas,2006-02-01,53,25,53,25,78
PAMPA AULLAGAS,consulta externa,nuevas en personas de 60 anos o mas,2006-02-01,7,8,7,8,15
PAMPA GRANDE,consulta externa,nuevas en personas de 60 anos o mas,2006-02-01,27,38,27,38,65
PAPEL PAMPA,consulta externa,nuevas en personas de 60 anos o mas,2006-02-01,36,36,36,36,72
PASORAPA,consulta externa,nuevas en personas de 60 anos o mas,2006-02-01,3,10,3,10,13
PATACAMAYA,consulta externa,nuevas en personas de 60 anos o mas,2006-02-01,29,28,29,28,57
PAZÑA,consulta externa,nuevas en personas de 60 anos o mas,2006-02-01,25,37,25,37,62
PELECHUCO,consulta externa,nuevas en personas de 60 anos o mas,2006-02-01,13,26,13,26,39
POCOATA,consulta externa,nuevas en personas de 60 anos o mas,2006-02-01,56,75,56,75,131
POCONA,consulta externa,nuevas en personas de 60 anos o mas,2006-02-01,17,50,17,50,67
POJO (CBBA),consulta externa,nuevas en personas de 60 anos o mas,2006-02-01,4,2,4,2,6
POOPO,consulta externa,nuevas en personas de 60 anos o mas,2006-02-01,41,65,41,65,106
PORCO,consulta externa,nuevas en personas de 60 anos o mas,2006-02-01,12,21,12,21,33
POROMA,consulta externa,nuevas en personas de 60 anos o mas,2006-02-01,43,80,43,80,123
PORONGO,consulta externa,nuevas en personas de 60 anos o mas,2006-02-01,28,20,28,20,48
PORTACHUELO,consulta externa,nuevas en personas de 60 anos o mas,2006-02-01,100,108,100,108,208
PORVENIR,consulta externa,nuevas en personas de 60 anos o mas,2006-02-01,8,12,8,12,20
POSTRER VALLE,consulta externa,nuevas en personas de 60 anos o mas,2006-02-01,21,21,21,21,42
POTOSI,consulta externa,nuevas en personas de 60 anos o mas,2006-02-01,1790,1640,1790,1640,3430
PRESTO,consulta externa,nuevas en personas de 60 anos o mas,2006-02-01,24,32,24,32,56
PUCARA,consulta externa,nuevas en personas de 60 anos o mas,2006-02-01,37,61,37,61,98
PUCARANI,consulta externa,nuevas en personas de 60 anos o mas,2006-02-01,43,38,43,38,81
PUERTO ACOSTA,consulta externa,nuevas en personas de 60 anos o mas,2006-02-01,254,230,254,230,484
PUERTO CARABUCO,consulta externa,nuevas en personas de 60 anos o mas,2006-02-01,67,81,67,81,148
PUERTO GONZALO MORENO,consulta externa,nuevas en personas de 60 anos o mas,2006-02-01,24,22,24,22,46
PUERTO PEREZ,consulta externa,nuevas en personas de 60 anos o mas,2006-02-01,36,46,36,46,82
PUERTO QUIJARRO,consulta externa,nuevas en personas de 60 anos o mas,2006-02-01,75,64,75,64,139
PUERTO RICO,consulta externa,nuevas en personas de 60 anos o mas,2006-02-01,9,11,9,11,20
PUERTO SILES,consulta externa,nuevas en personas de 60 anos o mas,2006-02-01,6,10,6,10,16
PUERTO SUAREZ,consulta externa,nuevas en personas de 60 anos o mas,2006-02-01,75,81,75,81,156
PUERTO VILLARROEL,consulta externa,nuevas en personas de 60 anos o mas,2006-02-01,38,31,38,31,69
PUNA,consulta externa,nuevas en personas de 60 anos o mas,2006-02-01,140,259,140,259,399
PUNATA,consulta externa,nuevas en personas de 60 anos o mas,2006-02-01,99,120,99,120,219
QUIABAYA,consulta externa,nuevas en personas de 60 anos o mas,2006-02-01,9,11,9,11,20
QUILLACOLLO,consulta externa,nuevas en personas de 60 anos o mas,2006-02-01,46,49,46,49,95
QUIME,consulta externa,nuevas en personas de 60 anos o mas,2006-02-01,34,41,34,41,75
QUIRUSILLAS,consulta externa,nuevas en personas de 60 anos o mas,2006-02-01,4,5,4,5,9
RAVELO,consulta externa,nuevas en personas de 60 anos o mas,2006-02-01,31,58,31,58,89
REYES,consulta externa,nuevas en personas de 60 anos o mas,2006-02-01,119,114,119,114,233
RIBERALTA,consulta externa,nuevas en personas de 60 anos o mas,2006-02-01,198,98,198,98,296
ROBORE,consulta externa,nuevas en personas de 60 anos o mas,2006-02-01,52,87,52,87,139
RURRENABAQUE,consulta externa,nuevas en personas de 60 anos o mas,2006-02-01,132,136,132,136,268
SABAYA,consulta externa,nuevas en personas de 60 anos o mas,2006-02-01,19,26,19,26,45
SACABA,consulta externa,nuevas en personas de 60 anos o mas,2006-02-01,131,181,131,181,312
SACABAMBA,consulta externa,nuevas en personas de 60 anos o mas,2006-02-01,8,14,8,14,22
SACACA,consulta externa,nuevas en personas de 60 anos o mas,2006-02-01,37,48,37,48,85
SAIPINA,consulta externa,nuevas en personas de 60 anos o mas,2006-02-01,83,110,83,110,193
SALINAS DE GARCI MENDOZA,consulta externa,nuevas en personas de 60 anos o mas,2006-02-01,54,69,54,69,123
SAMAIPATA,consulta externa,nuevas en personas de 60 anos o mas,2006-02-01,53,75,53,75,128
SAN AGUSTIN,consulta externa,nuevas en personas de 60 anos o mas,2006-02-01,7,9,7,9,16
SAN ANDRES,consulta externa,nuevas en personas de 60 anos o mas,2006-02-01,12,13,12,13,25
SAN ANDRES DE MACHACA,consulta externa,nuevas en personas de 60 anos o mas,2006-02-01,37,30,37,30,67
SAN ANTONIO DE ESMORUCO,consulta externa,nuevas en personas de 60 anos o mas,2006-02-01,2,4,2,4,6
SAN ANTONIO DE LOMERIO,consulta externa,nuevas en personas de 60 anos o mas,2006-02-01,10,7,10,7,17
SAN BENITO,consulta externa,nuevas en personas de 60 anos o mas,2006-02-01,13,31,13,31,44
SAN BORJA,consulta externa,nuevas en personas de 60 anos o mas,2006-02-01,112,103,112,103,215
SAN BUENA VENTURA,consulta externa,nuevas en personas de 60 anos o mas,2006-02-01,56,66,56,66,122
SAN CARLOS,consulta externa,nuevas en personas de 60 anos o mas,2006-02-01,94,101,94,101,195
SAN IGNACIO,consulta externa,nuevas en personas de 60 anos o mas,2006-02-01,90,116,90,116,206
SAN IGNACIO DE VELASCO,consulta externa,nuevas en personas de 60 anos o mas,2006-02-01,160,225,160,225,385
SAN JAVIER(BNI),consulta externa,nuevas en personas de 60 anos o mas,2006-02-01,4,5,4,5,9
SAN JAVIER(STC),consulta externa,nuevas en personas de 60 anos o mas,2006-02-01,13,20,13,20,33
SAN JOAQUIN,consulta externa,nuevas en personas de 60 anos o mas,2006-02-01,43,69,43,69,112
SAN JOSE DE CHIQUITOS,consulta externa,nuevas en personas de 60 anos o mas,2006-02-01,50,60,50,60,110
SAN JUAN DE YAPACANI,consulta externa,nuevas en personas de 60 anos o mas,2006-02-01,34,26,34,26,60
SAN JULIAN,consulta externa,nuevas en personas de 60 anos o mas,2006-02-01,150,157,150,157,307
SAN LORENZO(PND),consulta externa,nuevas en personas de 60 anos o mas,2006-02-01,9,6,9,6,15
SAN LORENZO(TJA),consulta externa,nuevas en personas de 60 anos o mas,2006-02-01,42,55,42,55,97
SAN LUCAS,consulta externa,nuevas en personas de 60 anos o mas,2006-02-01,96,209,96,209,305
SAN MATIAS,consulta externa,nuevas en personas de 60 anos o mas,2006-02-01,20,23,20,23,43
SAN MIGUEL DE VELASCO,consulta externa,nuevas en personas de 60 anos o mas,2006-02-01,29,42,29,42,71
SAN PABLO DE LIPEZ,consulta externa,nuevas en personas de 60 anos o mas,2006-02-01,15,22,15,22,37
SAN PEDRO,consulta externa,nuevas en personas de 60 anos o mas,2006-02-01,45,30,45,30,75
SAN PEDRO DE BUENA VISTA,consulta externa,nuevas en personas de 60 anos o mas,2006-02-01,40,44,40,44,84
SAN PEDRO DE CURAHUARA,consulta externa,nuevas en personas de 60 anos o mas,2006-02-01,22,21,22,21,43
SAN PEDRO DE QUEMES,consulta externa,nuevas en personas de 60 anos o mas,2006-02-01,2,1,2,1,3
SAN PEDRO DE TIQUINA,consulta externa,nuevas en personas de 60 anos o mas,2006-02-01,22,23,22,23,45
SAN PEDRO(PND),consulta externa,nuevas en personas de 60 anos o mas,2006-02-01,4,1,4,1,5
SAN RAFAEL,consulta externa,nuevas en personas de 60 anos o mas,2006-02-01,14,6,14,6,20
SAN RAMON,consulta externa,nuevas en personas de 60 anos o mas,2006-02-01,41,80,41,80,121
SAN RAMON,consulta externa,nuevas en personas de 60 anos o mas,2006-02-01,12,21,12,21,33
SANTA ANA,consulta externa,nuevas en personas de 60 anos o mas,2006-02-01,107,139,107,139,246
SANTA CRUZ DE LA SIERRA,consulta externa,nuevas en personas de 60 anos o mas,2006-02-01,5133,6999,5133,6999,12132
SANTA ROSA,consulta externa,nuevas en personas de 60 anos o mas,2006-02-01,48,59,48,59,107
SANTA ROSA DEL SARA,consulta externa,nuevas en personas de 60 anos o mas,2006-02-01,56,42,56,42,98
SANTIAGO DE CALLAPA,consulta externa,nuevas en personas de 60 anos o mas,2006-02-01,15,11,15,11,26
SANTIAGO DE HUARI,consulta externa,nuevas en personas de 60 anos o mas,2006-02-01,67,74,67,74,141
SANTIAGO DE MACHACA,consulta externa,nuevas en personas de 60 anos o mas,2006-02-01,46,67,46,67,113
SANTIVAÑES,consulta externa,nuevas en personas de 60 anos o mas,2006-02-01,23,39,23,39,62
SANTUARIO DE QUILLACAS,consulta externa,nuevas en personas de 60 anos o mas,2006-02-01,25,36,25,36,61
SAPAHAQUI,consulta externa,nuevas en personas de 60 anos o mas,2006-02-01,51,48,51,48,99
SENA,consulta externa,nuevas en personas de 60 anos o mas,2006-02-01,13,1,13,1,14
SICA SICA (VILLA AROMA),consulta externa,nuevas en personas de 60 anos o mas,2006-02-01,18,19,18,19,37
SICAYA,consulta externa,nuevas en personas de 60 anos o mas,2006-02-01,4,16,4,16,20
SIPE SIPE,consulta externa,nuevas en personas de 60 anos o mas,2006-02-01,26,36,26,36,62
SOPACHUY,consulta externa,nuevas en personas de 60 anos o mas,2006-02-01,24,34,24,34,58
SORACACHI,consulta externa,nuevas en personas de 60 anos o mas,2006-02-01,14,6,14,6,20
SORATA,consulta externa,nuevas en personas de 60 anos o mas,2006-02-01,48,47,48,47,95
SUCRE,consulta externa,nuevas en personas de 60 anos o mas,2006-02-01,2155,2935,2155,2935,5090
TACACHI,consulta externa,nuevas en personas de 60 anos o mas,2006-02-01,2,5,2,5,7
TACACOMA,consulta externa,nuevas en personas de 60 anos o mas,2006-02-01,19,11,19,11,30
TACOBAMBA,consulta externa,nuevas en personas de 60 anos o mas,2006-02-01,21,54,21,54,75
TACOPAYA,consulta externa,nuevas en personas de 60 anos o mas,2006-02-01,12,48,12,48,60
TAHUA,consulta externa,nuevas en personas de 60 anos o mas,2006-02-01,19,17,19,17,36
TAPACARI,consulta externa,nuevas en personas de 60 anos o mas,2006-02-01,56,70,56,70,126
TARABUCO,consulta externa,nuevas en personas de 60 anos o mas,2006-02-01,41,63,41,63,104
TARACO,consulta externa,nuevas en personas de 60 anos o mas,2006-02-01,15,14,15,14,29
TARATA,consulta externa,nuevas en personas de 60 anos o mas,2006-02-01,10,11,10,11,21
TARIJA,consulta externa,nuevas en personas de 60 anos o mas,2006-02-01,1173,1655,1173,1655,2828
TARVITA,consulta externa,nuevas en personas de 60 anos o mas,2006-02-01,74,89,74,89,163
TEOPONTE,consulta externa,nuevas en personas de 60 anos o mas,2006-02-01,65,48,65,48,113
TIAWANACU,consulta externa,nuevas en personas de 60 anos o mas,2006-02-01,24,20,24,20,44
TINGUIPAYA,consulta externa,nuevas en personas de 60 anos o mas,2006-02-01,43,79,43,79,122
TIPUANI,consulta externa,nuevas en personas de 60 anos o mas,2006-02-01,24,11,24,11,35
TIQUIPAYA,consulta externa,nuevas en personas de 60 anos o mas,2006-02-01,10,12,10,12,22
TIRAQUE (CBBA),consulta externa,nuevas en personas de 60 anos o mas,2006-02-01,48,43,48,43,91
TITO YUPANQUI (PARQUIPUJIO),consulta externa,nuevas en personas de 60 anos o mas,2006-02-01,7,9,7,9,16
TOCO,consulta externa,nuevas en personas de 60 anos o mas,2006-02-01,4,6,4,6,10
TODOS SANTOS,consulta externa,nuevas en personas de 60 anos o mas,2006-02-01,2,3,2,3,5
TOLATA,consulta externa,nuevas en personas de 60 anos o mas,2006-02-01,5,21,5,21,26
TOLEDO,consulta externa,nuevas en personas de 60 anos o mas,2006-02-01,41,39,41,39,80
TOMAVE,consulta externa,nuevas en personas de 60 anos o mas,2006-02-01,40,100,40,100,140
TOMINA,consulta externa,nuevas en personas de 60 anos o mas,2006-02-01,35,44,35,44,79
TORO TORO,consulta externa,nuevas en personas de 60 anos o mas,2006-02-01,26,43,26,43,69
TOTORA(CBBA),consulta externa,nuevas en personas de 60 anos o mas,2006-02-01,11,15,11,15,26
TOTORA(ORR),consulta externa,nuevas en personas de 60 anos o mas,2006-02-01,7,12,7,12,19
TRIGAL,consulta externa,nuevas en personas de 60 anos o mas,2006-02-01,69,80,69,80,149
TRINIDAD,consulta externa,nuevas en personas de 60 anos o mas,2006-02-01,478,572,478,572,1050
TUPIZA,consulta externa,nuevas en personas de 60 anos o mas,2006-02-01,306,544,306,544,850
TURCO,consulta externa,nuevas en personas de 60 anos o mas,2006-02-01,15,17,15,17,32
UMALA,consulta externa,nuevas en personas de 60 anos o mas,2006-02-01,53,51,53,51,104
UNCIA,consulta externa,nuevas en personas de 60 anos o mas,2006-02-01,121,178,121,178,299
URIONDO (A. CONCEPCION),consulta externa,nuevas en personas de 60 anos o mas,2006-02-01,25,31,25,31,56
URUBICHA,consulta externa,nuevas en personas de 60 anos o mas,2006-02-01,10,18,10,18,28
UYUNI,consulta externa,nuevas en personas de 60 anos o mas,2006-02-01,150,156,150,156,306
VACAS,consulta externa,nuevas en personas de 60 anos o mas,2006-02-01,18,51,18,51,69
VALLEGRANDE,consulta externa,nuevas en personas de 60 anos o mas,2006-02-01,257,345,257,345,602
VIACHA,consulta externa,nuevas en personas de 60 anos o mas,2006-02-01,411,362,411,362,773
VILA VILA,consulta externa,nuevas en personas de 60 anos o mas,2006-02-01,52,42,52,42,94
VILLA MONTES,consulta externa,nuevas en personas de 60 anos o mas,2006-02-01,101,86,101,86,187
VILLA RIVERO,consulta externa,nuevas en personas de 60 anos o mas,2006-02-01,11,11,11,11,22
VILLA SERRANO,consulta externa,nuevas en personas de 60 anos o mas,2006-02-01,37,67,37,67,104
VILLA TUNARI,consulta externa,nuevas en personas de 60 anos o mas,2006-02-01,123,90,123,90,213
VILLA VACA GUZMAN (MUYUPAMPA),consulta externa,nuevas en personas de 60 anos o mas,2006-02-01,61,53,61,53,114
VILLAZON,consulta externa,nuevas en personas de 60 anos o mas,2006-02-01,211,312,211,312,523
VINTO,consulta externa,nuevas en personas de 60 anos o mas,2006-02-01,40,39,40,39,79
VITICHI,consulta externa,nuevas en personas de 60 anos o mas,2006-02-01,52,82,52,82,134
WALDO BALLIVIAN,consulta externa,nuevas en personas de 60 anos o mas,2006-02-01,4,7,4,7,11
WARNES,consulta externa,nuevas en personas de 60 anos o mas,2006-02-01,63,48,63,48,111
YACO,consulta externa,nuevas en personas de 60 anos o mas,2006-02-01,15,22,15,22,37
YACUIBA,consulta externa,nuevas en personas de 60 anos o mas,2006-02-01,420,616,420,616,1036
YAMPARAEZ,consulta externa,nuevas en personas de 60 anos o mas,2006-02-01,36,46,36,46,82
YANACACHI,consulta externa,nuevas en personas de 60 anos o mas,2006-02-01,34,49,34,49,83
YAPACANI,consulta externa,nuevas en personas de 60 anos o mas,2006-02-01,199,172,199,172,371
YOCALLA,consulta externa,nuevas en personas de 60 anos o mas,2006-02-01,27,49,27,49,76
YOTALA,consulta externa,nuevas en personas de 60 anos o mas,2006-02-01,27,41,27,41,68
YUNCHARA,consulta externa,nuevas en personas de 60 anos o mas,2006-02-01,15,21,15,21,36
ZUDAÑEZ,consulta externa,nuevas en personas de 60 anos o mas,2006-02-01,34,47,34,47,81
ACACIO,consulta externa,nuevas en personas de 60 anos o mas,2006-03-01,35,45,35,45,80
ACHACACHI,consulta externa,nuevas en personas de 60 anos o mas,2006-03-01,249,269,249,269,518
ACHOCALLA,consulta externa,nuevas en personas de 60 anos o mas,2006-03-01,15,16,15,16,31
AIQUILE,consulta externa,nuevas en personas de 60 anos o mas,2006-03-01,95,121,95,121,216
ALALAY,consulta externa,nuevas en personas de 60 anos o mas,2006-03-01,2,7,2,7,9
ALCALA,consulta externa,nuevas en personas de 60 anos o mas,2006-03-01,69,113,69,113,182
ANCORAIMES,consulta externa,nuevas en personas de 60 anos o mas,2006-03-01,47,33,47,33,80
ANDAMARCA,consulta externa,nuevas en personas de 60 anos o mas,2006-03-01,29,44,29,44,73
ANTEQUERA,consulta externa,nuevas en personas de 60 anos o mas,2006-03-01,4,2,4,2,6
ANZALDO,consulta externa,nuevas en personas de 60 anos o mas,2006-03-01,23,24,23,24,47
APOLO,consulta externa,nuevas en personas de 60 anos o mas,2006-03-01,57,59,57,59,116
ARAMPAMPA,consulta externa,nuevas en personas de 60 anos o mas,2006-03-01,14,13,14,13,27
ARANI,consulta externa,nuevas en personas de 60 anos o mas,2006-03-01,16,17,16,17,33
ARBIETO,consulta externa,nuevas en personas de 60 anos o mas,2006-03-01,28,33,28,33,61
ARQUE,consulta externa,nuevas en personas de 60 anos o mas,2006-03-01,23,26,23,26,49
ASCENCION DE GUARAYOS,consulta externa,nuevas en personas de 60 anos o mas,2006-03-01,29,26,29,26,55
ATOCHA,consulta externa,nuevas en personas de 60 anos o mas,2006-03-01,92,143,92,143,235
AUCAPATA,consulta externa,nuevas en personas de 60 anos o mas,2006-03-01,26,23,26,23,49
AYATA,consulta externa,nuevas en personas de 60 anos o mas,2006-03-01,20,36,20,36,56
AYO AYO,consulta externa,nuevas en personas de 60 anos o mas,2006-03-01,12,10,12,10,22
AYOPAYA (V. DE INDEPENDENCIA),consulta externa,nuevas en personas de 60 anos o mas,2006-03-01,81,82,81,82,163
AZURDUY,consulta externa,nuevas en personas de 60 anos o mas,2006-03-01,114,134,114,134,248
BATALLAS,consulta externa,nuevas en personas de 60 anos o mas,2006-03-01,29,33,29,33,62
BAURES,consulta externa,nuevas en personas de 60 anos o mas,2006-03-01,36,33,36,33,69
BELEN DE ANDAMARCA,consulta externa,nuevas en personas de 60 anos o mas,2006-03-01,7,10,7,10,17
BELEN DE URMIRI,consulta externa,nuevas en personas de 60 anos o mas,2006-03-01,12,15,12,15,27
BELLA FLOR,consulta externa,nuevas en personas de 60 anos o mas,2006-03-01,19,10,19,10,29
BERMEJO,consulta externa,nuevas en personas de 60 anos o mas,2006-03-01,350,320,350,320,670
BETANZOS,consulta externa,nuevas en personas de 60 anos o mas,2006-03-01,147,281,147,281,428
BOLIVAR,consulta externa,nuevas en personas de 60 anos o mas,2006-03-01,71,71,71,71,142
BOLPEBRA,consulta externa,nuevas en personas de 60 anos o mas,2006-03-01,10,11,10,11,21
BOYUIBE,consulta externa,nuevas en personas de 60 anos o mas,2006-03-01,18,53,18,53,71
BUENA VISTA,consulta externa,nuevas en personas de 60 anos o mas,2006-03-01,137,87,137,87,224
CABEZAS,consulta externa,nuevas en personas de 60 anos o mas,2006-03-01,58,48,58,48,106
CAIROMA,consulta externa,nuevas en personas de 60 anos o mas,2006-03-01,50,37,50,37,87
"CAIZA ""D""",consulta externa,nuevas en personas de 60 anos o mas,2006-03-01,80,151,80,151,231
CAJUATA,consulta externa,nuevas en personas de 60 anos o mas,2006-03-01,57,46,57,46,103
CALACOTO,consulta externa,nuevas en personas de 60 anos o mas,2006-03-01,52,41,52,41,93
CALAMARCA,consulta externa,nuevas en personas de 60 anos o mas,2006-03-01,17,30,17,30,47
CAMARGO,consulta externa,nuevas en personas de 60 anos o mas,2006-03-01,230,341,230,341,571
CAMATAQUI (C. VILLA ABECIA),consulta externa,nuevas en personas de 60 anos o mas,2006-03-01,32,52,32,52,84
CAMIRI,consulta externa,nuevas en personas de 60 anos o mas,2006-03-01,628,1033,628,1033,1661
CAPINOTA,consulta externa,nuevas en personas de 60 anos o mas,2006-03-01,31,37,31,37,68
CAQUIAVIRI,consulta externa,nuevas en personas de 60 anos o mas,2006-03-01,43,64,43,64,107
CARACOLLO,consulta externa,nuevas en personas de 60 anos o mas,2006-03-01,86,69,86,69,155
CARANAVI,consulta externa,nuevas en personas de 60 anos o mas,2006-03-01,391,264,391,264,655
CARANGAS,consulta externa,nuevas en personas de 60 anos o mas,2006-03-01,0,1,0,1,1
CARAPARI,consulta externa,nuevas en personas de 60 anos o mas,2006-03-01,70,73,70,73,143
CARIPUYO,consulta externa,nuevas en personas de 60 anos o mas,2006-03-01,17,24,17,24,41
CARMEN RIVERO TORREZ,consulta externa,nuevas en personas de 60 anos o mas,2006-03-01,7,1,7,1,8
CATACORA,consulta externa,nuevas en personas de 60 anos o mas,2006-03-01,23,33,23,33,56
CHACARILLA,consulta externa,nuevas en personas de 60 anos o mas,2006-03-01,2,0,2,0,2
CHALLAPATA,consulta externa,nuevas en personas de 60 anos o mas,2006-03-01,139,152,139,152,291
CHAQUI,consulta externa,nuevas en personas de 60 anos o mas,2006-03-01,37,56,37,56,93
CHARAGUA,consulta externa,nuevas en personas de 60 anos o mas,2006-03-01,43,38,43,38,81
CHARAÑA,consulta externa,nuevas en personas de 60 anos o mas,2006-03-01,17,20,17,20,37
CHAYANTA,consulta externa,nuevas en personas de 60 anos o mas,2006-03-01,45,95,45,95,140
CHIMORE,consulta externa,nuevas en personas de 60 anos o mas,2006-03-01,24,20,24,20,44
CHIPAYA,consulta externa,nuevas en personas de 60 anos o mas,2006-03-01,2,2,2,2,4
CHOQUE COTA,consulta externa,nuevas en personas de 60 anos o mas,2006-03-01,9,15,9,15,24
CHULUMANI (V. DE LA LIBERTAD),consulta externa,nuevas en personas de 60 anos o mas,2006-03-01,58,36,58,36,94
CHUMA,consulta externa,nuevas en personas de 60 anos o mas,2006-03-01,37,65,37,65,102
CLIZA,consulta externa,nuevas en personas de 60 anos o mas,2006-03-01,11,22,11,22,33
COBIJA,consulta externa,nuevas en personas de 60 anos o mas,2006-03-01,336,363,336,363,699
COCHABAMBA,consulta externa,nuevas en personas de 60 anos o mas,2006-03-01,4031,6052,4031,6052,10083
COIPASA,consulta externa,nuevas en personas de 60 anos o mas,2006-03-01,2,1,2,1,3
COLCAPIRHUA,consulta externa,nuevas en personas de 60 anos o mas,2006-03-01,135,227,135,227,362
"COLCHA ""K""",consulta externa,nuevas en personas de 60 anos o mas,2006-03-01,87,123,87,123,210
COLLANA,consulta externa,nuevas en personas de 60 anos o mas,2006-03-01,8,14,8,14,22
COLOMI,consulta externa,nuevas en personas de 60 anos o mas,2006-03-01,19,19,19,19,38
COLPA BELGICA,consulta externa,nuevas en personas de 60 anos o mas,2006-03-01,67,59,67,59,126
COLQUECHACA,consulta externa,nuevas en personas de 60 anos o mas,2006-03-01,91,140,91,140,231
COLQUENCHA,consulta externa,nuevas en personas de 60 anos o mas,2006-03-01,31,33,31,33,64
COLQUIRI,consulta externa,nuevas en personas de 60 anos o mas,2006-03-01,66,78,66,78,144
COMANCHE,consulta externa,nuevas en personas de 60 anos o mas,2006-03-01,23,8,23,8,31
COMARAPA,consulta externa,nuevas en personas de 60 anos o mas,2006-03-01,142,169,142,169,311
COMBAYA,consulta externa,nuevas en personas de 60 anos o mas,2006-03-01,2,17,2,17,19
CONCEPCION,consulta externa,nuevas en personas de 60 anos o mas,2006-03-01,80,61,80,61,141
COPACABANA,consulta externa,nuevas en personas de 60 anos o mas,2006-03-01,64,61,64,61,125
CORIPATA,consulta externa,nuevas en personas de 60 anos o mas,2006-03-01,34,26,34,26,60
CORO CORO,consulta externa,nuevas en personas de 60 anos o mas,2006-03-01,27,27,27,27,54
COROICO,consulta externa,nuevas en personas de 60 anos o mas,2006-03-01,105,66,105,66,171
CORQUE,consulta externa,nuevas en personas de 60 anos o mas,2006-03-01,75,66,75,66,141
COTAGAITA,consulta externa,nuevas en personas de 60 anos o mas,2006-03-01,211,423,211,423,634
COTOCA,consulta externa,nuevas en personas de 60 anos o mas,2006-03-01,42,36,42,36,78
CUATRO CAÑADAS,consulta externa,nuevas en personas de 60 anos o mas,2006-03-01,61,78,61,78,139
CUCHUMUELA (V. G. VILLARROEL),consulta externa,nuevas en personas de 60 anos o mas,2006-03-01,13,13,13,13,26
CUEVO,consulta externa,nuevas en personas de 60 anos o mas,2006-03-01,24,42,24,42,66
CULPINA,consulta externa,nuevas en personas de 60 anos o mas,2006-03-01,91,165,91,165,256
CURAHUARA DE CARANGAS,consulta externa,nuevas en personas de 60 anos o mas,2006-03-01,33,31,33,31,64
CURVA,consulta externa,nuevas en personas de 60 anos o mas,2006-03-01,5,13,5,13,18
DESAGUADERO,consulta externa,nuevas en personas de 60 anos o mas,2006-03-01,19,19,19,19,38
EL ALTO,consulta externa,nuevas en personas de 60 anos o mas,2006-03-01,1331,1458,1331,1458,2789
EL CHORO,consulta externa,nuevas en personas de 60 anos o mas,2006-03-01,97,117,97,117,214
EL PUENTE(STC),consulta externa,nuevas en personas de 60 anos o mas,2006-03-01,36,35,36,35,71
EL PUENTE(TJA),consulta externa,nuevas en personas de 60 anos o mas,2006-03-01,87,148,87,148,235
EL TORNO,consulta externa,nuevas en personas de 60 anos o mas,2006-03-01,146,197,146,197,343
EL VILLAR,consulta externa,nuevas en personas de 60 anos o mas,2006-03-01,25,34,25,34,59
ENTRE RIOS,consulta externa,nuevas en personas de 60 anos o mas,2006-03-01,93,112,93,112,205
ENTRE RIOS,consulta externa,nuevas en personas de 60 anos o mas,2006-03-01,9,3,9,3,12
ESCARA,consulta externa,nuevas en personas de 60 anos o mas,2006-03-01,5,8,5,8,13
ESMERALDA,consulta externa,nuevas en personas de 60 anos o mas,2006-03-01,1,0,1,0,1
EUCALIPTUS,consulta externa,nuevas en personas de 60 anos o mas,2006-03-01,45,66,45,66,111
EXALTACION,consulta externa,nuevas en personas de 60 anos o mas,2006-03-01,1,1,1,1,2
FERNANDEZ ALONSO,consulta externa,nuevas en personas de 60 anos o mas,2006-03-01,10,10,10,10,20
FILADELFIA,consulta externa,nuevas en personas de 60 anos o mas,2006-03-01,23,20,23,20,43
GENERAL SAAVEDRA,consulta externa,nuevas en personas de 60 anos o mas,2006-03-01,25,40,25,40,65
GRAL. J.J. PEREZ (CHARAZANI),consulta externa,nuevas en personas de 60 anos o mas,2006-03-01,28,47,28,47,75
GUANAY,consulta externa,nuevas en personas de 60 anos o mas,2006-03-01,94,66,94,66,160
GUAQUI,consulta externa,nuevas en personas de 60 anos o mas,2006-03-01,13,29,13,29,42
GUAYARAMERIN,consulta externa,nuevas en personas de 60 anos o mas,2006-03-01,352,695,352,695,1047
GUTIERREZ,consulta externa,nuevas en personas de 60 anos o mas,2006-03-01,34,39,34,39,73
HUACARETA,consulta externa,nuevas en personas de 60 anos o mas,2006-03-01,47,69,47,69,116
HUACAYA (VILLA DE HUACAYA),consulta externa,nuevas en personas de 60 anos o mas,2006-03-01,6,15,6,15,21
HUACHACALLA,consulta externa,nuevas en personas de 60 anos o mas,2006-03-01,4,9,4,9,13
HUANUNI,consulta externa,nuevas en personas de 60 anos o mas,2006-03-01,114,134,114,134,248
HUARACAJE,consulta externa,nuevas en personas de 60 anos o mas,2006-03-01,9,15,9,15,24
HUAYLLAMARCA,consulta externa,nuevas en personas de 60 anos o mas,2006-03-01,52,58,52,58,110
ICHOCA,consulta externa,nuevas en personas de 60 anos o mas,2006-03-01,42,28,42,28,70
ICLA,consulta externa,nuevas en personas de 60 anos o mas,2006-03-01,42,48,42,48,90
INCAHUASI,consulta externa,nuevas en personas de 60 anos o mas,2006-03-01,61,102,61,102,163
INGAVI (HUMAITA),consulta externa,nuevas en personas de 60 anos o mas,2006-03-01,5,3,5,3,8
INQUISIVI,consulta externa,nuevas en personas de 60 anos o mas,2006-03-01,28,25,28,25,53
IRUPANA (VILLA DE LANZA),consulta externa,nuevas en personas de 60 anos o mas,2006-03-01,41,41,41,41,82
IXIAMAS,consulta externa,nuevas en personas de 60 anos o mas,2006-03-01,48,35,48,35,83
JESUS DE MACHACA,consulta externa,nuevas en personas de 60 anos o mas,2006-03-01,53,62,53,62,115
LA ASUNTA,consulta externa,nuevas en personas de 60 anos o mas,2006-03-01,17,14,17,14,31
LA GUARDIA,consulta externa,nuevas en personas de 60 anos o mas,2006-03-01,54,56,54,56,110
LA PAZ,consulta externa,nuevas en personas de 60 anos o mas,2006-03-01,8692,9707,8692,9707,18399
LA RIVERA,consulta externa,nuevas en personas de 60 anos o mas,2006-03-01,2,4,2,4,6
LAGUNILLAS,consulta externa,nuevas en personas de 60 anos o mas,2006-03-01,30,38,30,38,68
LAJA,consulta externa,nuevas en personas de 60 anos o mas,2006-03-01,25,35,25,35,60
LAS CARRERAS,consulta externa,nuevas en personas de 60 anos o mas,2006-03-01,24,41,24,41,65
LICOMA PAMPA,consulta externa,nuevas en personas de 60 anos o mas,2006-03-01,26,24,26,24,50
LLALLAGUA,consulta externa,nuevas en personas de 60 anos o mas,2006-03-01,191,264,191,264,455
LLICA,consulta externa,nuevas en personas de 60 anos o mas,2006-03-01,59,59,59,59,118
LORETO,consulta externa,nuevas en personas de 60 anos o mas,2006-03-01,8,8,8,8,16
LURIBAY,consulta externa,nuevas en personas de 60 anos o mas,2006-03-01,46,53,46,53,99
MACHACAMARCA,consulta externa,nuevas en personas de 60 anos o mas,2006-03-01,65,77,65,77,142
MACHARETI,consulta externa,nuevas en personas de 60 anos o mas,2006-03-01,47,41,47,41,88
MAGDALENA,consulta externa,nuevas en personas de 60 anos o mas,2006-03-01,32,38,32,38,70
MAIRANA,consulta externa,nuevas en personas de 60 anos o mas,2006-03-01,57,82,57,82,139
MALLA,consulta externa,nuevas en personas de 60 anos o mas,2006-03-01,10,12,10,12,22
MAPIRI,consulta externa,nuevas en personas de 60 anos o mas,2006-03-01,30,36,30,36,66
MECAPACA,consulta externa,nuevas en personas de 60 anos o mas,2006-03-01,62,37,62,37,99
MINEROS,consulta externa,nuevas en personas de 60 anos o mas,2006-03-01,10,11,10,11,21
MIZQUE,consulta externa,nuevas en personas de 60 anos o mas,2006-03-01,32,78,32,78,110
MOCOMOCO,consulta externa,nuevas en personas de 60 anos o mas,2006-03-01,91,110,91,110,201
MOJINETE,consulta externa,nuevas en personas de 60 anos o mas,2006-03-01,13,18,13,18,31
MOJOCOYA,consulta externa,nuevas en personas de 60 anos o mas,2006-03-01,31,48,31,48,79
MONTEAGUDO,consulta externa,nuevas en personas de 60 anos o mas,2006-03-01,211,338,211,338,549
MONTERO,consulta externa,nuevas en personas de 60 anos o mas,2006-03-01,475,641,475,641,1116
MORO MORO,consulta externa,nuevas en personas de 60 anos o mas,2006-03-01,41,52,41,52,93
MOROCHATA,consulta externa,nuevas en personas de 60 anos o mas,2006-03-01,22,24,22,24,46
NACEBE (SANTA ROSA DEL ABUNA),consulta externa,nuevas en personas de 60 anos o mas,2006-03-01,8,2,8,2,10
NAZACARA DE PACAJES,consulta externa,nuevas en personas de 60 anos o mas,2006-03-01,1,2,1,2,3
NUEVO MANOA (NUEVA ESPERANZA),consulta externa,nuevas en personas de 60 anos o mas,2006-03-01,11,4,11,4,15
OCURI,consulta externa,nuevas en personas de 60 anos o mas,2006-03-01,34,56,34,56,90
OKINAWA,consulta externa,nuevas en personas de 60 anos o mas,2006-03-01,72,68,72,68,140
OMEREQUE,consulta externa,nuevas en personas de 60 anos o mas,2006-03-01,13,9,13,9,22
ORURO,consulta externa,nuevas en personas de 60 anos o mas,2006-03-01,3048,2508,3048,2508,5556
PADCAYA,consulta externa,nuevas en personas de 60 anos o mas,2006-03-01,122,155,122,155,277
PADILLA,consulta externa,nuevas en personas de 60 anos o mas,2006-03-01,175,233,175,233,408
PAILON,consulta externa,nuevas en personas de 60 anos o mas,2006-03-01,20,18,20,18,38
PALCA,consulta externa,nuevas en personas de 60 anos o mas,2006-03-01,23,32,23,32,55
PALOS BLANCOS,consulta externa,nuevas en personas de 60 anos o mas,2006-03-01,74,50,74,50,124
PAMPA AULLAGAS,consulta externa,nuevas en personas de 60 anos o mas,2006-03-01,13,15,13,15,28
PAMPA GRANDE,consulta externa,nuevas en personas de 60 anos o mas,2006-03-01,49,64,49,64,113
PAPEL PAMPA,consulta externa,nuevas en personas de 60 anos o mas,2006-03-01,54,36,54,36,90
PASORAPA,consulta externa,nuevas en personas de 60 anos o mas,2006-03-01,7,11,7,11,18
PATACAMAYA,consulta externa,nuevas en personas de 60 anos o mas,2006-03-01,30,24,30,24,54
PAZÑA,consulta externa,nuevas en personas de 60 anos o mas,2006-03-01,37,57,37,57,94
PELECHUCO,consulta externa,nuevas en personas de 60 anos o mas,2006-03-01,26,16,26,16,42
POCOATA,consulta externa,nuevas en personas de 60 anos o mas,2006-03-01,78,106,78,106,184
POCONA,consulta externa,nuevas en personas de 60 anos o mas,2006-03-01,21,50,21,50,71
POJO (CBBA),consulta externa,nuevas en personas de 60 anos o mas,2006-03-01,7,13,7,13,20
POOPO,consulta externa,nuevas en personas de 60 anos o mas,2006-03-01,36,41,36,41,77
PORCO,consulta externa,nuevas en personas de 60 anos o mas,2006-03-01,6,22,6,22,28
POROMA,consulta externa,nuevas en personas de 60 anos o mas,2006-03-01,54,94,54,94,148
PORONGO,consulta externa,nuevas en personas de 60 anos o mas,2006-03-01,37,26,37,26,63
PORTACHUELO,consulta externa,nuevas en personas de 60 anos o mas,2006-03-01,146,170,146,170,316
PORVENIR,consulta externa,nuevas en personas de 60 anos o mas,2006-03-01,15,12,15,12,27
POSTRER VALLE,consulta externa,nuevas en personas de 60 anos o mas,2006-03-01,53,53,53,53,106
POTOSI,consulta externa,nuevas en personas de 60 anos o mas,2006-03-01,1964,2132,1964,2132,4096
PRESTO,consulta externa,nuevas en personas de 60 anos o mas,2006-03-01,35,63,35,63,98
PUCARA,consulta externa,nuevas en personas de 60 anos o mas,2006-03-01,15,43,15,43,58
PUCARANI,consulta externa,nuevas en personas de 60 anos o mas,2006-03-01,61,52,61,52,113
PUERTO ACOSTA,consulta externa,nuevas en personas de 60 anos o mas,2006-03-01,140,103,140,103,243
PUERTO CARABUCO,consulta externa,nuevas en personas de 60 anos o mas,2006-03-01,66,63,66,63,129
PUERTO GONZALO MORENO,consulta externa,nuevas en personas de 60 anos o mas,2006-03-01,29,15,29,15,44
PUERTO PEREZ,consulta externa,nuevas en personas de 60 anos o mas,2006-03-01,42,31,42,31,73
PUERTO QUIJARRO,consulta externa,nuevas en personas de 60 anos o mas,2006-03-01,87,73,87,73,160
PUERTO RICO,consulta externa,nuevas en personas de 60 anos o mas,2006-03-01,20,23,20,23,43
PUERTO SILES,consulta externa,nuevas en personas de 60 anos o mas,2006-03-01,2,1,2,1,3
PUERTO SUAREZ,consulta externa,nuevas en personas de 60 anos o mas,2006-03-01,104,120,104,120,224
PUERTO VILLARROEL,consulta externa,nuevas en personas de 60 anos o mas,2006-03-01,51,43,51,43,94
PUNA,consulta externa,nuevas en personas de 60 anos o mas,2006-03-01,205,286,205,286,491
PUNATA,consulta externa,nuevas en personas de 60 anos o mas,2006-03-01,141,141,141,141,282
QUIABAYA,consulta externa,nuevas en personas de 60 anos o mas,2006-03-01,11,8,11,8,19
QUILLACOLLO,consulta externa,nuevas en personas de 60 anos o mas,2006-03-01,469,645,469,645,1114
QUIME,consulta externa,nuevas en personas de 60 anos o mas,2006-03-01,34,32,34,32,66
QUIRUSILLAS,consulta externa,nuevas en personas de 60 anos o mas,2006-03-01,9,14,9,14,23
RAVELO,consulta externa,nuevas en personas de 60 anos o mas,2006-03-01,110,75,110,75,185
REYES,consulta externa,nuevas en personas de 60 anos o mas,2006-03-01,94,110,94,110,204
RIBERALTA,consulta externa,nuevas en personas de 60 anos o mas,2006-03-01,138,115,138,115,253
ROBORE,consulta externa,nuevas en personas de 60 anos o mas,2006-03-01,54,84,54,84,138
RURRENABAQUE,consulta externa,nuevas en personas de 60 anos o mas,2006-03-01,110,109,110,109,219
SABAYA,consulta externa,nuevas en personas de 60 anos o mas,2006-03-01,36,31,36,31,67
SACABA,consulta externa,nuevas en personas de 60 anos o mas,2006-03-01,183,332,183,332,515
SACABAMBA,consulta externa,nuevas en personas de 60 anos o mas,2006-03-01,7,14,7,14,21
SACACA,consulta externa,nuevas en personas de 60 anos o mas,2006-03-01,25,71,25,71,96
SAIPINA,consulta externa,nuevas en personas de 60 anos o mas,2006-03-01,34,30,34,30,64
SALINAS DE GARCI MENDOZA,consulta externa,nuevas en personas de 60 anos o mas,2006-03-01,62,61,62,61,123
SAMAIPATA,consulta externa,nuevas en personas de 60 anos o mas,2006-03-01,65,61,65,61,126
SAN AGUSTIN,consulta externa,nuevas en personas de 60 anos o mas,2006-03-01,15,8,15,8,23
SAN ANDRES,consulta externa,nuevas en personas de 60 anos o mas,2006-03-01,24,21,24,21,45
SAN ANDRES DE MACHACA,consulta externa,nuevas en personas de 60 anos o mas,2006-03-01,48,51,48,51,99
SAN ANTONIO DE ESMORUCO,consulta externa,nuevas en personas de 60 anos o mas,2006-03-01,17,13,17,13,30
SAN ANTONIO DE LOMERIO,consulta externa,nuevas en personas de 60 anos o mas,2006-03-01,15,18,15,18,33
SAN BENITO,consulta externa,nuevas en personas de 60 anos o mas,2006-03-01,20,18,20,18,38
SAN BORJA,consulta externa,nuevas en personas de 60 anos o mas,2006-03-01,90,94,90,94,184
SAN BUENA VENTURA,consulta externa,nuevas en personas de 60 anos o mas,2006-03-01,51,103,51,103,154
SAN CARLOS,consulta externa,nuevas en personas de 60 anos o mas,2006-03-01,89,118,89,118,207
SAN IGNACIO,consulta externa,nuevas en personas de 60 anos o mas,2006-03-01,106,120,106,120,226
SAN IGNACIO DE VELASCO,consulta externa,nuevas en personas de 60 anos o mas,2006-03-01,265,332,265,332,597
SAN JAVIER(BNI),consulta externa,nuevas en personas de 60 anos o mas,2006-03-01,3,4,3,4,7
SAN JAVIER(STC),consulta externa,nuevas en personas de 60 anos o mas,2006-03-01,54,41,54,41,95
SAN JOAQUIN,consulta externa,nuevas en personas de 60 anos o mas,2006-03-01,60,66,60,66,126
SAN JOSE DE CHIQUITOS,consulta externa,nuevas en personas de 60 anos o mas,2006-03-01,88,106,88,106,194
SAN JUAN DE YAPACANI,consulta externa,nuevas en personas de 60 anos o mas,2006-03-01,57,67,57,67,124
SAN JULIAN,consulta externa,nuevas en personas de 60 anos o mas,2006-03-01,235,210,235,210,445
SAN LORENZO(PND),consulta externa,nuevas en personas de 60 anos o mas,2006-03-01,45,34,45,34,79
SAN LORENZO(TJA),consulta externa,nuevas en personas de 60 anos o mas,2006-03-01,94,142,94,142,236
SAN LUCAS,consulta externa,nuevas en personas de 60 anos o mas,2006-03-01,203,356,203,356,559
SAN MATIAS,consulta externa,nuevas en personas de 60 anos o mas,2006-03-01,15,13,15,13,28
SAN MIGUEL DE VELASCO,consulta externa,nuevas en personas de 60 anos o mas,2006-03-01,38,56,38,56,94
SAN PABLO DE LIPEZ,consulta externa,nuevas en personas de 60 anos o mas,2006-03-01,25,30,25,30,55
SAN PEDRO,consulta externa,nuevas en personas de 60 anos o mas,2006-03-01,41,43,41,43,84
SAN PEDRO DE BUENA VISTA,consulta externa,nuevas en personas de 60 anos o mas,2006-03-01,35,65,35,65,100
SAN PEDRO DE CURAHUARA,consulta externa,nuevas en personas de 60 anos o mas,2006-03-01,77,69,77,69,146
SAN PEDRO DE TIQUINA,consulta externa,nuevas en personas de 60 anos o mas,2006-03-01,26,11,26,11,37
SAN PEDRO(PND),consulta externa,nuevas en personas de 60 anos o mas,2006-03-01,0,1,0,1,1
SAN RAFAEL,consulta externa,nuevas en personas de 60 anos o mas,2006-03-01,9,7,9,7,16
SAN RAMON,consulta externa,nuevas en personas de 60 anos o mas,2006-03-01,46,85,46,85,131
SAN RAMON,consulta externa,nuevas en personas de 60 anos o mas,2006-03-01,17,18,17,18,35
SANTA ANA,consulta externa,nuevas en personas de 60 anos o mas,2006-03-01,119,143,119,143,262
SANTA CRUZ DE LA SIERRA,consulta externa,nuevas en personas de 60 anos o mas,2006-03-01,6397,9083,6397,9083,15480
SANTA ROSA,consulta externa,nuevas en personas de 60 anos o mas,2006-03-01,53,61,53,61,114
SANTA ROSA DEL SARA,consulta externa,nuevas en personas de 60 anos o mas,2006-03-01,54,46,54,46,100
SANTIAGO DE CALLAPA,consulta externa,nuevas en personas de 60 anos o mas,2006-03-01,21,18,21,18,39
SANTIAGO DE HUARI,consulta externa,nuevas en personas de 60 anos o mas,2006-03-01,119,118,119,118,237
SANTIAGO DE MACHACA,consulta externa,nuevas en personas de 60 anos o mas,2006-03-01,11,14,11,14,25
SANTIVAÑES,consulta externa,nuevas en personas de 60 anos o mas,2006-03-01,25,51,25,51,76
SANTUARIO DE QUILLACAS,consulta externa,nuevas en personas de 60 anos o mas,2006-03-01,24,50,24,50,74
SAPAHAQUI,consulta externa,nuevas en personas de 60 anos o mas,2006-03-01,49,43,49,43,92
SENA,consulta externa,nuevas en personas de 60 anos o mas,2006-03-01,18,8,18,8,26
SICA SICA (VILLA AROMA),consulta externa,nuevas en personas de 60 anos o mas,2006-03-01,37,49,37,49,86
SICAYA,consulta externa,nuevas en personas de 60 anos o mas,2006-03-01,4,6,4,6,10
SIPE SIPE,consulta externa,nuevas en personas de 60 anos o mas,2006-03-01,32,53,32,53,85
SOPACHUY,consulta externa,nuevas en personas de 60 anos o mas,2006-03-01,48,71,48,71,119
SORACACHI,consulta externa,nuevas en personas de 60 anos o mas,2006-03-01,15,16,15,16,31
SORATA,consulta externa,nuevas en personas de 60 anos o mas,2006-03-01,58,67,58,67,125
SUCRE,consulta externa,nuevas en personas de 60 anos o mas,2006-03-01,2548,3332,2548,3332,5880
TACACHI,consulta externa,nuevas en personas de 60 anos o mas,2006-03-01,1,5,1,5,6
TACACOMA,consulta externa,nuevas en personas de 60 anos o mas,2006-03-01,18,15,18,15,33
TACOBAMBA,consulta externa,nuevas en personas de 60 anos o mas,2006-03-01,32,77,32,77,109
TACOPAYA,consulta externa,nuevas en personas de 60 anos o mas,2006-03-01,30,42,30,42,72
TAHUA,consulta externa,nuevas en personas de 60 anos o mas,2006-03-01,27,30,27,30,57
TAPACARI,consulta externa,nuevas en personas de 60 anos o mas,2006-03-01,72,100,72,100,172
TARABUCO,consulta externa,nuevas en personas de 60 anos o mas,2006-03-01,76,210,76,210,286
TARACO,consulta externa,nuevas en personas de 60 anos o mas,2006-03-01,14,15,14,15,29
TARATA,consulta externa,nuevas en personas de 60 anos o mas,2006-03-01,11,18,11,18,29
TARIJA,consulta externa,nuevas en personas de 60 anos o mas,2006-03-01,2067,2290,2067,2290,4357
TARVITA,consulta externa,nuevas en personas de 60 anos o mas,2006-03-01,83,127,83,127,210
TEOPONTE,consulta externa,nuevas en personas de 60 anos o mas,2006-03-01,97,60,97,60,157
TIAWANACU,consulta externa,nuevas en personas de 60 anos o mas,2006-03-01,30,40,30,40,70
TINGUIPAYA,consulta externa,nuevas en personas de 60 anos o mas,2006-03-01,48,96,48,96,144
TIPUANI,consulta externa,nuevas en personas de 60 anos o mas,2006-03-01,11,7,11,7,18
TIQUIPAYA,consulta externa,nuevas en personas de 60 anos o mas,2006-03-01,15,24,15,24,39
TIRAQUE (CBBA),consulta externa,nuevas en personas de 60 anos o mas,2006-03-01,42,38,42,38,80
TITO YUPANQUI (PARQUIPUJIO),consulta externa,nuevas en personas de 60 anos o mas,2006-03-01,12,9,12,9,21
TOCO,consulta externa,nuevas en personas de 60 anos o mas,2006-03-01,5,16,5,16,21
TODOS SANTOS,consulta externa,nuevas en personas de 60 anos o mas,2006-03-01,1,1,1,1,2
TOLATA,consulta externa,nuevas en personas de 60 anos o mas,2006-03-01,5,17,5,17,22
TOLEDO,consulta externa,nuevas en personas de 60 anos o mas,2006-03-01,27,33,27,33,60
TOMAVE,consulta externa,nuevas en personas de 60 anos o mas,2006-03-01,57,116,57,116,173
TOMINA,consulta externa,nuevas en personas de 60 anos o mas,2006-03-01,59,86,59,86,145
TORO TORO,consulta externa,nuevas en personas de 60 anos o mas,2006-03-01,35,51,35,51,86
TOTORA(CBBA),consulta externa,nuevas en personas de 60 anos o mas,2006-03-01,23,23,23,23,46
TOTORA(ORR),consulta externa,nuevas en personas de 60 anos o mas,2006-03-01,14,16,14,16,30
TRIGAL,consulta externa,nuevas en personas de 60 anos o mas,2006-03-01,49,64,49,64,113
TRINIDAD,consulta externa,nuevas en personas de 60 anos o mas,2006-03-01,522,573,522,573,1095
TUPIZA,consulta externa,nuevas en personas de 60 anos o mas,2006-03-01,423,710,423,710,1133
TURCO,consulta externa,nuevas en personas de 60 anos o mas,2006-03-01,34,49,34,49,83
UMALA,consulta externa,nuevas en personas de 60 anos o mas,2006-03-01,11,11,11,11,22
UNCIA,consulta externa,nuevas en personas de 60 anos o mas,2006-03-01,140,183,140,183,323
URIONDO (A. CONCEPCION),consulta externa,nuevas en personas de 60 anos o mas,2006-03-01,57,86,57,86,143
URUBICHA,consulta externa,nuevas en personas de 60 anos o mas,2006-03-01,6,7,6,7,13
UYUNI,consulta externa,nuevas en personas de 60 anos o mas,2006-03-01,205,292,205,292,497
VACAS,consulta externa,nuevas en personas de 60 anos o mas,2006-03-01,19,44,19,44,63
VALLEGRANDE,consulta externa,nuevas en personas de 60 anos o mas,2006-03-01,214,263,214,263,477
VIACHA,consulta externa,nuevas en personas de 60 anos o mas,2006-03-01,448,338,448,338,786
VILA VILA,consulta externa,nuevas en personas de 60 anos o mas,2006-03-01,18,11,18,11,29
VILLA MONTES,consulta externa,nuevas en personas de 60 anos o mas,2006-03-01,96,101,96,101,197
VILLA NUEVA (LOMA ALTA),consulta externa,nuevas en personas de 60 anos o mas,2006-03-01,6,6,6,6,12
VILLA RIVERO,consulta externa,nuevas en personas de 60 anos o mas,2006-03-01,18,21,18,21,39
VILLA SERRANO,consulta externa,nuevas en personas de 60 anos o mas,2006-03-01,67,166,67,166,233
VILLA TUNARI,consulta externa,nuevas en personas de 60 anos o mas,2006-03-01,137,108,137,108,245
VILLA VACA GUZMAN (MUYUPAMPA),consulta externa,nuevas en personas de 60 anos o mas,2006-03-01,65,72,65,72,137
VILLAZON,consulta externa,nuevas en personas de 60 anos o mas,2006-03-01,364,436,364,436,800
VINTO,consulta externa,nuevas en personas de 60 anos o mas,2006-03-01,10,51,10,51,61
VITICHI,consulta externa,nuevas en personas de 60 anos o mas,2006-03-01,54,108,54,108,162
WALDO BALLIVIAN,consulta externa,nuevas en personas de 60 anos o mas,2006-03-01,0,4,0,4,4
WARNES,consulta externa,nuevas en personas de 60 anos o mas,2006-03-01,68,44,68,44,112
YACO,consulta externa,nuevas en personas de 60 anos o mas,2006-03-01,26,17,26,17,43
YACUIBA,consulta externa,nuevas en personas de 60 anos o mas,2006-03-01,620,812,620,812,1432
YAMPARAEZ,consulta externa,nuevas en personas de 60 anos o mas,2006-03-01,48,40,48,40,88
YANACACHI,consulta externa,nuevas en personas de 60 anos o mas,2006-03-01,36,28,36,28,64
YAPACANI,consulta externa,nuevas en personas de 60 anos o mas,2006-03-01,194,210,194,210,404
YOCALLA,consulta externa,nuevas en personas de 60 anos o mas,2006-03-01,34,68,34,68,102
YOTALA,consulta externa,nuevas en personas de 60 anos o mas,2006-03-01,26,62,26,62,88
YUNCHARA,consulta externa,nuevas en personas de 60 anos o mas,2006-03-01,22,37,22,37,59
ZUDAÑEZ,consulta externa,nuevas en personas de 60 anos o mas,2006-03-01,55,118,55,118,173
ACACIO,consulta externa,nuevas en personas de 60 anos o mas,2006-04-01,42,31,42,31,73
ACHACACHI,consulta externa,nuevas en personas de 60 anos o mas,2006-04-01,142,171,142,171,313
ACHOCALLA,consulta externa,nuevas en personas de 60 anos o mas,2006-04-01,10,10,10,10,20
AIQUILE,consulta externa,nuevas en personas de 60 anos o mas,2006-04-01,66,91,66,91,157
ALALAY,consulta externa,nuevas en personas de 60 anos o mas,2006-04-01,8,9,8,9,17
ALCALA,consulta externa,nuevas en personas de 60 anos o mas,2006-04-01,32,40,32,40,72
ANCORAIMES,consulta externa,nuevas en personas de 60 anos o mas,2006-04-01,28,32,28,32,60
ANDAMARCA,consulta externa,nuevas en personas de 60 anos o mas,2006-04-01,29,57,29,57,86
ANTEQUERA,consulta externa,nuevas en personas de 60 anos o mas,2006-04-01,3,5,3,5,8
ANZALDO,consulta externa,nuevas en personas de 60 anos o mas,2006-04-01,8,26,8,26,34
APOLO,consulta externa,nuevas en personas de 60 anos o mas,2006-04-01,25,36,25,36,61
ARAMPAMPA,consulta externa,nuevas en personas de 60 anos o mas,2006-04-01,7,18,7,18,25
ARANI,consulta externa,nuevas en personas de 60 anos o mas,2006-04-01,21,19,21,19,40
ARBIETO,consulta externa,nuevas en personas de 60 anos o mas,2006-04-01,21,26,21,26,47
ARQUE,consulta externa,nuevas en personas de 60 anos o mas,2006-04-01,23,41,23,41,64
ASCENCION DE GUARAYOS,consulta externa,nuevas en personas de 60 anos o mas,2006-04-01,29,17,29,17,46
ATOCHA,consulta externa,nuevas en personas de 60 anos o mas,2006-04-01,84,116,84,116,200
AUCAPATA,consulta externa,nuevas en personas de 60 anos o mas,2006-04-01,25,30,25,30,55
AYATA,consulta externa,nuevas en personas de 60 anos o mas,2006-04-01,18,19,18,19,37
AYO AYO,consulta externa,nuevas en personas de 60 anos o mas,2006-04-01,13,11,13,11,24
AYOPAYA (V. DE INDEPENDENCIA),consulta externa,nuevas en personas de 60 anos o mas,2006-04-01,60,69,60,69,129
AZURDUY,consulta externa,nuevas en personas de 60 anos o mas,2006-04-01,72,81,72,81,153
BATALLAS,consulta externa,nuevas en personas de 60 anos o mas,2006-04-01,31,38,31,38,69
BAURES,consulta externa,nuevas en personas de 60 anos o mas,2006-04-01,42,41,42,41,83
BELEN DE ANDAMARCA,consulta externa,nuevas en personas de 60 anos o mas,2006-04-01,15,6,15,6,21
BELEN DE URMIRI,consulta externa,nuevas en personas de 60 anos o mas,2006-04-01,22,21,22,21,43
BELLA FLOR,consulta externa,nuevas en personas de 60 anos o mas,2006-04-01,16,14,16,14,30
BERMEJO,consulta externa,nuevas en personas de 60 anos o mas,2006-04-01,271,298,271,298,569
BETANZOS,consulta externa,nuevas en personas de 60 anos o mas,2006-04-01,124,259,124,259,383
BOLIVAR,consulta externa,nuevas en personas de 60 anos o mas,2006-04-01,18,28,18,28,46
BOLPEBRA,consulta externa,nuevas en personas de 60 anos o mas,2006-04-01,5,3,5,3,8
BOYUIBE,consulta externa,nuevas en personas de 60 anos o mas,2006-04-01,31,48,31,48,79
BUENA VISTA,consulta externa,nuevas en personas de 60 anos o mas,2006-04-01,120,105,120,105,225
CABEZAS,consulta externa,nuevas en personas de 60 anos o mas,2006-04-01,30,26,30,26,56
CAIROMA,consulta externa,nuevas en personas de 60 anos o mas,2006-04-01,38,31,38,31,69
"CAIZA ""D""",consulta externa,nuevas en personas de 60 anos o mas,2006-04-01,91,143,91,143,234
CAJUATA,consulta externa,nuevas en personas de 60 anos o mas,2006-04-01,44,41,44,41,85
CALACOTO,consulta externa,nuevas en personas de 60 anos o mas,2006-04-01,52,43,52,43,95
CALAMARCA,consulta externa,nuevas en personas de 60 anos o mas,2006-04-01,14,25,14,25,39
CAMARGO,consulta externa,nuevas en personas de 60 anos o mas,2006-04-01,135,209,135,209,344
CAMATAQUI (C. VILLA ABECIA),consulta externa,nuevas en personas de 60 anos o mas,2006-04-01,30,53,30,53,83
CAMIRI,consulta externa,nuevas en personas de 60 anos o mas,2006-04-01,632,1105,632,1105,1737
CAPINOTA,consulta externa,nuevas en personas de 60 anos o mas,2006-04-01,52,73,52,73,125
CAQUIAVIRI,consulta externa,nuevas en personas de 60 anos o mas,2006-04-01,38,39,38,39,77
CARACOLLO,consulta externa,nuevas en personas de 60 anos o mas,2006-04-01,104,91,104,91,195
CARANAVI,consulta externa,nuevas en personas de 60 anos o mas,2006-04-01,243,145,243,145,388
CARANGAS,consulta externa,nuevas en personas de 60 anos o mas,2006-04-01,2,0,2,0,2
CARAPARI,consulta externa,nuevas en personas de 60 anos o mas,2006-04-01,87,85,87,85,172
CARIPUYO,consulta externa,nuevas en personas de 60 anos o mas,2006-04-01,13,20,13,20,33
CARMEN RIVERO TORREZ,consulta externa,nuevas en personas de 60 anos o mas,2006-04-01,12,10,12,10,22
CATACORA,consulta externa,nuevas en personas de 60 anos o mas,2006-04-01,17,15,17,15,32
CHACARILLA,consulta externa,nuevas en personas de 60 anos o mas,2006-04-01,8,3,8,3,11
CHALLAPATA,consulta externa,nuevas en personas de 60 anos o mas,2006-04-01,143,146,143,146,289
CHAQUI,consulta externa,nuevas en personas de 60 anos o mas,2006-04-01,25,34,25,34,59
CHARAGUA,consulta externa,nuevas en personas de 60 anos o mas,2006-04-01,23,43,23,43,66
CHARAÑA,consulta externa,nuevas en personas de 60 anos o mas,2006-04-01,23,18,23,18,41
CHAYANTA,consulta externa,nuevas en personas de 60 anos o mas,2006-04-01,44,106,44,106,150
CHIMORE,consulta externa,nuevas en personas de 60 anos o mas,2006-04-01,20,21,20,21,41
CHIPAYA,consulta externa,nuevas en personas de 60 anos o mas,2006-04-01,21,22,21,22,43
CHOQUE COTA,consulta externa,nuevas en personas de 60 anos o mas,2006-04-01,11,18,11,18,29
CHULUMANI (V. DE LA LIBERTAD),consulta externa,nuevas en personas de 60 anos o mas,2006-04-01,58,38,58,38,96
CHUMA,consulta externa,nuevas en personas de 60 anos o mas,2006-04-01,33,37,33,37,70
CLIZA,consulta externa,nuevas en personas de 60 anos o mas,2006-04-01,12,10,12,10,22
COBIJA,consulta externa,nuevas en personas de 60 anos o mas,2006-04-01,175,106,175,106,281
COCHABAMBA,consulta externa,nuevas en personas de 60 anos o mas,2006-04-01,3380,4896,3380,4896,8276
COIPASA,consulta externa,nuevas en personas de 60 anos o mas,2006-04-01,1,0,1,0,1
COLCAPIRHUA,consulta externa,nuevas en personas de 60 anos o mas,2006-04-01,87,159,87,159,246
"COLCHA ""K""",consulta externa,nuevas en personas de 60 anos o mas,2006-04-01,68,67,68,67,135
COLLANA,consulta externa,nuevas en personas de 60 anos o mas,2006-04-01,6,9,6,9,15
COLOMI,consulta externa,nuevas en personas de 60 anos o mas,2006-04-01,12,10,12,10,22
COLPA BELGICA,consulta externa,nuevas en personas de 60 anos o mas,2006-04-01,71,47,71,47,118
COLQUECHACA,consulta externa,nuevas en personas de 60 anos o mas,2006-04-01,68,114,68,114,182
COLQUENCHA,consulta externa,nuevas en personas de 60 anos o mas,2006-04-01,28,28,28,28,56
COLQUIRI,consulta externa,nuevas en personas de 60 anos o mas,2006-04-01,69,20,69,20,89
COMANCHE,consulta externa,nuevas en personas de 60 anos o mas,2006-04-01,7,9,7,9,16
COMARAPA,consulta externa,nuevas en personas de 60 anos o mas,2006-04-01,79,117,79,117,196
COMBAYA,consulta externa,nuevas en personas de 60 anos o mas,2006-04-01,10,15,10,15,25
CONCEPCION,consulta externa,nuevas en personas de 60 anos o mas,2006-04-01,89,83,89,83,172
COPACABANA,consulta externa,nuevas en personas de 60 anos o mas,2006-04-01,96,85,96,85,181
CORIPATA,consulta externa,nuevas en personas de 60 anos o mas,2006-04-01,42,14,42,14,56
CORO CORO,consulta externa,nuevas en personas de 60 anos o mas,2006-04-01,13,11,13,11,24
COROICO,consulta externa,nuevas en personas de 60 anos o mas,2006-04-01,123,87,123,87,210
CORQUE,consulta externa,nuevas en personas de 60 anos o mas,2006-04-01,69,60,69,60,129
COTAGAITA,consulta externa,nuevas en personas de 60 anos o mas,2006-04-01,176,330,176,330,506
COTOCA,consulta externa,nuevas en personas de 60 anos o mas,2006-04-01,143,179,143,179,322
CUATRO CAÑADAS,consulta externa,nuevas en personas de 60 anos o mas,2006-04-01,44,43,44,43,87
CUCHUMUELA (V. G. VILLARROEL),consulta externa,nuevas en personas de 60 anos o mas,2006-04-01,8,13,8,13,21
CUEVO,consulta externa,nuevas en personas de 60 anos o mas,2006-04-01,20,28,20,28,48
CULPINA,consulta externa,nuevas en personas de 60 anos o mas,2006-04-01,62,69,62,69,131
CURAHUARA DE CARANGAS,consulta externa,nuevas en personas de 60 anos o mas,2006-04-01,50,49,50,49,99
CURVA,consulta externa,nuevas en personas de 60 anos o mas,2006-04-01,9,12,9,12,21
DESAGUADERO,consulta externa,nuevas en personas de 60 anos o mas,2006-04-01,17,12,17,12,29
EL ALTO,consulta externa,nuevas en personas de 60 anos o mas,2006-04-01,1267,1328,1267,1328,2595
EL CHORO,consulta externa,nuevas en personas de 60 anos o mas,2006-04-01,69,82,69,82,151
EL PUENTE(STC),consulta externa,nuevas en personas de 60 anos o mas,2006-04-01,19,23,19,23,42
EL PUENTE(TJA),consulta externa,nuevas en personas de 60 anos o mas,2006-04-01,56,81,56,81,137
EL TORNO,consulta externa,nuevas en personas de 60 anos o mas,2006-04-01,225,210,225,210,435
EL VILLAR,consulta externa,nuevas en personas de 60 anos o mas,2006-04-01,20,47,20,47,67
ENTRE RIOS,consulta externa,nuevas en personas de 60 anos o mas,2006-04-01,70,84,70,84,154
ENTRE RIOS,consulta externa,nuevas en personas de 60 anos o mas,2006-04-01,15,17,15,17,32
ESCARA,consulta externa,nuevas en personas de 60 anos o mas,2006-04-01,3,2,3,2,5
ESMERALDA,consulta externa,nuevas en personas de 60 anos o mas,2006-04-01,4,5,4,5,9
EUCALIPTUS,consulta externa,nuevas en personas de 60 anos o mas,2006-04-01,24,65,24,65,89
EUREKA (SANTOS MERCADO),consulta externa,nuevas en personas de 60 anos o mas,2006-04-01,2,0,2,0,2
EXALTACION,consulta externa,nuevas en personas de 60 anos o mas,2006-04-01,5,5,5,5,10
FERNANDEZ ALONSO,consulta externa,nuevas en personas de 60 anos o mas,2006-04-01,15,10,15,10,25
FILADELFIA,consulta externa,nuevas en personas de 60 anos o mas,2006-04-01,14,16,14,16,30
GENERAL SAAVEDRA,consulta externa,nuevas en personas de 60 anos o mas,2006-04-01,38,31,38,31,69
GRAL. J.J. PEREZ (CHARAZANI),consulta externa,nuevas en personas de 60 anos o mas,2006-04-01,25,31,25,31,56
GUANAY,consulta externa,nuevas en personas de 60 anos o mas,2006-04-01,48,54,48,54,102
GUAQUI,consulta externa,nuevas en personas de 60 anos o mas,2006-04-01,16,22,16,22,38
GUAYARAMERIN,consulta externa,nuevas en personas de 60 anos o mas,2006-04-01,301,299,301,299,600
GUTIERREZ,consulta externa,nuevas en personas de 60 anos o mas,2006-04-01,35,49,35,49,84
HUACARETA,consulta externa,nuevas en personas de 60 anos o mas,2006-04-01,57,67,57,67,124
HUACAYA (VILLA DE HUACAYA),consulta externa,nuevas en personas de 60 anos o mas,2006-04-01,4,23,4,23,27
HUACHACALLA,consulta externa,nuevas en personas de 60 anos o mas,2006-04-01,8,6,8,6,14
HUANUNI,consulta externa,nuevas en personas de 60 anos o mas,2006-04-01,119,150,119,150,269
HUARACAJE,consulta externa,nuevas en personas de 60 anos o mas,2006-04-01,12,6,12,6,18
HUAYLLAMARCA,consulta externa,nuevas en personas de 60 anos o mas,2006-04-01,31,24,31,24,55
ICHOCA,consulta externa,nuevas en personas de 60 anos o mas,2006-04-01,11,17,11,17,28
ICLA,consulta externa,nuevas en personas de 60 anos o mas,2006-04-01,28,70,28,70,98
INCAHUASI,consulta externa,nuevas en personas de 60 anos o mas,2006-04-01,44,111,44,111,155
INGAVI (HUMAITA),consulta externa,nuevas en personas de 60 anos o mas,2006-04-01,4,3,4,3,7
INQUISIVI,consulta externa,nuevas en personas de 60 anos o mas,2006-04-01,52,28,52,28,80
IRUPANA (VILLA DE LANZA),consulta externa,nuevas en personas de 60 anos o mas,2006-04-01,55,56,55,56,111
IXIAMAS,consulta externa,nuevas en personas de 60 anos o mas,2006-04-01,13,10,13,10,23
JESUS DE MACHACA,consulta externa,nuevas en personas de 60 anos o mas,2006-04-01,65,73,65,73,138
LA ASUNTA,consulta externa,nuevas en personas de 60 anos o mas,2006-04-01,13,19,13,19,32
LA GUARDIA,consulta externa,nuevas en personas de 60 anos o mas,2006-04-01,46,39,46,39,85
LA PAZ,consulta externa,nuevas en personas de 60 anos o mas,2006-04-01,8017,8725,8017,8725,16742
LA RIVERA,consulta externa,nuevas en personas de 60 anos o mas,2006-04-01,1,3,1,3,4
LAGUNILLAS,consulta externa,nuevas en personas de 60 anos o mas,2006-04-01,22,43,22,43,65
LAJA,consulta externa,nuevas en personas de 60 anos o mas,2006-04-01,17,29,17,29,46
LAS CARRERAS,consulta externa,nuevas en personas de 60 anos o mas,2006-04-01,25,38,25,38,63
LICOMA PAMPA,consulta externa,nuevas en personas de 60 anos o mas,2006-04-01,30,14,30,14,44
LLALLAGUA,consulta externa,nuevas en personas de 60 anos o mas,2006-04-01,186,227,186,227,413
LLICA,consulta externa,nuevas en personas de 60 anos o mas,2006-04-01,38,46,38,46,84
LORETO,consulta externa,nuevas en personas de 60 anos o mas,2006-04-01,19,13,19,13,32
LURIBAY,consulta externa,nuevas en personas de 60 anos o mas,2006-04-01,40,44,40,44,84
MACHACAMARCA,consulta externa,nuevas en personas de 60 anos o mas,2006-04-01,47,50,47,50,97
MACHARETI,consulta externa,nuevas en personas de 60 anos o mas,2006-04-01,45,41,45,41,86
MAGDALENA,consulta externa,nuevas en personas de 60 anos o mas,2006-04-01,35,20,35,20,55
MAIRANA,consulta externa,nuevas en personas de 60 anos o mas,2006-04-01,28,63,28,63,91
MALLA,consulta externa,nuevas en personas de 60 anos o mas,2006-04-01,7,7,7,7,14
MAPIRI,consulta externa,nuevas en personas de 60 anos o mas,2006-04-01,38,36,38,36,74
MECAPACA,consulta externa,nuevas en personas de 60 anos o mas,2006-04-01,32,30,32,30,62
MINEROS,consulta externa,nuevas en personas de 60 anos o mas,2006-04-01,18,9,18,9,27
MIZQUE,consulta externa,nuevas en personas de 60 anos o mas,2006-04-01,28,39,28,39,67
MOCOMOCO,consulta externa,nuevas en personas de 60 anos o mas,2006-04-01,76,73,76,73,149
MOJINETE,consulta externa,nuevas en personas de 60 anos o mas,2006-04-01,6,16,6,16,22
MOJOCOYA,consulta externa,nuevas en personas de 60 anos o mas,2006-04-01,44,47,44,47,91
MONTEAGUDO,consulta externa,nuevas en personas de 60 anos o mas,2006-04-01,173,250,173,250,423
MONTERO,consulta externa,nuevas en personas de 60 anos o mas,2006-04-01,339,362,339,362,701
MORO MORO,consulta externa,nuevas en personas de 60 anos o mas,2006-04-01,25,26,25,26,51
MOROCHATA,consulta externa,nuevas en personas de 60 anos o mas,2006-04-01,33,24,33,24,57
NACEBE (SANTA ROSA DEL ABUNA),consulta externa,nuevas en personas de 60 anos o mas,2006-04-01,6,3,6,3,9
NAZACARA DE PACAJES,consulta externa,nuevas en personas de 60 anos o mas,2006-04-01,6,4,6,4,10
NUEVO MANOA (NUEVA ESPERANZA),consulta externa,nuevas en personas de 60 anos o mas,2006-04-01,1,3,1,3,4
OCURI,consulta externa,nuevas en personas de 60 anos o mas,2006-04-01,28,44,28,44,72
OKINAWA,consulta externa,nuevas en personas de 60 anos o mas,2006-04-01,30,49,30,49,79
OMEREQUE,consulta externa,nuevas en personas de 60 anos o mas,2006-04-01,47,70,47,70,117
ORURO,consulta externa,nuevas en personas de 60 anos o mas,2006-04-01,2512,2838,2512,2838,5350
PADCAYA,consulta externa,nuevas en personas de 60 anos o mas,2006-04-01,93,170,93,170,263
PADILLA,consulta externa,nuevas en personas de 60 anos o mas,2006-04-01,135,249,135,249,384
PAILON,consulta externa,nuevas en personas de 60 anos o mas,2006-04-01,5,15,5,15,20
PALCA,consulta externa,nuevas en personas de 60 anos o mas,2006-04-01,24,17,24,17,41
PALOS BLANCOS,consulta externa,nuevas en personas de 60 anos o mas,2006-04-01,31,29,31,29,60
PAMPA AULLAGAS,consulta externa,nuevas en personas de 60 anos o mas,2006-04-01,2,10,2,10,12
PAMPA GRANDE,consulta externa,nuevas en personas de 60 anos o mas,2006-04-01,32,32,32,32,64
PAPEL PAMPA,consulta externa,nuevas en personas de 60 anos o mas,2006-04-01,53,47,53,47,100
PASORAPA,consulta externa,nuevas en personas de 60 anos o mas,2006-04-01,9,10,9,10,19
PATACAMAYA,consulta externa,nuevas en personas de 60 anos o mas,2006-04-01,45,23,45,23,68
PAZÑA,consulta externa,nuevas en personas de 60 anos o mas,2006-04-01,38,36,38,36,74
PELECHUCO,consulta externa,nuevas en personas de 60 anos o mas,2006-04-01,9,18,9,18,27
POCOATA,consulta externa,nuevas en personas de 60 anos o mas,2006-04-01,66,62,66,62,128
POCONA,consulta externa,nuevas en personas de 60 anos o mas,2006-04-01,21,51,21,51,72
POJO (CBBA),consulta externa,nuevas en personas de 60 anos o mas,2006-04-01,6,11,6,11,17
POOPO,consulta externa,nuevas en personas de 60 anos o mas,2006-04-01,44,78,44,78,122
PORCO,consulta externa,nuevas en personas de 60 anos o mas,2006-04-01,4,9,4,9,13
POROMA,consulta externa,nuevas en personas de 60 anos o mas,2006-04-01,48,58,48,58,106
PORONGO,consulta externa,nuevas en personas de 60 anos o mas,2006-04-01,25,17,25,17,42
PORTACHUELO,consulta externa,nuevas en personas de 60 anos o mas,2006-04-01,131,140,131,140,271
PORVENIR,consulta externa,nuevas en personas de 60 anos o mas,2006-04-01,13,5,13,5,18
POSTRER VALLE,consulta externa,nuevas en personas de 60 anos o mas,2006-04-01,27,23,27,23,50
POTOSI,consulta externa,nuevas en personas de 60 anos o mas,2006-04-01,1184,1718,1184,1718,2902
PRESTO,consulta externa,nuevas en personas de 60 anos o mas,2006-04-01,35,56,35,56,91
PUCARA,consulta externa,nuevas en personas de 60 anos o mas,2006-04-01,14,35,14,35,49
PUCARANI,consulta externa,nuevas en personas de 60 anos o mas,2006-04-01,68,41,68,41,109
PUERTO ACOSTA,consulta externa,nuevas en personas de 60 anos o mas,2006-04-01,135,142,135,142,277
PUERTO CARABUCO,consulta externa,nuevas en personas de 60 anos o mas,2006-04-01,75,79,75,79,154
PUERTO GONZALO MORENO,consulta externa,nuevas en personas de 60 anos o mas,2006-04-01,12,3,12,3,15
PUERTO PEREZ,consulta externa,nuevas en personas de 60 anos o mas,2006-04-01,33,27,33,27,60
PUERTO QUIJARRO,consulta externa,nuevas en personas de 60 anos o mas,2006-04-01,95,58,95,58,153
PUERTO RICO,consulta externa,nuevas en personas de 60 anos o mas,2006-04-01,15,6,15,6,21
PUERTO SILES,consulta externa,nuevas en personas de 60 anos o mas,2006-04-01,8,4,8,4,12
PUERTO SUAREZ,consulta externa,nuevas en personas de 60 anos o mas,2006-04-01,166,149,166,149,315
PUERTO VILLARROEL,consulta externa,nuevas en personas de 60 anos o mas,2006-04-01,50,30,50,30,80
PUNA,consulta externa,nuevas en personas de 60 anos o mas,2006-04-01,185,287,185,287,472
PUNATA,consulta externa,nuevas en personas de 60 anos o mas,2006-04-01,87,124,87,124,211
QUIABAYA,consulta externa,nuevas en personas de 60 anos o mas,2006-04-01,5,2,5,2,7
QUILLACOLLO,consulta externa,nuevas en personas de 60 anos o mas,2006-04-01,410,601,410,601,1011
QUIME,consulta externa,nuevas en personas de 60 anos o mas,2006-04-01,34,42,34,42,76
QUIRUSILLAS,consulta externa,nuevas en personas de 60 anos o mas,2006-04-01,3,9,3,9,12
RAVELO,consulta externa,nuevas en personas de 60 anos o mas,2006-04-01,36,68,36,68,104
REYES,consulta externa,nuevas en personas de 60 anos o mas,2006-04-01,90,105,90,105,195
RIBERALTA,consulta externa,nuevas en personas de 60 anos o mas,2006-04-01,141,115,141,115,256
ROBORE,consulta externa,nuevas en personas de 60 anos o mas,2006-04-01,42,49,42,49,91
RURRENABAQUE,consulta externa,nuevas en personas de 60 anos o mas,2006-04-01,112,112,112,112,224
SABAYA,consulta externa,nuevas en personas de 60 anos o mas,2006-04-01,30,33,30,33,63
SACABA,consulta externa,nuevas en personas de 60 anos o mas,2006-04-01,120,425,120,425,545
SACABAMBA,consulta externa,nuevas en personas de 60 anos o mas,2006-04-01,2,18,2,18,20
SACACA,consulta externa,nuevas en personas de 60 anos o mas,2006-04-01,47,80,47,80,127
SAIPINA,consulta externa,nuevas en personas de 60 anos o mas,2006-04-01,8,6,8,6,14
SALINAS DE GARCI MENDOZA,consulta externa,nuevas en personas de 60 anos o mas,2006-04-01,60,51,60,51,111
SAMAIPATA,consulta externa,nuevas en personas de 60 anos o mas,2006-04-01,59,53,59,53,112
SAN AGUSTIN,consulta externa,nuevas en personas de 60 anos o mas,2006-04-01,4,9,4,9,13
SAN ANDRES,consulta externa,nuevas en personas de 60 anos o mas,2006-04-01,12,11,12,11,23
SAN ANDRES DE MACHACA,consulta externa,nuevas en personas de 60 anos o mas,2006-04-01,50,58,50,58,108
SAN ANTONIO DE ESMORUCO,consulta externa,nuevas en personas de 60 anos o mas,2006-04-01,8,7,8,7,15
SAN ANTONIO DE LOMERIO,consulta externa,nuevas en personas de 60 anos o mas,2006-04-01,15,15,15,15,30
SAN BENITO,consulta externa,nuevas en personas de 60 anos o mas,2006-04-01,27,37,27,37,64
SAN BORJA,consulta externa,nuevas en personas de 60 anos o mas,2006-04-01,102,89,102,89,191
SAN BUENA VENTURA,consulta externa,nuevas en personas de 60 anos o mas,2006-04-01,28,46,28,46,74
SAN CARLOS,consulta externa,nuevas en personas de 60 anos o mas,2006-04-01,81,111,81,111,192
SAN IGNACIO,consulta externa,nuevas en personas de 60 anos o mas,2006-04-01,63,82,63,82,145
SAN IGNACIO DE VELASCO,consulta externa,nuevas en personas de 60 anos o mas,2006-04-01,194,239,194,239,433
SAN JAVIER(BNI),consulta externa,nuevas en personas de 60 anos o mas,2006-04-01,17,21,17,21,38
SAN JAVIER(STC),consulta externa,nuevas en personas de 60 anos o mas,2006-04-01,11,14,11,14,25
SAN JOAQUIN,consulta externa,nuevas en personas de 60 anos o mas,2006-04-01,62,61,62,61,123
SAN JOSE DE CHIQUITOS,consulta externa,nuevas en personas de 60 anos o mas,2006-04-01,94,83,94,83,177
SAN JUAN DE YAPACANI,consulta externa,nuevas en personas de 60 anos o mas,2006-04-01,47,35,47,35,82
SAN JULIAN,consulta externa,nuevas en personas de 60 anos o mas,2006-04-01,117,115,117,115,232
SAN LORENZO(PND),consulta externa,nuevas en personas de 60 anos o mas,2006-04-01,4,5,4,5,9
SAN LORENZO(TJA),consulta externa,nuevas en personas de 60 anos o mas,2006-04-01,68,110,68,110,178
SAN LUCAS,consulta externa,nuevas en personas de 60 anos o mas,2006-04-01,139,270,139,270,409
SAN MATIAS,consulta externa,nuevas en personas de 60 anos o mas,2006-04-01,19,12,19,12,31
SAN MIGUEL DE VELASCO,consulta externa,nuevas en personas de 60 anos o mas,2006-04-01,89,101,89,101,190
SAN PABLO DE LIPEZ,consulta externa,nuevas en personas de 60 anos o mas,2006-04-01,24,28,24,28,52
SAN PEDRO,consulta externa,nuevas en personas de 60 anos o mas,2006-04-01,63,72,63,72,135
SAN PEDRO DE BUENA VISTA,consulta externa,nuevas en personas de 60 anos o mas,2006-04-01,29,48,29,48,77
SAN PEDRO DE CURAHUARA,consulta externa,nuevas en personas de 60 anos o mas,2006-04-01,47,48,47,48,95
SAN PEDRO DE QUEMES,consulta externa,nuevas en personas de 60 anos o mas,2006-04-01,5,7,5,7,12
SAN PEDRO DE TIQUINA,consulta externa,nuevas en personas de 60 anos o mas,2006-04-01,11,29,11,29,40
SAN PEDRO(PND),consulta externa,nuevas en personas de 60 anos o mas,2006-04-01,4,9,4,9,13
SAN RAFAEL,consulta externa,nuevas en personas de 60 anos o mas,2006-04-01,22,19,22,19,41
SAN RAMON,consulta externa,nuevas en personas de 60 anos o mas,2006-04-01,31,80,31,80,111
SAN RAMON,consulta externa,nuevas en personas de 60 anos o mas,2006-04-01,11,12,11,12,23
SANTA ANA,consulta externa,nuevas en personas de 60 anos o mas,2006-04-01,89,123,89,123,212
SANTA CRUZ DE LA SIERRA,consulta externa,nuevas en personas de 60 anos o mas,2006-04-01,5803,7473,5803,7473,13276
SANTA ROSA,consulta externa,nuevas en personas de 60 anos o mas,2006-04-01,64,56,64,56,120
SANTA ROSA DEL SARA,consulta externa,nuevas en personas de 60 anos o mas,2006-04-01,41,45,41,45,86
SANTIAGO DE CALLAPA,consulta externa,nuevas en personas de 60 anos o mas,2006-04-01,14,9,14,9,23
SANTIAGO DE HUARI,consulta externa,nuevas en personas de 60 anos o mas,2006-04-01,52,56,52,56,108
SANTIAGO DE MACHACA,consulta externa,nuevas en personas de 60 anos o mas,2006-04-01,21,12,21,12,33
SANTIVAÑES,consulta externa,nuevas en personas de 60 anos o mas,2006-04-01,17,41,17,41,58
SANTUARIO DE QUILLACAS,consulta externa,nuevas en personas de 60 anos o mas,2006-04-01,17,18,17,18,35
SAPAHAQUI,consulta externa,nuevas en personas de 60 anos o mas,2006-04-01,40,34,40,34,74
SENA,consulta externa,nuevas en personas de 60 anos o mas,2006-04-01,8,3,8,3,11
SICA SICA (VILLA AROMA),consulta externa,nuevas en personas de 60 anos o mas,2006-04-01,25,38,25,38,63
SICAYA,consulta externa,nuevas en personas de 60 anos o mas,2006-04-01,3,7,3,7,10
SIPE SIPE,consulta externa,nuevas en personas de 60 anos o mas,2006-04-01,19,57,19,57,76
SOPACHUY,consulta externa,nuevas en personas de 60 anos o mas,2006-04-01,37,41,37,41,78
SORACACHI,consulta externa,nuevas en personas de 60 anos o mas,2006-04-01,12,9,12,9,21
SORATA,consulta externa,nuevas en personas de 60 anos o mas,2006-04-01,52,61,52,61,113
SUCRE,consulta externa,nuevas en personas de 60 anos o mas,2006-04-01,2388,3222,2388,3222,5610
TACACHI,consulta externa,nuevas en personas de 60 anos o mas,2006-04-01,2,5,2,5,7
TACACOMA,consulta externa,nuevas en personas de 60 anos o mas,2006-04-01,14,12,14,12,26
TACOBAMBA,consulta externa,nuevas en personas de 60 anos o mas,2006-04-01,17,67,17,67,84
TACOPAYA,consulta externa,nuevas en personas de 60 anos o mas,2006-04-01,26,63,26,63,89
TAHUA,consulta externa,nuevas en personas de 60 anos o mas,2006-04-01,7,4,7,4,11
TAPACARI,consulta externa,nuevas en personas de 60 anos o mas,2006-04-01,76,74,76,74,150
TARABUCO,consulta externa,nuevas en personas de 60 anos o mas,2006-04-01,98,151,98,151,249
TARACO,consulta externa,nuevas en personas de 60 anos o mas,2006-04-01,21,17,21,17,38
TARATA,consulta externa,nuevas en personas de 60 anos o mas,2006-04-01,7,10,7,10,17
TARIJA,consulta externa,nuevas en personas de 60 anos o mas,2006-04-01,1586,1690,1586,1690,3276
TARVITA,consulta externa,nuevas en personas de 60 anos o mas,2006-04-01,64,83,64,83,147
TEOPONTE,consulta externa,nuevas en personas de 60 anos o mas,2006-04-01,65,50,65,50,115
TIAWANACU,consulta externa,nuevas en personas de 60 anos o mas,2006-04-01,23,25,23,25,48
TINGUIPAYA,consulta externa,nuevas en personas de 60 anos o mas,2006-04-01,47,97,47,97,144
TIPUANI,consulta externa,nuevas en personas de 60 anos o mas,2006-04-01,13,9,13,9,22
TIQUIPAYA,consulta externa,nuevas en personas de 60 anos o mas,2006-04-01,17,12,17,12,29
TIRAQUE (CBBA),consulta externa,nuevas en personas de 60 anos o mas,2006-04-01,48,38,48,38,86
TITO YUPANQUI (PARQUIPUJIO),consulta externa,nuevas en personas de 60 anos o mas,2006-04-01,8,16,8,16,24
TOCO,consulta externa,nuevas en personas de 60 anos o mas,2006-04-01,7,17,7,17,24
TODOS SANTOS,consulta externa,nuevas en personas de 60 anos o mas,2006-04-01,2,0,2,0,2
TOLATA,consulta externa,nuevas en personas de 60 anos o mas,2006-04-01,13,19,13,19,32
TOLEDO,consulta externa,nuevas en personas de 60 anos o mas,2006-04-01,31,42,31,42,73
TOMAVE,consulta externa,nuevas en personas de 60 anos o mas,2006-04-01,55,115,55,115,170
TOMINA,consulta externa,nuevas en personas de 60 anos o mas,2006-04-01,34,53,34,53,87
TORO TORO,consulta externa,nuevas en personas de 60 anos o mas,2006-04-01,31,36,31,36,67
TOTORA(CBBA),consulta externa,nuevas en personas de 60 anos o mas,2006-04-01,18,34,18,34,52
TOTORA(ORR),consulta externa,nuevas en personas de 60 anos o mas,2006-04-01,9,16,9,16,25
TRIGAL,consulta externa,nuevas en personas de 60 anos o mas,2006-04-01,28,37,28,37,65
TRINIDAD,consulta externa,nuevas en personas de 60 anos o mas,2006-04-01,326,404,326,404,730
TUPIZA,consulta externa,nuevas en personas de 60 anos o mas,2006-04-01,379,561,379,561,940
TURCO,consulta externa,nuevas en personas de 60 anos o mas,2006-04-01,29,19,29,19,48
UMALA,consulta externa,nuevas en personas de 60 anos o mas,2006-04-01,27,24,27,24,51
UNCIA,consulta externa,nuevas en personas de 60 anos o mas,2006-04-01,138,182,138,182,320
URIONDO (A. CONCEPCION),consulta externa,nuevas en personas de 60 anos o mas,2006-04-01,57,64,57,64,121
URUBICHA,consulta externa,nuevas en personas de 60 anos o mas,2006-04-01,12,13,12,13,25
UYUNI,consulta externa,nuevas en personas de 60 anos o mas,2006-04-01,159,178,159,178,337
VACAS,consulta externa,nuevas en personas de 60 anos o mas,2006-04-01,30,55,30,55,85
VALLEGRANDE,consulta externa,nuevas en personas de 60 anos o mas,2006-04-01,180,233,180,233,413
VIACHA,consulta externa,nuevas en personas de 60 anos o mas,2006-04-01,266,235,266,235,501
VILA VILA,consulta externa,nuevas en personas de 60 anos o mas,2006-04-01,5,11,5,11,16
VILLA MONTES,consulta externa,nuevas en personas de 60 anos o mas,2006-04-01,66,65,66,65,131
VILLA NUEVA (LOMA ALTA),consulta externa,nuevas en personas de 60 anos o mas,2006-04-01,6,5,6,5,11
VILLA RIVERO,consulta externa,nuevas en personas de 60 anos o mas,2006-04-01,14,20,14,20,34
VILLA SERRANO,consulta externa,nuevas en personas de 60 anos o mas,2006-04-01,40,71,40,71,111
VILLA TUNARI,consulta externa,nuevas en personas de 60 anos o mas,2006-04-01,141,101,141,101,242
VILLA VACA GUZMAN (MUYUPAMPA),consulta externa,nuevas en personas de 60 anos o mas,2006-04-01,38,65,38,65,103
VILLAZON,consulta externa,nuevas en personas de 60 anos o mas,2006-04-01,223,300,223,300,523
VINTO,consulta externa,nuevas en personas de 60 anos o mas,2006-04-01,18,45,18,45,63
VITICHI,consulta externa,nuevas en personas de 60 anos o mas,2006-04-01,85,135,85,135,220
WALDO BALLIVIAN,consulta externa,nuevas en personas de 60 anos o mas,2006-04-01,3,3,3,3,6
WARNES,consulta externa,nuevas en personas de 60 anos o mas,2006-04-01,59,56,59,56,115
YACO,consulta externa,nuevas en personas de 60 anos o mas,2006-04-01,22,12,22,12,34
YACUIBA,consulta externa,nuevas en personas de 60 anos o mas,2006-04-01,514,564,514,564,1078
YAMPARAEZ,consulta externa,nuevas en personas de 60 anos o mas,2006-04-01,39,63,39,63,102
YANACACHI,consulta externa,nuevas en personas de 60 anos o mas,2006-04-01,27,21,27,21,48
YAPACANI,consulta externa,nuevas en personas de 60 anos o mas,2006-04-01,151,126,151,126,277
YOCALLA,consulta externa,nuevas en personas de 60 anos o mas,2006-04-01,36,53,36,53,89
YOTALA,consulta externa,nuevas en personas de 60 anos o mas,2006-04-01,116,107,116,107,223
YUNCHARA,consulta externa,nuevas en personas de 60 anos o mas,2006-04-01,23,47,23,47,70
ZUDAÑEZ,consulta externa,nuevas en personas de 60 anos o mas,2006-04-01,59,84,59,84,143
ACACIO,consulta externa,nuevas en personas de 60 anos o mas,2006-05-01,16,54,16,54,70
ACHACACHI,consulta externa,nuevas en personas de 60 anos o mas,2006-05-01,165,161,165,161,326
ACHOCALLA,consulta externa,nuevas en personas de 60 anos o mas,2006-05-01,15,4,15,4,19
AIQUILE,consulta externa,nuevas en personas de 60 anos o mas,2006-05-01,58,90,58,90,148
ALALAY,consulta externa,nuevas en personas de 60 anos o mas,2006-05-01,7,0,7,0,7
ALCALA,consulta externa,nuevas en personas de 60 anos o mas,2006-05-01,26,65,26,65,91
ANCORAIMES,consulta externa,nuevas en personas de 60 anos o mas,2006-05-01,34,40,34,40,74
ANDAMARCA,consulta externa,nuevas en personas de 60 anos o mas,2006-05-01,24,33,24,33,57
ANTEQUERA,consulta externa,nuevas en personas de 60 anos o mas,2006-05-01,2,8,2,8,10
ANZALDO,consulta externa,nuevas en personas de 60 anos o mas,2006-05-01,16,28,16,28,44
APOLO,consulta externa,nuevas en personas de 60 anos o mas,2006-05-01,33,59,33,59,92
ARAMPAMPA,consulta externa,nuevas en personas de 60 anos o mas,2006-05-01,26,16,26,16,42
ARANI,consulta externa,nuevas en personas de 60 anos o mas,2006-05-01,8,9,8,9,17
ARBIETO,consulta externa,nuevas en personas de 60 anos o mas,2006-05-01,27,23,27,23,50
ARQUE,consulta externa,nuevas en personas de 60 anos o mas,2006-05-01,28,15,28,15,43
ASCENCION DE GUARAYOS,consulta externa,nuevas en personas de 60 anos o mas,2006-05-01,24,20,24,20,44
ATOCHA,consulta externa,nuevas en personas de 60 anos o mas,2006-05-01,78,120,78,120,198
AUCAPATA,consulta externa,nuevas en personas de 60 anos o mas,2006-05-01,17,25,17,25,42
AYATA,consulta externa,nuevas en personas de 60 anos o mas,2006-05-01,21,14,21,14,35
AYO AYO,consulta externa,nuevas en personas de 60 anos o mas,2006-05-01,19,11,19,11,30
AYOPAYA (V. DE INDEPENDENCIA),consulta externa,nuevas en personas de 60 anos o mas,2006-05-01,57,71,57,71,128
AZURDUY,consulta externa,nuevas en personas de 60 anos o mas,2006-05-01,64,115,64,115,179
BATALLAS,consulta externa,nuevas en personas de 60 anos o mas,2006-05-01,36,38,36,38,74
BAURES,consulta externa,nuevas en personas de 60 anos o mas,2006-05-01,43,39,43,39,82
BELEN DE ANDAMARCA,consulta externa,nuevas en personas de 60 anos o mas,2006-05-01,11,6,11,6,17
BELEN DE URMIRI,consulta externa,nuevas en personas de 60 anos o mas,2006-05-01,38,40,38,40,78
BELLA FLOR,consulta externa,nuevas en personas de 60 anos o mas,2006-05-01,9,6,9,6,15
BERMEJO,consulta externa,nuevas en personas de 60 anos o mas,2006-05-01,293,251,293,251,544
BETANZOS,consulta externa,nuevas en personas de 60 anos o mas,2006-05-01,180,275,180,275,455
BOLIVAR,consulta externa,nuevas en personas de 60 anos o mas,2006-05-01,18,23,18,23,41
BOLPEBRA,consulta externa,nuevas en personas de 60 anos o mas,2006-05-01,5,4,5,4,9
BOYUIBE,consulta externa,nuevas en personas de 60 anos o mas,2006-05-01,21,44,21,44,65
BUENA VISTA,consulta externa,nuevas en personas de 60 anos o mas,2006-05-01,89,48,89,48,137
CABEZAS,consulta externa,nuevas en personas de 60 anos o mas,2006-05-01,31,40,31,40,71
CAIROMA,consulta externa,nuevas en personas de 60 anos o mas,2006-05-01,45,32,45,32,77
"CAIZA ""D""",consulta externa,nuevas en personas de 60 anos o mas,2006-05-01,68,95,68,95,163
CAJUATA,consulta externa,nuevas en personas de 60 anos o mas,2006-05-01,31,38,31,38,69
CALACOTO,consulta externa,nuevas en personas de 60 anos o mas,2006-05-01,84,84,84,84,168
CALAMARCA,consulta externa,nuevas en personas de 60 anos o mas,2006-05-01,21,17,21,17,38
CAMARGO,consulta externa,nuevas en personas de 60 anos o mas,2006-05-01,152,202,152,202,354
CAMATAQUI (C. VILLA ABECIA),consulta externa,nuevas en personas de 60 anos o mas,2006-05-01,52,55,52,55,107
CAMIRI,consulta externa,nuevas en personas de 60 anos o mas,2006-05-01,678,959,678,959,1637
CAPINOTA,consulta externa,nuevas en personas de 60 anos o mas,2006-05-01,25,28,25,28,53
CAQUIAVIRI,consulta externa,nuevas en personas de 60 anos o mas,2006-05-01,30,55,30,55,85
CARACOLLO,consulta externa,nuevas en personas de 60 anos o mas,2006-05-01,89,81,89,81,170
CARANAVI,consulta externa,nuevas en personas de 60 anos o mas,2006-05-01,348,183,348,183,531
CARANGAS,consulta externa,nuevas en personas de 60 anos o mas,2006-05-01,2,1,2,1,3
CARAPARI,consulta externa,nuevas en personas de 60 anos o mas,2006-05-01,52,70,52,70,122
CARIPUYO,consulta externa,nuevas en personas de 60 anos o mas,2006-05-01,17,24,17,24,41
CARMEN RIVERO TORREZ,consulta externa,nuevas en personas de 60 anos o mas,2006-05-01,2,0,2,0,2
CATACORA,consulta externa,nuevas en personas de 60 anos o mas,2006-05-01,9,8,9,8,17
CHACARILLA,consulta externa,nuevas en personas de 60 anos o mas,2006-05-01,4,4,4,4,8
CHALLAPATA,consulta externa,nuevas en personas de 60 anos o mas,2006-05-01,167,133,167,133,300
CHAQUI,consulta externa,nuevas en personas de 60 anos o mas,2006-05-01,16,38,16,38,54
CHARAGUA,consulta externa,nuevas en personas de 60 anos o mas,2006-05-01,43,38,43,38,81
CHARAÑA,consulta externa,nuevas en personas de 60 anos o mas,2006-05-01,14,13,14,13,27
CHAYANTA,consulta externa,nuevas en personas de 60 anos o mas,2006-05-01,58,127,58,127,185
CHIMORE,consulta externa,nuevas en personas de 60 anos o mas,2006-05-01,24,14,24,14,38
CHIPAYA,consulta externa,nuevas en personas de 60 anos o mas,2006-05-01,6,5,6,5,11
CHOQUE COTA,consulta externa,nuevas en personas de 60 anos o mas,2006-05-01,8,10,8,10,18
CHULUMANI (V. DE LA LIBERTAD),consulta externa,nuevas en personas de 60 anos o mas,2006-05-01,72,55,72,55,127
CHUMA,consulta externa,nuevas en personas de 60 anos o mas,2006-05-01,58,65,58,65,123
CLIZA,consulta externa,nuevas en personas de 60 anos o mas,2006-05-01,20,26,20,26,46
COBIJA,consulta externa,nuevas en personas de 60 anos o mas,2006-05-01,279,203,279,203,482
COCHABAMBA,consulta externa,nuevas en personas de 60 anos o mas,2006-05-01,4431,6463,4431,6463,10894
COIPASA,consulta externa,nuevas en personas de 60 anos o mas,2006-05-01,1,0,1,0,1
COLCAPIRHUA,consulta externa,nuevas en personas de 60 anos o mas,2006-05-01,137,169,137,169,306
"COLCHA ""K""",consulta externa,nuevas en personas de 60 anos o mas,2006-05-01,76,94,76,94,170
COLLANA,consulta externa,nuevas en personas de 60 anos o mas,2006-05-01,14,11,14,11,25
COLOMI,consulta externa,nuevas en personas de 60 anos o mas,2006-05-01,10,8,10,8,18
COLPA BELGICA,consulta externa,nuevas en personas de 60 anos o mas,2006-05-01,64,52,64,52,116
COLQUECHACA,consulta externa,nuevas en personas de 60 anos o mas,2006-05-01,100,120,100,120,220
COLQUENCHA,consulta externa,nuevas en personas de 60 anos o mas,2006-05-01,20,39,20,39,59
COLQUIRI,consulta externa,nuevas en personas de 60 anos o mas,2006-05-01,81,66,81,66,147
COMANCHE,consulta externa,nuevas en personas de 60 anos o mas,2006-05-01,16,21,16,21,37
COMARAPA,consulta externa,nuevas en personas de 60 anos o mas,2006-05-01,113,157,113,157,270
COMBAYA,consulta externa,nuevas en personas de 60 anos o mas,2006-05-01,15,16,15,16,31
CONCEPCION,consulta externa,nuevas en personas de 60 anos o mas,2006-05-01,64,48,64,48,112
COPACABANA,consulta externa,nuevas en personas de 60 anos o mas,2006-05-01,52,52,52,52,104
CORIPATA,consulta externa,nuevas en personas de 60 anos o mas,2006-05-01,34,27,34,27,61
CORO CORO,consulta externa,nuevas en personas de 60 anos o mas,2006-05-01,38,30,38,30,68
COROICO,consulta externa,nuevas en personas de 60 anos o mas,2006-05-01,113,93,113,93,206
CORQUE,consulta externa,nuevas en personas de 60 anos o mas,2006-05-01,66,58,66,58,124
COTAGAITA,consulta externa,nuevas en personas de 60 anos o mas,2006-05-01,277,539,277,539,816
COTOCA,consulta externa,nuevas en personas de 60 anos o mas,2006-05-01,65,82,65,82,147
CUATRO CAÑADAS,consulta externa,nuevas en personas de 60 anos o mas,2006-05-01,42,52,42,52,94
CUCHUMUELA (V. G. VILLARROEL),consulta externa,nuevas en personas de 60 anos o mas,2006-05-01,10,11,10,11,21
CUEVO,consulta externa,nuevas en personas de 60 anos o mas,2006-05-01,22,28,22,28,50
CULPINA,consulta externa,nuevas en personas de 60 anos o mas,2006-05-01,56,72,56,72,128
CURAHUARA DE CARANGAS,consulta externa,nuevas en personas de 60 anos o mas,2006-05-01,32,41,32,41,73
CURVA,consulta externa,nuevas en personas de 60 anos o mas,2006-05-01,4,16,4,16,20
DESAGUADERO,consulta externa,nuevas en personas de 60 anos o mas,2006-05-01,65,43,65,43,108
EL ALTO,consulta externa,nuevas en personas de 60 anos o mas,2006-05-01,1276,1268,1276,1268,2544
EL CHORO,consulta externa,nuevas en personas de 60 anos o mas,2006-05-01,33,34,33,34,67
EL PUENTE(STC),consulta externa,nuevas en personas de 60 anos o mas,2006-05-01,25,23,25,23,48
EL PUENTE(TJA),consulta externa,nuevas en personas de 60 anos o mas,2006-05-01,43,62,43,62,105
EL TORNO,consulta externa,nuevas en personas de 60 anos o mas,2006-05-01,256,209,256,209,465
EL VILLAR,consulta externa,nuevas en personas de 60 anos o mas,2006-05-01,21,34,21,34,55
ENTRE RIOS,consulta externa,nuevas en personas de 60 anos o mas,2006-05-01,109,120,109,120,229
ENTRE RIOS,consulta externa,nuevas en personas de 60 anos o mas,2006-05-01,10,3,10,3,13
ESCARA,consulta externa,nuevas en personas de 60 anos o mas,2006-05-01,2,7,2,7,9
EUCALIPTUS,consulta externa,nuevas en personas de 60 anos o mas,2006-05-01,63,76,63,76,139
EUREKA (SANTOS MERCADO),consulta externa,nuevas en personas de 60 anos o mas,2006-05-01,1,0,1,0,1
EXALTACION,consulta externa,nuevas en personas de 60 anos o mas,2006-05-01,15,17,15,17,32
FERNANDEZ ALONSO,consulta externa,nuevas en personas de 60 anos o mas,2006-05-01,11,19,11,19,30
FILADELFIA,consulta externa,nuevas en personas de 60 anos o mas,2006-05-01,17,11,17,11,28
GENERAL SAAVEDRA,consulta externa,nuevas en personas de 60 anos o mas,2006-05-01,27,18,27,18,45
GRAL. J.J. PEREZ (CHARAZANI),consulta externa,nuevas en personas de 60 anos o mas,2006-05-01,38,48,38,48,86
GUANAY,consulta externa,nuevas en personas de 60 anos o mas,2006-05-01,84,52,84,52,136
GUAQUI,consulta externa,nuevas en personas de 60 anos o mas,2006-05-01,17,21,17,21,38
GUAYARAMERIN,consulta externa,nuevas en personas de 60 anos o mas,2006-05-01,455,404,455,404,859
GUTIERREZ,consulta externa,nuevas en personas de 60 anos o mas,2006-05-01,48,32,48,32,80
HUACARETA,consulta externa,nuevas en personas de 60 anos o mas,2006-05-01,60,70,60,70,130
HUACAYA (VILLA DE HUACAYA),consulta externa,nuevas en personas de 60 anos o mas,2006-05-01,14,30,14,30,44
HUACHACALLA,consulta externa,nuevas en personas de 60 anos o mas,2006-05-01,7,5,7,5,12
HUANUNI,consulta externa,nuevas en personas de 60 anos o mas,2006-05-01,286,227,286,227,513
HUARACAJE,consulta externa,nuevas en personas de 60 anos o mas,2006-05-01,12,20,12,20,32
HUAYLLAMARCA,consulta externa,nuevas en personas de 60 anos o mas,2006-05-01,56,36,56,36,92
ICHOCA,consulta externa,nuevas en personas de 60 anos o mas,2006-05-01,21,20,21,20,41
ICLA,consulta externa,nuevas en personas de 60 anos o mas,2006-05-01,29,56,29,56,85
INCAHUASI,consulta externa,nuevas en personas de 60 anos o mas,2006-05-01,50,81,50,81,131
INGAVI (HUMAITA),consulta externa,nuevas en personas de 60 anos o mas,2006-05-01,2,1,2,1,3
INQUISIVI,consulta externa,nuevas en personas de 60 anos o mas,2006-05-01,42,32,42,32,74
IRUPANA (VILLA DE LANZA),consulta externa,nuevas en personas de 60 anos o mas,2006-05-01,48,46,48,46,94
IXIAMAS,consulta externa,nuevas en personas de 60 anos o mas,2006-05-01,40,22,40,22,62
JESUS DE MACHACA,consulta externa,nuevas en personas de 60 anos o mas,2006-05-01,63,80,63,80,143
LA ASUNTA,consulta externa,nuevas en personas de 60 anos o mas,2006-05-01,24,15,24,15,39
LA GUARDIA,consulta externa,nuevas en personas de 60 anos o mas,2006-05-01,63,61,63,61,124
LA PAZ,consulta externa,nuevas en personas de 60 anos o mas,2006-05-01,9431,11104,9431,11104,20535
LA RIVERA,consulta externa,nuevas en personas de 60 anos o mas,2006-05-01,3,2,3,2,5
LAGUNILLAS,consulta externa,nuevas en personas de 60 anos o mas,2006-05-01,25,25,25,25,50
LAJA,consulta externa,nuevas en personas de 60 anos o mas,2006-05-01,23,26,23,26,49
LAS CARRERAS,consulta externa,nuevas en personas de 60 anos o mas,2006-05-01,36,46,36,46,82
LICOMA PAMPA,consulta externa,nuevas en personas de 60 anos o mas,2006-05-01,26,18,26,18,44
LLALLAGUA,consulta externa,nuevas en personas de 60 anos o mas,2006-05-01,255,446,255,446,701
LLICA,consulta externa,nuevas en personas de 60 anos o mas,2006-05-01,58,51,58,51,109
LORETO,consulta externa,nuevas en personas de 60 anos o mas,2006-05-01,13,7,13,7,20
LURIBAY,consulta externa,nuevas en personas de 60 anos o mas,2006-05-01,46,53,46,53,99
MACHACAMARCA,consulta externa,nuevas en personas de 60 anos o mas,2006-05-01,58,67,58,67,125
MACHARETI,consulta externa,nuevas en personas de 60 anos o mas,2006-05-01,38,57,38,57,95
MAGDALENA,consulta externa,nuevas en personas de 60 anos o mas,2006-05-01,41,36,41,36,77
MAIRANA,consulta externa,nuevas en personas de 60 anos o mas,2006-05-01,44,91,44,91,135
MALLA,consulta externa,nuevas en personas de 60 anos o mas,2006-05-01,11,12,11,12,23
MAPIRI,consulta externa,nuevas en personas de 60 anos o mas,2006-05-01,45,51,45,51,96
MECAPACA,consulta externa,nuevas en personas de 60 anos o mas,2006-05-01,49,47,49,47,96
MINEROS,consulta externa,nuevas en personas de 60 anos o mas,2006-05-01,19,11,19,11,30
MIZQUE,consulta externa,nuevas en personas de 60 anos o mas,2006-05-01,34,49,34,49,83
MOCOMOCO,consulta externa,nuevas en personas de 60 anos o mas,2006-05-01,74,86,74,86,160
MOJINETE,consulta externa,nuevas en personas de 60 anos o mas,2006-05-01,11,28,11,28,39
MOJOCOYA,consulta externa,nuevas en personas de 60 anos o mas,2006-05-01,28,41,28,41,69
MONTEAGUDO,consulta externa,nuevas en personas de 60 anos o mas,2006-05-01,212,355,212,355,567
MONTERO,consulta externa,nuevas en personas de 60 anos o mas,2006-05-01,406,392,406,392,798
MORO MORO,consulta externa,nuevas en personas de 60 anos o mas,2006-05-01,22,37,22,37,59
MOROCHATA,consulta externa,nuevas en personas de 60 anos o mas,2006-05-01,17,32,17,32,49
NACEBE (SANTA ROSA DEL ABUNA),consulta externa,nuevas en personas de 60 anos o mas,2006-05-01,2,1,2,1,3
NAZACARA DE PACAJES,consulta externa,nuevas en personas de 60 anos o mas,2006-05-01,6,3,6,3,9
NUEVO MANOA (NUEVA ESPERANZA),consulta externa,nuevas en personas de 60 anos o mas,2006-05-01,1,1,1,1,2
OCURI,consulta externa,nuevas en personas de 60 anos o mas,2006-05-01,62,64,62,64,126
OKINAWA,consulta externa,nuevas en personas de 60 anos o mas,2006-05-01,23,34,23,34,57
OMEREQUE,consulta externa,nuevas en personas de 60 anos o mas,2006-05-01,19,27,19,27,46
ORURO,consulta externa,nuevas en personas de 60 anos o mas,2006-05-01,3079,3277,3079,3277,6356
PADCAYA,consulta externa,nuevas en personas de 60 anos o mas,2006-05-01,106,139,106,139,245
PADILLA,consulta externa,nuevas en personas de 60 anos o mas,2006-05-01,145,215,145,215,360
PAILON,consulta externa,nuevas en personas de 60 anos o mas,2006-05-01,14,16,14,16,30
PALCA,consulta externa,nuevas en personas de 60 anos o mas,2006-05-01,21,28,21,28,49
PALOS BLANCOS,consulta externa,nuevas en personas de 60 anos o mas,2006-05-01,57,30,57,30,87
PAMPA AULLAGAS,consulta externa,nuevas en personas de 60 anos o mas,2006-05-01,9,20,9,20,29
PAMPA GRANDE,consulta externa,nuevas en personas de 60 anos o mas,2006-05-01,28,34,28,34,62
PAPEL PAMPA,consulta externa,nuevas en personas de 60 anos o mas,2006-05-01,33,27,33,27,60
PASORAPA,consulta externa,nuevas en personas de 60 anos o mas,2006-05-01,9,12,9,12,21
PATACAMAYA,consulta externa,nuevas en personas de 60 anos o mas,2006-05-01,28,20,28,20,48
PAZÑA,consulta externa,nuevas en personas de 60 anos o mas,2006-05-01,38,50,38,50,88
PELECHUCO,consulta externa,nuevas en personas de 60 anos o mas,2006-05-01,18,20,18,20,38
POCOATA,consulta externa,nuevas en personas de 60 anos o mas,2006-05-01,82,111,82,111,193
POCONA,consulta externa,nuevas en personas de 60 anos o mas,2006-05-01,21,43,21,43,64
POJO (CBBA),consulta externa,nuevas en personas de 60 anos o mas,2006-05-01,17,23,17,23,40
POOPO,consulta externa,nuevas en personas de 60 anos o mas,2006-05-01,26,38,26,38,64
PORCO,consulta externa,nuevas en personas de 60 anos o mas,2006-05-01,8,22,8,22,30
POROMA,consulta externa,nuevas en personas de 60 anos o mas,2006-05-01,115,94,115,94,209
PORONGO,consulta externa,nuevas en personas de 60 anos o mas,2006-05-01,25,18,25,18,43
PORTACHUELO,consulta externa,nuevas en personas de 60 anos o mas,2006-05-01,157,153,157,153,310
PORVENIR,consulta externa,nuevas en personas de 60 anos o mas,2006-05-01,13,21,13,21,34
POSTRER VALLE,consulta externa,nuevas en personas de 60 anos o mas,2006-05-01,33,25,33,25,58
POTOSI,consulta externa,nuevas en personas de 60 anos o mas,2006-05-01,892,426,892,426,1318
PRESTO,consulta externa,nuevas en personas de 60 anos o mas,2006-05-01,15,49,15,49,64
PUCARA,consulta externa,nuevas en personas de 60 anos o mas,2006-05-01,59,82,59,82,141
PUCARANI,consulta externa,nuevas en personas de 60 anos o mas,2006-05-01,56,44,56,44,100
PUERTO ACOSTA,consulta externa,nuevas en personas de 60 anos o mas,2006-05-01,129,96,129,96,225
PUERTO CARABUCO,consulta externa,nuevas en personas de 60 anos o mas,2006-05-01,80,90,80,90,170
PUERTO GONZALO MORENO,consulta externa,nuevas en personas de 60 anos o mas,2006-05-01,24,11,24,11,35
PUERTO PEREZ,consulta externa,nuevas en personas de 60 anos o mas,2006-05-01,28,31,28,31,59
PUERTO QUIJARRO,consulta externa,nuevas en personas de 60 anos o mas,2006-05-01,118,75,118,75,193
PUERTO RICO,consulta externa,nuevas en personas de 60 anos o mas,2006-05-01,17,17,17,17,34
PUERTO SILES,consulta externa,nuevas en personas de 60 anos o mas,2006-05-01,1,1,1,1,2
PUERTO SUAREZ,consulta externa,nuevas en personas de 60 anos o mas,2006-05-01,108,187,108,187,295
PUERTO VILLARROEL,consulta externa,nuevas en personas de 60 anos o mas,2006-05-01,84,59,84,59,143
PUNA,consulta externa,nuevas en personas de 60 anos o mas,2006-05-01,180,264,180,264,444
PUNATA,consulta externa,nuevas en personas de 60 anos o mas,2006-05-01,123,139,123,139,262
QUIABAYA,consulta externa,nuevas en personas de 60 anos o mas,2006-05-01,16,13,16,13,29
QUILLACOLLO,consulta externa,nuevas en personas de 60 anos o mas,2006-05-01,408,438,408,438,846
QUIME,consulta externa,nuevas en personas de 60 anos o mas,2006-05-01,17,14,17,14,31
QUIRUSILLAS,consulta externa,nuevas en personas de 60 anos o mas,2006-05-01,9,13,9,13,22
RAVELO,consulta externa,nuevas en personas de 60 anos o mas,2006-05-01,79,100,79,100,179
REYES,consulta externa,nuevas en personas de 60 anos o mas,2006-05-01,51,64,51,64,115
RIBERALTA,consulta externa,nuevas en personas de 60 anos o mas,2006-05-01,94,98,94,98,192
ROBORE,consulta externa,nuevas en personas de 60 anos o mas,2006-05-01,39,52,39,52,91
RURRENABAQUE,consulta externa,nuevas en personas de 60 anos o mas,2006-05-01,137,115,137,115,252
SABAYA,consulta externa,nuevas en personas de 60 anos o mas,2006-05-01,33,34,33,34,67
SACABA,consulta externa,nuevas en personas de 60 anos o mas,2006-05-01,123,177,123,177,300
SACABAMBA,consulta externa,nuevas en personas de 60 anos o mas,2006-05-01,11,17,11,17,28
SACACA,consulta externa,nuevas en personas de 60 anos o mas,2006-05-01,62,136,62,136,198
SAIPINA,consulta externa,nuevas en personas de 60 anos o mas,2006-05-01,36,75,36,75,111
SALINAS DE GARCI MENDOZA,consulta externa,nuevas en personas de 60 anos o mas,2006-05-01,63,74,63,74,137
SAMAIPATA,consulta externa,nuevas en personas de 60 anos o mas,2006-05-01,36,39,36,39,75
SAN AGUSTIN,consulta externa,nuevas en personas de 60 anos o mas,2006-05-01,13,13,13,13,26
SAN ANDRES,consulta externa,nuevas en personas de 60 anos o mas,2006-05-01,19,16,19,16,35
SAN ANDRES DE MACHACA,consulta externa,nuevas en personas de 60 anos o mas,2006-05-01,36,79,36,79,115
SAN ANTONIO DE ESMORUCO,consulta externa,nuevas en personas de 60 anos o mas,2006-05-01,6,6,6,6,12
SAN ANTONIO DE LOMERIO,consulta externa,nuevas en personas de 60 anos o mas,2006-05-01,16,10,16,10,26
SAN BENITO,consulta externa,nuevas en personas de 60 anos o mas,2006-05-01,17,28,17,28,45
SAN BORJA,consulta externa,nuevas en personas de 60 anos o mas,2006-05-01,117,108,117,108,225
SAN BUENA VENTURA,consulta externa,nuevas en personas de 60 anos o mas,2006-05-01,31,17,31,17,48
SAN CARLOS,consulta externa,nuevas en personas de 60 anos o mas,2006-05-01,99,78,99,78,177
SAN IGNACIO,consulta externa,nuevas en personas de 60 anos o mas,2006-05-01,96,97,96,97,193
SAN IGNACIO DE VELASCO,consulta externa,nuevas en personas de 60 anos o mas,2006-05-01,287,342,287,342,629
SAN JAVIER(BNI),consulta externa,nuevas en personas de 60 anos o mas,2006-05-01,5,5,5,5,10
SAN JAVIER(STC),consulta externa,nuevas en personas de 60 anos o mas,2006-05-01,10,14,10,14,24
SAN JOAQUIN,consulta externa,nuevas en personas de 60 anos o mas,2006-05-01,62,45,62,45,107
SAN JOSE DE CHIQUITOS,consulta externa,nuevas en personas de 60 anos o mas,2006-05-01,67,97,67,97,164
SAN JUAN DE YAPACANI,consulta externa,nuevas en personas de 60 anos o mas,2006-05-01,62,42,62,42,104
SAN JULIAN,consulta externa,nuevas en personas de 60 anos o mas,2006-05-01,104,84,104,84,188
SAN LORENZO(PND),consulta externa,nuevas en personas de 60 anos o mas,2006-05-01,5,6,5,6,11
SAN LORENZO(TJA),consulta externa,nuevas en personas de 60 anos o mas,2006-05-01,59,77,59,77,136
SAN LUCAS,consulta externa,nuevas en personas de 60 anos o mas,2006-05-01,159,269,159,269,428
SAN MATIAS,consulta externa,nuevas en personas de 60 anos o mas,2006-05-01,15,13,15,13,28
SAN MIGUEL DE VELASCO,consulta externa,nuevas en personas de 60 anos o mas,2006-05-01,24,32,24,32,56
SAN PABLO DE LIPEZ,consulta externa,nuevas en personas de 60 anos o mas,2006-05-01,28,32,28,32,60
SAN PEDRO,consulta externa,nuevas en personas de 60 anos o mas,2006-05-01,100,31,100,31,131
SAN PEDRO DE BUENA VISTA,consulta externa,nuevas en personas de 60 anos o mas,2006-05-01,55,64,55,64,119
SAN PEDRO DE CURAHUARA,consulta externa,nuevas en personas de 60 anos o mas,2006-05-01,20,16,20,16,36
SAN PEDRO DE QUEMES,consulta externa,nuevas en personas de 60 anos o mas,2006-05-01,2,4,2,4,6
SAN PEDRO DE TIQUINA,consulta externa,nuevas en personas de 60 anos o mas,2006-05-01,22,23,22,23,45
SAN PEDRO(PND),consulta externa,nuevas en personas de 60 anos o mas,2006-05-01,4,3,4,3,7
SAN RAFAEL,consulta externa,nuevas en personas de 60 anos o mas,2006-05-01,8,2,8,2,10
SAN RAMON,consulta externa,nuevas en personas de 60 anos o mas,2006-05-01,50,89,50,89,139
SAN RAMON,consulta externa,nuevas en personas de 60 anos o mas,2006-05-01,11,12,11,12,23
SANTA ANA,consulta externa,nuevas en personas de 60 anos o mas,2006-05-01,89,131,89,131,220
SANTA CRUZ DE LA SIERRA,consulta externa,nuevas en personas de 60 anos o mas,2006-05-01,5474,7337,5474,7337,12811
SANTA ROSA,consulta externa,nuevas en personas de 60 anos o mas,2006-05-01,79,70,79,70,149
SANTA ROSA DEL SARA,consulta externa,nuevas en personas de 60 anos o mas,2006-05-01,48,40,48,40,88
SANTIAGO DE CALLAPA,consulta externa,nuevas en personas de 60 anos o mas,2006-05-01,22,25,22,25,47
SANTIAGO DE HUARI,consulta externa,nuevas en personas de 60 anos o mas,2006-05-01,79,86,79,86,165
SANTIAGO DE MACHACA,consulta externa,nuevas en personas de 60 anos o mas,2006-05-01,16,26,16,26,42
SANTIVAÑES,consulta externa,nuevas en personas de 60 anos o mas,2006-05-01,27,41,27,41,68
SANTUARIO DE QUILLACAS,consulta externa,nuevas en personas de 60 anos o mas,2006-05-01,18,22,18,22,40
SAPAHAQUI,consulta externa,nuevas en personas de 60 anos o mas,2006-05-01,41,28,41,28,69
SENA,consulta externa,nuevas en personas de 60 anos o mas,2006-05-01,15,6,15,6,21
SICA SICA (VILLA AROMA),consulta externa,nuevas en personas de 60 anos o mas,2006-05-01,22,55,22,55,77
SICAYA,consulta externa,nuevas en personas de 60 anos o mas,2006-05-01,3,4,3,4,7
SIPE SIPE,consulta externa,nuevas en personas de 60 anos o mas,2006-05-01,30,50,30,50,80
SOPACHUY,consulta externa,nuevas en personas de 60 anos o mas,2006-05-01,39,67,39,67,106
SORACACHI,consulta externa,nuevas en personas de 60 anos o mas,2006-05-01,7,12,7,12,19
SORATA,consulta externa,nuevas en personas de 60 anos o mas,2006-05-01,41,57,41,57,98
SUCRE,consulta externa,nuevas en personas de 60 anos o mas,2006-05-01,2626,3532,2626,3532,6158
TACACHI,consulta externa,nuevas en personas de 60 anos o mas,2006-05-01,1,5,1,5,6
TACACOMA,consulta externa,nuevas en personas de 60 anos o mas,2006-05-01,24,19,24,19,43
TACOBAMBA,consulta externa,nuevas en personas de 60 anos o mas,2006-05-01,25,48,25,48,73
TACOPAYA,consulta externa,nuevas en personas de 60 anos o mas,2006-05-01,17,27,17,27,44
TAHUA,consulta externa,nuevas en personas de 60 anos o mas,2006-05-01,9,4,9,4,13
TAPACARI,consulta externa,nuevas en personas de 60 anos o mas,2006-05-01,68,87,68,87,155
TARABUCO,consulta externa,nuevas en personas de 60 anos o mas,2006-05-01,101,155,101,155,256
TARACO,consulta externa,nuevas en personas de 60 anos o mas,2006-05-01,16,16,16,16,32
TARATA,consulta externa,nuevas en personas de 60 anos o mas,2006-05-01,12,12,12,12,24
TARIJA,consulta externa,nuevas en personas de 60 anos o mas,2006-05-01,1954,2145,1954,2145,4099
TARVITA,consulta externa,nuevas en personas de 60 anos o mas,2006-05-01,89,115,89,115,204
TEOPONTE,consulta externa,nuevas en personas de 60 anos o mas,2006-05-01,76,58,76,58,134
TIAWANACU,consulta externa,nuevas en personas de 60 anos o mas,2006-05-01,16,24,16,24,40
TINGUIPAYA,consulta externa,nuevas en personas de 60 anos o mas,2006-05-01,66,85,66,85,151
TIPUANI,consulta externa,nuevas en personas de 60 anos o mas,2006-05-01,21,19,21,19,40
TIQUIPAYA,consulta externa,nuevas en personas de 60 anos o mas,2006-05-01,23,236,23,236,259
TIRAQUE (CBBA),consulta externa,nuevas en personas de 60 anos o mas,2006-05-01,56,56,56,56,112
TITO YUPANQUI (PARQUIPUJIO),consulta externa,nuevas en personas de 60 anos o mas,2006-05-01,11,18,11,18,29
TOCO,consulta externa,nuevas en personas de 60 anos o mas,2006-05-01,9,6,9,6,15
TODOS SANTOS,consulta externa,nuevas en personas de 60 anos o mas,2006-05-01,1,1,1,1,2
TOLATA,consulta externa,nuevas en personas de 60 anos o mas,2006-05-01,6,22,6,22,28
TOLEDO,consulta externa,nuevas en personas de 60 anos o mas,2006-05-01,36,38,36,38,74
TOMAVE,consulta externa,nuevas en personas de 60 anos o mas,2006-05-01,68,100,68,100,168
TOMINA,consulta externa,nuevas en personas de 60 anos o mas,2006-05-01,51,64,51,64,115
TORO TORO,consulta externa,nuevas en personas de 60 anos o mas,2006-05-01,43,75,43,75,118
TOTORA(CBBA),consulta externa,nuevas en personas de 60 anos o mas,2006-05-01,22,17,22,17,39
TOTORA(ORR),consulta externa,nuevas en personas de 60 anos o mas,2006-05-01,12,13,12,13,25
TRIGAL,consulta externa,nuevas en personas de 60 anos o mas,2006-05-01,22,27,22,27,49
TRINIDAD,consulta externa,nuevas en personas de 60 anos o mas,2006-05-01,713,847,713,847,1560
TUPIZA,consulta externa,nuevas en personas de 60 anos o mas,2006-05-01,397,614,397,614,1011
TURCO,consulta externa,nuevas en personas de 60 anos o mas,2006-05-01,42,39,42,39,81
UMALA,consulta externa,nuevas en personas de 60 anos o mas,2006-05-01,34,34,34,34,68
UNCIA,consulta externa,nuevas en personas de 60 anos o mas,2006-05-01,149,260,149,260,409
URIONDO (A. CONCEPCION),consulta externa,nuevas en personas de 60 anos o mas,2006-05-01,43,93,43,93,136
URUBICHA,consulta externa,nuevas en personas de 60 anos o mas,2006-05-01,0,6,0,6,6
UYUNI,consulta externa,nuevas en personas de 60 anos o mas,2006-05-01,229,226,229,226,455
VACAS,consulta externa,nuevas en personas de 60 anos o mas,2006-05-01,24,44,24,44,68
VALLEGRANDE,consulta externa,nuevas en personas de 60 anos o mas,2006-05-01,172,223,172,223,395
VIACHA,consulta externa,nuevas en personas de 60 anos o mas,2006-05-01,327,286,327,286,613
VILA VILA,consulta externa,nuevas en personas de 60 anos o mas,2006-05-01,3,9,3,9,12
VILLA MONTES,consulta externa,nuevas en personas de 60 anos o mas,2006-05-01,83,89,83,89,172
VILLA NUEVA (LOMA ALTA),consulta externa,nuevas en personas de 60 anos o mas,2006-05-01,8,3,8,3,11
VILLA RIVERO,consulta externa,nuevas en personas de 60 anos o mas,2006-05-01,9,18,9,18,27
VILLA SERRANO,consulta externa,nuevas en personas de 60 anos o mas,2006-05-01,64,87,64,87,151
VILLA TUNARI,consulta externa,nuevas en personas de 60 anos o mas,2006-05-01,142,123,142,123,265
VILLA VACA GUZMAN (MUYUPAMPA),consulta externa,nuevas en personas de 60 anos o mas,2006-05-01,59,90,59,90,149
VILLAZON,consulta externa,nuevas en personas de 60 anos o mas,2006-05-01,234,302,234,302,536
VINTO,consulta externa,nuevas en personas de 60 anos o mas,2006-05-01,37,54,37,54,91
VITICHI,consulta externa,nuevas en personas de 60 anos o mas,2006-05-01,108,180,108,180,288
WALDO BALLIVIAN,consulta externa,nuevas en personas de 60 anos o mas,2006-05-01,3,7,3,7,10
WARNES,consulta externa,nuevas en personas de 60 anos o mas,2006-05-01,55,55,55,55,110
YACO,consulta externa,nuevas en personas de 60 anos o mas,2006-05-01,12,12,12,12,24
YACUIBA,consulta externa,nuevas en personas de 60 anos o mas,2006-05-01,476,652,476,652,1128
YAMPARAEZ,consulta externa,nuevas en personas de 60 anos o mas,2006-05-01,37,49,37,49,86
YANACACHI,consulta externa,nuevas en personas de 60 anos o mas,2006-05-01,10,16,10,16,26
YAPACANI,consulta externa,nuevas en personas de 60 anos o mas,2006-05-01,144,104,144,104,248
YOCALLA,consulta externa,nuevas en personas de 60 anos o mas,2006-05-01,47,31,47,31,78
YOTALA,consulta externa,nuevas en personas de 60 anos o mas,2006-05-01,23,66,23,66,89
YUNCHARA,consulta externa,nuevas en personas de 60 anos o mas,2006-05-01,8,19,8,19,27
ZUDAÑEZ,consulta externa,nuevas en personas de 60 anos o mas,2006-05-01,44,84,44,84,128
ACACIO,consulta externa,nuevas en personas de 60 anos o mas,2006-06-01,28,48,28,48,76
ACHACACHI,consulta externa,nuevas en personas de 60 anos o mas,2006-06-01,158,171,158,171,329
ACHOCALLA,consulta externa,nuevas en personas de 60 anos o mas,2006-06-01,17,7,17,7,24
AIQUILE,consulta externa,nuevas en personas de 60 anos o mas,2006-06-01,84,113,84,113,197
ALALAY,consulta externa,nuevas en personas de 60 anos o mas,2006-06-01,4,3,4,3,7
ALCALA,consulta externa,nuevas en personas de 60 anos o mas,2006-06-01,20,47,20,47,67
ANCORAIMES,consulta externa,nuevas en personas de 60 anos o mas,2006-06-01,33,23,33,23,56
ANDAMARCA,consulta externa,nuevas en personas de 60 anos o mas,2006-06-01,19,22,19,22,41
ANTEQUERA,consulta externa,nuevas en personas de 60 anos o mas,2006-06-01,8,11,8,11,19
ANZALDO,consulta externa,nuevas en personas de 60 anos o mas,2006-06-01,22,22,22,22,44
APOLO,consulta externa,nuevas en personas de 60 anos o mas,2006-06-01,53,50,53,50,103
ARAMPAMPA,consulta externa,nuevas en personas de 60 anos o mas,2006-06-01,9,10,9,10,19
ARANI,consulta externa,nuevas en personas de 60 anos o mas,2006-06-01,10,17,10,17,27
ARBIETO,consulta externa,nuevas en personas de 60 anos o mas,2006-06-01,24,36,24,36,60
ARQUE,consulta externa,nuevas en personas de 60 anos o mas,2006-06-01,11,18,11,18,29
ASCENCION DE GUARAYOS,consulta externa,nuevas en personas de 60 anos o mas,2006-06-01,29,29,29,29,58
ATOCHA,consulta externa,nuevas en personas de 60 anos o mas,2006-06-01,64,105,64,105,169
AUCAPATA,consulta externa,nuevas en personas de 60 anos o mas,2006-06-01,25,32,25,32,57
AYATA,consulta externa,nuevas en personas de 60 anos o mas,2006-06-01,11,9,11,9,20
AYO AYO,consulta externa,nuevas en personas de 60 anos o mas,2006-06-01,18,6,18,6,24
AYOPAYA (V. DE INDEPENDENCIA),consulta externa,nuevas en personas de 60 anos o mas,2006-06-01,50,70,50,70,120
AZURDUY,consulta externa,nuevas en personas de 60 anos o mas,2006-06-01,87,94,87,94,181
BATALLAS,consulta externa,nuevas en personas de 60 anos o mas,2006-06-01,49,25,49,25,74
BAURES,consulta externa,nuevas en personas de 60 anos o mas,2006-06-01,46,49,46,49,95
BELEN DE ANDAMARCA,consulta externa,nuevas en personas de 60 anos o mas,2006-06-01,7,13,7,13,20
BELEN DE URMIRI,consulta externa,nuevas en personas de 60 anos o mas,2006-06-01,10,13,10,13,23
BELLA FLOR,consulta externa,nuevas en personas de 60 anos o mas,2006-06-01,14,10,14,10,24
BERMEJO,consulta externa,nuevas en personas de 60 anos o mas,2006-06-01,254,307,254,307,561
BETANZOS,consulta externa,nuevas en personas de 60 anos o mas,2006-06-01,163,260,163,260,423
BOLIVAR,consulta externa,nuevas en personas de 60 anos o mas,2006-06-01,14,15,14,15,29
BOLPEBRA,consulta externa,nuevas en personas de 60 anos o mas,2006-06-01,8,2,8,2,10
BOYUIBE,consulta externa,nuevas en personas de 60 anos o mas,2006-06-01,35,29,35,29,64
BUENA VISTA,consulta externa,nuevas en personas de 60 anos o mas,2006-06-01,104,111,104,111,215
CABEZAS,consulta externa,nuevas en personas de 60 anos o mas,2006-06-01,26,43,26,43,69
CAIROMA,consulta externa,nuevas en personas de 60 anos o mas,2006-06-01,28,30,28,30,58
"CAIZA ""D""",consulta externa,nuevas en personas de 60 anos o mas,2006-06-01,75,113,75,113,188
CAJUATA,consulta externa,nuevas en personas de 60 anos o mas,2006-06-01,20,26,20,26,46
CALACOTO,consulta externa,nuevas en personas de 60 anos o mas,2006-06-01,23,37,23,37,60
CALAMARCA,consulta externa,nuevas en personas de 60 anos o mas,2006-06-01,25,22,25,22,47
CAMARGO,consulta externa,nuevas en personas de 60 anos o mas,2006-06-01,135,203,135,203,338
CAMATAQUI (C. VILLA ABECIA),consulta externa,nuevas en personas de 60 anos o mas,2006-06-01,26,43,26,43,69
CAMIRI,consulta externa,nuevas en personas de 60 anos o mas,2006-06-01,546,793,546,793,1339
CAPINOTA,consulta externa,nuevas en personas de 60 anos o mas,2006-06-01,41,63,41,63,104
CAQUIAVIRI,consulta externa,nuevas en personas de 60 anos o mas,2006-06-01,37,45,37,45,82
CARACOLLO,consulta externa,nuevas en personas de 60 anos o mas,2006-06-01,117,100,117,100,217
CARANAVI,consulta externa,nuevas en personas de 60 anos o mas,2006-06-01,265,137,265,137,402
CARANGAS,consulta externa,nuevas en personas de 60 anos o mas,2006-06-01,1,0,1,0,1
CARAPARI,consulta externa,nuevas en personas de 60 anos o mas,2006-06-01,62,54,62,54,116
CARIPUYO,consulta externa,nuevas en personas de 60 anos o mas,2006-06-01,7,16,7,16,23
CARMEN RIVERO TORREZ,consulta externa,nuevas en personas de 60 anos o mas,2006-06-01,4,4,4,4,8
CATACORA,consulta externa,nuevas en personas de 60 anos o mas,2006-06-01,2,4,2,4,6
CHACARILLA,consulta externa,nuevas en personas de 60 anos o mas,2006-06-01,3,4,3,4,7
CHALLAPATA,consulta externa,nuevas en personas de 60 anos o mas,2006-06-01,73,40,73,40,113
CHAQUI,consulta externa,nuevas en personas de 60 anos o mas,2006-06-01,23,29,23,29,52
CHARAGUA,consulta externa,nuevas en personas de 60 anos o mas,2006-06-01,62,40,62,40,102
CHARAÑA,consulta externa,nuevas en personas de 60 anos o mas,2006-06-01,4,6,4,6,10
CHAYANTA,consulta externa,nuevas en personas de 60 anos o mas,2006-06-01,56,105,56,105,161
CHIMORE,consulta externa,nuevas en personas de 60 anos o mas,2006-06-01,18,15,18,15,33
CHIPAYA,consulta externa,nuevas en personas de 60 anos o mas,2006-06-01,5,3,5,3,8
CHOQUE COTA,consulta externa,nuevas en personas de 60 anos o mas,2006-06-01,7,6,7,6,13
CHULUMANI (V. DE LA LIBERTAD),consulta externa,nuevas en personas de 60 anos o mas,2006-06-01,75,47,75,47,122
CHUMA,consulta externa,nuevas en personas de 60 anos o mas,2006-06-01,88,70,88,70,158
CLIZA,consulta externa,nuevas en personas de 60 anos o mas,2006-06-01,22,26,22,26,48
COBIJA,consulta externa,nuevas en personas de 60 anos o mas,2006-06-01,215,321,215,321,536
COCHABAMBA,consulta externa,nuevas en personas de 60 anos o mas,2006-06-01,5048,5960,5048,5960,11008
COIPASA,consulta externa,nuevas en personas de 60 anos o mas,2006-06-01,8,2,8,2,10
COLCAPIRHUA,consulta externa,nuevas en personas de 60 anos o mas,2006-06-01,148,181,148,181,329
"COLCHA ""K""",consulta externa,nuevas en personas de 60 anos o mas,2006-06-01,59,72,59,72,131
COLLANA,consulta externa,nuevas en personas de 60 anos o mas,2006-06-01,12,12,12,12,24
COLOMI,consulta externa,nuevas en personas de 60 anos o mas,2006-06-01,13,15,13,15,28
COLPA BELGICA,consulta externa,nuevas en personas de 60 anos o mas,2006-06-01,69,49,69,49,118
COLQUECHACA,consulta externa,nuevas en personas de 60 anos o mas,2006-06-01,82,124,82,124,206
COLQUENCHA,consulta externa,nuevas en personas de 60 anos o mas,2006-06-01,28,37,28,37,65
COLQUIRI,consulta externa,nuevas en personas de 60 anos o mas,2006-06-01,58,47,58,47,105
COMANCHE,consulta externa,nuevas en personas de 60 anos o mas,2006-06-01,12,8,12,8,20
COMARAPA,consulta externa,nuevas en personas de 60 anos o mas,2006-06-01,89,120,89,120,209
COMBAYA,consulta externa,nuevas en personas de 60 anos o mas,2006-06-01,5,8,5,8,13
CONCEPCION,consulta externa,nuevas en personas de 60 anos o mas,2006-06-01,61,73,61,73,134
COPACABANA,consulta externa,nuevas en personas de 60 anos o mas,2006-06-01,35,43,35,43,78
CORIPATA,consulta externa,nuevas en personas de 60 anos o mas,2006-06-01,45,28,45,28,73
CORO CORO,consulta externa,nuevas en personas de 60 anos o mas,2006-06-01,24,17,24,17,41
COROICO,consulta externa,nuevas en personas de 60 anos o mas,2006-06-01,84,60,84,60,144
CORQUE,consulta externa,nuevas en personas de 60 anos o mas,2006-06-01,40,40,40,40,80
COTAGAITA,consulta externa,nuevas en personas de 60 anos o mas,2006-06-01,247,369,247,369,616
COTOCA,consulta externa,nuevas en personas de 60 anos o mas,2006-06-01,133,153,133,153,286
CUATRO CAÑADAS,consulta externa,nuevas en personas de 60 anos o mas,2006-06-01,21,31,21,31,52
CUCHUMUELA (V. G. VILLARROEL),consulta externa,nuevas en personas de 60 anos o mas,2006-06-01,3,10,3,10,13
CUEVO,consulta externa,nuevas en personas de 60 anos o mas,2006-06-01,19,42,19,42,61
CULPINA,consulta externa,nuevas en personas de 60 anos o mas,2006-06-01,50,63,50,63,113
CURAHUARA DE CARANGAS,consulta externa,nuevas en personas de 60 anos o mas,2006-06-01,30,32,30,32,62
CURVA,consulta externa,nuevas en personas de 60 anos o mas,2006-06-01,8,9,8,9,17
DESAGUADERO,consulta externa,nuevas en personas de 60 anos o mas,2006-06-01,23,22,23,22,45
EL ALTO,consulta externa,nuevas en personas de 60 anos o mas,2006-06-01,1295,1453,1295,1453,2748
EL CHORO,consulta externa,nuevas en personas de 60 anos o mas,2006-06-01,22,17,22,17,39
EL PUENTE(STC),consulta externa,nuevas en personas de 60 anos o mas,2006-06-01,23,30,23,30,53
EL PUENTE(TJA),consulta externa,nuevas en personas de 60 anos o mas,2006-06-01,50,68,50,68,118
EL TORNO,consulta externa,nuevas en personas de 60 anos o mas,2006-06-01,561,501,561,501,1062
EL VILLAR,consulta externa,nuevas en personas de 60 anos o mas,2006-06-01,30,72,30,72,102
ENTRE RIOS,consulta externa,nuevas en personas de 60 anos o mas,2006-06-01,105,120,105,120,225
ENTRE RIOS,consulta externa,nuevas en personas de 60 anos o mas,2006-06-01,26,43,26,43,69
ESCARA,consulta externa,nuevas en personas de 60 anos o mas,2006-06-01,4,4,4,4,8
EUCALIPTUS,consulta externa,nuevas en personas de 60 anos o mas,2006-06-01,31,47,31,47,78
EXALTACION,consulta externa,nuevas en personas de 60 anos o mas,2006-06-01,8,7,8,7,15
FERNANDEZ ALONSO,consulta externa,nuevas en personas de 60 anos o mas,2006-06-01,8,12,8,12,20
FILADELFIA,consulta externa,nuevas en personas de 60 anos o mas,2006-06-01,12,17,12,17,29
GENERAL SAAVEDRA,consulta externa,nuevas en personas de 60 anos o mas,2006-06-01,28,27,28,27,55
GRAL. J.J. PEREZ (CHARAZANI),consulta externa,nuevas en personas de 60 anos o mas,2006-06-01,16,25,16,25,41
GUANAY,consulta externa,nuevas en personas de 60 anos o mas,2006-06-01,94,72,94,72,166
GUAQUI,consulta externa,nuevas en personas de 60 anos o mas,2006-06-01,12,17,12,17,29
GUAYARAMERIN,consulta externa,nuevas en personas de 60 anos o mas,2006-06-01,417,420,417,420,837
GUTIERREZ,consulta externa,nuevas en personas de 60 anos o mas,2006-06-01,33,52,33,52,85
HUACARETA,consulta externa,nuevas en personas de 60 anos o mas,2006-06-01,66,55,66,55,121
HUACAYA (VILLA DE HUACAYA),consulta externa,nuevas en personas de 60 anos o mas,2006-06-01,8,15,8,15,23
HUACHACALLA,consulta externa,nuevas en personas de 60 anos o mas,2006-06-01,4,1,4,1,5
HUANUNI,consulta externa,nuevas en personas de 60 anos o mas,2006-06-01,139,160,139,160,299
HUARACAJE,consulta externa,nuevas en personas de 60 anos o mas,2006-06-01,8,7,8,7,15
HUAYLLAMARCA,consulta externa,nuevas en personas de 60 anos o mas,2006-06-01,24,33,24,33,57
ICHOCA,consulta externa,nuevas en personas de 60 anos o mas,2006-06-01,13,17,13,17,30
ICLA,consulta externa,nuevas en personas de 60 anos o mas,2006-06-01,38,70,38,70,108
INCAHUASI,consulta externa,nuevas en personas de 60 anos o mas,2006-06-01,55,80,55,80,135
INGAVI (HUMAITA),consulta externa,nuevas en personas de 60 anos o mas,2006-06-01,6,4,6,4,10
INQUISIVI,consulta externa,nuevas en personas de 60 anos o mas,2006-06-01,34,32,34,32,66
IRUPANA (VILLA DE LANZA),consulta externa,nuevas en personas de 60 anos o mas,2006-06-01,53,40,53,40,93
IXIAMAS,consulta externa,nuevas en personas de 60 anos o mas,2006-06-01,24,16,24,16,40
JESUS DE MACHACA,consulta externa,nuevas en personas de 60 anos o mas,2006-06-01,47,75,47,75,122
LA ASUNTA,consulta externa,nuevas en personas de 60 anos o mas,2006-06-01,24,15,24,15,39
LA GUARDIA,consulta externa,nuevas en personas de 60 anos o mas,2006-06-01,65,71,65,71,136
LA PAZ,consulta externa,nuevas en personas de 60 anos o mas,2006-06-01,8602,10198,8602,10198,18800
LA RIVERA,consulta externa,nuevas en personas de 60 anos o mas,2006-06-01,2,2,2,2,4
LAGUNILLAS,consulta externa,nuevas en personas de 60 anos o mas,2006-06-01,32,43,32,43,75
LAJA,consulta externa,nuevas en personas de 60 anos o mas,2006-06-01,23,24,23,24,47
LAS CARRERAS,consulta externa,nuevas en personas de 60 anos o mas,2006-06-01,38,31,38,31,69
LICOMA PAMPA,consulta externa,nuevas en personas de 60 anos o mas,2006-06-01,29,21,29,21,50
LLALLAGUA,consulta externa,nuevas en personas de 60 anos o mas,2006-06-01,291,497,291,497,788
LLICA,consulta externa,nuevas en personas de 60 anos o mas,2006-06-01,25,26,25,26,51
LORETO,consulta externa,nuevas en personas de 60 anos o mas,2006-06-01,12,19,12,19,31
LURIBAY,consulta externa,nuevas en personas de 60 anos o mas,2006-06-01,48,36,48,36,84
MACHACAMARCA,consulta externa,nuevas en personas de 60 anos o mas,2006-06-01,63,61,63,61,124
MACHARETI,consulta externa,nuevas en personas de 60 anos o mas,2006-06-01,59,40,59,40,99
MAGDALENA,consulta externa,nuevas en personas de 60 anos o mas,2006-06-01,38,28,38,28,66
MAIRANA,consulta externa,nuevas en personas de 60 anos o mas,2006-06-01,65,83,65,83,148
MALLA,consulta externa,nuevas en personas de 60 anos o mas,2006-06-01,6,13,6,13,19
MAPIRI,consulta externa,nuevas en personas de 60 anos o mas,2006-06-01,50,48,50,48,98
MECAPACA,consulta externa,nuevas en personas de 60 anos o mas,2006-06-01,41,29,41,29,70
MINEROS,consulta externa,nuevas en personas de 60 anos o mas,2006-06-01,12,9,12,9,21
MIZQUE,consulta externa,nuevas en personas de 60 anos o mas,2006-06-01,45,48,45,48,93
MOCOMOCO,consulta externa,nuevas en personas de 60 anos o mas,2006-06-01,57,58,57,58,115
MOJINETE,consulta externa,nuevas en personas de 60 anos o mas,2006-06-01,12,14,12,14,26
MOJOCOYA,consulta externa,nuevas en personas de 60 anos o mas,2006-06-01,40,55,40,55,95
MONTEAGUDO,consulta externa,nuevas en personas de 60 anos o mas,2006-06-01,412,558,412,558,970
MONTERO,consulta externa,nuevas en personas de 60 anos o mas,2006-06-01,453,511,453,511,964
MORO MORO,consulta externa,nuevas en personas de 60 anos o mas,2006-06-01,14,15,14,15,29
MOROCHATA,consulta externa,nuevas en personas de 60 anos o mas,2006-06-01,28,31,28,31,59
NACEBE (SANTA ROSA DEL ABUNA),consulta externa,nuevas en personas de 60 anos o mas,2006-06-01,10,2,10,2,12
NAZACARA DE PACAJES,consulta externa,nuevas en personas de 60 anos o mas,2006-06-01,0,5,0,5,5
OCURI,consulta externa,nuevas en personas de 60 anos o mas,2006-06-01,26,33,26,33,59
OKINAWA,consulta externa,nuevas en personas de 60 anos o mas,2006-06-01,48,71,48,71,119
OMEREQUE,consulta externa,nuevas en personas de 60 anos o mas,2006-06-01,17,19,17,19,36
ORURO,consulta externa,nuevas en personas de 60 anos o mas,2006-06-01,2875,3110,2875,3110,5985
PADCAYA,consulta externa,nuevas en personas de 60 anos o mas,2006-06-01,104,136,104,136,240
PADILLA,consulta externa,nuevas en personas de 60 anos o mas,2006-06-01,168,252,168,252,420
PAILON,consulta externa,nuevas en personas de 60 anos o mas,2006-06-01,11,9,11,9,20
PALCA,consulta externa,nuevas en personas de 60 anos o mas,2006-06-01,16,20,16,20,36
PALOS BLANCOS,consulta externa,nuevas en personas de 60 anos o mas,2006-06-01,54,28,54,28,82
PAMPA AULLAGAS,consulta externa,nuevas en personas de 60 anos o mas,2006-06-01,17,20,17,20,37
PAMPA GRANDE,consulta externa,nuevas en personas de 60 anos o mas,2006-06-01,15,45,15,45,60
PAPEL PAMPA,consulta externa,nuevas en personas de 60 anos o mas,2006-06-01,31,30,31,30,61
PASORAPA,consulta externa,nuevas en personas de 60 anos o mas,2006-06-01,2,5,2,5,7
PATACAMAYA,consulta externa,nuevas en personas de 60 anos o mas,2006-06-01,27,31,27,31,58
PAZÑA,consulta externa,nuevas en personas de 60 anos o mas,2006-06-01,22,27,22,27,49
PELECHUCO,consulta externa,nuevas en personas de 60 anos o mas,2006-06-01,16,13,16,13,29
POCOATA,consulta externa,nuevas en personas de 60 anos o mas,2006-06-01,65,55,65,55,120
POCONA,consulta externa,nuevas en personas de 60 anos o mas,2006-06-01,14,39,14,39,53
POJO (CBBA),consulta externa,nuevas en personas de 60 anos o mas,2006-06-01,8,20,8,20,28
POOPO,consulta externa,nuevas en personas de 60 anos o mas,2006-06-01,40,33,40,33,73
PORCO,consulta externa,nuevas en personas de 60 anos o mas,2006-06-01,11,26,11,26,37
POROMA,consulta externa,nuevas en personas de 60 anos o mas,2006-06-01,63,65,63,65,128
PORONGO,consulta externa,nuevas en personas de 60 anos o mas,2006-06-01,40,22,40,22,62
PORTACHUELO,consulta externa,nuevas en personas de 60 anos o mas,2006-06-01,141,132,141,132,273
PORVENIR,consulta externa,nuevas en personas de 60 anos o mas,2006-06-01,16,17,16,17,33
POSTRER VALLE,consulta externa,nuevas en personas de 60 anos o mas,2006-06-01,29,27,29,27,56
POTOSI,consulta externa,nuevas en personas de 60 anos o mas,2006-06-01,1765,1725,1765,1725,3490
PRESTO,consulta externa,nuevas en personas de 60 anos o mas,2006-06-01,29,49,29,49,78
PUCARA,consulta externa,nuevas en personas de 60 anos o mas,2006-06-01,40,50,40,50,90
PUCARANI,consulta externa,nuevas en personas de 60 anos o mas,2006-06-01,50,45,50,45,95
PUERTO ACOSTA,consulta externa,nuevas en personas de 60 anos o mas,2006-06-01,194,160,194,160,354
PUERTO CARABUCO,consulta externa,nuevas en personas de 60 anos o mas,2006-06-01,53,64,53,64,117
PUERTO GONZALO MORENO,consulta externa,nuevas en personas de 60 anos o mas,2006-06-01,16,12,16,12,28
PUERTO PEREZ,consulta externa,nuevas en personas de 60 anos o mas,2006-06-01,30,43,30,43,73
PUERTO QUIJARRO,consulta externa,nuevas en personas de 60 anos o mas,2006-06-01,147,133,147,133,280
PUERTO RICO,consulta externa,nuevas en personas de 60 anos o mas,2006-06-01,17,8,17,8,25
PUERTO SILES,consulta externa,nuevas en personas de 60 anos o mas,2006-06-01,1,3,1,3,4
PUERTO SUAREZ,consulta externa,nuevas en personas de 60 anos o mas,2006-06-01,107,110,107,110,217
PUERTO VILLARROEL,consulta externa,nuevas en personas de 60 anos o mas,2006-06-01,50,44,50,44,94
PUNA,consulta externa,nuevas en personas de 60 anos o mas,2006-06-01,170,223,170,223,393
PUNATA,consulta externa,nuevas en personas de 60 anos o mas,2006-06-01,135,110,135,110,245
QUIABAYA,consulta externa,nuevas en personas de 60 anos o mas,2006-06-01,10,12,10,12,22
QUILLACOLLO,consulta externa,nuevas en personas de 60 anos o mas,2006-06-01,344,366,344,366,710
QUIME,consulta externa,nuevas en personas de 60 anos o mas,2006-06-01,18,27,18,27,45
QUIRUSILLAS,consulta externa,nuevas en personas de 60 anos o mas,2006-06-01,17,13,17,13,30
RAVELO,consulta externa,nuevas en personas de 60 anos o mas,2006-06-01,45,56,45,56,101
REYES,consulta externa,nuevas en personas de 60 anos o mas,2006-06-01,118,105,118,105,223
RIBERALTA,consulta externa,nuevas en personas de 60 anos o mas,2006-06-01,113,94,113,94,207
ROBORE,consulta externa,nuevas en personas de 60 anos o mas,2006-06-01,55,56,55,56,111
RURRENABAQUE,consulta externa,nuevas en personas de 60 anos o mas,2006-06-01,165,128,165,128,293
SABAYA,consulta externa,nuevas en personas de 60 anos o mas,2006-06-01,25,32,25,32,57
SACABA,consulta externa,nuevas en personas de 60 anos o mas,2006-06-01,112,164,112,164,276
SACABAMBA,consulta externa,nuevas en personas de 60 anos o mas,2006-06-01,10,9,10,9,19
SACACA,consulta externa,nuevas en personas de 60 anos o mas,2006-06-01,74,145,74,145,219
SAIPINA,consulta externa,nuevas en personas de 60 anos o mas,2006-06-01,70,117,70,117,187
SALINAS DE GARCI MENDOZA,consulta externa,nuevas en personas de 60 anos o mas,2006-06-01,41,46,41,46,87
SAMAIPATA,consulta externa,nuevas en personas de 60 anos o mas,2006-06-01,62,58,62,58,120
SAN AGUSTIN,consulta externa,nuevas en personas de 60 anos o mas,2006-06-01,8,21,8,21,29
SAN ANDRES,consulta externa,nuevas en personas de 60 anos o mas,2006-06-01,10,14,10,14,24
SAN ANDRES DE MACHACA,consulta externa,nuevas en personas de 60 anos o mas,2006-06-01,47,68,47,68,115
SAN ANTONIO DE ESMORUCO,consulta externa,nuevas en personas de 60 anos o mas,2006-06-01,2,4,2,4,6
SAN ANTONIO DE LOMERIO,consulta externa,nuevas en personas de 60 anos o mas,2006-06-01,10,9,10,9,19
SAN BENITO,consulta externa,nuevas en personas de 60 anos o mas,2006-06-01,26,38,26,38,64
SAN BORJA,consulta externa,nuevas en personas de 60 anos o mas,2006-06-01,109,84,109,84,193
SAN BUENA VENTURA,consulta externa,nuevas en personas de 60 anos o mas,2006-06-01,10,11,10,11,21
SAN CARLOS,consulta externa,nuevas en personas de 60 anos o mas,2006-06-01,195,167,195,167,362
SAN IGNACIO,consulta externa,nuevas en personas de 60 anos o mas,2006-06-01,91,104,91,104,195
SAN IGNACIO DE VELASCO,consulta externa,nuevas en personas de 60 anos o mas,2006-06-01,206,270,206,270,476
SAN JAVIER(BNI),consulta externa,nuevas en personas de 60 anos o mas,2006-06-01,4,5,4,5,9
SAN JAVIER(STC),consulta externa,nuevas en personas de 60 anos o mas,2006-06-01,17,9,17,9,26
SAN JOAQUIN,consulta externa,nuevas en personas de 60 anos o mas,2006-06-01,80,92,80,92,172
SAN JOSE DE CHIQUITOS,consulta externa,nuevas en personas de 60 anos o mas,2006-06-01,68,114,68,114,182
SAN JUAN DE YAPACANI,consulta externa,nuevas en personas de 60 anos o mas,2006-06-01,53,35,53,35,88
SAN JULIAN,consulta externa,nuevas en personas de 60 anos o mas,2006-06-01,87,69,87,69,156
SAN LORENZO(PND),consulta externa,nuevas en personas de 60 anos o mas,2006-06-01,4,3,4,3,7
SAN LORENZO(TJA),consulta externa,nuevas en personas de 60 anos o mas,2006-06-01,68,112,68,112,180
SAN LUCAS,consulta externa,nuevas en personas de 60 anos o mas,2006-06-01,119,219,119,219,338
SAN MATIAS,consulta externa,nuevas en personas de 60 anos o mas,2006-06-01,20,10,20,10,30
SAN MIGUEL DE VELASCO,consulta externa,nuevas en personas de 60 anos o mas,2006-06-01,46,71,46,71,117
SAN PABLO DE LIPEZ,consulta externa,nuevas en personas de 60 anos o mas,2006-06-01,16,23,16,23,39
SAN PEDRO,consulta externa,nuevas en personas de 60 anos o mas,2006-06-01,29,31,29,31,60
SAN PEDRO DE BUENA VISTA,consulta externa,nuevas en personas de 60 anos o mas,2006-06-01,35,56,35,56,91
SAN PEDRO DE CURAHUARA,consulta externa,nuevas en personas de 60 anos o mas,2006-06-01,15,20,15,20,35
SAN PEDRO DE QUEMES,consulta externa,nuevas en personas de 60 anos o mas,2006-06-01,5,1,5,1,6
SAN PEDRO DE TIQUINA,consulta externa,nuevas en personas de 60 anos o mas,2006-06-01,52,42,52,42,94
SAN PEDRO(PND),consulta externa,nuevas en personas de 60 anos o mas,2006-06-01,4,8,4,8,12
SAN RAFAEL,consulta externa,nuevas en personas de 60 anos o mas,2006-06-01,5,9,5,9,14
SAN RAMON,consulta externa,nuevas en personas de 60 anos o mas,2006-06-01,43,40,43,40,83
SAN RAMON,consulta externa,nuevas en personas de 60 anos o mas,2006-06-01,8,12,8,12,20
SANTA ANA,consulta externa,nuevas en personas de 60 anos o mas,2006-06-01,92,133,92,133,225
SANTA CRUZ DE LA SIERRA,consulta externa,nuevas en personas de 60 anos o mas,2006-06-01,3987,5691,3987,5691,9678
SANTA ROSA,consulta externa,nuevas en personas de 60 anos o mas,2006-06-01,22,22,22,22,44
SANTA ROSA DEL SARA,consulta externa,nuevas en personas de 60 anos o mas,2006-06-01,36,37,36,37,73
SANTIAGO DE CALLAPA,consulta externa,nuevas en personas de 60 anos o mas,2006-06-01,10,21,10,21,31
SANTIAGO DE HUARI,consulta externa,nuevas en personas de 60 anos o mas,2006-06-01,80,113,80,113,193
SANTIAGO DE MACHACA,consulta externa,nuevas en personas de 60 anos o mas,2006-06-01,9,15,9,15,24
SANTIVAÑES,consulta externa,nuevas en personas de 60 anos o mas,2006-06-01,31,39,31,39,70
SANTUARIO DE QUILLACAS,consulta externa,nuevas en personas de 60 anos o mas,2006-06-01,14,9,14,9,23
SAPAHAQUI,consulta externa,nuevas en personas de 60 anos o mas,2006-06-01,36,34,36,34,70
SENA,consulta externa,nuevas en personas de 60 anos o mas,2006-06-01,17,8,17,8,25
SICA SICA (VILLA AROMA),consulta externa,nuevas en personas de 60 anos o mas,2006-06-01,32,27,32,27,59
SICAYA,consulta externa,nuevas en personas de 60 anos o mas,2006-06-01,4,7,4,7,11
SIPE SIPE,consulta externa,nuevas en personas de 60 anos o mas,2006-06-01,33,44,33,44,77
SOPACHUY,consulta externa,nuevas en personas de 60 anos o mas,2006-06-01,34,61,34,61,95
SORACACHI,consulta externa,nuevas en personas de 60 anos o mas,2006-06-01,6,7,6,7,13
SORATA,consulta externa,nuevas en personas de 60 anos o mas,2006-06-01,54,58,54,58,112
SUCRE,consulta externa,nuevas en personas de 60 anos o mas,2006-06-01,2670,3257,2670,3257,5927
TACACHI,consulta externa,nuevas en personas de 60 anos o mas,2006-06-01,3,5,3,5,8
TACACOMA,consulta externa,nuevas en personas de 60 anos o mas,2006-06-01,66,50,66,50,116
TACOBAMBA,consulta externa,nuevas en personas de 60 anos o mas,2006-06-01,22,35,22,35,57
TACOPAYA,consulta externa,nuevas en personas de 60 anos o mas,2006-06-01,13,16,13,16,29
TAHUA,consulta externa,nuevas en personas de 60 anos o mas,2006-06-01,5,4,5,4,9
TAPACARI,consulta externa,nuevas en personas de 60 anos o mas,2006-06-01,79,108,79,108,187
TARABUCO,consulta externa,nuevas en personas de 60 anos o mas,2006-06-01,58,118,58,118,176
TARACO,consulta externa,nuevas en personas de 60 anos o mas,2006-06-01,17,14,17,14,31
TARATA,consulta externa,nuevas en personas de 60 anos o mas,2006-06-01,6,18,6,18,24
TARIJA,consulta externa,nuevas en personas de 60 anos o mas,2006-06-01,1720,2196,1720,2196,3916
TARVITA,consulta externa,nuevas en personas de 60 anos o mas,2006-06-01,81,95,81,95,176
TEOPONTE,consulta externa,nuevas en personas de 60 anos o mas,2006-06-01,67,66,67,66,133
TIAWANACU,consulta externa,nuevas en personas de 60 anos o mas,2006-06-01,35,32,35,32,67
TINGUIPAYA,consulta externa,nuevas en personas de 60 anos o mas,2006-06-01,69,75,69,75,144
TIPUANI,consulta externa,nuevas en personas de 60 anos o mas,2006-06-01,22,19,22,19,41
TIQUIPAYA,consulta externa,nuevas en personas de 60 anos o mas,2006-06-01,9,27,9,27,36
TIRAQUE (CBBA),consulta externa,nuevas en personas de 60 anos o mas,2006-06-01,68,65,68,65,133
TITO YUPANQUI (PARQUIPUJIO),consulta externa,nuevas en personas de 60 anos o mas,2006-06-01,3,11,3,11,14
TOCO,consulta externa,nuevas en personas de 60 anos o mas,2006-06-01,3,9,3,9,12
TODOS SANTOS,consulta externa,nuevas en personas de 60 anos o mas,2006-06-01,5,2,5,2,7
TOLATA,consulta externa,nuevas en personas de 60 anos o mas,2006-06-01,1,11,1,11,12
TOLEDO,consulta externa,nuevas en personas de 60 anos o mas,2006-06-01,29,45,29,45,74
TOMAVE,consulta externa,nuevas en personas de 60 anos o mas,2006-06-01,53,71,53,71,124
TOMINA,consulta externa,nuevas en personas de 60 anos o mas,2006-06-01,29,48,29,48,77
TORO TORO,consulta externa,nuevas en personas de 60 anos o mas,2006-06-01,30,58,30,58,88
TOTORA(CBBA),consulta externa,nuevas en personas de 60 anos o mas,2006-06-01,23,22,23,22,45
TOTORA(ORR),consulta externa,nuevas en personas de 60 anos o mas,2006-06-01,7,4,7,4,11
TRIGAL,consulta externa,nuevas en personas de 60 anos o mas,2006-06-01,27,36,27,36,63
TRINIDAD,consulta externa,nuevas en personas de 60 anos o mas,2006-06-01,583,620,583,620,1203
TUPIZA,consulta externa,nuevas en personas de 60 anos o mas,2006-06-01,321,502,321,502,823
TURCO,consulta externa,nuevas en personas de 60 anos o mas,2006-06-01,25,29,25,29,54
UMALA,consulta externa,nuevas en personas de 60 anos o mas,2006-06-01,29,30,29,30,59
UNCIA,consulta externa,nuevas en personas de 60 anos o mas,2006-06-01,118,170,118,170,288
URIONDO (A. CONCEPCION),consulta externa,nuevas en personas de 60 anos o mas,2006-06-01,48,69,48,69,117
URUBICHA,consulta externa,nuevas en personas de 60 anos o mas,2006-06-01,3,10,3,10,13
UYUNI,consulta externa,nuevas en personas de 60 anos o mas,2006-06-01,312,156,312,156,468
VACAS,consulta externa,nuevas en personas de 60 anos o mas,2006-06-01,46,58,46,58,104
VALLEGRANDE,consulta externa,nuevas en personas de 60 anos o mas,2006-06-01,237,316,237,316,553
VIACHA,consulta externa,nuevas en personas de 60 anos o mas,2006-06-01,274,234,274,234,508
VILA VILA,consulta externa,nuevas en personas de 60 anos o mas,2006-06-01,6,9,6,9,15
VILLA MONTES,consulta externa,nuevas en personas de 60 anos o mas,2006-06-01,108,84,108,84,192
VILLA NUEVA (LOMA ALTA),consulta externa,nuevas en personas de 60 anos o mas,2006-06-01,1,0,1,0,1
VILLA RIVERO,consulta externa,nuevas en personas de 60 anos o mas,2006-06-01,13,22,13,22,35
VILLA SERRANO,consulta externa,nuevas en personas de 60 anos o mas,2006-06-01,65,85,65,85,150
VILLA TUNARI,consulta externa,nuevas en personas de 60 anos o mas,2006-06-01,131,102,131,102,233
VILLA VACA GUZMAN (MUYUPAMPA),consulta externa,nuevas en personas de 60 anos o mas,2006-06-01,54,75,54,75,129
VILLAZON,consulta externa,nuevas en personas de 60 anos o mas,2006-06-01,301,392,301,392,693
VINTO,consulta externa,nuevas en personas de 60 anos o mas,2006-06-01,8,13,8,13,21
VITICHI,consulta externa,nuevas en personas de 60 anos o mas,2006-06-01,73,119,73,119,192
WALDO BALLIVIAN,consulta externa,nuevas en personas de 60 anos o mas,2006-06-01,1,6,1,6,7
WARNES,consulta externa,nuevas en personas de 60 anos o mas,2006-06-01,54,63,54,63,117
YACO,consulta externa,nuevas en personas de 60 anos o mas,2006-06-01,12,13,12,13,25
YACUIBA,consulta externa,nuevas en personas de 60 anos o mas,2006-06-01,461,630,461,630,1091
YAMPARAEZ,consulta externa,nuevas en personas de 60 anos o mas,2006-06-01,35,49,35,49,84
YANACACHI,consulta externa,nuevas en personas de 60 anos o mas,2006-06-01,18,17,18,17,35
YAPACANI,consulta externa,nuevas en personas de 60 anos o mas,2006-06-01,137,108,137,108,245
YOCALLA,consulta externa,nuevas en personas de 60 anos o mas,2006-06-01,40,72,40,72,112
YOTALA,consulta externa,nuevas en personas de 60 anos o mas,2006-06-01,70,95,70,95,165
YUNCHARA,consulta externa,nuevas en personas de 60 anos o mas,2006-06-01,13,17,13,17,30
ZUDAÑEZ,consulta externa,nuevas en personas de 60 anos o mas,2006-06-01,90,110,90,110,200
ACACIO,consulta externa,nuevas en personas de 60 anos o mas,2006-07-01,26,45,26,45,71
ACHACACHI,consulta externa,nuevas en personas de 60 anos o mas,2006-07-01,122,149,122,149,271
ACHOCALLA,consulta externa,nuevas en personas de 60 anos o mas,2006-07-01,7,4,7,4,11
AIQUILE,consulta externa,nuevas en personas de 60 anos o mas,2006-07-01,80,86,80,86,166
ALALAY,consulta externa,nuevas en personas de 60 anos o mas,2006-07-01,2,4,2,4,6
ALCALA,consulta externa,nuevas en personas de 60 anos o mas,2006-07-01,34,49,34,49,83
ANCORAIMES,consulta externa,nuevas en personas de 60 anos o mas,2006-07-01,37,36,37,36,73
ANDAMARCA,consulta externa,nuevas en personas de 60 anos o mas,2006-07-01,22,34,22,34,56
ANTEQUERA,consulta externa,nuevas en personas de 60 anos o mas,2006-07-01,6,9,6,9,15
ANZALDO,consulta externa,nuevas en personas de 60 anos o mas,2006-07-01,9,13,9,13,22
APOLO,consulta externa,nuevas en personas de 60 anos o mas,2006-07-01,30,54,30,54,84
ARAMPAMPA,consulta externa,nuevas en personas de 60 anos o mas,2006-07-01,14,8,14,8,22
ARANI,consulta externa,nuevas en personas de 60 anos o mas,2006-07-01,12,7,12,7,19
ARBIETO,consulta externa,nuevas en personas de 60 anos o mas,2006-07-01,16,23,16,23,39
ARQUE,consulta externa,nuevas en personas de 60 anos o mas,2006-07-01,12,14,12,14,26
ASCENCION DE GUARAYOS,consulta externa,nuevas en personas de 60 anos o mas,2006-07-01,50,28,50,28,78
ATOCHA,consulta externa,nuevas en personas de 60 anos o mas,2006-07-01,74,90,74,90,164
AUCAPATA,consulta externa,nuevas en personas de 60 anos o mas,2006-07-01,31,15,31,15,46
AYATA,consulta externa,nuevas en personas de 60 anos o mas,2006-07-01,11,14,11,14,25
AYO AYO,consulta externa,nuevas en personas de 60 anos o mas,2006-07-01,13,8,13,8,21
AYOPAYA (V. DE INDEPENDENCIA),consulta externa,nuevas en personas de 60 anos o mas,2006-07-01,62,71,62,71,133
AZURDUY,consulta externa,nuevas en personas de 60 anos o mas,2006-07-01,75,94,75,94,169
BATALLAS,consulta externa,nuevas en personas de 60 anos o mas,2006-07-01,38,29,38,29,67
BAURES,consulta externa,nuevas en personas de 60 anos o mas,2006-07-01,41,35,41,35,76
BELEN DE ANDAMARCA,consulta externa,nuevas en personas de 60 anos o mas,2006-07-01,7,11,7,11,18
BELEN DE URMIRI,consulta externa,nuevas en personas de 60 anos o mas,2006-07-01,7,14,7,14,21
BELLA FLOR,consulta externa,nuevas en personas de 60 anos o mas,2006-07-01,10,8,10,8,18
BERMEJO,consulta externa,nuevas en personas de 60 anos o mas,2006-07-01,247,279,247,279,526
BETANZOS,consulta externa,nuevas en personas de 60 anos o mas,2006-07-01,179,286,179,286,465
BOLIVAR,consulta externa,nuevas en personas de 60 anos o mas,2006-07-01,27,24,27,24,51
BOLPEBRA,consulta externa,nuevas en personas de 60 anos o mas,2006-07-01,8,3,8,3,11
BOYUIBE,consulta externa,nuevas en personas de 60 anos o mas,2006-07-01,31,73,31,73,104
BUENA VISTA,consulta externa,nuevas en personas de 60 anos o mas,2006-07-01,57,50,57,50,107
CABEZAS,consulta externa,nuevas en personas de 60 anos o mas,2006-07-01,62,66,62,66,128
CAIROMA,consulta externa,nuevas en personas de 60 anos o mas,2006-07-01,44,24,44,24,68
"CAIZA ""D""",consulta externa,nuevas en personas de 60 anos o mas,2006-07-01,73,121,73,121,194
CAJUATA,consulta externa,nuevas en personas de 60 anos o mas,2006-07-01,51,48,51,48,99
CALACOTO,consulta externa,nuevas en personas de 60 anos o mas,2006-07-01,41,37,41,37,78
CALAMARCA,consulta externa,nuevas en personas de 60 anos o mas,2006-07-01,15,23,15,23,38
CAMARGO,consulta externa,nuevas en personas de 60 anos o mas,2006-07-01,214,303,214,303,517
CAMATAQUI (C. VILLA ABECIA),consulta externa,nuevas en personas de 60 anos o mas,2006-07-01,40,52,40,52,92
CAMIRI,consulta externa,nuevas en personas de 60 anos o mas,2006-07-01,607,913,607,913,1520
CAPINOTA,consulta externa,nuevas en personas de 60 anos o mas,2006-07-01,47,52,47,52,99
CAQUIAVIRI,consulta externa,nuevas en personas de 60 anos o mas,2006-07-01,37,31,37,31,68
CARACOLLO,consulta externa,nuevas en personas de 60 anos o mas,2006-07-01,94,102,94,102,196
CARANAVI,consulta externa,nuevas en personas de 60 anos o mas,2006-07-01,314,179,314,179,493
CARANGAS,consulta externa,nuevas en personas de 60 anos o mas,2006-07-01,0,1,0,1,1
CARAPARI,consulta externa,nuevas en personas de 60 anos o mas,2006-07-01,43,47,43,47,90
CARIPUYO,consulta externa,nuevas en personas de 60 anos o mas,2006-07-01,7,15,7,15,22
CARMEN RIVERO TORREZ,consulta externa,nuevas en personas de 60 anos o mas,2006-07-01,3,4,3,4,7
CATACORA,consulta externa,nuevas en personas de 60 anos o mas,2006-07-01,9,10,9,10,19
CHACARILLA,consulta externa,nuevas en personas de 60 anos o mas,2006-07-01,5,1,5,1,6
CHALLAPATA,consulta externa,nuevas en personas de 60 anos o mas,2006-07-01,107,111,107,111,218
CHAQUI,consulta externa,nuevas en personas de 60 anos o mas,2006-07-01,24,45,24,45,69
CHARAGUA,consulta externa,nuevas en personas de 60 anos o mas,2006-07-01,40,51,40,51,91
CHARAÑA,consulta externa,nuevas en personas de 60 anos o mas,2006-07-01,8,6,8,6,14
CHAYANTA,consulta externa,nuevas en personas de 60 anos o mas,2006-07-01,72,117,72,117,189
CHIMORE,consulta externa,nuevas en personas de 60 anos o mas,2006-07-01,15,11,15,11,26
CHIPAYA,consulta externa,nuevas en personas de 60 anos o mas,2006-07-01,5,2,5,2,7
CHOQUE COTA,consulta externa,nuevas en personas de 60 anos o mas,2006-07-01,17,30,17,30,47
CHULUMANI (V. DE LA LIBERTAD),consulta externa,nuevas en personas de 60 anos o mas,2006-07-01,52,37,52,37,89
CHUMA,consulta externa,nuevas en personas de 60 anos o mas,2006-07-01,59,72,59,72,131
CLIZA,consulta externa,nuevas en personas de 60 anos o mas,2006-07-01,26,39,26,39,65
COBIJA,consulta externa,nuevas en personas de 60 anos o mas,2006-07-01,228,400,228,400,628
COCHABAMBA,consulta externa,nuevas en personas de 60 anos o mas,2006-07-01,4134,5491,4134,5491,9625
COIPASA,consulta externa,nuevas en personas de 60 anos o mas,2006-07-01,4,2,4,2,6
COLCAPIRHUA,consulta externa,nuevas en personas de 60 anos o mas,2006-07-01,104,197,104,197,301
"COLCHA ""K""",consulta externa,nuevas en personas de 60 anos o mas,2006-07-01,57,63,57,63,120
COLLANA,consulta externa,nuevas en personas de 60 anos o mas,2006-07-01,6,8,6,8,14
COLOMI,consulta externa,nuevas en personas de 60 anos o mas,2006-07-01,13,16,13,16,29
COLPA BELGICA,consulta externa,nuevas en personas de 60 anos o mas,2006-07-01,63,41,63,41,104
COLQUECHACA,consulta externa,nuevas en personas de 60 anos o mas,2006-07-01,71,75,71,75,146
COLQUENCHA,consulta externa,nuevas en personas de 60 anos o mas,2006-07-01,24,33,24,33,57
COLQUIRI,consulta externa,nuevas en personas de 60 anos o mas,2006-07-01,69,46,69,46,115
COMANCHE,consulta externa,nuevas en personas de 60 anos o mas,2006-07-01,10,13,10,13,23
COMARAPA,consulta externa,nuevas en personas de 60 anos o mas,2006-07-01,131,160,131,160,291
COMBAYA,consulta externa,nuevas en personas de 60 anos o mas,2006-07-01,10,9,10,9,19
CONCEPCION,consulta externa,nuevas en personas de 60 anos o mas,2006-07-01,60,74,60,74,134
COPACABANA,consulta externa,nuevas en personas de 60 anos o mas,2006-07-01,45,52,45,52,97
CORIPATA,consulta externa,nuevas en personas de 60 anos o mas,2006-07-01,37,42,37,42,79
CORO CORO,consulta externa,nuevas en personas de 60 anos o mas,2006-07-01,22,25,22,25,47
COROICO,consulta externa,nuevas en personas de 60 anos o mas,2006-07-01,70,78,70,78,148
CORQUE,consulta externa,nuevas en personas de 60 anos o mas,2006-07-01,33,32,33,32,65
COTAGAITA,consulta externa,nuevas en personas de 60 anos o mas,2006-07-01,208,363,208,363,571
COTOCA,consulta externa,nuevas en personas de 60 anos o mas,2006-07-01,86,143,86,143,229
CUATRO CAÑADAS,consulta externa,nuevas en personas de 60 anos o mas,2006-07-01,46,37,46,37,83
CUCHUMUELA (V. G. VILLARROEL),consulta externa,nuevas en personas de 60 anos o mas,2006-07-01,1,8,1,8,9
CUEVO,consulta externa,nuevas en personas de 60 anos o mas,2006-07-01,14,36,14,36,50
CULPINA,consulta externa,nuevas en personas de 60 anos o mas,2006-07-01,86,109,86,109,195
CURAHUARA DE CARANGAS,consulta externa,nuevas en personas de 60 anos o mas,2006-07-01,62,41,62,41,103
CURVA,consulta externa,nuevas en personas de 60 anos o mas,2006-07-01,6,11,6,11,17
DESAGUADERO,consulta externa,nuevas en personas de 60 anos o mas,2006-07-01,30,33,30,33,63
EL ALTO,consulta externa,nuevas en personas de 60 anos o mas,2006-07-01,1164,1101,1164,1101,2265
EL CHORO,consulta externa,nuevas en personas de 60 anos o mas,2006-07-01,18,25,18,25,43
EL PUENTE(STC),consulta externa,nuevas en personas de 60 anos o mas,2006-07-01,31,26,31,26,57
EL PUENTE(TJA),consulta externa,nuevas en personas de 60 anos o mas,2006-07-01,40,71,40,71,111
EL TORNO,consulta externa,nuevas en personas de 60 anos o mas,2006-07-01,205,201,205,201,406
EL VILLAR,consulta externa,nuevas en personas de 60 anos o mas,2006-07-01,40,113,40,113,153
ENTRE RIOS,consulta externa,nuevas en personas de 60 anos o mas,2006-07-01,98,102,98,102,200
ENTRE RIOS,consulta externa,nuevas en personas de 60 anos o mas,2006-07-01,23,14,23,14,37
ESCARA,consulta externa,nuevas en personas de 60 anos o mas,2006-07-01,5,4,5,4,9
ESMERALDA,consulta externa,nuevas en personas de 60 anos o mas,2006-07-01,3,9,3,9,12
EUCALIPTUS,consulta externa,nuevas en personas de 60 anos o mas,2006-07-01,40,60,40,60,100
EUREKA (SANTOS MERCADO),consulta externa,nuevas en personas de 60 anos o mas,2006-07-01,2,0,2,0,2
EXALTACION,consulta externa,nuevas en personas de 60 anos o mas,2006-07-01,4,1,4,1,5
FERNANDEZ ALONSO,consulta externa,nuevas en personas de 60 anos o mas,2006-07-01,15,9,15,9,24
FILADELFIA,consulta externa,nuevas en personas de 60 anos o mas,2006-07-01,11,13,11,13,24
GENERAL SAAVEDRA,consulta externa,nuevas en personas de 60 anos o mas,2006-07-01,25,22,25,22,47
GRAL. J.J. PEREZ (CHARAZANI),consulta externa,nuevas en personas de 60 anos o mas,2006-07-01,22,33,22,33,55
GUANAY,consulta externa,nuevas en personas de 60 anos o mas,2006-07-01,104,106,104,106,210
GUAQUI,consulta externa,nuevas en personas de 60 anos o mas,2006-07-01,22,26,22,26,48
GUAYARAMERIN,consulta externa,nuevas en personas de 60 anos o mas,2006-07-01,379,426,379,426,805
GUTIERREZ,consulta externa,nuevas en personas de 60 anos o mas,2006-07-01,36,53,36,53,89
HUACARETA,consulta externa,nuevas en personas de 60 anos o mas,2006-07-01,61,80,61,80,141
HUACAYA (VILLA DE HUACAYA),consulta externa,nuevas en personas de 60 anos o mas,2006-07-01,7,26,7,26,33
HUACHACALLA,consulta externa,nuevas en personas de 60 anos o mas,2006-07-01,15,15,15,15,30
HUANUNI,consulta externa,nuevas en personas de 60 anos o mas,2006-07-01,120,125,120,125,245
HUARACAJE,consulta externa,nuevas en personas de 60 anos o mas,2006-07-01,8,5,8,5,13
HUAYLLAMARCA,consulta externa,nuevas en personas de 60 anos o mas,2006-07-01,49,63,49,63,112
ICHOCA,consulta externa,nuevas en personas de 60 anos o mas,2006-07-01,18,16,18,16,34
ICLA,consulta externa,nuevas en personas de 60 anos o mas,2006-07-01,45,74,45,74,119
INCAHUASI,consulta externa,nuevas en personas de 60 anos o mas,2006-07-01,59,104,59,104,163
INGAVI (HUMAITA),consulta externa,nuevas en personas de 60 anos o mas,2006-07-01,3,2,3,2,5
INQUISIVI,consulta externa,nuevas en personas de 60 anos o mas,2006-07-01,40,17,40,17,57
IRUPANA (VILLA DE LANZA),consulta externa,nuevas en personas de 60 anos o mas,2006-07-01,60,26,60,26,86
IXIAMAS,consulta externa,nuevas en personas de 60 anos o mas,2006-07-01,46,48,46,48,94
JESUS DE MACHACA,consulta externa,nuevas en personas de 60 anos o mas,2006-07-01,88,121,88,121,209
LA ASUNTA,consulta externa,nuevas en personas de 60 anos o mas,2006-07-01,37,26,37,26,63
LA GUARDIA,consulta externa,nuevas en personas de 60 anos o mas,2006-07-01,75,75,75,75,150
LA PAZ,consulta externa,nuevas en personas de 60 anos o mas,2006-07-01,7834,9603,7834,9603,17437
LA RIVERA,consulta externa,nuevas en personas de 60 anos o mas,2006-07-01,1,2,1,2,3
LAGUNILLAS,consulta externa,nuevas en personas de 60 anos o mas,2006-07-01,35,34,35,34,69
LAJA,consulta externa,nuevas en personas de 60 anos o mas,2006-07-01,27,15,27,15,42
LAS CARRERAS,consulta externa,nuevas en personas de 60 anos o mas,2006-07-01,42,64,42,64,106
LICOMA PAMPA,consulta externa,nuevas en personas de 60 anos o mas,2006-07-01,18,17,18,17,35
LLALLAGUA,consulta externa,nuevas en personas de 60 anos o mas,2006-07-01,394,465,394,465,859
LLICA,consulta externa,nuevas en personas de 60 anos o mas,2006-07-01,32,58,32,58,90
LORETO,consulta externa,nuevas en personas de 60 anos o mas,2006-07-01,6,5,6,5,11
LURIBAY,consulta externa,nuevas en personas de 60 anos o mas,2006-07-01,44,34,44,34,78
MACHACAMARCA,consulta externa,nuevas en personas de 60 anos o mas,2006-07-01,74,73,74,73,147
MACHARETI,consulta externa,nuevas en personas de 60 anos o mas,2006-07-01,38,55,38,55,93
MAGDALENA,consulta externa,nuevas en personas de 60 anos o mas,2006-07-01,81,77,81,77,158
MAIRANA,consulta externa,nuevas en personas de 60 anos o mas,2006-07-01,42,68,42,68,110
MALLA,consulta externa,nuevas en personas de 60 anos o mas,2006-07-01,7,9,7,9,16
MAPIRI,consulta externa,nuevas en personas de 60 anos o mas,2006-07-01,51,36,51,36,87
MECAPACA,consulta externa,nuevas en personas de 60 anos o mas,2006-07-01,73,50,73,50,123
MINEROS,consulta externa,nuevas en personas de 60 anos o mas,2006-07-01,12,11,12,11,23
MIZQUE,consulta externa,nuevas en personas de 60 anos o mas,2006-07-01,28,54,28,54,82
MOCOMOCO,consulta externa,nuevas en personas de 60 anos o mas,2006-07-01,58,69,58,69,127
MOJINETE,consulta externa,nuevas en personas de 60 anos o mas,2006-07-01,9,26,9,26,35
MOJOCOYA,consulta externa,nuevas en personas de 60 anos o mas,2006-07-01,42,63,42,63,105
MONTEAGUDO,consulta externa,nuevas en personas de 60 anos o mas,2006-07-01,445,462,445,462,907
MONTERO,consulta externa,nuevas en personas de 60 anos o mas,2006-07-01,255,273,255,273,528
MORO MORO,consulta externa,nuevas en personas de 60 anos o mas,2006-07-01,26,41,26,41,67
MOROCHATA,consulta externa,nuevas en personas de 60 anos o mas,2006-07-01,15,27,15,27,42
NACEBE (SANTA ROSA DEL ABUNA),consulta externa,nuevas en personas de 60 anos o mas,2006-07-01,2,3,2,3,5
NUEVO MANOA (NUEVA ESPERANZA),consulta externa,nuevas en personas de 60 anos o mas,2006-07-01,2,1,2,1,3
OCURI,consulta externa,nuevas en personas de 60 anos o mas,2006-07-01,45,50,45,50,95
OKINAWA,consulta externa,nuevas en personas de 60 anos o mas,2006-07-01,102,120,102,120,222
OMEREQUE,consulta externa,nuevas en personas de 60 anos o mas,2006-07-01,14,25,14,25,39
ORURO,consulta externa,nuevas en personas de 60 anos o mas,2006-07-01,2839,2914,2839,2914,5753
PADCAYA,consulta externa,nuevas en personas de 60 anos o mas,2006-07-01,95,150,95,150,245
PADILLA,consulta externa,nuevas en personas de 60 anos o mas,2006-07-01,181,241,181,241,422
PAILON,consulta externa,nuevas en personas de 60 anos o mas,2006-07-01,16,8,16,8,24
PALCA,consulta externa,nuevas en personas de 60 anos o mas,2006-07-01,31,29,31,29,60
PALOS BLANCOS,consulta externa,nuevas en personas de 60 anos o mas,2006-07-01,50,30,50,30,80
PAMPA AULLAGAS,consulta externa,nuevas en personas de 60 anos o mas,2006-07-01,8,10,8,10,18
PAMPA GRANDE,consulta externa,nuevas en personas de 60 anos o mas,2006-07-01,34,36,34,36,70
PAPEL PAMPA,consulta externa,nuevas en personas de 60 anos o mas,2006-07-01,31,30,31,30,61
PASORAPA,consulta externa,nuevas en personas de 60 anos o mas,2006-07-01,9,10,9,10,19
PATACAMAYA,consulta externa,nuevas en personas de 60 anos o mas,2006-07-01,29,17,29,17,46
PAZÑA,consulta externa,nuevas en personas de 60 anos o mas,2006-07-01,34,34,34,34,68
PELECHUCO,consulta externa,nuevas en personas de 60 anos o mas,2006-07-01,23,14,23,14,37
POCOATA,consulta externa,nuevas en personas de 60 anos o mas,2006-07-01,54,88,54,88,142
POCONA,consulta externa,nuevas en personas de 60 anos o mas,2006-07-01,10,35,10,35,45
POJO (CBBA),consulta externa,nuevas en personas de 60 anos o mas,2006-07-01,14,19,14,19,33
POOPO,consulta externa,nuevas en personas de 60 anos o mas,2006-07-01,23,34,23,34,57
PORCO,consulta externa,nuevas en personas de 60 anos o mas,2006-07-01,11,23,11,23,34
POROMA,consulta externa,nuevas en personas de 60 anos o mas,2006-07-01,106,90,106,90,196
PORONGO,consulta externa,nuevas en personas de 60 anos o mas,2006-07-01,65,46,65,46,111
PORTACHUELO,consulta externa,nuevas en personas de 60 anos o mas,2006-07-01,126,152,126,152,278
PORVENIR,consulta externa,nuevas en personas de 60 anos o mas,2006-07-01,15,21,15,21,36
POSTRER VALLE,consulta externa,nuevas en personas de 60 anos o mas,2006-07-01,31,23,31,23,54
POTOSI,consulta externa,nuevas en personas de 60 anos o mas,2006-07-01,1348,1730,1348,1730,3078
PRESTO,consulta externa,nuevas en personas de 60 anos o mas,2006-07-01,32,91,32,91,123
PUCARA,consulta externa,nuevas en personas de 60 anos o mas,2006-07-01,29,30,29,30,59
PUCARANI,consulta externa,nuevas en personas de 60 anos o mas,2006-07-01,56,42,56,42,98
PUERTO ACOSTA,consulta externa,nuevas en personas de 60 anos o mas,2006-07-01,175,133,175,133,308
PUERTO CARABUCO,consulta externa,nuevas en personas de 60 anos o mas,2006-07-01,39,61,39,61,100
PUERTO GONZALO MORENO,consulta externa,nuevas en personas de 60 anos o mas,2006-07-01,14,10,14,10,24
PUERTO PEREZ,consulta externa,nuevas en personas de 60 anos o mas,2006-07-01,25,19,25,19,44
PUERTO QUIJARRO,consulta externa,nuevas en personas de 60 anos o mas,2006-07-01,101,88,101,88,189
PUERTO RICO,consulta externa,nuevas en personas de 60 anos o mas,2006-07-01,9,5,9,5,14
PUERTO SILES,consulta externa,nuevas en personas de 60 anos o mas,2006-07-01,10,0,10,0,10
PUERTO SUAREZ,consulta externa,nuevas en personas de 60 anos o mas,2006-07-01,75,93,75,93,168
PUERTO VILLARROEL,consulta externa,nuevas en personas de 60 anos o mas,2006-07-01,37,30,37,30,67
PUNA,consulta externa,nuevas en personas de 60 anos o mas,2006-07-01,135,213,135,213,348
PUNATA,consulta externa,nuevas en personas de 60 anos o mas,2006-07-01,142,108,142,108,250
QUIABAYA,consulta externa,nuevas en personas de 60 anos o mas,2006-07-01,24,22,24,22,46
QUILLACOLLO,consulta externa,nuevas en personas de 60 anos o mas,2006-07-01,46,97,46,97,143
QUIME,consulta externa,nuevas en personas de 60 anos o mas,2006-07-01,15,10,15,10,25
QUIRUSILLAS,consulta externa,nuevas en personas de 60 anos o mas,2006-07-01,2,7,2,7,9
RAVELO,consulta externa,nuevas en personas de 60 anos o mas,2006-07-01,61,55,61,55,116
REYES,consulta externa,nuevas en personas de 60 anos o mas,2006-07-01,84,89,84,89,173
RIBERALTA,consulta externa,nuevas en personas de 60 anos o mas,2006-07-01,129,113,129,113,242
ROBORE,consulta externa,nuevas en personas de 60 anos o mas,2006-07-01,116,87,116,87,203
RURRENABAQUE,consulta externa,nuevas en personas de 60 anos o mas,2006-07-01,112,105,112,105,217
SABAYA,consulta externa,nuevas en personas de 60 anos o mas,2006-07-01,37,41,37,41,78
SACABA,consulta externa,nuevas en personas de 60 anos o mas,2006-07-01,112,182,112,182,294
SACABAMBA,consulta externa,nuevas en personas de 60 anos o mas,2006-07-01,7,6,7,6,13
SACACA,consulta externa,nuevas en personas de 60 anos o mas,2006-07-01,57,97,57,97,154
SAIPINA,consulta externa,nuevas en personas de 60 anos o mas,2006-07-01,52,68,52,68,120
SALINAS DE GARCI MENDOZA,consulta externa,nuevas en personas de 60 anos o mas,2006-07-01,74,76,74,76,150
SAMAIPATA,consulta externa,nuevas en personas de 60 anos o mas,2006-07-01,50,59,50,59,109
SAN AGUSTIN,consulta externa,nuevas en personas de 60 anos o mas,2006-07-01,7,7,7,7,14
SAN ANDRES,consulta externa,nuevas en personas de 60 anos o mas,2006-07-01,18,23,18,23,41
SAN ANDRES DE MACHACA,consulta externa,nuevas en personas de 60 anos o mas,2006-07-01,39,65,39,65,104
SAN ANTONIO DE ESMORUCO,consulta externa,nuevas en personas de 60 anos o mas,2006-07-01,6,5,6,5,11
SAN ANTONIO DE LOMERIO,consulta externa,nuevas en personas de 60 anos o mas,2006-07-01,14,17,14,17,31
SAN BENITO,consulta externa,nuevas en personas de 60 anos o mas,2006-07-01,21,33,21,33,54
SAN BORJA,consulta externa,nuevas en personas de 60 anos o mas,2006-07-01,92,76,92,76,168
SAN BUENA VENTURA,consulta externa,nuevas en personas de 60 anos o mas,2006-07-01,25,22,25,22,47
SAN CARLOS,consulta externa,nuevas en personas de 60 anos o mas,2006-07-01,142,131,142,131,273
SAN IGNACIO,consulta externa,nuevas en personas de 60 anos o mas,2006-07-01,117,132,117,132,249
SAN IGNACIO DE VELASCO,consulta externa,nuevas en personas de 60 anos o mas,2006-07-01,226,284,226,284,510
SAN JAVIER(BNI),consulta externa,nuevas en personas de 60 anos o mas,2006-07-01,8,10,8,10,18
SAN JAVIER(STC),consulta externa,nuevas en personas de 60 anos o mas,2006-07-01,7,14,7,14,21
SAN JOAQUIN,consulta externa,nuevas en personas de 60 anos o mas,2006-07-01,83,71,83,71,154
SAN JOSE DE CHIQUITOS,consulta externa,nuevas en personas de 60 anos o mas,2006-07-01,22,30,22,30,52
SAN JUAN DE YAPACANI,consulta externa,nuevas en personas de 60 anos o mas,2006-07-01,36,41,36,41,77
SAN JULIAN,consulta externa,nuevas en personas de 60 anos o mas,2006-07-01,150,145,150,145,295
SAN LORENZO(PND),consulta externa,nuevas en personas de 60 anos o mas,2006-07-01,23,21,23,21,44
SAN LORENZO(TJA),consulta externa,nuevas en personas de 60 anos o mas,2006-07-01,72,85,72,85,157
SAN LUCAS,consulta externa,nuevas en personas de 60 anos o mas,2006-07-01,99,228,99,228,327
SAN MATIAS,consulta externa,nuevas en personas de 60 anos o mas,2006-07-01,21,16,21,16,37
SAN MIGUEL DE VELASCO,consulta externa,nuevas en personas de 60 anos o mas,2006-07-01,27,41,27,41,68
SAN PABLO DE LIPEZ,consulta externa,nuevas en personas de 60 anos o mas,2006-07-01,14,13,14,13,27
SAN PEDRO,consulta externa,nuevas en personas de 60 anos o mas,2006-07-01,58,35,58,35,93
SAN PEDRO DE BUENA VISTA,consulta externa,nuevas en personas de 60 anos o mas,2006-07-01,32,43,32,43,75
SAN PEDRO DE CURAHUARA,consulta externa,nuevas en personas de 60 anos o mas,2006-07-01,12,4,12,4,16
SAN PEDRO DE QUEMES,consulta externa,nuevas en personas de 60 anos o mas,2006-07-01,4,1,4,1,5
SAN PEDRO DE TIQUINA,consulta externa,nuevas en personas de 60 anos o mas,2006-07-01,26,21,26,21,47
SAN PEDRO(PND),consulta externa,nuevas en personas de 60 anos o mas,2006-07-01,1,0,1,0,1
SAN RAFAEL,consulta externa,nuevas en personas de 60 anos o mas,2006-07-01,10,10,10,10,20
SAN RAMON,consulta externa,nuevas en personas de 60 anos o mas,2006-07-01,50,79,50,79,129
SAN RAMON,consulta externa,nuevas en personas de 60 anos o mas,2006-07-01,12,14,12,14,26
SANTA ANA,consulta externa,nuevas en personas de 60 anos o mas,2006-07-01,70,114,70,114,184
SANTA CRUZ DE LA SIERRA,consulta externa,nuevas en personas de 60 anos o mas,2006-07-01,4762,6798,4762,6798,11560
SANTA ROSA,consulta externa,nuevas en personas de 60 anos o mas,2006-07-01,58,47,58,47,105
SANTA ROSA DEL SARA,consulta externa,nuevas en personas de 60 anos o mas,2006-07-01,77,56,77,56,133
SANTIAGO DE CALLAPA,consulta externa,nuevas en personas de 60 anos o mas,2006-07-01,18,14,18,14,32
SANTIAGO DE HUARI,consulta externa,nuevas en personas de 60 anos o mas,2006-07-01,70,87,70,87,157
SANTIAGO DE MACHACA,consulta externa,nuevas en personas de 60 anos o mas,2006-07-01,14,17,14,17,31
SANTIVAÑES,consulta externa,nuevas en personas de 60 anos o mas,2006-07-01,40,48,40,48,88
SANTUARIO DE QUILLACAS,consulta externa,nuevas en personas de 60 anos o mas,2006-07-01,20,25,20,25,45
SAPAHAQUI,consulta externa,nuevas en personas de 60 anos o mas,2006-07-01,49,52,49,52,101
SENA,consulta externa,nuevas en personas de 60 anos o mas,2006-07-01,15,7,15,7,22
SICA SICA (VILLA AROMA),consulta externa,nuevas en personas de 60 anos o mas,2006-07-01,29,33,29,33,62
SICAYA,consulta externa,nuevas en personas de 60 anos o mas,2006-07-01,1,7,1,7,8
SIPE SIPE,consulta externa,nuevas en personas de 60 anos o mas,2006-07-01,17,34,17,34,51
SOPACHUY,consulta externa,nuevas en personas de 60 anos o mas,2006-07-01,29,72,29,72,101
SORACACHI,consulta externa,nuevas en personas de 60 anos o mas,2006-07-01,14,20,14,20,34
SORATA,consulta externa,nuevas en personas de 60 anos o mas,2006-07-01,62,66,62,66,128
SUCRE,consulta externa,nuevas en personas de 60 anos o mas,2006-07-01,2539,3198,2539,3198,5737
TACACHI,consulta externa,nuevas en personas de 60 anos o mas,2006-07-01,1,4,1,4,5
TACACOMA,consulta externa,nuevas en personas de 60 anos o mas,2006-07-01,14,23,14,23,37
TACOBAMBA,consulta externa,nuevas en personas de 60 anos o mas,2006-07-01,17,32,17,32,49
TACOPAYA,consulta externa,nuevas en personas de 60 anos o mas,2006-07-01,25,51,25,51,76
TAHUA,consulta externa,nuevas en personas de 60 anos o mas,2006-07-01,4,3,4,3,7
TAPACARI,consulta externa,nuevas en personas de 60 anos o mas,2006-07-01,62,68,62,68,130
TARABUCO,consulta externa,nuevas en personas de 60 anos o mas,2006-07-01,163,221,163,221,384
TARACO,consulta externa,nuevas en personas de 60 anos o mas,2006-07-01,8,15,8,15,23
TARATA,consulta externa,nuevas en personas de 60 anos o mas,2006-07-01,10,17,10,17,27
TARIJA,consulta externa,nuevas en personas de 60 anos o mas,2006-07-01,855,837,855,837,1692
TARVITA,consulta externa,nuevas en personas de 60 anos o mas,2006-07-01,79,128,79,128,207
TEOPONTE,consulta externa,nuevas en personas de 60 anos o mas,2006-07-01,80,50,80,50,130
TIAWANACU,consulta externa,nuevas en personas de 60 anos o mas,2006-07-01,13,14,13,14,27
TINGUIPAYA,consulta externa,nuevas en personas de 60 anos o mas,2006-07-01,61,72,61,72,133
TIPUANI,consulta externa,nuevas en personas de 60 anos o mas,2006-07-01,31,22,31,22,53
TIQUIPAYA,consulta externa,nuevas en personas de 60 anos o mas,2006-07-01,29,28,29,28,57
TIRAQUE (CBBA),consulta externa,nuevas en personas de 60 anos o mas,2006-07-01,66,58,66,58,124
TITO YUPANQUI (PARQUIPUJIO),consulta externa,nuevas en personas de 60 anos o mas,2006-07-01,14,13,14,13,27
TOCO,consulta externa,nuevas en personas de 60 anos o mas,2006-07-01,7,5,7,5,12
TODOS SANTOS,consulta externa,nuevas en personas de 60 anos o mas,2006-07-01,1,0,1,0,1
TOLATA,consulta externa,nuevas en personas de 60 anos o mas,2006-07-01,4,9,4,9,13
TOLEDO,consulta externa,nuevas en personas de 60 anos o mas,2006-07-01,50,49,50,49,99
TOMAVE,consulta externa,nuevas en personas de 60 anos o mas,2006-07-01,58,94,58,94,152
TOMINA,consulta externa,nuevas en personas de 60 anos o mas,2006-07-01,39,90,39,90,129
TORO TORO,consulta externa,nuevas en personas de 60 anos o mas,2006-07-01,34,71,34,71,105
TOTORA(CBBA),consulta externa,nuevas en personas de 60 anos o mas,2006-07-01,10,15,10,15,25
TOTORA(ORR),consulta externa,nuevas en personas de 60 anos o mas,2006-07-01,32,28,32,28,60
TRIGAL,consulta externa,nuevas en personas de 60 anos o mas,2006-07-01,7,32,7,32,39
TRINIDAD,consulta externa,nuevas en personas de 60 anos o mas,2006-07-01,338,478,338,478,816
TUPIZA,consulta externa,nuevas en personas de 60 anos o mas,2006-07-01,343,509,343,509,852
TURCO,consulta externa,nuevas en personas de 60 anos o mas,2006-07-01,57,57,57,57,114
UMALA,consulta externa,nuevas en personas de 60 anos o mas,2006-07-01,38,45,38,45,83
UNCIA,consulta externa,nuevas en personas de 60 anos o mas,2006-07-01,153,175,153,175,328
URIONDO (A. CONCEPCION),consulta externa,nuevas en personas de 60 anos o mas,2006-07-01,66,76,66,76,142
URUBICHA,consulta externa,nuevas en personas de 60 anos o mas,2006-07-01,13,14,13,14,27
UYUNI,consulta externa,nuevas en personas de 60 anos o mas,2006-07-01,220,202,220,202,422
VACAS,consulta externa,nuevas en personas de 60 anos o mas,2006-07-01,19,43,19,43,62
VALLEGRANDE,consulta externa,nuevas en personas de 60 anos o mas,2006-07-01,284,341,284,341,625
VIACHA,consulta externa,nuevas en personas de 60 anos o mas,2006-07-01,270,248,270,248,518
VILA VILA,consulta externa,nuevas en personas de 60 anos o mas,2006-07-01,6,6,6,6,12
VILLA MONTES,consulta externa,nuevas en personas de 60 anos o mas,2006-07-01,127,128,127,128,255
VILLA NUEVA (LOMA ALTA),consulta externa,nuevas en personas de 60 anos o mas,2006-07-01,6,3,6,3,9
VILLA RIVERO,consulta externa,nuevas en personas de 60 anos o mas,2006-07-01,20,21,20,21,41
VILLA SERRANO,consulta externa,nuevas en personas de 60 anos o mas,2006-07-01,69,112,69,112,181
VILLA TUNARI,consulta externa,nuevas en personas de 60 anos o mas,2006-07-01,155,145,155,145,300
VILLA VACA GUZMAN (MUYUPAMPA),consulta externa,nuevas en personas de 60 anos o mas,2006-07-01,57,75,57,75,132
VILLAZON,consulta externa,nuevas en personas de 60 anos o mas,2006-07-01,625,887,625,887,1512
VINTO,consulta externa,nuevas en personas de 60 anos o mas,2006-07-01,76,88,76,88,164
VITICHI,consulta externa,nuevas en personas de 60 anos o mas,2006-07-01,56,122,56,122,178
WALDO BALLIVIAN,consulta externa,nuevas en personas de 60 anos o mas,2006-07-01,3,7,3,7,10
WARNES,consulta externa,nuevas en personas de 60 anos o mas,2006-07-01,123,112,123,112,235
YACO,consulta externa,nuevas en personas de 60 anos o mas,2006-07-01,20,13,20,13,33
YACUIBA,consulta externa,nuevas en personas de 60 anos o mas,2006-07-01,679,861,679,861,1540
YAMPARAEZ,consulta externa,nuevas en personas de 60 anos o mas,2006-07-01,30,52,30,52,82
YANACACHI,consulta externa,nuevas en personas de 60 anos o mas,2006-07-01,86,78,86,78,164
YAPACANI,consulta externa,nuevas en personas de 60 anos o mas,2006-07-01,229,200,229,200,429
YOCALLA,consulta externa,nuevas en personas de 60 anos o mas,2006-07-01,70,111,70,111,181
YOTALA,consulta externa,nuevas en personas de 60 anos o mas,2006-07-01,45,72,45,72,117
YUNCHARA,consulta externa,nuevas en personas de 60 anos o mas,2006-07-01,16,28,16,28,44
ZUDAÑEZ,consulta externa,nuevas en personas de 60 anos o mas,2006-07-01,72,123,72,123,195
ACACIO,consulta externa,nuevas en personas de 60 anos o mas,2006-08-01,22,30,22,30,52
ACHACACHI,consulta externa,nuevas en personas de 60 anos o mas,2006-08-01,181,179,181,179,360
ACHOCALLA,consulta externa,nuevas en personas de 60 anos o mas,2006-08-01,8,8,8,8,16
AIQUILE,consulta externa,nuevas en personas de 60 anos o mas,2006-08-01,107,114,107,114,221
ALCALA,consulta externa,nuevas en personas de 60 anos o mas,2006-08-01,25,74,25,74,99
ANCORAIMES,consulta externa,nuevas en personas de 60 anos o mas,2006-08-01,42,44,42,44,86
ANDAMARCA,consulta externa,nuevas en personas de 60 anos o mas,2006-08-01,59,66,59,66,125
ANTEQUERA,consulta externa,nuevas en personas de 60 anos o mas,2006-08-01,4,4,4,4,8
ANZALDO,consulta externa,nuevas en personas de 60 anos o mas,2006-08-01,20,20,20,20,40
APOLO,consulta externa,nuevas en personas de 60 anos o mas,2006-08-01,41,46,41,46,87
ARAMPAMPA,consulta externa,nuevas en personas de 60 anos o mas,2006-08-01,9,15,9,15,24
ARANI,consulta externa,nuevas en personas de 60 anos o mas,2006-08-01,15,22,15,22,37
ARBIETO,consulta externa,nuevas en personas de 60 anos o mas,2006-08-01,26,35,26,35,61
ARQUE,consulta externa,nuevas en personas de 60 anos o mas,2006-08-01,8,15,8,15,23
ASCENCION DE GUARAYOS,consulta externa,nuevas en personas de 60 anos o mas,2006-08-01,48,31,48,31,79
ATOCHA,consulta externa,nuevas en personas de 60 anos o mas,2006-08-01,85,108,85,108,193
AUCAPATA,consulta externa,nuevas en personas de 60 anos o mas,2006-08-01,29,25,29,25,54
AYATA,consulta externa,nuevas en personas de 60 anos o mas,2006-08-01,14,20,14,20,34
AYO AYO,consulta externa,nuevas en personas de 60 anos o mas,2006-08-01,19,18,19,18,37
AYOPAYA (V. DE INDEPENDENCIA),consulta externa,nuevas en personas de 60 anos o mas,2006-08-01,60,73,60,73,133
AZURDUY,consulta externa,nuevas en personas de 60 anos o mas,2006-08-01,79,116,79,116,195
BATALLAS,consulta externa,nuevas en personas de 60 anos o mas,2006-08-01,35,31,35,31,66
BAURES,consulta externa,nuevas en personas de 60 anos o mas,2006-08-01,36,34,36,34,70
BELEN DE ANDAMARCA,consulta externa,nuevas en personas de 60 anos o mas,2006-08-01,10,13,10,13,23
BELEN DE URMIRI,consulta externa,nuevas en personas de 60 anos o mas,2006-08-01,17,10,17,10,27
BELLA FLOR,consulta externa,nuevas en personas de 60 anos o mas,2006-08-01,26,9,26,9,35
BERMEJO,consulta externa,nuevas en personas de 60 anos o mas,2006-08-01,271,297,271,297,568
BETANZOS,consulta externa,nuevas en personas de 60 anos o mas,2006-08-01,170,282,170,282,452
BOLIVAR,consulta externa,nuevas en personas de 60 anos o mas,2006-08-01,16,24,16,24,40
BOLPEBRA,consulta externa,nuevas en personas de 60 anos o mas,2006-08-01,14,12,14,12,26
BOYUIBE,consulta externa,nuevas en personas de 60 anos o mas,2006-08-01,41,58,41,58,99
BUENA VISTA,consulta externa,nuevas en personas de 60 anos o mas,2006-08-01,70,46,70,46,116
CABEZAS,consulta externa,nuevas en personas de 60 anos o mas,2006-08-01,100,235,100,235,335
CAIROMA,consulta externa,nuevas en personas de 60 anos o mas,2006-08-01,39,27,39,27,66
"CAIZA ""D""",consulta externa,nuevas en personas de 60 anos o mas,2006-08-01,69,120,69,120,189
CAJUATA,consulta externa,nuevas en personas de 60 anos o mas,2006-08-01,41,43,41,43,84
CALACOTO,consulta externa,nuevas en personas de 60 anos o mas,2006-08-01,46,51,46,51,97
CALAMARCA,consulta externa,nuevas en personas de 60 anos o mas,2006-08-01,28,20,28,20,48
CAMARGO,consulta externa,nuevas en personas de 60 anos o mas,2006-08-01,204,250,204,250,454
CAMATAQUI (C. VILLA ABECIA),consulta externa,nuevas en personas de 60 anos o mas,2006-08-01,45,46,45,46,91
CAMIRI,consulta externa,nuevas en personas de 60 anos o mas,2006-08-01,622,964,622,964,1586
CAPINOTA,consulta externa,nuevas en personas de 60 anos o mas,2006-08-01,62,65,62,65,127
CAQUIAVIRI,consulta externa,nuevas en personas de 60 anos o mas,2006-08-01,37,38,37,38,75
CARACOLLO,consulta externa,nuevas en personas de 60 anos o mas,2006-08-01,87,50,87,50,137
CARANAVI,consulta externa,nuevas en personas de 60 anos o mas,2006-08-01,356,217,356,217,573
CARAPARI,consulta externa,nuevas en personas de 60 anos o mas,2006-08-01,61,35,61,35,96
CARIPUYO,consulta externa,nuevas en personas de 60 anos o mas,2006-08-01,6,26,6,26,32
CARMEN RIVERO TORREZ,consulta externa,nuevas en personas de 60 anos o mas,2006-08-01,4,3,4,3,7
CATACORA,consulta externa,nuevas en personas de 60 anos o mas,2006-08-01,7,15,7,15,22
CHACARILLA,consulta externa,nuevas en personas de 60 anos o mas,2006-08-01,6,7,6,7,13
CHALLAPATA,consulta externa,nuevas en personas de 60 anos o mas,2006-08-01,108,116,108,116,224
CHAQUI,consulta externa,nuevas en personas de 60 anos o mas,2006-08-01,26,40,26,40,66
CHARAGUA,consulta externa,nuevas en personas de 60 anos o mas,2006-08-01,37,36,37,36,73
CHARAÑA,consulta externa,nuevas en personas de 60 anos o mas,2006-08-01,4,8,4,8,12
CHAYANTA,consulta externa,nuevas en personas de 60 anos o mas,2006-08-01,48,110,48,110,158
CHIMORE,consulta externa,nuevas en personas de 60 anos o mas,2006-08-01,13,16,13,16,29
CHIPAYA,consulta externa,nuevas en personas de 60 anos o mas,2006-08-01,0,3,0,3,3
CHOQUE COTA,consulta externa,nuevas en personas de 60 anos o mas,2006-08-01,44,52,44,52,96
CHULUMANI (V. DE LA LIBERTAD),consulta externa,nuevas en personas de 60 anos o mas,2006-08-01,54,38,54,38,92
CHUMA,consulta externa,nuevas en personas de 60 anos o mas,2006-08-01,57,80,57,80,137
CLIZA,consulta externa,nuevas en personas de 60 anos o mas,2006-08-01,43,56,43,56,99
COBIJA,consulta externa,nuevas en personas de 60 anos o mas,2006-08-01,321,194,321,194,515
COCHABAMBA,consulta externa,nuevas en personas de 60 anos o mas,2006-08-01,4069,5921,4069,5921,9990
COIPASA,consulta externa,nuevas en personas de 60 anos o mas,2006-08-01,9,6,9,6,15
COLCAPIRHUA,consulta externa,nuevas en personas de 60 anos o mas,2006-08-01,172,222,172,222,394
"COLCHA ""K""",consulta externa,nuevas en personas de 60 anos o mas,2006-08-01,73,69,73,69,142
COLLANA,consulta externa,nuevas en personas de 60 anos o mas,2006-08-01,11,14,11,14,25
COLOMI,consulta externa,nuevas en personas de 60 anos o mas,2006-08-01,19,14,19,14,33
COLPA BELGICA,consulta externa,nuevas en personas de 60 anos o mas,2006-08-01,4,4,4,4,8
COLQUECHACA,consulta externa,nuevas en personas de 60 anos o mas,2006-08-01,81,96,81,96,177
COLQUENCHA,consulta externa,nuevas en personas de 60 anos o mas,2006-08-01,24,37,24,37,61
COLQUIRI,consulta externa,nuevas en personas de 60 anos o mas,2006-08-01,48,39,48,39,87
COMANCHE,consulta externa,nuevas en personas de 60 anos o mas,2006-08-01,6,12,6,12,18
COMARAPA,consulta externa,nuevas en personas de 60 anos o mas,2006-08-01,149,216,149,216,365
COMBAYA,consulta externa,nuevas en personas de 60 anos o mas,2006-08-01,13,18,13,18,31
CONCEPCION,consulta externa,nuevas en personas de 60 anos o mas,2006-08-01,89,100,89,100,189
COPACABANA,consulta externa,nuevas en personas de 60 anos o mas,2006-08-01,30,32,30,32,62
CORIPATA,consulta externa,nuevas en personas de 60 anos o mas,2006-08-01,24,35,24,35,59
CORO CORO,consulta externa,nuevas en personas de 60 anos o mas,2006-08-01,42,38,42,38,80
COROICO,consulta externa,nuevas en personas de 60 anos o mas,2006-08-01,109,70,109,70,179
CORQUE,consulta externa,nuevas en personas de 60 anos o mas,2006-08-01,35,35,35,35,70
COTAGAITA,consulta externa,nuevas en personas de 60 anos o mas,2006-08-01,234,370,234,370,604
COTOCA,consulta externa,nuevas en personas de 60 anos o mas,2006-08-01,112,103,112,103,215
CUATRO CAÑADAS,consulta externa,nuevas en personas de 60 anos o mas,2006-08-01,47,35,47,35,82
CUCHUMUELA (V. G. VILLARROEL),consulta externa,nuevas en personas de 60 anos o mas,2006-08-01,3,4,3,4,7
CUEVO,consulta externa,nuevas en personas de 60 anos o mas,2006-08-01,15,29,15,29,44
CULPINA,consulta externa,nuevas en personas de 60 anos o mas,2006-08-01,67,82,67,82,149
CURAHUARA DE CARANGAS,consulta externa,nuevas en personas de 60 anos o mas,2006-08-01,72,58,72,58,130
CURVA,consulta externa,nuevas en personas de 60 anos o mas,2006-08-01,7,10,7,10,17
DESAGUADERO,consulta externa,nuevas en personas de 60 anos o mas,2006-08-01,56,45,56,45,101
EL ALTO,consulta externa,nuevas en personas de 60 anos o mas,2006-08-01,1379,1589,1379,1589,2968
EL CHORO,consulta externa,nuevas en personas de 60 anos o mas,2006-08-01,43,59,43,59,102
EL PUENTE(STC),consulta externa,nuevas en personas de 60 anos o mas,2006-08-01,23,25,23,25,48
EL PUENTE(TJA),consulta externa,nuevas en personas de 60 anos o mas,2006-08-01,42,61,42,61,103
EL TORNO,consulta externa,nuevas en personas de 60 anos o mas,2006-08-01,208,196,208,196,404
EL VILLAR,consulta externa,nuevas en personas de 60 anos o mas,2006-08-01,38,68,38,68,106
ENTRE RIOS,consulta externa,nuevas en personas de 60 anos o mas,2006-08-01,107,132,107,132,239
ENTRE RIOS,consulta externa,nuevas en personas de 60 anos o mas,2006-08-01,26,16,26,16,42
ESCARA,consulta externa,nuevas en personas de 60 anos o mas,2006-08-01,3,4,3,4,7
ESMERALDA,consulta externa,nuevas en personas de 60 anos o mas,2006-08-01,10,25,10,25,35
EUCALIPTUS,consulta externa,nuevas en personas de 60 anos o mas,2006-08-01,65,85,65,85,150
EUREKA (SANTOS MERCADO),consulta externa,nuevas en personas de 60 anos o mas,2006-08-01,4,0,4,0,4
EXALTACION,consulta externa,nuevas en personas de 60 anos o mas,2006-08-01,2,4,2,4,6
FERNANDEZ ALONSO,consulta externa,nuevas en personas de 60 anos o mas,2006-08-01,13,16,13,16,29
FILADELFIA,consulta externa,nuevas en personas de 60 anos o mas,2006-08-01,16,14,16,14,30
GENERAL SAAVEDRA,consulta externa,nuevas en personas de 60 anos o mas,2006-08-01,20,28,20,28,48
GRAL. J.J. PEREZ (CHARAZANI),consulta externa,nuevas en personas de 60 anos o mas,2006-08-01,30,37,30,37,67
GUANAY,consulta externa,nuevas en personas de 60 anos o mas,2006-08-01,87,69,87,69,156
GUAQUI,consulta externa,nuevas en personas de 60 anos o mas,2006-08-01,30,37,30,37,67
GUAYARAMERIN,consulta externa,nuevas en personas de 60 anos o mas,2006-08-01,522,402,522,402,924
GUTIERREZ,consulta externa,nuevas en personas de 60 anos o mas,2006-08-01,27,56,27,56,83
HUACARETA,consulta externa,nuevas en personas de 60 anos o mas,2006-08-01,53,61,53,61,114
HUACAYA (VILLA DE HUACAYA),consulta externa,nuevas en personas de 60 anos o mas,2006-08-01,20,13,20,13,33
HUACHACALLA,consulta externa,nuevas en personas de 60 anos o mas,2006-08-01,12,9,12,9,21
HUANUNI,consulta externa,nuevas en personas de 60 anos o mas,2006-08-01,262,258,262,258,520
HUARACAJE,consulta externa,nuevas en personas de 60 anos o mas,2006-08-01,14,13,14,13,27
HUAYLLAMARCA,consulta externa,nuevas en personas de 60 anos o mas,2006-08-01,46,41,46,41,87
ICHOCA,consulta externa,nuevas en personas de 60 anos o mas,2006-08-01,7,11,7,11,18
ICLA,consulta externa,nuevas en personas de 60 anos o mas,2006-08-01,32,55,32,55,87
INCAHUASI,consulta externa,nuevas en personas de 60 anos o mas,2006-08-01,69,135,69,135,204
INGAVI (HUMAITA),consulta externa,nuevas en personas de 60 anos o mas,2006-08-01,3,3,3,3,6
INQUISIVI,consulta externa,nuevas en personas de 60 anos o mas,2006-08-01,47,34,47,34,81
IRUPANA (VILLA DE LANZA),consulta externa,nuevas en personas de 60 anos o mas,2006-08-01,42,60,42,60,102
IXIAMAS,consulta externa,nuevas en personas de 60 anos o mas,2006-08-01,56,25,56,25,81
JESUS DE MACHACA,consulta externa,nuevas en personas de 60 anos o mas,2006-08-01,83,107,83,107,190
LA ASUNTA,consulta externa,nuevas en personas de 60 anos o mas,2006-08-01,25,14,25,14,39
LA GUARDIA,consulta externa,nuevas en personas de 60 anos o mas,2006-08-01,39,49,39,49,88
LA PAZ,consulta externa,nuevas en personas de 60 anos o mas,2006-08-01,8359,9825,8359,9825,18184
LA RIVERA,consulta externa,nuevas en personas de 60 anos o mas,2006-08-01,6,7,6,7,13
LAGUNILLAS,consulta externa,nuevas en personas de 60 anos o mas,2006-08-01,26,35,26,35,61
LAJA,consulta externa,nuevas en personas de 60 anos o mas,2006-08-01,44,34,44,34,78
LAS CARRERAS,consulta externa,nuevas en personas de 60 anos o mas,2006-08-01,29,76,29,76,105
LICOMA PAMPA,consulta externa,nuevas en personas de 60 anos o mas,2006-08-01,28,18,28,18,46
LLALLAGUA,consulta externa,nuevas en personas de 60 anos o mas,2006-08-01,400,370,400,370,770
LLICA,consulta externa,nuevas en personas de 60 anos o mas,2006-08-01,57,47,57,47,104
LORETO,consulta externa,nuevas en personas de 60 anos o mas,2006-08-01,6,4,6,4,10
LURIBAY,consulta externa,nuevas en personas de 60 anos o mas,2006-08-01,63,57,63,57,120
MACHACAMARCA,consulta externa,nuevas en personas de 60 anos o mas,2006-08-01,77,82,77,82,159
MACHARETI,consulta externa,nuevas en personas de 60 anos o mas,2006-08-01,39,51,39,51,90
MAGDALENA,consulta externa,nuevas en personas de 60 anos o mas,2006-08-01,41,37,41,37,78
MAIRANA,consulta externa,nuevas en personas de 60 anos o mas,2006-08-01,58,77,58,77,135
MALLA,consulta externa,nuevas en personas de 60 anos o mas,2006-08-01,8,9,8,9,17
MAPIRI,consulta externa,nuevas en personas de 60 anos o mas,2006-08-01,43,47,43,47,90
MECAPACA,consulta externa,nuevas en personas de 60 anos o mas,2006-08-01,55,43,55,43,98
MINEROS,consulta externa,nuevas en personas de 60 anos o mas,2006-08-01,8,9,8,9,17
MIZQUE,consulta externa,nuevas en personas de 60 anos o mas,2006-08-01,36,20,36,20,56
MOCOMOCO,consulta externa,nuevas en personas de 60 anos o mas,2006-08-01,81,90,81,90,171
MOJINETE,consulta externa,nuevas en personas de 60 anos o mas,2006-08-01,16,31,16,31,47
MOJOCOYA,consulta externa,nuevas en personas de 60 anos o mas,2006-08-01,54,65,54,65,119
MONTEAGUDO,consulta externa,nuevas en personas de 60 anos o mas,2006-08-01,400,479,400,479,879
MONTERO,consulta externa,nuevas en personas de 60 anos o mas,2006-08-01,439,589,439,589,1028
MORO MORO,consulta externa,nuevas en personas de 60 anos o mas,2006-08-01,22,25,22,25,47
MOROCHATA,consulta externa,nuevas en personas de 60 anos o mas,2006-08-01,14,14,14,14,28
NUEVO MANOA (NUEVA ESPERANZA),consulta externa,nuevas en personas de 60 anos o mas,2006-08-01,4,2,4,2,6
OCURI,consulta externa,nuevas en personas de 60 anos o mas,2006-08-01,73,66,73,66,139
OKINAWA,consulta externa,nuevas en personas de 60 anos o mas,2006-08-01,75,69,75,69,144
OMEREQUE,consulta externa,nuevas en personas de 60 anos o mas,2006-08-01,16,18,16,18,34
ORURO,consulta externa,nuevas en personas de 60 anos o mas,2006-08-01,2816,3282,2816,3282,6098
PADCAYA,consulta externa,nuevas en personas de 60 anos o mas,2006-08-01,135,179,135,179,314
PADILLA,consulta externa,nuevas en personas de 60 anos o mas,2006-08-01,166,263,166,263,429
PAILON,consulta externa,nuevas en personas de 60 anos o mas,2006-08-01,24,13,24,13,37
PALCA,consulta externa,nuevas en personas de 60 anos o mas,2006-08-01,31,35,31,35,66
PALOS BLANCOS,consulta externa,nuevas en personas de 60 anos o mas,2006-08-01,40,26,40,26,66
PAMPA AULLAGAS,consulta externa,nuevas en personas de 60 anos o mas,2006-08-01,11,10,11,10,21
PAMPA GRANDE,consulta externa,nuevas en personas de 60 anos o mas,2006-08-01,41,64,41,64,105
PAPEL PAMPA,consulta externa,nuevas en personas de 60 anos o mas,2006-08-01,28,24,28,24,52
PASORAPA,consulta externa,nuevas en personas de 60 anos o mas,2006-08-01,5,27,5,27,32
PATACAMAYA,consulta externa,nuevas en personas de 60 anos o mas,2006-08-01,27,25,27,25,52
PAZÑA,consulta externa,nuevas en personas de 60 anos o mas,2006-08-01,62,44,62,44,106
PELECHUCO,consulta externa,nuevas en personas de 60 anos o mas,2006-08-01,24,14,24,14,38
POCOATA,consulta externa,nuevas en personas de 60 anos o mas,2006-08-01,63,86,63,86,149
POCONA,consulta externa,nuevas en personas de 60 anos o mas,2006-08-01,23,33,23,33,56
POJO (CBBA),consulta externa,nuevas en personas de 60 anos o mas,2006-08-01,8,12,8,12,20
POOPO,consulta externa,nuevas en personas de 60 anos o mas,2006-08-01,50,56,50,56,106
PORCO,consulta externa,nuevas en personas de 60 anos o mas,2006-08-01,16,18,16,18,34
POROMA,consulta externa,nuevas en personas de 60 anos o mas,2006-08-01,112,148,112,148,260
PORONGO,consulta externa,nuevas en personas de 60 anos o mas,2006-08-01,52,45,52,45,97
PORTACHUELO,consulta externa,nuevas en personas de 60 anos o mas,2006-08-01,121,135,121,135,256
PORVENIR,consulta externa,nuevas en personas de 60 anos o mas,2006-08-01,14,12,14,12,26
POSTRER VALLE,consulta externa,nuevas en personas de 60 anos o mas,2006-08-01,37,47,37,47,84
POTOSI,consulta externa,nuevas en personas de 60 anos o mas,2006-08-01,2294,1653,2294,1653,3947
PRESTO,consulta externa,nuevas en personas de 60 anos o mas,2006-08-01,44,88,44,88,132
PUCARA,consulta externa,nuevas en personas de 60 anos o mas,2006-08-01,42,41,42,41,83
PUCARANI,consulta externa,nuevas en personas de 60 anos o mas,2006-08-01,53,43,53,43,96
PUERTO ACOSTA,consulta externa,nuevas en personas de 60 anos o mas,2006-08-01,259,217,259,217,476
PUERTO CARABUCO,consulta externa,nuevas en personas de 60 anos o mas,2006-08-01,71,72,71,72,143
PUERTO GONZALO MORENO,consulta externa,nuevas en personas de 60 anos o mas,2006-08-01,13,11,13,11,24
PUERTO PEREZ,consulta externa,nuevas en personas de 60 anos o mas,2006-08-01,19,19,19,19,38
PUERTO QUIJARRO,consulta externa,nuevas en personas de 60 anos o mas,2006-08-01,113,104,113,104,217
PUERTO RICO,consulta externa,nuevas en personas de 60 anos o mas,2006-08-01,27,11,27,11,38
PUERTO SUAREZ,consulta externa,nuevas en personas de 60 anos o mas,2006-08-01,98,96,98,96,194
PUERTO VILLARROEL,consulta externa,nuevas en personas de 60 anos o mas,2006-08-01,42,35,42,35,77
PUNA,consulta externa,nuevas en personas de 60 anos o mas,2006-08-01,152,242,152,242,394
PUNATA,consulta externa,nuevas en personas de 60 anos o mas,2006-08-01,141,126,141,126,267
QUIABAYA,consulta externa,nuevas en personas de 60 anos o mas,2006-08-01,17,20,17,20,37
QUILLACOLLO,consulta externa,nuevas en personas de 60 anos o mas,2006-08-01,37,58,37,58,95
QUIME,consulta externa,nuevas en personas de 60 anos o mas,2006-08-01,15,10,15,10,25
QUIRUSILLAS,consulta externa,nuevas en personas de 60 anos o mas,2006-08-01,5,16,5,16,21
RAVELO,consulta externa,nuevas en personas de 60 anos o mas,2006-08-01,44,82,44,82,126
REYES,consulta externa,nuevas en personas de 60 anos o mas,2006-08-01,105,139,105,139,244
RIBERALTA,consulta externa,nuevas en personas de 60 anos o mas,2006-08-01,80,101,80,101,181
ROBORE,consulta externa,nuevas en personas de 60 anos o mas,2006-08-01,105,120,105,120,225
RURRENABAQUE,consulta externa,nuevas en personas de 60 anos o mas,2006-08-01,133,112,133,112,245
SABAYA,consulta externa,nuevas en personas de 60 anos o mas,2006-08-01,55,60,55,60,115
SACABA,consulta externa,nuevas en personas de 60 anos o mas,2006-08-01,136,174,136,174,310
SACABAMBA,consulta externa,nuevas en personas de 60 anos o mas,2006-08-01,7,9,7,9,16
SACACA,consulta externa,nuevas en personas de 60 anos o mas,2006-08-01,45,75,45,75,120
SAIPINA,consulta externa,nuevas en personas de 60 anos o mas,2006-08-01,4,5,4,5,9
SALINAS DE GARCI MENDOZA,consulta externa,nuevas en personas de 60 anos o mas,2006-08-01,70,79,70,79,149
SAMAIPATA,consulta externa,nuevas en personas de 60 anos o mas,2006-08-01,49,65,49,65,114
SAN AGUSTIN,consulta externa,nuevas en personas de 60 anos o mas,2006-08-01,12,12,12,12,24
SAN ANDRES,consulta externa,nuevas en personas de 60 anos o mas,2006-08-01,17,23,17,23,40
SAN ANDRES DE MACHACA,consulta externa,nuevas en personas de 60 anos o mas,2006-08-01,29,46,29,46,75
SAN ANTONIO DE ESMORUCO,consulta externa,nuevas en personas de 60 anos o mas,2006-08-01,7,8,7,8,15
SAN ANTONIO DE LOMERIO,consulta externa,nuevas en personas de 60 anos o mas,2006-08-01,22,26,22,26,48
SAN BENITO,consulta externa,nuevas en personas de 60 anos o mas,2006-08-01,69,176,69,176,245
SAN BORJA,consulta externa,nuevas en personas de 60 anos o mas,2006-08-01,123,113,123,113,236
SAN BUENA VENTURA,consulta externa,nuevas en personas de 60 anos o mas,2006-08-01,52,56,52,56,108
SAN CARLOS,consulta externa,nuevas en personas de 60 anos o mas,2006-08-01,142,172,142,172,314
SAN IGNACIO,consulta externa,nuevas en personas de 60 anos o mas,2006-08-01,104,156,104,156,260
SAN IGNACIO DE VELASCO,consulta externa,nuevas en personas de 60 anos o mas,2006-08-01,210,315,210,315,525
SAN JAVIER(BNI),consulta externa,nuevas en personas de 60 anos o mas,2006-08-01,8,9,8,9,17
SAN JAVIER(STC),consulta externa,nuevas en personas de 60 anos o mas,2006-08-01,12,13,12,13,25
SAN JOAQUIN,consulta externa,nuevas en personas de 60 anos o mas,2006-08-01,112,102,112,102,214
SAN JOSE DE CHIQUITOS,consulta externa,nuevas en personas de 60 anos o mas,2006-08-01,69,82,69,82,151
SAN JUAN DE YAPACANI,consulta externa,nuevas en personas de 60 anos o mas,2006-08-01,56,63,56,63,119
SAN JULIAN,consulta externa,nuevas en personas de 60 anos o mas,2006-08-01,215,251,215,251,466
SAN LORENZO(PND),consulta externa,nuevas en personas de 60 anos o mas,2006-08-01,3,4,3,4,7
SAN LORENZO(TJA),consulta externa,nuevas en personas de 60 anos o mas,2006-08-01,51,78,51,78,129
SAN LUCAS,consulta externa,nuevas en personas de 60 anos o mas,2006-08-01,151,268,151,268,419
SAN MATIAS,consulta externa,nuevas en personas de 60 anos o mas,2006-08-01,20,14,20,14,34
SAN MIGUEL DE VELASCO,consulta externa,nuevas en personas de 60 anos o mas,2006-08-01,22,45,22,45,67
SAN PABLO DE LIPEZ,consulta externa,nuevas en personas de 60 anos o mas,2006-08-01,24,30,24,30,54
SAN PEDRO,consulta externa,nuevas en personas de 60 anos o mas,2006-08-01,58,28,58,28,86
SAN PEDRO DE BUENA VISTA,consulta externa,nuevas en personas de 60 anos o mas,2006-08-01,32,59,32,59,91
SAN PEDRO DE CURAHUARA,consulta externa,nuevas en personas de 60 anos o mas,2006-08-01,19,22,19,22,41
SAN PEDRO DE QUEMES,consulta externa,nuevas en personas de 60 anos o mas,2006-08-01,6,6,6,6,12
SAN PEDRO DE TIQUINA,consulta externa,nuevas en personas de 60 anos o mas,2006-08-01,36,29,36,29,65
SAN PEDRO(PND),consulta externa,nuevas en personas de 60 anos o mas,2006-08-01,3,4,3,4,7
SAN RAFAEL,consulta externa,nuevas en personas de 60 anos o mas,2006-08-01,9,13,9,13,22
SAN RAMON,consulta externa,nuevas en personas de 60 anos o mas,2006-08-01,51,84,51,84,135
SAN RAMON,consulta externa,nuevas en personas de 60 anos o mas,2006-08-01,52,65,52,65,117
SANTA ANA,consulta externa,nuevas en personas de 60 anos o mas,2006-08-01,88,139,88,139,227
SANTA CRUZ DE LA SIERRA,consulta externa,nuevas en personas de 60 anos o mas,2006-08-01,4037,5534,4037,5534,9571
SANTA ROSA,consulta externa,nuevas en personas de 60 anos o mas,2006-08-01,36,32,36,32,68
SANTA ROSA DEL SARA,consulta externa,nuevas en personas de 60 anos o mas,2006-08-01,72,67,72,67,139
SANTIAGO DE CALLAPA,consulta externa,nuevas en personas de 60 anos o mas,2006-08-01,13,16,13,16,29
SANTIAGO DE HUARI,consulta externa,nuevas en personas de 60 anos o mas,2006-08-01,125,128,125,128,253
SANTIAGO DE MACHACA,consulta externa,nuevas en personas de 60 anos o mas,2006-08-01,21,15,21,15,36
SANTIVAÑES,consulta externa,nuevas en personas de 60 anos o mas,2006-08-01,53,99,53,99,152
SANTUARIO DE QUILLACAS,consulta externa,nuevas en personas de 60 anos o mas,2006-08-01,25,24,25,24,49
SAPAHAQUI,consulta externa,nuevas en personas de 60 anos o mas,2006-08-01,48,50,48,50,98
SENA,consulta externa,nuevas en personas de 60 anos o mas,2006-08-01,9,9,9,9,18
SICA SICA (VILLA AROMA),consulta externa,nuevas en personas de 60 anos o mas,2006-08-01,35,46,35,46,81
SICAYA,consulta externa,nuevas en personas de 60 anos o mas,2006-08-01,6,6,6,6,12
SIPE SIPE,consulta externa,nuevas en personas de 60 anos o mas,2006-08-01,21,45,21,45,66
SOPACHUY,consulta externa,nuevas en personas de 60 anos o mas,2006-08-01,33,66,33,66,99
SORACACHI,consulta externa,nuevas en personas de 60 anos o mas,2006-08-01,10,11,10,11,21
SORATA,consulta externa,nuevas en personas de 60 anos o mas,2006-08-01,63,48,63,48,111
SUCRE,consulta externa,nuevas en personas de 60 anos o mas,2006-08-01,2410,3082,2410,3082,5492
TACACHI,consulta externa,nuevas en personas de 60 anos o mas,2006-08-01,1,6,1,6,7
TACACOMA,consulta externa,nuevas en personas de 60 anos o mas,2006-08-01,10,8,10,8,18
TACOBAMBA,consulta externa,nuevas en personas de 60 anos o mas,2006-08-01,23,39,23,39,62
TACOPAYA,consulta externa,nuevas en personas de 60 anos o mas,2006-08-01,12,28,12,28,40
TAHUA,consulta externa,nuevas en personas de 60 anos o mas,2006-08-01,8,9,8,9,17
TAPACARI,consulta externa,nuevas en personas de 60 anos o mas,2006-08-01,95,82,95,82,177
TARABUCO,consulta externa,nuevas en personas de 60 anos o mas,2006-08-01,121,134,121,134,255
TARACO,consulta externa,nuevas en personas de 60 anos o mas,2006-08-01,21,18,21,18,39
TARATA,consulta externa,nuevas en personas de 60 anos o mas,2006-08-01,9,30,9,30,39
TARIJA,consulta externa,nuevas en personas de 60 anos o mas,2006-08-01,883,1000,883,1000,1883
TARVITA,consulta externa,nuevas en personas de 60 anos o mas,2006-08-01,77,125,77,125,202
TEOPONTE,consulta externa,nuevas en personas de 60 anos o mas,2006-08-01,59,36,59,36,95
TIAWANACU,consulta externa,nuevas en personas de 60 anos o mas,2006-08-01,16,12,16,12,28
TINGUIPAYA,consulta externa,nuevas en personas de 60 anos o mas,2006-08-01,40,98,40,98,138
TIPUANI,consulta externa,nuevas en personas de 60 anos o mas,2006-08-01,25,12,25,12,37
TIQUIPAYA,consulta externa,nuevas en personas de 60 anos o mas,2006-08-01,25,28,25,28,53
TIRAQUE (CBBA),consulta externa,nuevas en personas de 60 anos o mas,2006-08-01,64,67,64,67,131
TITO YUPANQUI (PARQUIPUJIO),consulta externa,nuevas en personas de 60 anos o mas,2006-08-01,15,18,15,18,33
TOCO,consulta externa,nuevas en personas de 60 anos o mas,2006-08-01,8,13,8,13,21
TOLATA,consulta externa,nuevas en personas de 60 anos o mas,2006-08-01,5,6,5,6,11
TOLEDO,consulta externa,nuevas en personas de 60 anos o mas,2006-08-01,39,41,39,41,80
TOMAVE,consulta externa,nuevas en personas de 60 anos o mas,2006-08-01,34,106,34,106,140
TOMINA,consulta externa,nuevas en personas de 60 anos o mas,2006-08-01,65,75,65,75,140
TORO TORO,consulta externa,nuevas en personas de 60 anos o mas,2006-08-01,47,71,47,71,118
TOTORA(CBBA),consulta externa,nuevas en personas de 60 anos o mas,2006-08-01,18,30,18,30,48
TOTORA(ORR),consulta externa,nuevas en personas de 60 anos o mas,2006-08-01,25,28,25,28,53
TRIGAL,consulta externa,nuevas en personas de 60 anos o mas,2006-08-01,39,51,39,51,90
TRINIDAD,consulta externa,nuevas en personas de 60 anos o mas,2006-08-01,451,399,451,399,850
TUPIZA,consulta externa,nuevas en personas de 60 anos o mas,2006-08-01,325,522,325,522,847
TURCO,consulta externa,nuevas en personas de 60 anos o mas,2006-08-01,40,35,40,35,75
UMALA,consulta externa,nuevas en personas de 60 anos o mas,2006-08-01,17,17,17,17,34
UNCIA,consulta externa,nuevas en personas de 60 anos o mas,2006-08-01,132,188,132,188,320
URIONDO (A. CONCEPCION),consulta externa,nuevas en personas de 60 anos o mas,2006-08-01,63,101,63,101,164
URUBICHA,consulta externa,nuevas en personas de 60 anos o mas,2006-08-01,12,9,12,9,21
UYUNI,consulta externa,nuevas en personas de 60 anos o mas,2006-08-01,312,324,312,324,636
VACAS,consulta externa,nuevas en personas de 60 anos o mas,2006-08-01,34,31,34,31,65
VALLEGRANDE,consulta externa,nuevas en personas de 60 anos o mas,2006-08-01,371,415,371,415,786
VIACHA,consulta externa,nuevas en personas de 60 anos o mas,2006-08-01,312,277,312,277,589
VILA VILA,consulta externa,nuevas en personas de 60 anos o mas,2006-08-01,1,3,1,3,4
VILLA MONTES,consulta externa,nuevas en personas de 60 anos o mas,2006-08-01,169,166,169,166,335
VILLA NUEVA (LOMA ALTA),consulta externa,nuevas en personas de 60 anos o mas,2006-08-01,11,12,11,12,23
VILLA RIVERO,consulta externa,nuevas en personas de 60 anos o mas,2006-08-01,21,14,21,14,35
VILLA SERRANO,consulta externa,nuevas en personas de 60 anos o mas,2006-08-01,84,92,84,92,176
VILLA TUNARI,consulta externa,nuevas en personas de 60 anos o mas,2006-08-01,129,126,129,126,255
VILLA VACA GUZMAN (MUYUPAMPA),consulta externa,nuevas en personas de 60 anos o mas,2006-08-01,57,57,57,57,114
VILLAZON,consulta externa,nuevas en personas de 60 anos o mas,2006-08-01,468,591,468,591,1059
VINTO,consulta externa,nuevas en personas de 60 anos o mas,2006-08-01,23,41,23,41,64
VITICHI,consulta externa,nuevas en personas de 60 anos o mas,2006-08-01,76,123,76,123,199
WALDO BALLIVIAN,consulta externa,nuevas en personas de 60 anos o mas,2006-08-01,3,5,3,5,8
WARNES,consulta externa,nuevas en personas de 60 anos o mas,2006-08-01,65,76,65,76,141
YACO,consulta externa,nuevas en personas de 60 anos o mas,2006-08-01,21,12,21,12,33
YACUIBA,consulta externa,nuevas en personas de 60 anos o mas,2006-08-01,641,940,641,940,1581
YAMPARAEZ,consulta externa,nuevas en personas de 60 anos o mas,2006-08-01,30,45,30,45,75
YANACACHI,consulta externa,nuevas en personas de 60 anos o mas,2006-08-01,32,28,32,28,60
YAPACANI,consulta externa,nuevas en personas de 60 anos o mas,2006-08-01,319,252,319,252,571
YOCALLA,consulta externa,nuevas en personas de 60 anos o mas,2006-08-01,87,134,87,134,221
YOTALA,consulta externa,nuevas en personas de 60 anos o mas,2006-08-01,27,49,27,49,76
YUNCHARA,consulta externa,nuevas en personas de 60 anos o mas,2006-08-01,18,45,18,45,63
ZUDAÑEZ,consulta externa,nuevas en personas de 60 anos o mas,2006-08-01,89,96,89,96,185
ACACIO,consulta externa,nuevas en personas de 60 anos o mas,2006-09-01,23,29,23,29,52
ACHACACHI,consulta externa,nuevas en personas de 60 anos o mas,2006-09-01,154,166,154,166,320
ACHOCALLA,consulta externa,nuevas en personas de 60 anos o mas,2006-09-01,11,10,11,10,21
AIQUILE,consulta externa,nuevas en personas de 60 anos o mas,2006-09-01,75,106,75,106,181
ALCALA,consulta externa,nuevas en personas de 60 anos o mas,2006-09-01,36,46,36,46,82
ANCORAIMES,consulta externa,nuevas en personas de 60 anos o mas,2006-09-01,39,35,39,35,74
ANDAMARCA,consulta externa,nuevas en personas de 60 anos o mas,2006-09-01,30,31,30,31,61
ANTEQUERA,consulta externa,nuevas en personas de 60 anos o mas,2006-09-01,3,3,3,3,6
ANZALDO,consulta externa,nuevas en personas de 60 anos o mas,2006-09-01,16,27,16,27,43
APOLO,consulta externa,nuevas en personas de 60 anos o mas,2006-09-01,50,56,50,56,106
ARAMPAMPA,consulta externa,nuevas en personas de 60 anos o mas,2006-09-01,9,12,9,12,21
ARANI,consulta externa,nuevas en personas de 60 anos o mas,2006-09-01,9,12,9,12,21
ARBIETO,consulta externa,nuevas en personas de 60 anos o mas,2006-09-01,16,45,16,45,61
ARQUE,consulta externa,nuevas en personas de 60 anos o mas,2006-09-01,13,17,13,17,30
ASCENCION DE GUARAYOS,consulta externa,nuevas en personas de 60 anos o mas,2006-09-01,28,24,28,24,52
ATOCHA,consulta externa,nuevas en personas de 60 anos o mas,2006-09-01,79,106,79,106,185
AUCAPATA,consulta externa,nuevas en personas de 60 anos o mas,2006-09-01,18,27,18,27,45
AYATA,consulta externa,nuevas en personas de 60 anos o mas,2006-09-01,20,22,20,22,42
AYO AYO,consulta externa,nuevas en personas de 60 anos o mas,2006-09-01,9,10,9,10,19
AYOPAYA (V. DE INDEPENDENCIA),consulta externa,nuevas en personas de 60 anos o mas,2006-09-01,47,81,47,81,128
AZURDUY,consulta externa,nuevas en personas de 60 anos o mas,2006-09-01,56,95,56,95,151
BATALLAS,consulta externa,nuevas en personas de 60 anos o mas,2006-09-01,39,29,39,29,68
BAURES,consulta externa,nuevas en personas de 60 anos o mas,2006-09-01,30,32,30,32,62
BELEN DE ANDAMARCA,consulta externa,nuevas en personas de 60 anos o mas,2006-09-01,8,11,8,11,19
BELEN DE URMIRI,consulta externa,nuevas en personas de 60 anos o mas,2006-09-01,27,23,27,23,50
BELLA FLOR,consulta externa,nuevas en personas de 60 anos o mas,2006-09-01,7,2,7,2,9
BERMEJO,consulta externa,nuevas en personas de 60 anos o mas,2006-09-01,475,452,475,452,927
BETANZOS,consulta externa,nuevas en personas de 60 anos o mas,2006-09-01,183,289,183,289,472
BOLIVAR,consulta externa,nuevas en personas de 60 anos o mas,2006-09-01,22,22,22,22,44
BOLPEBRA,consulta externa,nuevas en personas de 60 anos o mas,2006-09-01,3,3,3,3,6
BOYUIBE,consulta externa,nuevas en personas de 60 anos o mas,2006-09-01,23,39,23,39,62
BUENA VISTA,consulta externa,nuevas en personas de 60 anos o mas,2006-09-01,42,51,42,51,93
CABEZAS,consulta externa,nuevas en personas de 60 anos o mas,2006-09-01,47,62,47,62,109
CAIROMA,consulta externa,nuevas en personas de 60 anos o mas,2006-09-01,36,39,36,39,75
"CAIZA ""D""",consulta externa,nuevas en personas de 60 anos o mas,2006-09-01,56,105,56,105,161
CAJUATA,consulta externa,nuevas en personas de 60 anos o mas,2006-09-01,29,23,29,23,52
CALACOTO,consulta externa,nuevas en personas de 60 anos o mas,2006-09-01,17,27,17,27,44
CALAMARCA,consulta externa,nuevas en personas de 60 anos o mas,2006-09-01,17,24,17,24,41
CAMARGO,consulta externa,nuevas en personas de 60 anos o mas,2006-09-01,242,313,242,313,555
CAMATAQUI (C. VILLA ABECIA),consulta externa,nuevas en personas de 60 anos o mas,2006-09-01,29,42,29,42,71
CAMIRI,consulta externa,nuevas en personas de 60 anos o mas,2006-09-01,240,439,240,439,679
CAPINOTA,consulta externa,nuevas en personas de 60 anos o mas,2006-09-01,52,74,52,74,126
CAQUIAVIRI,consulta externa,nuevas en personas de 60 anos o mas,2006-09-01,49,53,49,53,102
CARACOLLO,consulta externa,nuevas en personas de 60 anos o mas,2006-09-01,71,63,71,63,134
CARANAVI,consulta externa,nuevas en personas de 60 anos o mas,2006-09-01,389,207,389,207,596
CARANGAS,consulta externa,nuevas en personas de 60 anos o mas,2006-09-01,0,3,0,3,3
CARAPARI,consulta externa,nuevas en personas de 60 anos o mas,2006-09-01,48,49,48,49,97
CARIPUYO,consulta externa,nuevas en personas de 60 anos o mas,2006-09-01,14,26,14,26,40
CARMEN RIVERO TORREZ,consulta externa,nuevas en personas de 60 anos o mas,2006-09-01,10,5,10,5,15
CATACORA,consulta externa,nuevas en personas de 60 anos o mas,2006-09-01,3,9,3,9,12
CHACARILLA,consulta externa,nuevas en personas de 60 anos o mas,2006-09-01,1,1,1,1,2
CHALLAPATA,consulta externa,nuevas en personas de 60 anos o mas,2006-09-01,129,128,129,128,257
CHAQUI,consulta externa,nuevas en personas de 60 anos o mas,2006-09-01,27,40,27,40,67
CHARAGUA,consulta externa,nuevas en personas de 60 anos o mas,2006-09-01,56,67,56,67,123
CHARAÑA,consulta externa,nuevas en personas de 60 anos o mas,2006-09-01,4,8,4,8,12
CHAYANTA,consulta externa,nuevas en personas de 60 anos o mas,2006-09-01,47,96,47,96,143
CHIMORE,consulta externa,nuevas en personas de 60 anos o mas,2006-09-01,18,7,18,7,25
CHIPAYA,consulta externa,nuevas en personas de 60 anos o mas,2006-09-01,1,1,1,1,2
CHOQUE COTA,consulta externa,nuevas en personas de 60 anos o mas,2006-09-01,14,16,14,16,30
CHULUMANI (V. DE LA LIBERTAD),consulta externa,nuevas en personas de 60 anos o mas,2006-09-01,55,43,55,43,98
CHUMA,consulta externa,nuevas en personas de 60 anos o mas,2006-09-01,80,72,80,72,152
CLIZA,consulta externa,nuevas en personas de 60 anos o mas,2006-09-01,34,42,34,42,76
COBIJA,consulta externa,nuevas en personas de 60 anos o mas,2006-09-01,295,343,295,343,638
COCHABAMBA,consulta externa,nuevas en personas de 60 anos o mas,2006-09-01,4330,5807,4330,5807,10137
COIPASA,consulta externa,nuevas en personas de 60 anos o mas,2006-09-01,1,2,1,2,3
COLCAPIRHUA,consulta externa,nuevas en personas de 60 anos o mas,2006-09-01,162,237,162,237,399
"COLCHA ""K""",consulta externa,nuevas en personas de 60 anos o mas,2006-09-01,45,69,45,69,114
COLLANA,consulta externa,nuevas en personas de 60 anos o mas,2006-09-01,10,11,10,11,21
COLOMI,consulta externa,nuevas en personas de 60 anos o mas,2006-09-01,19,29,19,29,48
COLPA BELGICA,consulta externa,nuevas en personas de 60 anos o mas,2006-09-01,56,40,56,40,96
COLQUECHACA,consulta externa,nuevas en personas de 60 anos o mas,2006-09-01,75,92,75,92,167
COLQUENCHA,consulta externa,nuevas en personas de 60 anos o mas,2006-09-01,27,42,27,42,69
COLQUIRI,consulta externa,nuevas en personas de 60 anos o mas,2006-09-01,61,51,61,51,112
COMANCHE,consulta externa,nuevas en personas de 60 anos o mas,2006-09-01,13,12,13,12,25
COMARAPA,consulta externa,nuevas en personas de 60 anos o mas,2006-09-01,91,102,91,102,193
COMBAYA,consulta externa,nuevas en personas de 60 anos o mas,2006-09-01,25,26,25,26,51
CONCEPCION,consulta externa,nuevas en personas de 60 anos o mas,2006-09-01,45,35,45,35,80
COPACABANA,consulta externa,nuevas en personas de 60 anos o mas,2006-09-01,29,21,29,21,50
CORIPATA,consulta externa,nuevas en personas de 60 anos o mas,2006-09-01,27,22,27,22,49
CORO CORO,consulta externa,nuevas en personas de 60 anos o mas,2006-09-01,25,32,25,32,57
COROICO,consulta externa,nuevas en personas de 60 anos o mas,2006-09-01,82,57,82,57,139
CORQUE,consulta externa,nuevas en personas de 60 anos o mas,2006-09-01,37,44,37,44,81
COTAGAITA,consulta externa,nuevas en personas de 60 anos o mas,2006-09-01,225,465,225,465,690
COTOCA,consulta externa,nuevas en personas de 60 anos o mas,2006-09-01,23,27,23,27,50
CUATRO CAÑADAS,consulta externa,nuevas en personas de 60 anos o mas,2006-09-01,20,31,20,31,51
CUCHUMUELA (V. G. VILLARROEL),consulta externa,nuevas en personas de 60 anos o mas,2006-09-01,8,6,8,6,14
CUEVO,consulta externa,nuevas en personas de 60 anos o mas,2006-09-01,15,34,15,34,49
CULPINA,consulta externa,nuevas en personas de 60 anos o mas,2006-09-01,97,106,97,106,203
CURAHUARA DE CARANGAS,consulta externa,nuevas en personas de 60 anos o mas,2006-09-01,50,44,50,44,94
CURVA,consulta externa,nuevas en personas de 60 anos o mas,2006-09-01,7,10,7,10,17
DESAGUADERO,consulta externa,nuevas en personas de 60 anos o mas,2006-09-01,29,32,29,32,61
EL ALTO,consulta externa,nuevas en personas de 60 anos o mas,2006-09-01,1367,1346,1367,1346,2713
EL CHORO,consulta externa,nuevas en personas de 60 anos o mas,2006-09-01,52,45,52,45,97
EL PUENTE(STC),consulta externa,nuevas en personas de 60 anos o mas,2006-09-01,13,12,13,12,25
EL PUENTE(TJA),consulta externa,nuevas en personas de 60 anos o mas,2006-09-01,28,54,28,54,82
EL TORNO,consulta externa,nuevas en personas de 60 anos o mas,2006-09-01,130,138,130,138,268
EL VILLAR,consulta externa,nuevas en personas de 60 anos o mas,2006-09-01,32,64,32,64,96
ENTRE RIOS,consulta externa,nuevas en personas de 60 anos o mas,2006-09-01,96,103,96,103,199
ENTRE RIOS,consulta externa,nuevas en personas de 60 anos o mas,2006-09-01,24,26,24,26,50
ESCARA,consulta externa,nuevas en personas de 60 anos o mas,2006-09-01,2,2,2,2,4
ESMERALDA,consulta externa,nuevas en personas de 60 anos o mas,2006-09-01,8,12,8,12,20
EUCALIPTUS,consulta externa,nuevas en personas de 60 anos o mas,2006-09-01,66,50,66,50,116
EUREKA (SANTOS MERCADO),consulta externa,nuevas en personas de 60 anos o mas,2006-09-01,1,1,1,1,2
EXALTACION,consulta externa,nuevas en personas de 60 anos o mas,2006-09-01,9,8,9,8,17
FERNANDEZ ALONSO,consulta externa,nuevas en personas de 60 anos o mas,2006-09-01,14,11,14,11,25
FILADELFIA,consulta externa,nuevas en personas de 60 anos o mas,2006-09-01,8,8,8,8,16
GENERAL SAAVEDRA,consulta externa,nuevas en personas de 60 anos o mas,2006-09-01,31,40,31,40,71
GRAL. J.J. PEREZ (CHARAZANI),consulta externa,nuevas en personas de 60 anos o mas,2006-09-01,32,22,32,22,54
GUANAY,consulta externa,nuevas en personas de 60 anos o mas,2006-09-01,98,93,98,93,191
GUAQUI,consulta externa,nuevas en personas de 60 anos o mas,2006-09-01,27,29,27,29,56
GUAYARAMERIN,consulta externa,nuevas en personas de 60 anos o mas,2006-09-01,361,155,361,155,516
GUTIERREZ,consulta externa,nuevas en personas de 60 anos o mas,2006-09-01,38,67,38,67,105
HUACARETA,consulta externa,nuevas en personas de 60 anos o mas,2006-09-01,40,64,40,64,104
HUACAYA (VILLA DE HUACAYA),consulta externa,nuevas en personas de 60 anos o mas,2006-09-01,9,16,9,16,25
HUACHACALLA,consulta externa,nuevas en personas de 60 anos o mas,2006-09-01,56,56,56,56,112
HUANUNI,consulta externa,nuevas en personas de 60 anos o mas,2006-09-01,187,206,187,206,393
HUARACAJE,consulta externa,nuevas en personas de 60 anos o mas,2006-09-01,9,4,9,4,13
HUAYLLAMARCA,consulta externa,nuevas en personas de 60 anos o mas,2006-09-01,45,29,45,29,74
ICHOCA,consulta externa,nuevas en personas de 60 anos o mas,2006-09-01,19,18,19,18,37
ICLA,consulta externa,nuevas en personas de 60 anos o mas,2006-09-01,23,37,23,37,60
INCAHUASI,consulta externa,nuevas en personas de 60 anos o mas,2006-09-01,44,91,44,91,135
INGAVI (HUMAITA),consulta externa,nuevas en personas de 60 anos o mas,2006-09-01,1,3,1,3,4
INQUISIVI,consulta externa,nuevas en personas de 60 anos o mas,2006-09-01,36,32,36,32,68
IRUPANA (VILLA DE LANZA),consulta externa,nuevas en personas de 60 anos o mas,2006-09-01,77,48,77,48,125
IXIAMAS,consulta externa,nuevas en personas de 60 anos o mas,2006-09-01,27,17,27,17,44
JESUS DE MACHACA,consulta externa,nuevas en personas de 60 anos o mas,2006-09-01,76,102,76,102,178
LA ASUNTA,consulta externa,nuevas en personas de 60 anos o mas,2006-09-01,21,20,21,20,41
LA GUARDIA,consulta externa,nuevas en personas de 60 anos o mas,2006-09-01,31,44,31,44,75
LA PAZ,consulta externa,nuevas en personas de 60 anos o mas,2006-09-01,8826,10400,8826,10400,19226
LA RIVERA,consulta externa,nuevas en personas de 60 anos o mas,2006-09-01,2,2,2,2,4
LAGUNILLAS,consulta externa,nuevas en personas de 60 anos o mas,2006-09-01,26,34,26,34,60
LAJA,consulta externa,nuevas en personas de 60 anos o mas,2006-09-01,37,39,37,39,76
LAS CARRERAS,consulta externa,nuevas en personas de 60 anos o mas,2006-09-01,31,45,31,45,76
LICOMA PAMPA,consulta externa,nuevas en personas de 60 anos o mas,2006-09-01,12,21,12,21,33
LLALLAGUA,consulta externa,nuevas en personas de 60 anos o mas,2006-09-01,329,438,329,438,767
LLICA,consulta externa,nuevas en personas de 60 anos o mas,2006-09-01,22,31,22,31,53
LORETO,consulta externa,nuevas en personas de 60 anos o mas,2006-09-01,8,6,8,6,14
LURIBAY,consulta externa,nuevas en personas de 60 anos o mas,2006-09-01,33,64,33,64,97
MACHACAMARCA,consulta externa,nuevas en personas de 60 anos o mas,2006-09-01,9,18,9,18,27
MACHARETI,consulta externa,nuevas en personas de 60 anos o mas,2006-09-01,62,75,62,75,137
MAGDALENA,consulta externa,nuevas en personas de 60 anos o mas,2006-09-01,47,30,47,30,77
MAIRANA,consulta externa,nuevas en personas de 60 anos o mas,2006-09-01,52,73,52,73,125
MALLA,consulta externa,nuevas en personas de 60 anos o mas,2006-09-01,9,13,9,13,22
MAPIRI,consulta externa,nuevas en personas de 60 anos o mas,2006-09-01,53,34,53,34,87
MECAPACA,consulta externa,nuevas en personas de 60 anos o mas,2006-09-01,38,31,38,31,69
MINEROS,consulta externa,nuevas en personas de 60 anos o mas,2006-09-01,16,7,16,7,23
MIZQUE,consulta externa,nuevas en personas de 60 anos o mas,2006-09-01,39,22,39,22,61
MOCOMOCO,consulta externa,nuevas en personas de 60 anos o mas,2006-09-01,53,69,53,69,122
MOJINETE,consulta externa,nuevas en personas de 60 anos o mas,2006-09-01,13,13,13,13,26
MOJOCOYA,consulta externa,nuevas en personas de 60 anos o mas,2006-09-01,60,41,60,41,101
MONTEAGUDO,consulta externa,nuevas en personas de 60 anos o mas,2006-09-01,382,525,382,525,907
MONTERO,consulta externa,nuevas en personas de 60 anos o mas,2006-09-01,260,243,260,243,503
MORO MORO,consulta externa,nuevas en personas de 60 anos o mas,2006-09-01,37,57,37,57,94
MOROCHATA,consulta externa,nuevas en personas de 60 anos o mas,2006-09-01,19,22,19,22,41
NACEBE (SANTA ROSA DEL ABUNA),consulta externa,nuevas en personas de 60 anos o mas,2006-09-01,8,0,8,0,8
NUEVO MANOA (NUEVA ESPERANZA),consulta externa,nuevas en personas de 60 anos o mas,2006-09-01,8,3,8,3,11
OCURI,consulta externa,nuevas en personas de 60 anos o mas,2006-09-01,33,67,33,67,100
OKINAWA,consulta externa,nuevas en personas de 60 anos o mas,2006-09-01,74,71,74,71,145
OMEREQUE,consulta externa,nuevas en personas de 60 anos o mas,2006-09-01,13,17,13,17,30
ORURO,consulta externa,nuevas en personas de 60 anos o mas,2006-09-01,2989,3407,2989,3407,6396
PADCAYA,consulta externa,nuevas en personas de 60 anos o mas,2006-09-01,100,123,100,123,223
PADILLA,consulta externa,nuevas en personas de 60 anos o mas,2006-09-01,63,73,63,73,136
PAILON,consulta externa,nuevas en personas de 60 anos o mas,2006-09-01,21,8,21,8,29
PALCA,consulta externa,nuevas en personas de 60 anos o mas,2006-09-01,28,22,28,22,50
PALOS BLANCOS,consulta externa,nuevas en personas de 60 anos o mas,2006-09-01,28,23,28,23,51
PAMPA AULLAGAS,consulta externa,nuevas en personas de 60 anos o mas,2006-09-01,8,12,8,12,20
PAMPA GRANDE,consulta externa,nuevas en personas de 60 anos o mas,2006-09-01,23,40,23,40,63
PAPEL PAMPA,consulta externa,nuevas en personas de 60 anos o mas,2006-09-01,34,25,34,25,59
PASORAPA,consulta externa,nuevas en personas de 60 anos o mas,2006-09-01,5,8,5,8,13
PATACAMAYA,consulta externa,nuevas en personas de 60 anos o mas,2006-09-01,30,35,30,35,65
PAZÑA,consulta externa,nuevas en personas de 60 anos o mas,2006-09-01,38,49,38,49,87
PELECHUCO,consulta externa,nuevas en personas de 60 anos o mas,2006-09-01,13,18,13,18,31
POCOATA,consulta externa,nuevas en personas de 60 anos o mas,2006-09-01,80,79,80,79,159
POCONA,consulta externa,nuevas en personas de 60 anos o mas,2006-09-01,17,54,17,54,71
POJO (CBBA),consulta externa,nuevas en personas de 60 anos o mas,2006-09-01,7,28,7,28,35
POOPO,consulta externa,nuevas en personas de 60 anos o mas,2006-09-01,25,65,25,65,90
PORCO,consulta externa,nuevas en personas de 60 anos o mas,2006-09-01,5,26,5,26,31
POROMA,consulta externa,nuevas en personas de 60 anos o mas,2006-09-01,101,116,101,116,217
PORONGO,consulta externa,nuevas en personas de 60 anos o mas,2006-09-01,41,44,41,44,85
PORTACHUELO,consulta externa,nuevas en personas de 60 anos o mas,2006-09-01,74,117,74,117,191
PORVENIR,consulta externa,nuevas en personas de 60 anos o mas,2006-09-01,16,8,16,8,24
POSTRER VALLE,consulta externa,nuevas en personas de 60 anos o mas,2006-09-01,30,43,30,43,73
POTOSI,consulta externa,nuevas en personas de 60 anos o mas,2006-09-01,1683,1768,1683,1768,3451
PRESTO,consulta externa,nuevas en personas de 60 anos o mas,2006-09-01,30,76,30,76,106
PUCARA,consulta externa,nuevas en personas de 60 anos o mas,2006-09-01,33,50,33,50,83
PUCARANI,consulta externa,nuevas en personas de 60 anos o mas,2006-09-01,44,47,44,47,91
PUERTO ACOSTA,consulta externa,nuevas en personas de 60 anos o mas,2006-09-01,170,62,170,62,232
PUERTO CARABUCO,consulta externa,nuevas en personas de 60 anos o mas,2006-09-01,59,81,59,81,140
PUERTO GONZALO MORENO,consulta externa,nuevas en personas de 60 anos o mas,2006-09-01,11,12,11,12,23
PUERTO PEREZ,consulta externa,nuevas en personas de 60 anos o mas,2006-09-01,28,21,28,21,49
PUERTO QUIJARRO,consulta externa,nuevas en personas de 60 anos o mas,2006-09-01,104,140,104,140,244
PUERTO RICO,consulta externa,nuevas en personas de 60 anos o mas,2006-09-01,22,11,22,11,33
PUERTO SILES,consulta externa,nuevas en personas de 60 anos o mas,2006-09-01,9,5,9,5,14
PUERTO SUAREZ,consulta externa,nuevas en personas de 60 anos o mas,2006-09-01,187,178,187,178,365
PUERTO VILLARROEL,consulta externa,nuevas en personas de 60 anos o mas,2006-09-01,24,31,24,31,55
PUNA,consulta externa,nuevas en personas de 60 anos o mas,2006-09-01,164,257,164,257,421
PUNATA,consulta externa,nuevas en personas de 60 anos o mas,2006-09-01,139,151,139,151,290
QUIABAYA,consulta externa,nuevas en personas de 60 anos o mas,2006-09-01,19,17,19,17,36
QUILLACOLLO,consulta externa,nuevas en personas de 60 anos o mas,2006-09-01,37,68,37,68,105
QUIME,consulta externa,nuevas en personas de 60 anos o mas,2006-09-01,17,19,17,19,36
QUIRUSILLAS,consulta externa,nuevas en personas de 60 anos o mas,2006-09-01,4,5,4,5,9
RAVELO,consulta externa,nuevas en personas de 60 anos o mas,2006-09-01,41,63,41,63,104
REYES,consulta externa,nuevas en personas de 60 anos o mas,2006-09-01,75,83,75,83,158
RIBERALTA,consulta externa,nuevas en personas de 60 anos o mas,2006-09-01,573,634,573,634,1207
ROBORE,consulta externa,nuevas en personas de 60 anos o mas,2006-09-01,161,171,161,171,332
RURRENABAQUE,consulta externa,nuevas en personas de 60 anos o mas,2006-09-01,125,105,125,105,230
SABAYA,consulta externa,nuevas en personas de 60 anos o mas,2006-09-01,44,42,44,42,86
SACABA,consulta externa,nuevas en personas de 60 anos o mas,2006-09-01,124,261,124,261,385
SACABAMBA,consulta externa,nuevas en personas de 60 anos o mas,2006-09-01,5,6,5,6,11
SACACA,consulta externa,nuevas en personas de 60 anos o mas,2006-09-01,41,75,41,75,116
SAIPINA,consulta externa,nuevas en personas de 60 anos o mas,2006-09-01,20,25,20,25,45
SALINAS DE GARCI MENDOZA,consulta externa,nuevas en personas de 60 anos o mas,2006-09-01,72,82,72,82,154
SAMAIPATA,consulta externa,nuevas en personas de 60 anos o mas,2006-09-01,47,42,47,42,89
SAN AGUSTIN,consulta externa,nuevas en personas de 60 anos o mas,2006-09-01,7,18,7,18,25
SAN ANDRES,consulta externa,nuevas en personas de 60 anos o mas,2006-09-01,19,15,19,15,34
SAN ANDRES DE MACHACA,consulta externa,nuevas en personas de 60 anos o mas,2006-09-01,38,70,38,70,108
SAN ANTONIO DE ESMORUCO,consulta externa,nuevas en personas de 60 anos o mas,2006-09-01,6,16,6,16,22
SAN ANTONIO DE LOMERIO,consulta externa,nuevas en personas de 60 anos o mas,2006-09-01,22,23,22,23,45
SAN BENITO,consulta externa,nuevas en personas de 60 anos o mas,2006-09-01,15,47,15,47,62
SAN BORJA,consulta externa,nuevas en personas de 60 anos o mas,2006-09-01,95,92,95,92,187
SAN BUENA VENTURA,consulta externa,nuevas en personas de 60 anos o mas,2006-09-01,73,75,73,75,148
SAN CARLOS,consulta externa,nuevas en personas de 60 anos o mas,2006-09-01,102,107,102,107,209
SAN IGNACIO,consulta externa,nuevas en personas de 60 anos o mas,2006-09-01,81,105,81,105,186
SAN IGNACIO DE VELASCO,consulta externa,nuevas en personas de 60 anos o mas,2006-09-01,258,267,258,267,525
SAN JAVIER(BNI),consulta externa,nuevas en personas de 60 anos o mas,2006-09-01,11,9,11,9,20
SAN JAVIER(STC),consulta externa,nuevas en personas de 60 anos o mas,2006-09-01,11,17,11,17,28
SAN JOAQUIN,consulta externa,nuevas en personas de 60 anos o mas,2006-09-01,115,137,115,137,252
SAN JOSE DE CHIQUITOS,consulta externa,nuevas en personas de 60 anos o mas,2006-09-01,55,72,55,72,127
SAN JUAN DE YAPACANI,consulta externa,nuevas en personas de 60 anos o mas,2006-09-01,64,42,64,42,106
SAN JULIAN,consulta externa,nuevas en personas de 60 anos o mas,2006-09-01,207,274,207,274,481
SAN LORENZO(PND),consulta externa,nuevas en personas de 60 anos o mas,2006-09-01,6,3,6,3,9
SAN LORENZO(TJA),consulta externa,nuevas en personas de 60 anos o mas,2006-09-01,63,114,63,114,177
SAN LUCAS,consulta externa,nuevas en personas de 60 anos o mas,2006-09-01,177,289,177,289,466
SAN MATIAS,consulta externa,nuevas en personas de 60 anos o mas,2006-09-01,30,31,30,31,61
SAN MIGUEL DE VELASCO,consulta externa,nuevas en personas de 60 anos o mas,2006-09-01,38,72,38,72,110
SAN PABLO DE LIPEZ,consulta externa,nuevas en personas de 60 anos o mas,2006-09-01,14,23,14,23,37
SAN PEDRO,consulta externa,nuevas en personas de 60 anos o mas,2006-09-01,41,29,41,29,70
SAN PEDRO DE BUENA VISTA,consulta externa,nuevas en personas de 60 anos o mas,2006-09-01,40,66,40,66,106
SAN PEDRO DE CURAHUARA,consulta externa,nuevas en personas de 60 anos o mas,2006-09-01,19,26,19,26,45
SAN PEDRO DE QUEMES,consulta externa,nuevas en personas de 60 anos o mas,2006-09-01,1,0,1,0,1
SAN PEDRO DE TIQUINA,consulta externa,nuevas en personas de 60 anos o mas,2006-09-01,33,24,33,24,57
SAN PEDRO(PND),consulta externa,nuevas en personas de 60 anos o mas,2006-09-01,1,0,1,0,1
SAN RAFAEL,consulta externa,nuevas en personas de 60 anos o mas,2006-09-01,15,9,15,9,24
SAN RAMON,consulta externa,nuevas en personas de 60 anos o mas,2006-09-01,58,89,58,89,147
SAN RAMON,consulta externa,nuevas en personas de 60 anos o mas,2006-09-01,42,56,42,56,98
SANTA ANA,consulta externa,nuevas en personas de 60 anos o mas,2006-09-01,94,128,94,128,222
SANTA CRUZ DE LA SIERRA,consulta externa,nuevas en personas de 60 anos o mas,2006-09-01,3781,5578,3781,5578,9359
SANTA ROSA,consulta externa,nuevas en personas de 60 anos o mas,2006-09-01,147,109,147,109,256
SANTA ROSA DEL SARA,consulta externa,nuevas en personas de 60 anos o mas,2006-09-01,59,65,59,65,124
SANTIAGO DE CALLAPA,consulta externa,nuevas en personas de 60 anos o mas,2006-09-01,11,13,11,13,24
SANTIAGO DE HUARI,consulta externa,nuevas en personas de 60 anos o mas,2006-09-01,113,142,113,142,255
SANTIAGO DE MACHACA,consulta externa,nuevas en personas de 60 anos o mas,2006-09-01,18,20,18,20,38
SANTIVAÑES,consulta externa,nuevas en personas de 60 anos o mas,2006-09-01,32,76,32,76,108
SANTUARIO DE QUILLACAS,consulta externa,nuevas en personas de 60 anos o mas,2006-09-01,16,17,16,17,33
SAPAHAQUI,consulta externa,nuevas en personas de 60 anos o mas,2006-09-01,26,36,26,36,62
SENA,consulta externa,nuevas en personas de 60 anos o mas,2006-09-01,9,2,9,2,11
SICA SICA (VILLA AROMA),consulta externa,nuevas en personas de 60 anos o mas,2006-09-01,34,27,34,27,61
SICAYA,consulta externa,nuevas en personas de 60 anos o mas,2006-09-01,3,10,3,10,13
SIPE SIPE,consulta externa,nuevas en personas de 60 anos o mas,2006-09-01,23,17,23,17,40
SOPACHUY,consulta externa,nuevas en personas de 60 anos o mas,2006-09-01,40,62,40,62,102
SORACACHI,consulta externa,nuevas en personas de 60 anos o mas,2006-09-01,18,28,18,28,46
SORATA,consulta externa,nuevas en personas de 60 anos o mas,2006-09-01,61,57,61,57,118
SUCRE,consulta externa,nuevas en personas de 60 anos o mas,2006-09-01,2239,3319,2239,3319,5558
TACACHI,consulta externa,nuevas en personas de 60 anos o mas,2006-09-01,1,8,1,8,9
TACACOMA,consulta externa,nuevas en personas de 60 anos o mas,2006-09-01,12,9,12,9,21
TACOBAMBA,consulta externa,nuevas en personas de 60 anos o mas,2006-09-01,13,38,13,38,51
TACOPAYA,consulta externa,nuevas en personas de 60 anos o mas,2006-09-01,14,20,14,20,34
TAHUA,consulta externa,nuevas en personas de 60 anos o mas,2006-09-01,9,6,9,6,15
TAPACARI,consulta externa,nuevas en personas de 60 anos o mas,2006-09-01,80,89,80,89,169
TARABUCO,consulta externa,nuevas en personas de 60 anos o mas,2006-09-01,116,135,116,135,251
TARACO,consulta externa,nuevas en personas de 60 anos o mas,2006-09-01,16,11,16,11,27
TARATA,consulta externa,nuevas en personas de 60 anos o mas,2006-09-01,15,20,15,20,35
TARIJA,consulta externa,nuevas en personas de 60 anos o mas,2006-09-01,2079,2332,2079,2332,4411
TARVITA,consulta externa,nuevas en personas de 60 anos o mas,2006-09-01,86,130,86,130,216
TEOPONTE,consulta externa,nuevas en personas de 60 anos o mas,2006-09-01,54,38,54,38,92
TIAWANACU,consulta externa,nuevas en personas de 60 anos o mas,2006-09-01,12,13,12,13,25
TINGUIPAYA,consulta externa,nuevas en personas de 60 anos o mas,2006-09-01,47,79,47,79,126
TIPUANI,consulta externa,nuevas en personas de 60 anos o mas,2006-09-01,15,14,15,14,29
TIQUIPAYA,consulta externa,nuevas en personas de 60 anos o mas,2006-09-01,19,31,19,31,50
TIRAQUE (CBBA),consulta externa,nuevas en personas de 60 anos o mas,2006-09-01,61,61,61,61,122
TITO YUPANQUI (PARQUIPUJIO),consulta externa,nuevas en personas de 60 anos o mas,2006-09-01,12,16,12,16,28
TOCO,consulta externa,nuevas en personas de 60 anos o mas,2006-09-01,6,11,6,11,17
TODOS SANTOS,consulta externa,nuevas en personas de 60 anos o mas,2006-09-01,4,5,4,5,9
TOLATA,consulta externa,nuevas en personas de 60 anos o mas,2006-09-01,9,4,9,4,13
TOLEDO,consulta externa,nuevas en personas de 60 anos o mas,2006-09-01,47,50,47,50,97
TOMAVE,consulta externa,nuevas en personas de 60 anos o mas,2006-09-01,60,85,60,85,145
TOMINA,consulta externa,nuevas en personas de 60 anos o mas,2006-09-01,49,66,49,66,115
TORO TORO,consulta externa,nuevas en personas de 60 anos o mas,2006-09-01,44,64,44,64,108
TOTORA(CBBA),consulta externa,nuevas en personas de 60 anos o mas,2006-09-01,21,34,21,34,55
TOTORA(ORR),consulta externa,nuevas en personas de 60 anos o mas,2006-09-01,15,14,15,14,29
TRIGAL,consulta externa,nuevas en personas de 60 anos o mas,2006-09-01,21,32,21,32,53
TRINIDAD,consulta externa,nuevas en personas de 60 anos o mas,2006-09-01,302,366,302,366,668
TUPIZA,consulta externa,nuevas en personas de 60 anos o mas,2006-09-01,356,549,356,549,905
TURCO,consulta externa,nuevas en personas de 60 anos o mas,2006-09-01,45,36,45,36,81
UMALA,consulta externa,nuevas en personas de 60 anos o mas,2006-09-01,7,10,7,10,17
UNCIA,consulta externa,nuevas en personas de 60 anos o mas,2006-09-01,151,189,151,189,340
URIONDO (A. CONCEPCION),consulta externa,nuevas en personas de 60 anos o mas,2006-09-01,63,82,63,82,145
URUBICHA,consulta externa,nuevas en personas de 60 anos o mas,2006-09-01,6,8,6,8,14
UYUNI,consulta externa,nuevas en personas de 60 anos o mas,2006-09-01,186,185,186,185,371
VACAS,consulta externa,nuevas en personas de 60 anos o mas,2006-09-01,17,52,17,52,69
VALLEGRANDE,consulta externa,nuevas en personas de 60 anos o mas,2006-09-01,325,429,325,429,754
VIACHA,consulta externa,nuevas en personas de 60 anos o mas,2006-09-01,362,280,362,280,642
VILA VILA,consulta externa,nuevas en personas de 60 anos o mas,2006-09-01,3,8,3,8,11
VILLA MONTES,consulta externa,nuevas en personas de 60 anos o mas,2006-09-01,187,200,187,200,387
VILLA NUEVA (LOMA ALTA),consulta externa,nuevas en personas de 60 anos o mas,2006-09-01,8,11,8,11,19
VILLA RIVERO,consulta externa,nuevas en personas de 60 anos o mas,2006-09-01,13,31,13,31,44
VILLA SERRANO,consulta externa,nuevas en personas de 60 anos o mas,2006-09-01,51,90,51,90,141
VILLA TUNARI,consulta externa,nuevas en personas de 60 anos o mas,2006-09-01,151,156,151,156,307
VILLA VACA GUZMAN (MUYUPAMPA),consulta externa,nuevas en personas de 60 anos o mas,2006-09-01,51,81,51,81,132
VILLAZON,consulta externa,nuevas en personas de 60 anos o mas,2006-09-01,476,609,476,609,1085
VINTO,consulta externa,nuevas en personas de 60 anos o mas,2006-09-01,57,54,57,54,111
VITICHI,consulta externa,nuevas en personas de 60 anos o mas,2006-09-01,55,99,55,99,154
WALDO BALLIVIAN,consulta externa,nuevas en personas de 60 anos o mas,2006-09-01,2,3,2,3,5
WARNES,consulta externa,nuevas en personas de 60 anos o mas,2006-09-01,109,95,109,95,204
YACO,consulta externa,nuevas en personas de 60 anos o mas,2006-09-01,15,14,15,14,29
YACUIBA,consulta externa,nuevas en personas de 60 anos o mas,2006-09-01,779,985,779,985,1764
YAMPARAEZ,consulta externa,nuevas en personas de 60 anos o mas,2006-09-01,48,71,48,71,119
YANACACHI,consulta externa,nuevas en personas de 60 anos o mas,2006-09-01,44,36,44,36,80
YAPACANI,consulta externa,nuevas en personas de 60 anos o mas,2006-09-01,217,246,217,246,463
YOCALLA,consulta externa,nuevas en personas de 60 anos o mas,2006-09-01,57,88,57,88,145
YOTALA,consulta externa,nuevas en personas de 60 anos o mas,2006-09-01,22,38,22,38,60
YUNCHARA,consulta externa,nuevas en personas de 60 anos o mas,2006-09-01,24,29,24,29,53
ZUDAÑEZ,consulta externa,nuevas en personas de 60 anos o mas,2006-09-01,100,76,100,76,176
ACACIO,consulta externa,nuevas en personas de 60 anos o mas,2006-10-01,18,44,18,44,62
ACHACACHI,consulta externa,nuevas en personas de 60 anos o mas,2006-10-01,169,191,169,191,360
ACHOCALLA,consulta externa,nuevas en personas de 60 anos o mas,2006-10-01,17,15,17,15,32
AIQUILE,consulta externa,nuevas en personas de 60 anos o mas,2006-10-01,86,102,86,102,188
ALCALA,consulta externa,nuevas en personas de 60 anos o mas,2006-10-01,22,56,22,56,78
ANCORAIMES,consulta externa,nuevas en personas de 60 anos o mas,2006-10-01,15,39,15,39,54
ANDAMARCA,consulta externa,nuevas en personas de 60 anos o mas,2006-10-01,46,65,46,65,111
ANTEQUERA,consulta externa,nuevas en personas de 60 anos o mas,2006-10-01,4,10,4,10,14
ANZALDO,consulta externa,nuevas en personas de 60 anos o mas,2006-10-01,17,27,17,27,44
APOLO,consulta externa,nuevas en personas de 60 anos o mas,2006-10-01,39,41,39,41,80
ARAMPAMPA,consulta externa,nuevas en personas de 60 anos o mas,2006-10-01,11,13,11,13,24
ARANI,consulta externa,nuevas en personas de 60 anos o mas,2006-10-01,14,33,14,33,47
ARBIETO,consulta externa,nuevas en personas de 60 anos o mas,2006-10-01,32,35,32,35,67
ARQUE,consulta externa,nuevas en personas de 60 anos o mas,2006-10-01,19,25,19,25,44
ASCENCION DE GUARAYOS,consulta externa,nuevas en personas de 60 anos o mas,2006-10-01,26,17,26,17,43
ATOCHA,consulta externa,nuevas en personas de 60 anos o mas,2006-10-01,76,129,76,129,205
AUCAPATA,consulta externa,nuevas en personas de 60 anos o mas,2006-10-01,30,21,30,21,51
AYATA,consulta externa,nuevas en personas de 60 anos o mas,2006-10-01,38,47,38,47,85
AYO AYO,consulta externa,nuevas en personas de 60 anos o mas,2006-10-01,13,16,13,16,29
AYOPAYA (V. DE INDEPENDENCIA),consulta externa,nuevas en personas de 60 anos o mas,2006-10-01,59,93,59,93,152
AZURDUY,consulta externa,nuevas en personas de 60 anos o mas,2006-10-01,76,105,76,105,181
BATALLAS,consulta externa,nuevas en personas de 60 anos o mas,2006-10-01,25,34,25,34,59
BAURES,consulta externa,nuevas en personas de 60 anos o mas,2006-10-01,35,41,35,41,76
BELEN DE ANDAMARCA,consulta externa,nuevas en personas de 60 anos o mas,2006-10-01,7,12,7,12,19
BELEN DE URMIRI,consulta externa,nuevas en personas de 60 anos o mas,2006-10-01,22,14,22,14,36
BELLA FLOR,consulta externa,nuevas en personas de 60 anos o mas,2006-10-01,26,10,26,10,36
BERMEJO,consulta externa,nuevas en personas de 60 anos o mas,2006-10-01,287,298,287,298,585
BETANZOS,consulta externa,nuevas en personas de 60 anos o mas,2006-10-01,172,288,172,288,460
BOLIVAR,consulta externa,nuevas en personas de 60 anos o mas,2006-10-01,21,35,21,35,56
BOLPEBRA,consulta externa,nuevas en personas de 60 anos o mas,2006-10-01,5,4,5,4,9
BOYUIBE,consulta externa,nuevas en personas de 60 anos o mas,2006-10-01,20,29,20,29,49
BUENA VISTA,consulta externa,nuevas en personas de 60 anos o mas,2006-10-01,61,38,61,38,99
CABEZAS,consulta externa,nuevas en personas de 60 anos o mas,2006-10-01,45,73,45,73,118
CAIROMA,consulta externa,nuevas en personas de 60 anos o mas,2006-10-01,36,25,36,25,61
"CAIZA ""D""",consulta externa,nuevas en personas de 60 anos o mas,2006-10-01,61,114,61,114,175
CAJUATA,consulta externa,nuevas en personas de 60 anos o mas,2006-10-01,36,39,36,39,75
CALACOTO,consulta externa,nuevas en personas de 60 anos o mas,2006-10-01,45,39,45,39,84
CALAMARCA,consulta externa,nuevas en personas de 60 anos o mas,2006-10-01,25,22,25,22,47
CAMARGO,consulta externa,nuevas en personas de 60 anos o mas,2006-10-01,237,320,237,320,557
CAMATAQUI (C. VILLA ABECIA),consulta externa,nuevas en personas de 60 anos o mas,2006-10-01,31,43,31,43,74
CAMIRI,consulta externa,nuevas en personas de 60 anos o mas,2006-10-01,710,1048,710,1048,1758
CAPINOTA,consulta externa,nuevas en personas de 60 anos o mas,2006-10-01,56,71,56,71,127
CAQUIAVIRI,consulta externa,nuevas en personas de 60 anos o mas,2006-10-01,39,43,39,43,82
CARACOLLO,consulta externa,nuevas en personas de 60 anos o mas,2006-10-01,117,73,117,73,190
CARANAVI,consulta externa,nuevas en personas de 60 anos o mas,2006-10-01,330,176,330,176,506
CARANGAS,consulta externa,nuevas en personas de 60 anos o mas,2006-10-01,1,1,1,1,2
CARAPARI,consulta externa,nuevas en personas de 60 anos o mas,2006-10-01,57,58,57,58,115
CARIPUYO,consulta externa,nuevas en personas de 60 anos o mas,2006-10-01,10,30,10,30,40
CARMEN RIVERO TORREZ,consulta externa,nuevas en personas de 60 anos o mas,2006-10-01,3,7,3,7,10
CATACORA,consulta externa,nuevas en personas de 60 anos o mas,2006-10-01,1,0,1,0,1
CHACARILLA,consulta externa,nuevas en personas de 60 anos o mas,2006-10-01,5,4,5,4,9
CHALLAPATA,consulta externa,nuevas en personas de 60 anos o mas,2006-10-01,222,253,222,253,475
CHAQUI,consulta externa,nuevas en personas de 60 anos o mas,2006-10-01,34,32,34,32,66
CHARAGUA,consulta externa,nuevas en personas de 60 anos o mas,2006-10-01,53,52,53,52,105
CHARAÑA,consulta externa,nuevas en personas de 60 anos o mas,2006-10-01,5,11,5,11,16
CHAYANTA,consulta externa,nuevas en personas de 60 anos o mas,2006-10-01,59,129,59,129,188
CHIMORE,consulta externa,nuevas en personas de 60 anos o mas,2006-10-01,13,10,13,10,23
CHOQUE COTA,consulta externa,nuevas en personas de 60 anos o mas,2006-10-01,11,13,11,13,24
CHULUMANI (V. DE LA LIBERTAD),consulta externa,nuevas en personas de 60 anos o mas,2006-10-01,60,42,60,42,102
CHUMA,consulta externa,nuevas en personas de 60 anos o mas,2006-10-01,62,72,62,72,134
CLIZA,consulta externa,nuevas en personas de 60 anos o mas,2006-10-01,29,47,29,47,76
COBIJA,consulta externa,nuevas en personas de 60 anos o mas,2006-10-01,271,178,271,178,449
COCHABAMBA,consulta externa,nuevas en personas de 60 anos o mas,2006-10-01,4190,6188,4190,6188,10378
COIPASA,consulta externa,nuevas en personas de 60 anos o mas,2006-10-01,4,3,4,3,7
COLCAPIRHUA,consulta externa,nuevas en personas de 60 anos o mas,2006-10-01,144,239,144,239,383
"COLCHA ""K""",consulta externa,nuevas en personas de 60 anos o mas,2006-10-01,111,118,111,118,229
COLLANA,consulta externa,nuevas en personas de 60 anos o mas,2006-10-01,14,21,14,21,35
COLOMI,consulta externa,nuevas en personas de 60 anos o mas,2006-10-01,15,16,15,16,31
COLPA BELGICA,consulta externa,nuevas en personas de 60 anos o mas,2006-10-01,80,45,80,45,125
COLQUECHACA,consulta externa,nuevas en personas de 60 anos o mas,2006-10-01,102,124,102,124,226
COLQUENCHA,consulta externa,nuevas en personas de 60 anos o mas,2006-10-01,28,36,28,36,64
COLQUIRI,consulta externa,nuevas en personas de 60 anos o mas,2006-10-01,79,75,79,75,154
COMANCHE,consulta externa,nuevas en personas de 60 anos o mas,2006-10-01,14,6,14,6,20
COMARAPA,consulta externa,nuevas en personas de 60 anos o mas,2006-10-01,121,131,121,131,252
COMBAYA,consulta externa,nuevas en personas de 60 anos o mas,2006-10-01,7,10,7,10,17
CONCEPCION,consulta externa,nuevas en personas de 60 anos o mas,2006-10-01,103,104,103,104,207
COPACABANA,consulta externa,nuevas en personas de 60 anos o mas,2006-10-01,91,118,91,118,209
CORIPATA,consulta externa,nuevas en personas de 60 anos o mas,2006-10-01,25,22,25,22,47
CORO CORO,consulta externa,nuevas en personas de 60 anos o mas,2006-10-01,60,65,60,65,125
COROICO,consulta externa,nuevas en personas de 60 anos o mas,2006-10-01,70,47,70,47,117
CORQUE,consulta externa,nuevas en personas de 60 anos o mas,2006-10-01,39,30,39,30,69
COTAGAITA,consulta externa,nuevas en personas de 60 anos o mas,2006-10-01,213,402,213,402,615
COTOCA,consulta externa,nuevas en personas de 60 anos o mas,2006-10-01,93,105,93,105,198
CUATRO CAÑADAS,consulta externa,nuevas en personas de 60 anos o mas,2006-10-01,24,31,24,31,55
CUCHUMUELA (V. G. VILLARROEL),consulta externa,nuevas en personas de 60 anos o mas,2006-10-01,11,4,11,4,15
CUEVO,consulta externa,nuevas en personas de 60 anos o mas,2006-10-01,19,30,19,30,49
CULPINA,consulta externa,nuevas en personas de 60 anos o mas,2006-10-01,82,106,82,106,188
CURAHUARA DE CARANGAS,consulta externa,nuevas en personas de 60 anos o mas,2006-10-01,68,81,68,81,149
CURVA,consulta externa,nuevas en personas de 60 anos o mas,2006-10-01,12,12,12,12,24
DESAGUADERO,consulta externa,nuevas en personas de 60 anos o mas,2006-10-01,23,18,23,18,41
EL ALTO,consulta externa,nuevas en personas de 60 anos o mas,2006-10-01,1278,1413,1278,1413,2691
EL CHORO,consulta externa,nuevas en personas de 60 anos o mas,2006-10-01,27,26,27,26,53
EL PUENTE(STC),consulta externa,nuevas en personas de 60 anos o mas,2006-10-01,10,9,10,9,19
EL PUENTE(TJA),consulta externa,nuevas en personas de 60 anos o mas,2006-10-01,35,49,35,49,84
EL TORNO,consulta externa,nuevas en personas de 60 anos o mas,2006-10-01,142,168,142,168,310
EL VILLAR,consulta externa,nuevas en personas de 60 anos o mas,2006-10-01,26,69,26,69,95
ENTRE RIOS,consulta externa,nuevas en personas de 60 anos o mas,2006-10-01,90,131,90,131,221
ENTRE RIOS,consulta externa,nuevas en personas de 60 anos o mas,2006-10-01,8,8,8,8,16
ESCARA,consulta externa,nuevas en personas de 60 anos o mas,2006-10-01,2,3,2,3,5
ESMERALDA,consulta externa,nuevas en personas de 60 anos o mas,2006-10-01,17,15,17,15,32
EUCALIPTUS,consulta externa,nuevas en personas de 60 anos o mas,2006-10-01,73,96,73,96,169
EXALTACION,consulta externa,nuevas en personas de 60 anos o mas,2006-10-01,2,2,2,2,4
FERNANDEZ ALONSO,consulta externa,nuevas en personas de 60 anos o mas,2006-10-01,8,7,8,7,15
FILADELFIA,consulta externa,nuevas en personas de 60 anos o mas,2006-10-01,12,10,12,10,22
GENERAL SAAVEDRA,consulta externa,nuevas en personas de 60 anos o mas,2006-10-01,22,33,22,33,55
GRAL. J.J. PEREZ (CHARAZANI),consulta externa,nuevas en personas de 60 anos o mas,2006-10-01,25,36,25,36,61
GUANAY,consulta externa,nuevas en personas de 60 anos o mas,2006-10-01,84,93,84,93,177
GUAQUI,consulta externa,nuevas en personas de 60 anos o mas,2006-10-01,35,33,35,33,68
GUAYARAMERIN,consulta externa,nuevas en personas de 60 anos o mas,2006-10-01,272,491,272,491,763
GUTIERREZ,consulta externa,nuevas en personas de 60 anos o mas,2006-10-01,45,62,45,62,107
HUACARETA,consulta externa,nuevas en personas de 60 anos o mas,2006-10-01,64,92,64,92,156
HUACAYA (VILLA DE HUACAYA),consulta externa,nuevas en personas de 60 anos o mas,2006-10-01,2,7,2,7,9
HUACHACALLA,consulta externa,nuevas en personas de 60 anos o mas,2006-10-01,44,49,44,49,93
HUANUNI,consulta externa,nuevas en personas de 60 anos o mas,2006-10-01,28,70,28,70,98
HUARACAJE,consulta externa,nuevas en personas de 60 anos o mas,2006-10-01,4,13,4,13,17
HUAYLLAMARCA,consulta externa,nuevas en personas de 60 anos o mas,2006-10-01,23,47,23,47,70
ICHOCA,consulta externa,nuevas en personas de 60 anos o mas,2006-10-01,20,24,20,24,44
ICLA,consulta externa,nuevas en personas de 60 anos o mas,2006-10-01,26,65,26,65,91
INCAHUASI,consulta externa,nuevas en personas de 60 anos o mas,2006-10-01,50,110,50,110,160
INGAVI (HUMAITA),consulta externa,nuevas en personas de 60 anos o mas,2006-10-01,4,2,4,2,6
INQUISIVI,consulta externa,nuevas en personas de 60 anos o mas,2006-10-01,35,22,35,22,57
IRUPANA (VILLA DE LANZA),consulta externa,nuevas en personas de 60 anos o mas,2006-10-01,80,65,80,65,145
IXIAMAS,consulta externa,nuevas en personas de 60 anos o mas,2006-10-01,33,18,33,18,51
JESUS DE MACHACA,consulta externa,nuevas en personas de 60 anos o mas,2006-10-01,105,134,105,134,239
LA ASUNTA,consulta externa,nuevas en personas de 60 anos o mas,2006-10-01,25,24,25,24,49
LA GUARDIA,consulta externa,nuevas en personas de 60 anos o mas,2006-10-01,43,50,43,50,93
LA PAZ,consulta externa,nuevas en personas de 60 anos o mas,2006-10-01,9169,10737,9169,10737,19906
LA RIVERA,consulta externa,nuevas en personas de 60 anos o mas,2006-10-01,1,1,1,1,2
LAGUNILLAS,consulta externa,nuevas en personas de 60 anos o mas,2006-10-01,26,28,26,28,54
LAJA,consulta externa,nuevas en personas de 60 anos o mas,2006-10-01,38,43,38,43,81
LAS CARRERAS,consulta externa,nuevas en personas de 60 anos o mas,2006-10-01,51,74,51,74,125
LICOMA PAMPA,consulta externa,nuevas en personas de 60 anos o mas,2006-10-01,34,17,34,17,51
LLALLAGUA,consulta externa,nuevas en personas de 60 anos o mas,2006-10-01,288,429,288,429,717
LLICA,consulta externa,nuevas en personas de 60 anos o mas,2006-10-01,57,49,57,49,106
LORETO,consulta externa,nuevas en personas de 60 anos o mas,2006-10-01,7,13,7,13,20
LURIBAY,consulta externa,nuevas en personas de 60 anos o mas,2006-10-01,45,45,45,45,90
MACHACAMARCA,consulta externa,nuevas en personas de 60 anos o mas,2006-10-01,15,23,15,23,38
MACHARETI,consulta externa,nuevas en personas de 60 anos o mas,2006-10-01,60,65,60,65,125
MAGDALENA,consulta externa,nuevas en personas de 60 anos o mas,2006-10-01,35,32,35,32,67
MAIRANA,consulta externa,nuevas en personas de 60 anos o mas,2006-10-01,60,82,60,82,142
MALLA,consulta externa,nuevas en personas de 60 anos o mas,2006-10-01,6,18,6,18,24
MAPIRI,consulta externa,nuevas en personas de 60 anos o mas,2006-10-01,43,27,43,27,70
MECAPACA,consulta externa,nuevas en personas de 60 anos o mas,2006-10-01,73,40,73,40,113
MINEROS,consulta externa,nuevas en personas de 60 anos o mas,2006-10-01,11,13,11,13,24
MIZQUE,consulta externa,nuevas en personas de 60 anos o mas,2006-10-01,34,45,34,45,79
MOCOMOCO,consulta externa,nuevas en personas de 60 anos o mas,2006-10-01,70,82,70,82,152
MOJINETE,consulta externa,nuevas en personas de 60 anos o mas,2006-10-01,4,8,4,8,12
MOJOCOYA,consulta externa,nuevas en personas de 60 anos o mas,2006-10-01,48,55,48,55,103
MONTEAGUDO,consulta externa,nuevas en personas de 60 anos o mas,2006-10-01,350,446,350,446,796
MONTERO,consulta externa,nuevas en personas de 60 anos o mas,2006-10-01,396,468,396,468,864
MORO MORO,consulta externa,nuevas en personas de 60 anos o mas,2006-10-01,29,55,29,55,84
MOROCHATA,consulta externa,nuevas en personas de 60 anos o mas,2006-10-01,30,28,30,28,58
NUEVO MANOA (NUEVA ESPERANZA),consulta externa,nuevas en personas de 60 anos o mas,2006-10-01,15,4,15,4,19
OCURI,consulta externa,nuevas en personas de 60 anos o mas,2006-10-01,80,104,80,104,184
OKINAWA,consulta externa,nuevas en personas de 60 anos o mas,2006-10-01,74,68,74,68,142
OMEREQUE,consulta externa,nuevas en personas de 60 anos o mas,2006-10-01,8,24,8,24,32
ORURO,consulta externa,nuevas en personas de 60 anos o mas,2006-10-01,3027,3717,3027,3717,6744
PADCAYA,consulta externa,nuevas en personas de 60 anos o mas,2006-10-01,180,120,180,120,300
PADILLA,consulta externa,nuevas en personas de 60 anos o mas,2006-10-01,208,326,208,326,534
PAILON,consulta externa,nuevas en personas de 60 anos o mas,2006-10-01,20,21,20,21,41
PALCA,consulta externa,nuevas en personas de 60 anos o mas,2006-10-01,25,15,25,15,40
PALOS BLANCOS,consulta externa,nuevas en personas de 60 anos o mas,2006-10-01,45,41,45,41,86
PAMPA AULLAGAS,consulta externa,nuevas en personas de 60 anos o mas,2006-10-01,9,20,9,20,29
PAMPA GRANDE,consulta externa,nuevas en personas de 60 anos o mas,2006-10-01,31,27,31,27,58
PAPEL PAMPA,consulta externa,nuevas en personas de 60 anos o mas,2006-10-01,27,27,27,27,54
PASORAPA,consulta externa,nuevas en personas de 60 anos o mas,2006-10-01,6,12,6,12,18
PATACAMAYA,consulta externa,nuevas en personas de 60 anos o mas,2006-10-01,29,28,29,28,57
PAZÑA,consulta externa,nuevas en personas de 60 anos o mas,2006-10-01,38,36,38,36,74
PELECHUCO,consulta externa,nuevas en personas de 60 anos o mas,2006-10-01,18,26,18,26,44
POCOATA,consulta externa,nuevas en personas de 60 anos o mas,2006-10-01,64,96,64,96,160
POCONA,consulta externa,nuevas en personas de 60 anos o mas,2006-10-01,18,35,18,35,53
POJO (CBBA),consulta externa,nuevas en personas de 60 anos o mas,2006-10-01,7,7,7,7,14
POOPO,consulta externa,nuevas en personas de 60 anos o mas,2006-10-01,32,67,32,67,99
PORCO,consulta externa,nuevas en personas de 60 anos o mas,2006-10-01,9,18,9,18,27
POROMA,consulta externa,nuevas en personas de 60 anos o mas,2006-10-01,78,95,78,95,173
PORONGO,consulta externa,nuevas en personas de 60 anos o mas,2006-10-01,26,21,26,21,47
PORTACHUELO,consulta externa,nuevas en personas de 60 anos o mas,2006-10-01,122,190,122,190,312
PORVENIR,consulta externa,nuevas en personas de 60 anos o mas,2006-10-01,27,24,27,24,51
POSTRER VALLE,consulta externa,nuevas en personas de 60 anos o mas,2006-10-01,26,30,26,30,56
POTOSI,consulta externa,nuevas en personas de 60 anos o mas,2006-10-01,1371,1906,1371,1906,3277
PRESTO,consulta externa,nuevas en personas de 60 anos o mas,2006-10-01,23,49,23,49,72
PUCARA,consulta externa,nuevas en personas de 60 anos o mas,2006-10-01,49,83,49,83,132
PUCARANI,consulta externa,nuevas en personas de 60 anos o mas,2006-10-01,32,38,32,38,70
PUERTO ACOSTA,consulta externa,nuevas en personas de 60 anos o mas,2006-10-01,190,65,190,65,255
PUERTO CARABUCO,consulta externa,nuevas en personas de 60 anos o mas,2006-10-01,55,50,55,50,105
PUERTO GONZALO MORENO,consulta externa,nuevas en personas de 60 anos o mas,2006-10-01,14,13,14,13,27
PUERTO PEREZ,consulta externa,nuevas en personas de 60 anos o mas,2006-10-01,30,21,30,21,51
PUERTO QUIJARRO,consulta externa,nuevas en personas de 60 anos o mas,2006-10-01,105,49,105,49,154
PUERTO RICO,consulta externa,nuevas en personas de 60 anos o mas,2006-10-01,21,6,21,6,27
PUERTO SUAREZ,consulta externa,nuevas en personas de 60 anos o mas,2006-10-01,135,117,135,117,252
PUERTO VILLARROEL,consulta externa,nuevas en personas de 60 anos o mas,2006-10-01,44,30,44,30,74
PUNA,consulta externa,nuevas en personas de 60 anos o mas,2006-10-01,159,249,159,249,408
PUNATA,consulta externa,nuevas en personas de 60 anos o mas,2006-10-01,161,154,161,154,315
QUIABAYA,consulta externa,nuevas en personas de 60 anos o mas,2006-10-01,15,25,15,25,40
QUILLACOLLO,consulta externa,nuevas en personas de 60 anos o mas,2006-10-01,48,52,48,52,100
QUIME,consulta externa,nuevas en personas de 60 anos o mas,2006-10-01,21,15,21,15,36
QUIRUSILLAS,consulta externa,nuevas en personas de 60 anos o mas,2006-10-01,8,14,8,14,22
RAVELO,consulta externa,nuevas en personas de 60 anos o mas,2006-10-01,76,113,76,113,189
REYES,consulta externa,nuevas en personas de 60 anos o mas,2006-10-01,76,94,76,94,170
RIBERALTA,consulta externa,nuevas en personas de 60 anos o mas,2006-10-01,401,449,401,449,850
ROBORE,consulta externa,nuevas en personas de 60 anos o mas,2006-10-01,234,248,234,248,482
RURRENABAQUE,consulta externa,nuevas en personas de 60 anos o mas,2006-10-01,170,143,170,143,313
SABAYA,consulta externa,nuevas en personas de 60 anos o mas,2006-10-01,37,45,37,45,82
SACABA,consulta externa,nuevas en personas de 60 anos o mas,2006-10-01,131,181,131,181,312
SACABAMBA,consulta externa,nuevas en personas de 60 anos o mas,2006-10-01,9,18,9,18,27
SACACA,consulta externa,nuevas en personas de 60 anos o mas,2006-10-01,43,79,43,79,122
SAIPINA,consulta externa,nuevas en personas de 60 anos o mas,2006-10-01,117,201,117,201,318
SALINAS DE GARCI MENDOZA,consulta externa,nuevas en personas de 60 anos o mas,2006-10-01,69,66,69,66,135
SAMAIPATA,consulta externa,nuevas en personas de 60 anos o mas,2006-10-01,67,58,67,58,125
SAN AGUSTIN,consulta externa,nuevas en personas de 60 anos o mas,2006-10-01,11,20,11,20,31
SAN ANDRES,consulta externa,nuevas en personas de 60 anos o mas,2006-10-01,17,18,17,18,35
SAN ANDRES DE MACHACA,consulta externa,nuevas en personas de 60 anos o mas,2006-10-01,40,72,40,72,112
SAN ANTONIO DE ESMORUCO,consulta externa,nuevas en personas de 60 anos o mas,2006-10-01,21,21,21,21,42
SAN ANTONIO DE LOMERIO,consulta externa,nuevas en personas de 60 anos o mas,2006-10-01,25,29,25,29,54
SAN BENITO,consulta externa,nuevas en personas de 60 anos o mas,2006-10-01,22,31,22,31,53
SAN BORJA,consulta externa,nuevas en personas de 60 anos o mas,2006-10-01,100,68,100,68,168
SAN BUENA VENTURA,consulta externa,nuevas en personas de 60 anos o mas,2006-10-01,52,47,52,47,99
SAN CARLOS,consulta externa,nuevas en personas de 60 anos o mas,2006-10-01,125,143,125,143,268
SAN IGNACIO,consulta externa,nuevas en personas de 60 anos o mas,2006-10-01,71,81,71,81,152
SAN IGNACIO DE VELASCO,consulta externa,nuevas en personas de 60 anos o mas,2006-10-01,232,261,232,261,493
SAN JAVIER(BNI),consulta externa,nuevas en personas de 60 anos o mas,2006-10-01,7,4,7,4,11
SAN JAVIER(STC),consulta externa,nuevas en personas de 60 anos o mas,2006-10-01,45,69,45,69,114
SAN JOAQUIN,consulta externa,nuevas en personas de 60 anos o mas,2006-10-01,61,99,61,99,160
SAN JOSE DE CHIQUITOS,consulta externa,nuevas en personas de 60 anos o mas,2006-10-01,39,73,39,73,112
SAN JUAN DE YAPACANI,consulta externa,nuevas en personas de 60 anos o mas,2006-10-01,105,78,105,78,183
SAN JULIAN,consulta externa,nuevas en personas de 60 anos o mas,2006-10-01,226,210,226,210,436
SAN LORENZO(PND),consulta externa,nuevas en personas de 60 anos o mas,2006-10-01,4,2,4,2,6
SAN LORENZO(TJA),consulta externa,nuevas en personas de 60 anos o mas,2006-10-01,71,116,71,116,187
SAN LUCAS,consulta externa,nuevas en personas de 60 anos o mas,2006-10-01,119,228,119,228,347
SAN MATIAS,consulta externa,nuevas en personas de 60 anos o mas,2006-10-01,19,15,19,15,34
SAN MIGUEL DE VELASCO,consulta externa,nuevas en personas de 60 anos o mas,2006-10-01,36,35,36,35,71
SAN PABLO DE LIPEZ,consulta externa,nuevas en personas de 60 anos o mas,2006-10-01,16,13,16,13,29
SAN PEDRO,consulta externa,nuevas en personas de 60 anos o mas,2006-10-01,45,47,45,47,92
SAN PEDRO DE BUENA VISTA,consulta externa,nuevas en personas de 60 anos o mas,2006-10-01,37,65,37,65,102
SAN PEDRO DE CURAHUARA,consulta externa,nuevas en personas de 60 anos o mas,2006-10-01,19,23,19,23,42
SAN PEDRO DE QUEMES,consulta externa,nuevas en personas de 60 anos o mas,2006-10-01,1,0,1,0,1
SAN PEDRO DE TIQUINA,consulta externa,nuevas en personas de 60 anos o mas,2006-10-01,20,17,20,17,37
SAN PEDRO(PND),consulta externa,nuevas en personas de 60 anos o mas,2006-10-01,0,5,0,5,5
SAN RAFAEL,consulta externa,nuevas en personas de 60 anos o mas,2006-10-01,10,6,10,6,16
SAN RAMON,consulta externa,nuevas en personas de 60 anos o mas,2006-10-01,54,84,54,84,138
SAN RAMON,consulta externa,nuevas en personas de 60 anos o mas,2006-10-01,40,46,40,46,86
SANTA ANA,consulta externa,nuevas en personas de 60 anos o mas,2006-10-01,91,132,91,132,223
SANTA CRUZ DE LA SIERRA,consulta externa,nuevas en personas de 60 anos o mas,2006-10-01,4215,6099,4215,6099,10314
SANTA ROSA,consulta externa,nuevas en personas de 60 anos o mas,2006-10-01,37,31,37,31,68
SANTA ROSA DEL SARA,consulta externa,nuevas en personas de 60 anos o mas,2006-10-01,56,43,56,43,99
SANTIAGO DE CALLAPA,consulta externa,nuevas en personas de 60 anos o mas,2006-10-01,15,14,15,14,29
SANTIAGO DE HUARI,consulta externa,nuevas en personas de 60 anos o mas,2006-10-01,70,104,70,104,174
SANTIAGO DE MACHACA,consulta externa,nuevas en personas de 60 anos o mas,2006-10-01,13,16,13,16,29
SANTIVAÑES,consulta externa,nuevas en personas de 60 anos o mas,2006-10-01,32,58,32,58,90
SANTUARIO DE QUILLACAS,consulta externa,nuevas en personas de 60 anos o mas,2006-10-01,22,19,22,19,41
SAPAHAQUI,consulta externa,nuevas en personas de 60 anos o mas,2006-10-01,22,32,22,32,54
SENA,consulta externa,nuevas en personas de 60 anos o mas,2006-10-01,1,3,1,3,4
SICA SICA (VILLA AROMA),consulta externa,nuevas en personas de 60 anos o mas,2006-10-01,21,32,21,32,53
SICAYA,consulta externa,nuevas en personas de 60 anos o mas,2006-10-01,3,7,3,7,10
SIPE SIPE,consulta externa,nuevas en personas de 60 anos o mas,2006-10-01,22,26,22,26,48
SOPACHUY,consulta externa,nuevas en personas de 60 anos o mas,2006-10-01,31,59,31,59,90
SORACACHI,consulta externa,nuevas en personas de 60 anos o mas,2006-10-01,13,21,13,21,34
SORATA,consulta externa,nuevas en personas de 60 anos o mas,2006-10-01,37,45,37,45,82
SUCRE,consulta externa,nuevas en personas de 60 anos o mas,2006-10-01,2344,3515,2344,3515,5859
TACACHI,consulta externa,nuevas en personas de 60 anos o mas,2006-10-01,2,8,2,8,10
TACACOMA,consulta externa,nuevas en personas de 60 anos o mas,2006-10-01,13,20,13,20,33
TACOBAMBA,consulta externa,nuevas en personas de 60 anos o mas,2006-10-01,33,54,33,54,87
TACOPAYA,consulta externa,nuevas en personas de 60 anos o mas,2006-10-01,16,27,16,27,43
TAHUA,consulta externa,nuevas en personas de 60 anos o mas,2006-10-01,12,8,12,8,20
TAPACARI,consulta externa,nuevas en personas de 60 anos o mas,2006-10-01,51,79,51,79,130
TARABUCO,consulta externa,nuevas en personas de 60 anos o mas,2006-10-01,113,180,113,180,293
TARACO,consulta externa,nuevas en personas de 60 anos o mas,2006-10-01,22,20,22,20,42
TARATA,consulta externa,nuevas en personas de 60 anos o mas,2006-10-01,12,21,12,21,33
TARIJA,consulta externa,nuevas en personas de 60 anos o mas,2006-10-01,1872,2286,1872,2286,4158
TARVITA,consulta externa,nuevas en personas de 60 anos o mas,2006-10-01,83,133,83,133,216
TEOPONTE,consulta externa,nuevas en personas de 60 anos o mas,2006-10-01,63,37,63,37,100
TIAWANACU,consulta externa,nuevas en personas de 60 anos o mas,2006-10-01,15,16,15,16,31
TINGUIPAYA,consulta externa,nuevas en personas de 60 anos o mas,2006-10-01,51,63,51,63,114
TIPUANI,consulta externa,nuevas en personas de 60 anos o mas,2006-10-01,30,26,30,26,56
TIQUIPAYA,consulta externa,nuevas en personas de 60 anos o mas,2006-10-01,23,23,23,23,46
TIRAQUE (CBBA),consulta externa,nuevas en personas de 60 anos o mas,2006-10-01,34,43,34,43,77
TITO YUPANQUI (PARQUIPUJIO),consulta externa,nuevas en personas de 60 anos o mas,2006-10-01,11,13,11,13,24
TOCO,consulta externa,nuevas en personas de 60 anos o mas,2006-10-01,7,16,7,16,23
TODOS SANTOS,consulta externa,nuevas en personas de 60 anos o mas,2006-10-01,1,0,1,0,1
TOLATA,consulta externa,nuevas en personas de 60 anos o mas,2006-10-01,8,4,8,4,12
TOLEDO,consulta externa,nuevas en personas de 60 anos o mas,2006-10-01,40,52,40,52,92
TOMAVE,consulta externa,nuevas en personas de 60 anos o mas,2006-10-01,26,92,26,92,118
TOMINA,consulta externa,nuevas en personas de 60 anos o mas,2006-10-01,60,99,60,99,159
TORO TORO,consulta externa,nuevas en personas de 60 anos o mas,2006-10-01,35,52,35,52,87
TOTORA(CBBA),consulta externa,nuevas en personas de 60 anos o mas,2006-10-01,14,20,14,20,34
TOTORA(ORR),consulta externa,nuevas en personas de 60 anos o mas,2006-10-01,15,17,15,17,32
TRIGAL,consulta externa,nuevas en personas de 60 anos o mas,2006-10-01,20,37,20,37,57
TRINIDAD,consulta externa,nuevas en personas de 60 anos o mas,2006-10-01,337,400,337,400,737
TUPIZA,consulta externa,nuevas en personas de 60 anos o mas,2006-10-01,340,497,340,497,837
TURCO,consulta externa,nuevas en personas de 60 anos o mas,2006-10-01,26,17,26,17,43
UMALA,consulta externa,nuevas en personas de 60 anos o mas,2006-10-01,11,15,11,15,26
UNCIA,consulta externa,nuevas en personas de 60 anos o mas,2006-10-01,92,113,92,113,205
URIONDO (A. CONCEPCION),consulta externa,nuevas en personas de 60 anos o mas,2006-10-01,42,82,42,82,124
URUBICHA,consulta externa,nuevas en personas de 60 anos o mas,2006-10-01,15,22,15,22,37
UYUNI,consulta externa,nuevas en personas de 60 anos o mas,2006-10-01,217,239,217,239,456
VACAS,consulta externa,nuevas en personas de 60 anos o mas,2006-10-01,38,75,38,75,113
VALLEGRANDE,consulta externa,nuevas en personas de 60 anos o mas,2006-10-01,300,425,300,425,725
VIACHA,consulta externa,nuevas en personas de 60 anos o mas,2006-10-01,324,313,324,313,637
VILA VILA,consulta externa,nuevas en personas de 60 anos o mas,2006-10-01,5,4,5,4,9
VILLA MONTES,consulta externa,nuevas en personas de 60 anos o mas,2006-10-01,179,206,179,206,385
VILLA NUEVA (LOMA ALTA),consulta externa,nuevas en personas de 60 anos o mas,2006-10-01,7,13,7,13,20
VILLA RIVERO,consulta externa,nuevas en personas de 60 anos o mas,2006-10-01,16,18,16,18,34
VILLA SERRANO,consulta externa,nuevas en personas de 60 anos o mas,2006-10-01,66,85,66,85,151
VILLA TUNARI,consulta externa,nuevas en personas de 60 anos o mas,2006-10-01,133,154,133,154,287
VILLA VACA GUZMAN (MUYUPAMPA),consulta externa,nuevas en personas de 60 anos o mas,2006-10-01,87,87,87,87,174
VILLAZON,consulta externa,nuevas en personas de 60 anos o mas,2006-10-01,869,428,869,428,1297
VINTO,consulta externa,nuevas en personas de 60 anos o mas,2006-10-01,48,72,48,72,120
VITICHI,consulta externa,nuevas en personas de 60 anos o mas,2006-10-01,63,114,63,114,177
WALDO BALLIVIAN,consulta externa,nuevas en personas de 60 anos o mas,2006-10-01,7,4,7,4,11
WARNES,consulta externa,nuevas en personas de 60 anos o mas,2006-10-01,130,97,130,97,227
YACO,consulta externa,nuevas en personas de 60 anos o mas,2006-10-01,24,11,24,11,35
YACUIBA,consulta externa,nuevas en personas de 60 anos o mas,2006-10-01,639,887,639,887,1526
YAMPARAEZ,consulta externa,nuevas en personas de 60 anos o mas,2006-10-01,57,78,57,78,135
YANACACHI,consulta externa,nuevas en personas de 60 anos o mas,2006-10-01,47,37,47,37,84
YAPACANI,consulta externa,nuevas en personas de 60 anos o mas,2006-10-01,160,122,160,122,282
YOCALLA,consulta externa,nuevas en personas de 60 anos o mas,2006-10-01,56,80,56,80,136
YOTALA,consulta externa,nuevas en personas de 60 anos o mas,2006-10-01,23,47,23,47,70
YUNCHARA,consulta externa,nuevas en personas de 60 anos o mas,2006-10-01,16,30,16,30,46
ZUDAÑEZ,consulta externa,nuevas en personas de 60 anos o mas,2006-10-01,61,75,61,75,136
ACACIO,consulta externa,nuevas en personas de 60 anos o mas,2006-11-01,24,30,24,30,54
ACHACACHI,consulta externa,nuevas en personas de 60 anos o mas,2006-11-01,144,245,144,245,389
ACHOCALLA,consulta externa,nuevas en personas de 60 anos o mas,2006-11-01,18,21,18,21,39
AIQUILE,consulta externa,nuevas en personas de 60 anos o mas,2006-11-01,96,104,96,104,200
ALCALA,consulta externa,nuevas en personas de 60 anos o mas,2006-11-01,21,70,21,70,91
ANCORAIMES,consulta externa,nuevas en personas de 60 anos o mas,2006-11-01,34,31,34,31,65
ANDAMARCA,consulta externa,nuevas en personas de 60 anos o mas,2006-11-01,12,17,12,17,29
ANTEQUERA,consulta externa,nuevas en personas de 60 anos o mas,2006-11-01,0,7,0,7,7
ANZALDO,consulta externa,nuevas en personas de 60 anos o mas,2006-11-01,17,20,17,20,37
APOLO,consulta externa,nuevas en personas de 60 anos o mas,2006-11-01,54,53,54,53,107
ARAMPAMPA,consulta externa,nuevas en personas de 60 anos o mas,2006-11-01,8,15,8,15,23
ARANI,consulta externa,nuevas en personas de 60 anos o mas,2006-11-01,19,27,19,27,46
ARBIETO,consulta externa,nuevas en personas de 60 anos o mas,2006-11-01,16,36,16,36,52
ARQUE,consulta externa,nuevas en personas de 60 anos o mas,2006-11-01,14,42,14,42,56
ASCENCION DE GUARAYOS,consulta externa,nuevas en personas de 60 anos o mas,2006-11-01,39,26,39,26,65
ATOCHA,consulta externa,nuevas en personas de 60 anos o mas,2006-11-01,94,144,94,144,238
AUCAPATA,consulta externa,nuevas en personas de 60 anos o mas,2006-11-01,16,20,16,20,36
AYATA,consulta externa,nuevas en personas de 60 anos o mas,2006-11-01,9,31,9,31,40
AYO AYO,consulta externa,nuevas en personas de 60 anos o mas,2006-11-01,23,21,23,21,44
AYOPAYA (V. DE INDEPENDENCIA),consulta externa,nuevas en personas de 60 anos o mas,2006-11-01,51,72,51,72,123
AZURDUY,consulta externa,nuevas en personas de 60 anos o mas,2006-11-01,56,102,56,102,158
BATALLAS,consulta externa,nuevas en personas de 60 anos o mas,2006-11-01,26,32,26,32,58
BAURES,consulta externa,nuevas en personas de 60 anos o mas,2006-11-01,34,46,34,46,80
BELEN DE ANDAMARCA,consulta externa,nuevas en personas de 60 anos o mas,2006-11-01,10,9,10,9,19
BELEN DE URMIRI,consulta externa,nuevas en personas de 60 anos o mas,2006-11-01,13,12,13,12,25
BELLA FLOR,consulta externa,nuevas en personas de 60 anos o mas,2006-11-01,6,4,6,4,10
BERMEJO,consulta externa,nuevas en personas de 60 anos o mas,2006-11-01,251,291,251,291,542
BETANZOS,consulta externa,nuevas en personas de 60 anos o mas,2006-11-01,188,298,188,298,486
BOLIVAR,consulta externa,nuevas en personas de 60 anos o mas,2006-11-01,38,43,38,43,81
BOLPEBRA,consulta externa,nuevas en personas de 60 anos o mas,2006-11-01,13,7,13,7,20
BOYUIBE,consulta externa,nuevas en personas de 60 anos o mas,2006-11-01,6,18,6,18,24
BUENA VISTA,consulta externa,nuevas en personas de 60 anos o mas,2006-11-01,81,63,81,63,144
CABEZAS,consulta externa,nuevas en personas de 60 anos o mas,2006-11-01,79,95,79,95,174
CAIROMA,consulta externa,nuevas en personas de 60 anos o mas,2006-11-01,34,33,34,33,67
"CAIZA ""D""",consulta externa,nuevas en personas de 60 anos o mas,2006-11-01,64,95,64,95,159
CAJUATA,consulta externa,nuevas en personas de 60 anos o mas,2006-11-01,32,33,32,33,65
CALACOTO,consulta externa,nuevas en personas de 60 anos o mas,2006-11-01,34,43,34,43,77
CALAMARCA,consulta externa,nuevas en personas de 60 anos o mas,2006-11-01,18,12,18,12,30
CAMARGO,consulta externa,nuevas en personas de 60 anos o mas,2006-11-01,198,249,198,249,447
CAMATAQUI (C. VILLA ABECIA),consulta externa,nuevas en personas de 60 anos o mas,2006-11-01,59,88,59,88,147
CAMIRI,consulta externa,nuevas en personas de 60 anos o mas,2006-11-01,620,970,620,970,1590
CAPINOTA,consulta externa,nuevas en personas de 60 anos o mas,2006-11-01,55,82,55,82,137
CAQUIAVIRI,consulta externa,nuevas en personas de 60 anos o mas,2006-11-01,47,57,47,57,104
CARACOLLO,consulta externa,nuevas en personas de 60 anos o mas,2006-11-01,92,62,92,62,154
CARANAVI,consulta externa,nuevas en personas de 60 anos o mas,2006-11-01,292,184,292,184,476
CARANGAS,consulta externa,nuevas en personas de 60 anos o mas,2006-11-01,2,0,2,0,2
CARAPARI,consulta externa,nuevas en personas de 60 anos o mas,2006-11-01,54,80,54,80,134
CARIPUYO,consulta externa,nuevas en personas de 60 anos o mas,2006-11-01,11,25,11,25,36
CARMEN RIVERO TORREZ,consulta externa,nuevas en personas de 60 anos o mas,2006-11-01,4,3,4,3,7
CATACORA,consulta externa,nuevas en personas de 60 anos o mas,2006-11-01,4,9,4,9,13
CHACARILLA,consulta externa,nuevas en personas de 60 anos o mas,2006-11-01,3,4,3,4,7
CHALLAPATA,consulta externa,nuevas en personas de 60 anos o mas,2006-11-01,579,460,579,460,1039
CHAQUI,consulta externa,nuevas en personas de 60 anos o mas,2006-11-01,31,73,31,73,104
CHARAGUA,consulta externa,nuevas en personas de 60 anos o mas,2006-11-01,42,32,42,32,74
CHARAÑA,consulta externa,nuevas en personas de 60 anos o mas,2006-11-01,12,15,12,15,27
CHAYANTA,consulta externa,nuevas en personas de 60 anos o mas,2006-11-01,56,110,56,110,166
CHIMORE,consulta externa,nuevas en personas de 60 anos o mas,2006-11-01,9,12,9,12,21
CHIPAYA,consulta externa,nuevas en personas de 60 anos o mas,2006-11-01,5,3,5,3,8
CHOQUE COTA,consulta externa,nuevas en personas de 60 anos o mas,2006-11-01,21,17,21,17,38
CHULUMANI (V. DE LA LIBERTAD),consulta externa,nuevas en personas de 60 anos o mas,2006-11-01,57,52,57,52,109
CHUMA,consulta externa,nuevas en personas de 60 anos o mas,2006-11-01,74,68,74,68,142
CLIZA,consulta externa,nuevas en personas de 60 anos o mas,2006-11-01,20,54,20,54,74
COBIJA,consulta externa,nuevas en personas de 60 anos o mas,2006-11-01,302,290,302,290,592
COCHABAMBA,consulta externa,nuevas en personas de 60 anos o mas,2006-11-01,5550,6600,5550,6600,12150
COIPASA,consulta externa,nuevas en personas de 60 anos o mas,2006-11-01,6,2,6,2,8
COLCAPIRHUA,consulta externa,nuevas en personas de 60 anos o mas,2006-11-01,162,280,162,280,442
"COLCHA ""K""",consulta externa,nuevas en personas de 60 anos o mas,2006-11-01,91,103,91,103,194
COLLANA,consulta externa,nuevas en personas de 60 anos o mas,2006-11-01,10,9,10,9,19
COLOMI,consulta externa,nuevas en personas de 60 anos o mas,2006-11-01,19,23,19,23,42
COLPA BELGICA,consulta externa,nuevas en personas de 60 anos o mas,2006-11-01,61,34,61,34,95
COLQUECHACA,consulta externa,nuevas en personas de 60 anos o mas,2006-11-01,85,128,85,128,213
COLQUENCHA,consulta externa,nuevas en personas de 60 anos o mas,2006-11-01,29,44,29,44,73
COLQUIRI,consulta externa,nuevas en personas de 60 anos o mas,2006-11-01,37,45,37,45,82
COMANCHE,consulta externa,nuevas en personas de 60 anos o mas,2006-11-01,8,11,8,11,19
COMARAPA,consulta externa,nuevas en personas de 60 anos o mas,2006-11-01,97,132,97,132,229
COMBAYA,consulta externa,nuevas en personas de 60 anos o mas,2006-11-01,4,7,4,7,11
CONCEPCION,consulta externa,nuevas en personas de 60 anos o mas,2006-11-01,24,27,24,27,51
COPACABANA,consulta externa,nuevas en personas de 60 anos o mas,2006-11-01,82,62,82,62,144
CORIPATA,consulta externa,nuevas en personas de 60 anos o mas,2006-11-01,27,35,27,35,62
CORO CORO,consulta externa,nuevas en personas de 60 anos o mas,2006-11-01,52,78,52,78,130
COROICO,consulta externa,nuevas en personas de 60 anos o mas,2006-11-01,80,61,80,61,141
CORQUE,consulta externa,nuevas en personas de 60 anos o mas,2006-11-01,49,45,49,45,94
COTAGAITA,consulta externa,nuevas en personas de 60 anos o mas,2006-11-01,230,370,230,370,600
COTOCA,consulta externa,nuevas en personas de 60 anos o mas,2006-11-01,73,96,73,96,169
CUATRO CAÑADAS,consulta externa,nuevas en personas de 60 anos o mas,2006-11-01,39,26,39,26,65
CUCHUMUELA (V. G. VILLARROEL),consulta externa,nuevas en personas de 60 anos o mas,2006-11-01,5,5,5,5,10
CUEVO,consulta externa,nuevas en personas de 60 anos o mas,2006-11-01,11,38,11,38,49
CULPINA,consulta externa,nuevas en personas de 60 anos o mas,2006-11-01,89,123,89,123,212
CURAHUARA DE CARANGAS,consulta externa,nuevas en personas de 60 anos o mas,2006-11-01,66,66,66,66,132
CURVA,consulta externa,nuevas en personas de 60 anos o mas,2006-11-01,3,11,3,11,14
DESAGUADERO,consulta externa,nuevas en personas de 60 anos o mas,2006-11-01,34,26,34,26,60
EL ALTO,consulta externa,nuevas en personas de 60 anos o mas,2006-11-01,1308,1567,1308,1567,2875
EL CHORO,consulta externa,nuevas en personas de 60 anos o mas,2006-11-01,29,50,29,50,79
EL PUENTE(STC),consulta externa,nuevas en personas de 60 anos o mas,2006-11-01,11,14,11,14,25
EL PUENTE(TJA),consulta externa,nuevas en personas de 60 anos o mas,2006-11-01,34,69,34,69,103
EL TORNO,consulta externa,nuevas en personas de 60 anos o mas,2006-11-01,139,150,139,150,289
EL VILLAR,consulta externa,nuevas en personas de 60 anos o mas,2006-11-01,24,41,24,41,65
ENTRE RIOS,consulta externa,nuevas en personas de 60 anos o mas,2006-11-01,106,121,106,121,227
ENTRE RIOS,consulta externa,nuevas en personas de 60 anos o mas,2006-11-01,37,11,37,11,48
ESCARA,consulta externa,nuevas en personas de 60 anos o mas,2006-11-01,5,0,5,0,5
ESMERALDA,consulta externa,nuevas en personas de 60 anos o mas,2006-11-01,26,25,26,25,51
EUCALIPTUS,consulta externa,nuevas en personas de 60 anos o mas,2006-11-01,85,75,85,75,160
EUREKA (SANTOS MERCADO),consulta externa,nuevas en personas de 60 anos o mas,2006-11-01,2,0,2,0,2
EXALTACION,consulta externa,nuevas en personas de 60 anos o mas,2006-11-01,10,12,10,12,22
FERNANDEZ ALONSO,consulta externa,nuevas en personas de 60 anos o mas,2006-11-01,23,27,23,27,50
FILADELFIA,consulta externa,nuevas en personas de 60 anos o mas,2006-11-01,12,16,12,16,28
GENERAL SAAVEDRA,consulta externa,nuevas en personas de 60 anos o mas,2006-11-01,48,48,48,48,96
GRAL. J.J. PEREZ (CHARAZANI),consulta externa,nuevas en personas de 60 anos o mas,2006-11-01,26,28,26,28,54
GUANAY,consulta externa,nuevas en personas de 60 anos o mas,2006-11-01,127,83,127,83,210
GUAQUI,consulta externa,nuevas en personas de 60 anos o mas,2006-11-01,26,40,26,40,66
GUAYARAMERIN,consulta externa,nuevas en personas de 60 anos o mas,2006-11-01,442,295,442,295,737
GUTIERREZ,consulta externa,nuevas en personas de 60 anos o mas,2006-11-01,41,60,41,60,101
HUACARETA,consulta externa,nuevas en personas de 60 anos o mas,2006-11-01,80,73,80,73,153
HUACAYA (VILLA DE HUACAYA),consulta externa,nuevas en personas de 60 anos o mas,2006-11-01,6,28,6,28,34
HUACHACALLA,consulta externa,nuevas en personas de 60 anos o mas,2006-11-01,159,99,159,99,258
HUANUNI,consulta externa,nuevas en personas de 60 anos o mas,2006-11-01,99,123,99,123,222
HUARACAJE,consulta externa,nuevas en personas de 60 anos o mas,2006-11-01,7,10,7,10,17
HUAYLLAMARCA,consulta externa,nuevas en personas de 60 anos o mas,2006-11-01,42,62,42,62,104
ICHOCA,consulta externa,nuevas en personas de 60 anos o mas,2006-11-01,6,25,6,25,31
ICLA,consulta externa,nuevas en personas de 60 anos o mas,2006-11-01,18,51,18,51,69
INCAHUASI,consulta externa,nuevas en personas de 60 anos o mas,2006-11-01,55,114,55,114,169
INGAVI (HUMAITA),consulta externa,nuevas en personas de 60 anos o mas,2006-11-01,1,1,1,1,2
INQUISIVI,consulta externa,nuevas en personas de 60 anos o mas,2006-11-01,61,52,61,52,113
IRUPANA (VILLA DE LANZA),consulta externa,nuevas en personas de 60 anos o mas,2006-11-01,53,47,53,47,100
IXIAMAS,consulta externa,nuevas en personas de 60 anos o mas,2006-11-01,48,26,48,26,74
JESUS DE MACHACA,consulta externa,nuevas en personas de 60 anos o mas,2006-11-01,111,112,111,112,223
LA ASUNTA,consulta externa,nuevas en personas de 60 anos o mas,2006-11-01,25,14,25,14,39
LA GUARDIA,consulta externa,nuevas en personas de 60 anos o mas,2006-11-01,45,55,45,55,100
LA PAZ,consulta externa,nuevas en personas de 60 anos o mas,2006-11-01,10226,11609,10226,11609,21835
LAGUNILLAS,consulta externa,nuevas en personas de 60 anos o mas,2006-11-01,26,137,26,137,163
LAJA,consulta externa,nuevas en personas de 60 anos o mas,2006-11-01,24,25,24,25,49
LAS CARRERAS,consulta externa,nuevas en personas de 60 anos o mas,2006-11-01,41,56,41,56,97
LICOMA PAMPA,consulta externa,nuevas en personas de 60 anos o mas,2006-11-01,20,19,20,19,39
LLALLAGUA,consulta externa,nuevas en personas de 60 anos o mas,2006-11-01,281,371,281,371,652
LLICA,consulta externa,nuevas en personas de 60 anos o mas,2006-11-01,58,54,58,54,112
LORETO,consulta externa,nuevas en personas de 60 anos o mas,2006-11-01,13,19,13,19,32
LURIBAY,consulta externa,nuevas en personas de 60 anos o mas,2006-11-01,53,56,53,56,109
MACHACAMARCA,consulta externa,nuevas en personas de 60 anos o mas,2006-11-01,57,90,57,90,147
MACHARETI,consulta externa,nuevas en personas de 60 anos o mas,2006-11-01,50,76,50,76,126
MAGDALENA,consulta externa,nuevas en personas de 60 anos o mas,2006-11-01,27,38,27,38,65
MAIRANA,consulta externa,nuevas en personas de 60 anos o mas,2006-11-01,42,62,42,62,104
MALLA,consulta externa,nuevas en personas de 60 anos o mas,2006-11-01,3,13,3,13,16
MAPIRI,consulta externa,nuevas en personas de 60 anos o mas,2006-11-01,35,27,35,27,62
MECAPACA,consulta externa,nuevas en personas de 60 anos o mas,2006-11-01,46,35,46,35,81
MINEROS,consulta externa,nuevas en personas de 60 anos o mas,2006-11-01,7,13,7,13,20
MIZQUE,consulta externa,nuevas en personas de 60 anos o mas,2006-11-01,26,32,26,32,58
MOCOMOCO,consulta externa,nuevas en personas de 60 anos o mas,2006-11-01,83,74,83,74,157
MOJINETE,consulta externa,nuevas en personas de 60 anos o mas,2006-11-01,9,18,9,18,27
MOJOCOYA,consulta externa,nuevas en personas de 60 anos o mas,2006-11-01,37,103,37,103,140
MONTEAGUDO,consulta externa,nuevas en personas de 60 anos o mas,2006-11-01,342,514,342,514,856
MONTERO,consulta externa,nuevas en personas de 60 anos o mas,2006-11-01,344,503,344,503,847
MORO MORO,consulta externa,nuevas en personas de 60 anos o mas,2006-11-01,23,35,23,35,58
MOROCHATA,consulta externa,nuevas en personas de 60 anos o mas,2006-11-01,27,40,27,40,67
NACEBE (SANTA ROSA DEL ABUNA),consulta externa,nuevas en personas de 60 anos o mas,2006-11-01,5,5,5,5,10
NUEVO MANOA (NUEVA ESPERANZA),consulta externa,nuevas en personas de 60 anos o mas,2006-11-01,5,2,5,2,7
OCURI,consulta externa,nuevas en personas de 60 anos o mas,2006-11-01,51,71,51,71,122
OKINAWA,consulta externa,nuevas en personas de 60 anos o mas,2006-11-01,116,118,116,118,234
OMEREQUE,consulta externa,nuevas en personas de 60 anos o mas,2006-11-01,10,23,10,23,33
ORURO,consulta externa,nuevas en personas de 60 anos o mas,2006-11-01,2935,3241,2935,3241,6176
PADCAYA,consulta externa,nuevas en personas de 60 anos o mas,2006-11-01,125,169,125,169,294
PADILLA,consulta externa,nuevas en personas de 60 anos o mas,2006-11-01,199,262,199,262,461
PAILON,consulta externa,nuevas en personas de 60 anos o mas,2006-11-01,27,21,27,21,48
PALCA,consulta externa,nuevas en personas de 60 anos o mas,2006-11-01,24,27,24,27,51
PALOS BLANCOS,consulta externa,nuevas en personas de 60 anos o mas,2006-11-01,43,17,43,17,60
PAMPA AULLAGAS,consulta externa,nuevas en personas de 60 anos o mas,2006-11-01,15,15,15,15,30
PAMPA GRANDE,consulta externa,nuevas en personas de 60 anos o mas,2006-11-01,22,23,22,23,45
PAPEL PAMPA,consulta externa,nuevas en personas de 60 anos o mas,2006-11-01,35,46,35,46,81
PASORAPA,consulta externa,nuevas en personas de 60 anos o mas,2006-11-01,6,5,6,5,11
PATACAMAYA,consulta externa,nuevas en personas de 60 anos o mas,2006-11-01,34,40,34,40,74
PAZÑA,consulta externa,nuevas en personas de 60 anos o mas,2006-11-01,50,37,50,37,87
PELECHUCO,consulta externa,nuevas en personas de 60 anos o mas,2006-11-01,24,22,24,22,46
POCOATA,consulta externa,nuevas en personas de 60 anos o mas,2006-11-01,77,94,77,94,171
POCONA,consulta externa,nuevas en personas de 60 anos o mas,2006-11-01,22,56,22,56,78
POJO (CBBA),consulta externa,nuevas en personas de 60 anos o mas,2006-11-01,7,30,7,30,37
POOPO,consulta externa,nuevas en personas de 60 anos o mas,2006-11-01,39,34,39,34,73
PORCO,consulta externa,nuevas en personas de 60 anos o mas,2006-11-01,14,22,14,22,36
POROMA,consulta externa,nuevas en personas de 60 anos o mas,2006-11-01,89,100,89,100,189
PORONGO,consulta externa,nuevas en personas de 60 anos o mas,2006-11-01,27,20,27,20,47
PORTACHUELO,consulta externa,nuevas en personas de 60 anos o mas,2006-11-01,137,184,137,184,321
PORVENIR,consulta externa,nuevas en personas de 60 anos o mas,2006-11-01,14,11,14,11,25
POSTRER VALLE,consulta externa,nuevas en personas de 60 anos o mas,2006-11-01,28,31,28,31,59
POTOSI,consulta externa,nuevas en personas de 60 anos o mas,2006-11-01,1576,1993,1576,1993,3569
PRESTO,consulta externa,nuevas en personas de 60 anos o mas,2006-11-01,31,59,31,59,90
PUCARA,consulta externa,nuevas en personas de 60 anos o mas,2006-11-01,25,39,25,39,64
PUCARANI,consulta externa,nuevas en personas de 60 anos o mas,2006-11-01,47,25,47,25,72
PUERTO ACOSTA,consulta externa,nuevas en personas de 60 anos o mas,2006-11-01,165,152,165,152,317
PUERTO CARABUCO,consulta externa,nuevas en personas de 60 anos o mas,2006-11-01,63,75,63,75,138
PUERTO GONZALO MORENO,consulta externa,nuevas en personas de 60 anos o mas,2006-11-01,12,7,12,7,19
PUERTO PEREZ,consulta externa,nuevas en personas de 60 anos o mas,2006-11-01,30,22,30,22,52
PUERTO QUIJARRO,consulta externa,nuevas en personas de 60 anos o mas,2006-11-01,140,93,140,93,233
PUERTO RICO,consulta externa,nuevas en personas de 60 anos o mas,2006-11-01,8,11,8,11,19
PUERTO SILES,consulta externa,nuevas en personas de 60 anos o mas,2006-11-01,8,4,8,4,12
PUERTO SUAREZ,consulta externa,nuevas en personas de 60 anos o mas,2006-11-01,100,100,100,100,200
PUERTO VILLARROEL,consulta externa,nuevas en personas de 60 anos o mas,2006-11-01,49,29,49,29,78
PUNA,consulta externa,nuevas en personas de 60 anos o mas,2006-11-01,166,275,166,275,441
PUNATA,consulta externa,nuevas en personas de 60 anos o mas,2006-11-01,157,125,157,125,282
QUIABAYA,consulta externa,nuevas en personas de 60 anos o mas,2006-11-01,20,19,20,19,39
QUILLACOLLO,consulta externa,nuevas en personas de 60 anos o mas,2006-11-01,42,46,42,46,88
QUIME,consulta externa,nuevas en personas de 60 anos o mas,2006-11-01,22,9,22,9,31
QUIRUSILLAS,consulta externa,nuevas en personas de 60 anos o mas,2006-11-01,13,7,13,7,20
RAVELO,consulta externa,nuevas en personas de 60 anos o mas,2006-11-01,55,88,55,88,143
REYES,consulta externa,nuevas en personas de 60 anos o mas,2006-11-01,61,101,61,101,162
RIBERALTA,consulta externa,nuevas en personas de 60 anos o mas,2006-11-01,137,131,137,131,268
ROBORE,consulta externa,nuevas en personas de 60 anos o mas,2006-11-01,197,247,197,247,444
RURRENABAQUE,consulta externa,nuevas en personas de 60 anos o mas,2006-11-01,75,56,75,56,131
SABAYA,consulta externa,nuevas en personas de 60 anos o mas,2006-11-01,49,49,49,49,98
SACABA,consulta externa,nuevas en personas de 60 anos o mas,2006-11-01,158,233,158,233,391
SACABAMBA,consulta externa,nuevas en personas de 60 anos o mas,2006-11-01,6,33,6,33,39
SACACA,consulta externa,nuevas en personas de 60 anos o mas,2006-11-01,51,99,51,99,150
SAIPINA,consulta externa,nuevas en personas de 60 anos o mas,2006-11-01,42,94,42,94,136
SALINAS DE GARCI MENDOZA,consulta externa,nuevas en personas de 60 anos o mas,2006-11-01,70,85,70,85,155
SAMAIPATA,consulta externa,nuevas en personas de 60 anos o mas,2006-11-01,45,40,45,40,85
SAN AGUSTIN,consulta externa,nuevas en personas de 60 anos o mas,2006-11-01,8,7,8,7,15
SAN ANDRES,consulta externa,nuevas en personas de 60 anos o mas,2006-11-01,9,13,9,13,22
SAN ANDRES DE MACHACA,consulta externa,nuevas en personas de 60 anos o mas,2006-11-01,44,70,44,70,114
SAN ANTONIO DE ESMORUCO,consulta externa,nuevas en personas de 60 anos o mas,2006-11-01,7,9,7,9,16
SAN ANTONIO DE LOMERIO,consulta externa,nuevas en personas de 60 anos o mas,2006-11-01,24,20,24,20,44
SAN BENITO,consulta externa,nuevas en personas de 60 anos o mas,2006-11-01,50,87,50,87,137
SAN BORJA,consulta externa,nuevas en personas de 60 anos o mas,2006-11-01,113,101,113,101,214
SAN BUENA VENTURA,consulta externa,nuevas en personas de 60 anos o mas,2006-11-01,53,49,53,49,102
SAN CARLOS,consulta externa,nuevas en personas de 60 anos o mas,2006-11-01,122,140,122,140,262
SAN IGNACIO,consulta externa,nuevas en personas de 60 anos o mas,2006-11-01,61,112,61,112,173
SAN IGNACIO DE VELASCO,consulta externa,nuevas en personas de 60 anos o mas,2006-11-01,234,258,234,258,492
SAN JAVIER(BNI),consulta externa,nuevas en personas de 60 anos o mas,2006-11-01,5,2,5,2,7
SAN JAVIER(STC),consulta externa,nuevas en personas de 60 anos o mas,2006-11-01,86,121,86,121,207
SAN JOAQUIN,consulta externa,nuevas en personas de 60 anos o mas,2006-11-01,59,99,59,99,158
SAN JOSE DE CHIQUITOS,consulta externa,nuevas en personas de 60 anos o mas,2006-11-01,87,133,87,133,220
SAN JUAN DE YAPACANI,consulta externa,nuevas en personas de 60 anos o mas,2006-11-01,85,53,85,53,138
SAN JULIAN,consulta externa,nuevas en personas de 60 anos o mas,2006-11-01,145,147,145,147,292
SAN LORENZO(PND),consulta externa,nuevas en personas de 60 anos o mas,2006-11-01,18,11,18,11,29
SAN LORENZO(TJA),consulta externa,nuevas en personas de 60 anos o mas,2006-11-01,84,112,84,112,196
SAN LUCAS,consulta externa,nuevas en personas de 60 anos o mas,2006-11-01,188,297,188,297,485
SAN MATIAS,consulta externa,nuevas en personas de 60 anos o mas,2006-11-01,15,31,15,31,46
SAN MIGUEL DE VELASCO,consulta externa,nuevas en personas de 60 anos o mas,2006-11-01,79,126,79,126,205
SAN PABLO DE LIPEZ,consulta externa,nuevas en personas de 60 anos o mas,2006-11-01,20,27,20,27,47
SAN PEDRO,consulta externa,nuevas en personas de 60 anos o mas,2006-11-01,51,37,51,37,88
SAN PEDRO DE BUENA VISTA,consulta externa,nuevas en personas de 60 anos o mas,2006-11-01,48,89,48,89,137
SAN PEDRO DE CURAHUARA,consulta externa,nuevas en personas de 60 anos o mas,2006-11-01,28,25,28,25,53
SAN PEDRO DE QUEMES,consulta externa,nuevas en personas de 60 anos o mas,2006-11-01,2,5,2,5,7
SAN PEDRO DE TIQUINA,consulta externa,nuevas en personas de 60 anos o mas,2006-11-01,28,35,28,35,63
SAN PEDRO(PND),consulta externa,nuevas en personas de 60 anos o mas,2006-11-01,2,1,2,1,3
SAN RAFAEL,consulta externa,nuevas en personas de 60 anos o mas,2006-11-01,12,11,12,11,23
SAN RAMON,consulta externa,nuevas en personas de 60 anos o mas,2006-11-01,42,51,42,51,93
SAN RAMON,consulta externa,nuevas en personas de 60 anos o mas,2006-11-01,25,31,25,31,56
SANTA ANA,consulta externa,nuevas en personas de 60 anos o mas,2006-11-01,81,119,81,119,200
SANTA CRUZ DE LA SIERRA,consulta externa,nuevas en personas de 60 anos o mas,2006-11-01,4561,6327,4561,6327,10888
SANTA ROSA,consulta externa,nuevas en personas de 60 anos o mas,2006-11-01,35,53,35,53,88
SANTA ROSA DEL SARA,consulta externa,nuevas en personas de 60 anos o mas,2006-11-01,125,117,125,117,242
SANTIAGO DE CALLAPA,consulta externa,nuevas en personas de 60 anos o mas,2006-11-01,8,8,8,8,16
SANTIAGO DE HUARI,consulta externa,nuevas en personas de 60 anos o mas,2006-11-01,96,111,96,111,207
SANTIAGO DE MACHACA,consulta externa,nuevas en personas de 60 anos o mas,2006-11-01,9,11,9,11,20
SANTIVAÑES,consulta externa,nuevas en personas de 60 anos o mas,2006-11-01,48,91,48,91,139
SANTUARIO DE QUILLACAS,consulta externa,nuevas en personas de 60 anos o mas,2006-11-01,29,24,29,24,53
SAPAHAQUI,consulta externa,nuevas en personas de 60 anos o mas,2006-11-01,32,46,32,46,78
SENA,consulta externa,nuevas en personas de 60 anos o mas,2006-11-01,12,8,12,8,20
SICA SICA (VILLA AROMA),consulta externa,nuevas en personas de 60 anos o mas,2006-11-01,32,42,32,42,74
SICAYA,consulta externa,nuevas en personas de 60 anos o mas,2006-11-01,6,9,6,9,15
SIPE SIPE,consulta externa,nuevas en personas de 60 anos o mas,2006-11-01,17,47,17,47,64
SOPACHUY,consulta externa,nuevas en personas de 60 anos o mas,2006-11-01,47,75,47,75,122
SORACACHI,consulta externa,nuevas en personas de 60 anos o mas,2006-11-01,30,53,30,53,83
SORATA,consulta externa,nuevas en personas de 60 anos o mas,2006-11-01,56,45,56,45,101
SUCRE,consulta externa,nuevas en personas de 60 anos o mas,2006-11-01,2282,3414,2282,3414,5696
TACACHI,consulta externa,nuevas en personas de 60 anos o mas,2006-11-01,1,8,1,8,9
TACACOMA,consulta externa,nuevas en personas de 60 anos o mas,2006-11-01,8,14,8,14,22
TACOBAMBA,consulta externa,nuevas en personas de 60 anos o mas,2006-11-01,27,49,27,49,76
TACOPAYA,consulta externa,nuevas en personas de 60 anos o mas,2006-11-01,17,37,17,37,54
TAHUA,consulta externa,nuevas en personas de 60 anos o mas,2006-11-01,8,5,8,5,13
TAPACARI,consulta externa,nuevas en personas de 60 anos o mas,2006-11-01,66,82,66,82,148
TARABUCO,consulta externa,nuevas en personas de 60 anos o mas,2006-11-01,137,141,137,141,278
TARACO,consulta externa,nuevas en personas de 60 anos o mas,2006-11-01,23,20,23,20,43
TARATA,consulta externa,nuevas en personas de 60 anos o mas,2006-11-01,11,23,11,23,34
TARIJA,consulta externa,nuevas en personas de 60 anos o mas,2006-11-01,684,701,684,701,1385
TARVITA,consulta externa,nuevas en personas de 60 anos o mas,2006-11-01,97,157,97,157,254
TEOPONTE,consulta externa,nuevas en personas de 60 anos o mas,2006-11-01,43,34,43,34,77
TIAWANACU,consulta externa,nuevas en personas de 60 anos o mas,2006-11-01,26,23,26,23,49
TINGUIPAYA,consulta externa,nuevas en personas de 60 anos o mas,2006-11-01,32,83,32,83,115
TIPUANI,consulta externa,nuevas en personas de 60 anos o mas,2006-11-01,42,37,42,37,79
TIQUIPAYA,consulta externa,nuevas en personas de 60 anos o mas,2006-11-01,21,17,21,17,38
TIRAQUE (CBBA),consulta externa,nuevas en personas de 60 anos o mas,2006-11-01,46,60,46,60,106
TITO YUPANQUI (PARQUIPUJIO),consulta externa,nuevas en personas de 60 anos o mas,2006-11-01,7,8,7,8,15
TOCO,consulta externa,nuevas en personas de 60 anos o mas,2006-11-01,11,15,11,15,26
TODOS SANTOS,consulta externa,nuevas en personas de 60 anos o mas,2006-11-01,2,2,2,2,4
TOLATA,consulta externa,nuevas en personas de 60 anos o mas,2006-11-01,7,8,7,8,15
TOLEDO,consulta externa,nuevas en personas de 60 anos o mas,2006-11-01,73,111,73,111,184
TOMAVE,consulta externa,nuevas en personas de 60 anos o mas,2006-11-01,58,77,58,77,135
TOMINA,consulta externa,nuevas en personas de 60 anos o mas,2006-11-01,65,100,65,100,165
TORO TORO,consulta externa,nuevas en personas de 60 anos o mas,2006-11-01,30,61,30,61,91
TOTORA(CBBA),consulta externa,nuevas en personas de 60 anos o mas,2006-11-01,14,30,14,30,44
TOTORA(ORR),consulta externa,nuevas en personas de 60 anos o mas,2006-11-01,16,26,16,26,42
TRIGAL,consulta externa,nuevas en personas de 60 anos o mas,2006-11-01,24,39,24,39,63
TRINIDAD,consulta externa,nuevas en personas de 60 anos o mas,2006-11-01,324,339,324,339,663
TUPIZA,consulta externa,nuevas en personas de 60 anos o mas,2006-11-01,365,592,365,592,957
TURCO,consulta externa,nuevas en personas de 60 anos o mas,2006-11-01,31,51,31,51,82
UMALA,consulta externa,nuevas en personas de 60 anos o mas,2006-11-01,8,13,8,13,21
UNCIA,consulta externa,nuevas en personas de 60 anos o mas,2006-11-01,46,69,46,69,115
URIONDO (A. CONCEPCION),consulta externa,nuevas en personas de 60 anos o mas,2006-11-01,55,91,55,91,146
URUBICHA,consulta externa,nuevas en personas de 60 anos o mas,2006-11-01,14,15,14,15,29
UYUNI,consulta externa,nuevas en personas de 60 anos o mas,2006-11-01,185,221,185,221,406
VACAS,consulta externa,nuevas en personas de 60 anos o mas,2006-11-01,28,56,28,56,84
VALLEGRANDE,consulta externa,nuevas en personas de 60 anos o mas,2006-11-01,351,419,351,419,770
VIACHA,consulta externa,nuevas en personas de 60 anos o mas,2006-11-01,310,317,310,317,627
VILA VILA,consulta externa,nuevas en personas de 60 anos o mas,2006-11-01,5,6,5,6,11
VILLA MONTES,consulta externa,nuevas en personas de 60 anos o mas,2006-11-01,156,184,156,184,340
VILLA NUEVA (LOMA ALTA),consulta externa,nuevas en personas de 60 anos o mas,2006-11-01,8,5,8,5,13
VILLA RIVERO,consulta externa,nuevas en personas de 60 anos o mas,2006-11-01,16,16,16,16,32
VILLA SERRANO,consulta externa,nuevas en personas de 60 anos o mas,2006-11-01,81,114,81,114,195
VILLA TUNARI,consulta externa,nuevas en personas de 60 anos o mas,2006-11-01,136,166,136,166,302
VILLA VACA GUZMAN (MUYUPAMPA),consulta externa,nuevas en personas de 60 anos o mas,2006-11-01,77,124,77,124,201
VILLAZON,consulta externa,nuevas en personas de 60 anos o mas,2006-11-01,303,458,303,458,761
VINTO,consulta externa,nuevas en personas de 60 anos o mas,2006-11-01,14,12,14,12,26
VITICHI,consulta externa,nuevas en personas de 60 anos o mas,2006-11-01,56,119,56,119,175
WALDO BALLIVIAN,consulta externa,nuevas en personas de 60 anos o mas,2006-11-01,4,5,4,5,9
WARNES,consulta externa,nuevas en personas de 60 anos o mas,2006-11-01,144,125,144,125,269
YACO,consulta externa,nuevas en personas de 60 anos o mas,2006-11-01,15,19,15,19,34
YACUIBA,consulta externa,nuevas en personas de 60 anos o mas,2006-11-01,692,1046,692,1046,1738
YAMPARAEZ,consulta externa,nuevas en personas de 60 anos o mas,2006-11-01,37,43,37,43,80
YANACACHI,consulta externa,nuevas en personas de 60 anos o mas,2006-11-01,58,42,58,42,100
YAPACANI,consulta externa,nuevas en personas de 60 anos o mas,2006-11-01,176,197,176,197,373
YOCALLA,consulta externa,nuevas en personas de 60 anos o mas,2006-11-01,64,60,64,60,124
YOTALA,consulta externa,nuevas en personas de 60 anos o mas,2006-11-01,55,88,55,88,143
YUNCHARA,consulta externa,nuevas en personas de 60 anos o mas,2006-11-01,19,27,19,27,46
ZUDAÑEZ,consulta externa,nuevas en personas de 60 anos o mas,2006-11-01,57,112,57,112,169
ACACIO,consulta externa,nuevas en personas de 60 anos o mas,2006-12-01,17,50,17,50,67
ACHACACHI,consulta externa,nuevas en personas de 60 anos o mas,2006-12-01,107,143,107,143,250
ACHOCALLA,consulta externa,nuevas en personas de 60 anos o mas,2006-12-01,26,36,26,36,62
AIQUILE,consulta externa,nuevas en personas de 60 anos o mas,2006-12-01,106,172,106,172,278
ALALAY,consulta externa,nuevas en personas de 60 anos o mas,2006-12-01,0,1,0,1,1
ALCALA,consulta externa,nuevas en personas de 60 anos o mas,2006-12-01,32,59,32,59,91
ANCORAIMES,consulta externa,nuevas en personas de 60 anos o mas,2006-12-01,30,32,30,32,62
ANDAMARCA,consulta externa,nuevas en personas de 60 anos o mas,2006-12-01,53,56,53,56,109
ANTEQUERA,consulta externa,nuevas en personas de 60 anos o mas,2006-12-01,4,4,4,4,8
ANZALDO,consulta externa,nuevas en personas de 60 anos o mas,2006-12-01,13,30,13,30,43
APOLO,consulta externa,nuevas en personas de 60 anos o mas,2006-12-01,41,57,41,57,98
ARAMPAMPA,consulta externa,nuevas en personas de 60 anos o mas,2006-12-01,8,14,8,14,22
ARANI,consulta externa,nuevas en personas de 60 anos o mas,2006-12-01,9,13,9,13,22
ARBIETO,consulta externa,nuevas en personas de 60 anos o mas,2006-12-01,18,40,18,40,58
ARQUE,consulta externa,nuevas en personas de 60 anos o mas,2006-12-01,18,26,18,26,44
ASCENCION DE GUARAYOS,consulta externa,nuevas en personas de 60 anos o mas,2006-12-01,30,24,30,24,54
ATOCHA,consulta externa,nuevas en personas de 60 anos o mas,2006-12-01,92,143,92,143,235
AUCAPATA,consulta externa,nuevas en personas de 60 anos o mas,2006-12-01,16,9,16,9,25
AYATA,consulta externa,nuevas en personas de 60 anos o mas,2006-12-01,24,26,24,26,50
AYO AYO,consulta externa,nuevas en personas de 60 anos o mas,2006-12-01,13,15,13,15,28
AYOPAYA (V. DE INDEPENDENCIA),consulta externa,nuevas en personas de 60 anos o mas,2006-12-01,50,67,50,67,117
AZURDUY,consulta externa,nuevas en personas de 60 anos o mas,2006-12-01,63,90,63,90,153
BATALLAS,consulta externa,nuevas en personas de 60 anos o mas,2006-12-01,27,20,27,20,47
BAURES,consulta externa,nuevas en personas de 60 anos o mas,2006-12-01,34,42,34,42,76
BELEN DE ANDAMARCA,consulta externa,nuevas en personas de 60 anos o mas,2006-12-01,20,27,20,27,47
BELEN DE URMIRI,consulta externa,nuevas en personas de 60 anos o mas,2006-12-01,15,10,15,10,25
BELLA FLOR,consulta externa,nuevas en personas de 60 anos o mas,2006-12-01,6,3,6,3,9
BERMEJO,consulta externa,nuevas en personas de 60 anos o mas,2006-12-01,251,318,251,318,569
BETANZOS,consulta externa,nuevas en personas de 60 anos o mas,2006-12-01,203,325,203,325,528
BOLIVAR,consulta externa,nuevas en personas de 60 anos o mas,2006-12-01,26,32,26,32,58
BOLPEBRA,consulta externa,nuevas en personas de 60 anos o mas,2006-12-01,4,9,4,9,13
BOYUIBE,consulta externa,nuevas en personas de 60 anos o mas,2006-12-01,16,21,16,21,37
BUENA VISTA,consulta externa,nuevas en personas de 60 anos o mas,2006-12-01,53,42,53,42,95
CABEZAS,consulta externa,nuevas en personas de 60 anos o mas,2006-12-01,18,27,18,27,45
CAIROMA,consulta externa,nuevas en personas de 60 anos o mas,2006-12-01,21,20,21,20,41
"CAIZA ""D""",consulta externa,nuevas en personas de 60 anos o mas,2006-12-01,51,72,51,72,123
CAJUATA,consulta externa,nuevas en personas de 60 anos o mas,2006-12-01,29,30,29,30,59
CALACOTO,consulta externa,nuevas en personas de 60 anos o mas,2006-12-01,53,49,53,49,102
CALAMARCA,consulta externa,nuevas en personas de 60 anos o mas,2006-12-01,21,21,21,21,42
CAMARGO,consulta externa,nuevas en personas de 60 anos o mas,2006-12-01,211,262,211,262,473
CAMATAQUI (C. VILLA ABECIA),consulta externa,nuevas en personas de 60 anos o mas,2006-12-01,44,55,44,55,99
CAMIRI,consulta externa,nuevas en personas de 60 anos o mas,2006-12-01,629,705,629,705,1334
CAPINOTA,consulta externa,nuevas en personas de 60 anos o mas,2006-12-01,30,44,30,44,74
CAQUIAVIRI,consulta externa,nuevas en personas de 60 anos o mas,2006-12-01,24,42,24,42,66
CARACOLLO,consulta externa,nuevas en personas de 60 anos o mas,2006-12-01,101,83,101,83,184
CARANAVI,consulta externa,nuevas en personas de 60 anos o mas,2006-12-01,1004,163,1004,163,1167
CARANGAS,consulta externa,nuevas en personas de 60 anos o mas,2006-12-01,2,4,2,4,6
CARAPARI,consulta externa,nuevas en personas de 60 anos o mas,2006-12-01,47,59,47,59,106
CARIPUYO,consulta externa,nuevas en personas de 60 anos o mas,2006-12-01,5,25,5,25,30
CARMEN RIVERO TORREZ,consulta externa,nuevas en personas de 60 anos o mas,2006-12-01,3,0,3,0,3
CATACORA,consulta externa,nuevas en personas de 60 anos o mas,2006-12-01,4,4,4,4,8
CHACARILLA,consulta externa,nuevas en personas de 60 anos o mas,2006-12-01,1,2,1,2,3
CHALLAPATA,consulta externa,nuevas en personas de 60 anos o mas,2006-12-01,238,206,238,206,444
CHAQUI,consulta externa,nuevas en personas de 60 anos o mas,2006-12-01,29,49,29,49,78
CHARAGUA,consulta externa,nuevas en personas de 60 anos o mas,2006-12-01,46,59,46,59,105
CHARAÑA,consulta externa,nuevas en personas de 60 anos o mas,2006-12-01,5,12,5,12,17
CHAYANTA,consulta externa,nuevas en personas de 60 anos o mas,2006-12-01,59,119,59,119,178
CHIMORE,consulta externa,nuevas en personas de 60 anos o mas,2006-12-01,10,11,10,11,21
CHIPAYA,consulta externa,nuevas en personas de 60 anos o mas,2006-12-01,11,3,11,3,14
CHOQUE COTA,consulta externa,nuevas en personas de 60 anos o mas,2006-12-01,8,13,8,13,21
CHULUMANI (V. DE LA LIBERTAD),consulta externa,nuevas en personas de 60 anos o mas,2006-12-01,41,35,41,35,76
CHUMA,consulta externa,nuevas en personas de 60 anos o mas,2006-12-01,37,35,37,35,72
CLIZA,consulta externa,nuevas en personas de 60 anos o mas,2006-12-01,27,28,27,28,55
COBIJA,consulta externa,nuevas en personas de 60 anos o mas,2006-12-01,209,256,209,256,465
COCHABAMBA,consulta externa,nuevas en personas de 60 anos o mas,2006-12-01,4076,4891,4076,4891,8967
COIPASA,consulta externa,nuevas en personas de 60 anos o mas,2006-12-01,3,3,3,3,6
COLCAPIRHUA,consulta externa,nuevas en personas de 60 anos o mas,2006-12-01,129,233,129,233,362
"COLCHA ""K""",consulta externa,nuevas en personas de 60 anos o mas,2006-12-01,37,44,37,44,81
COLLANA,consulta externa,nuevas en personas de 60 anos o mas,2006-12-01,39,45,39,45,84
COLOMI,consulta externa,nuevas en personas de 60 anos o mas,2006-12-01,16,7,16,7,23
COLPA BELGICA,consulta externa,nuevas en personas de 60 anos o mas,2006-12-01,44,26,44,26,70
COLQUECHACA,consulta externa,nuevas en personas de 60 anos o mas,2006-12-01,75,136,75,136,211
COLQUENCHA,consulta externa,nuevas en personas de 60 anos o mas,2006-12-01,26,44,26,44,70
COLQUIRI,consulta externa,nuevas en personas de 60 anos o mas,2006-12-01,32,46,32,46,78
COMANCHE,consulta externa,nuevas en personas de 60 anos o mas,2006-12-01,9,11,9,11,20
COMARAPA,consulta externa,nuevas en personas de 60 anos o mas,2006-12-01,94,121,94,121,215
COMBAYA,consulta externa,nuevas en personas de 60 anos o mas,2006-12-01,8,5,8,5,13
CONCEPCION,consulta externa,nuevas en personas de 60 anos o mas,2006-12-01,60,48,60,48,108
COPACABANA,consulta externa,nuevas en personas de 60 anos o mas,2006-12-01,32,20,32,20,52
CORIPATA,consulta externa,nuevas en personas de 60 anos o mas,2006-12-01,23,29,23,29,52
CORO CORO,consulta externa,nuevas en personas de 60 anos o mas,2006-12-01,17,29,17,29,46
COROICO,consulta externa,nuevas en personas de 60 anos o mas,2006-12-01,73,55,73,55,128
CORQUE,consulta externa,nuevas en personas de 60 anos o mas,2006-12-01,28,43,28,43,71
COTAGAITA,consulta externa,nuevas en personas de 60 anos o mas,2006-12-01,184,282,184,282,466
COTOCA,consulta externa,nuevas en personas de 60 anos o mas,2006-12-01,60,60,60,60,120
CUATRO CAÑADAS,consulta externa,nuevas en personas de 60 anos o mas,2006-12-01,39,43,39,43,82
CUCHUMUELA (V. G. VILLARROEL),consulta externa,nuevas en personas de 60 anos o mas,2006-12-01,2,3,2,3,5
CUEVO,consulta externa,nuevas en personas de 60 anos o mas,2006-12-01,13,35,13,35,48
CULPINA,consulta externa,nuevas en personas de 60 anos o mas,2006-12-01,52,67,52,67,119
CURAHUARA DE CARANGAS,consulta externa,nuevas en personas de 60 anos o mas,2006-12-01,84,95,84,95,179
CURVA,consulta externa,nuevas en personas de 60 anos o mas,2006-12-01,5,13,5,13,18
DESAGUADERO,consulta externa,nuevas en personas de 60 anos o mas,2006-12-01,11,6,11,6,17
EL ALTO,consulta externa,nuevas en personas de 60 anos o mas,2006-12-01,1172,1286,1172,1286,2458
EL CHORO,consulta externa,nuevas en personas de 60 anos o mas,2006-12-01,44,68,44,68,112
EL PUENTE(STC),consulta externa,nuevas en personas de 60 anos o mas,2006-12-01,7,5,7,5,12
EL PUENTE(TJA),consulta externa,nuevas en personas de 60 anos o mas,2006-12-01,34,71,34,71,105
EL TORNO,consulta externa,nuevas en personas de 60 anos o mas,2006-12-01,124,115,124,115,239
EL VILLAR,consulta externa,nuevas en personas de 60 anos o mas,2006-12-01,38,43,38,43,81
ENTRE RIOS,consulta externa,nuevas en personas de 60 anos o mas,2006-12-01,98,109,98,109,207
ENTRE RIOS,consulta externa,nuevas en personas de 60 anos o mas,2006-12-01,11,6,11,6,17
ESCARA,consulta externa,nuevas en personas de 60 anos o mas,2006-12-01,2,3,2,3,5
ESMERALDA,consulta externa,nuevas en personas de 60 anos o mas,2006-12-01,19,12,19,12,31
EUCALIPTUS,consulta externa,nuevas en personas de 60 anos o mas,2006-12-01,58,72,58,72,130
EXALTACION,consulta externa,nuevas en personas de 60 anos o mas,2006-12-01,1,3,1,3,4
FERNANDEZ ALONSO,consulta externa,nuevas en personas de 60 anos o mas,2006-12-01,27,17,27,17,44
FILADELFIA,consulta externa,nuevas en personas de 60 anos o mas,2006-12-01,5,4,5,4,9
GENERAL SAAVEDRA,consulta externa,nuevas en personas de 60 anos o mas,2006-12-01,37,33,37,33,70
GRAL. J.J. PEREZ (CHARAZANI),consulta externa,nuevas en personas de 60 anos o mas,2006-12-01,20,26,20,26,46
GUANAY,consulta externa,nuevas en personas de 60 anos o mas,2006-12-01,78,77,78,77,155
GUAQUI,consulta externa,nuevas en personas de 60 anos o mas,2006-12-01,23,30,23,30,53
GUAYARAMERIN,consulta externa,nuevas en personas de 60 anos o mas,2006-12-01,275,322,275,322,597
GUTIERREZ,consulta externa,nuevas en personas de 60 anos o mas,2006-12-01,42,59,42,59,101
HUACARETA,consulta externa,nuevas en personas de 60 anos o mas,2006-12-01,60,62,60,62,122
HUACAYA (VILLA DE HUACAYA),consulta externa,nuevas en personas de 60 anos o mas,2006-12-01,7,8,7,8,15
HUACHACALLA,consulta externa,nuevas en personas de 60 anos o mas,2006-12-01,100,62,100,62,162
HUANUNI,consulta externa,nuevas en personas de 60 anos o mas,2006-12-01,187,188,187,188,375
HUARACAJE,consulta externa,nuevas en personas de 60 anos o mas,2006-12-01,5,14,5,14,19
HUAYLLAMARCA,consulta externa,nuevas en personas de 60 anos o mas,2006-12-01,38,34,38,34,72
ICHOCA,consulta externa,nuevas en personas de 60 anos o mas,2006-12-01,11,11,11,11,22
ICLA,consulta externa,nuevas en personas de 60 anos o mas,2006-12-01,39,72,39,72,111
INCAHUASI,consulta externa,nuevas en personas de 60 anos o mas,2006-12-01,70,89,70,89,159
INGAVI (HUMAITA),consulta externa,nuevas en personas de 60 anos o mas,2006-12-01,2,3,2,3,5
INQUISIVI,consulta externa,nuevas en personas de 60 anos o mas,2006-12-01,37,45,37,45,82
IRUPANA (VILLA DE LANZA),consulta externa,nuevas en personas de 60 anos o mas,2006-12-01,48,40,48,40,88
IXIAMAS,consulta externa,nuevas en personas de 60 anos o mas,2006-12-01,40,14,40,14,54
JESUS DE MACHACA,consulta externa,nuevas en personas de 60 anos o mas,2006-12-01,112,129,112,129,241
LA ASUNTA,consulta externa,nuevas en personas de 60 anos o mas,2006-12-01,19,11,19,11,30
LA GUARDIA,consulta externa,nuevas en personas de 60 anos o mas,2006-12-01,46,63,46,63,109
LA PAZ,consulta externa,nuevas en personas de 60 anos o mas,2006-12-01,7803,9005,7803,9005,16808
LA RIVERA,consulta externa,nuevas en personas de 60 anos o mas,2006-12-01,9,7,9,7,16
LAGUNILLAS,consulta externa,nuevas en personas de 60 anos o mas,2006-12-01,24,36,24,36,60
LAJA,consulta externa,nuevas en personas de 60 anos o mas,2006-12-01,21,25,21,25,46
LAS CARRERAS,consulta externa,nuevas en personas de 60 anos o mas,2006-12-01,15,39,15,39,54
LICOMA PAMPA,consulta externa,nuevas en personas de 60 anos o mas,2006-12-01,20,12,20,12,32
LLALLAGUA,consulta externa,nuevas en personas de 60 anos o mas,2006-12-01,223,349,223,349,572
LLICA,consulta externa,nuevas en personas de 60 anos o mas,2006-12-01,20,29,20,29,49
LORETO,consulta externa,nuevas en personas de 60 anos o mas,2006-12-01,7,5,7,5,12
LURIBAY,consulta externa,nuevas en personas de 60 anos o mas,2006-12-01,45,42,45,42,87
MACHACAMARCA,consulta externa,nuevas en personas de 60 anos o mas,2006-12-01,48,63,48,63,111
MACHARETI,consulta externa,nuevas en personas de 60 anos o mas,2006-12-01,54,99,54,99,153
MAGDALENA,consulta externa,nuevas en personas de 60 anos o mas,2006-12-01,23,22,23,22,45
MAIRANA,consulta externa,nuevas en personas de 60 anos o mas,2006-12-01,35,47,35,47,82
MALLA,consulta externa,nuevas en personas de 60 anos o mas,2006-12-01,5,6,5,6,11
MAPIRI,consulta externa,nuevas en personas de 60 anos o mas,2006-12-01,29,12,29,12,41
MECAPACA,consulta externa,nuevas en personas de 60 anos o mas,2006-12-01,31,13,31,13,44
MINEROS,consulta externa,nuevas en personas de 60 anos o mas,2006-12-01,20,6,20,6,26
MIZQUE,consulta externa,nuevas en personas de 60 anos o mas,2006-12-01,27,28,27,28,55
MOCOMOCO,consulta externa,nuevas en personas de 60 anos o mas,2006-12-01,70,61,70,61,131
MOJINETE,consulta externa,nuevas en personas de 60 anos o mas,2006-12-01,2,12,2,12,14
MOJOCOYA,consulta externa,nuevas en personas de 60 anos o mas,2006-12-01,38,46,38,46,84
MONTEAGUDO,consulta externa,nuevas en personas de 60 anos o mas,2006-12-01,390,475,390,475,865
MONTERO,consulta externa,nuevas en personas de 60 anos o mas,2006-12-01,390,501,390,501,891
MORO MORO,consulta externa,nuevas en personas de 60 anos o mas,2006-12-01,31,47,31,47,78
MOROCHATA,consulta externa,nuevas en personas de 60 anos o mas,2006-12-01,14,20,14,20,34
NACEBE (SANTA ROSA DEL ABUNA),consulta externa,nuevas en personas de 60 anos o mas,2006-12-01,5,3,5,3,8
NAZACARA DE PACAJES,consulta externa,nuevas en personas de 60 anos o mas,2006-12-01,3,2,3,2,5
NUEVO MANOA (NUEVA ESPERANZA),consulta externa,nuevas en personas de 60 anos o mas,2006-12-01,0,1,0,1,1
OCURI,consulta externa,nuevas en personas de 60 anos o mas,2006-12-01,39,68,39,68,107
OKINAWA,consulta externa,nuevas en personas de 60 anos o mas,2006-12-01,63,67,63,67,130
OMEREQUE,consulta externa,nuevas en personas de 60 anos o mas,2006-12-01,21,38,21,38,59
ORURO,consulta externa,nuevas en personas de 60 anos o mas,2006-12-01,2891,3302,2891,3302,6193
PADCAYA,consulta externa,nuevas en personas de 60 anos o mas,2006-12-01,97,128,97,128,225
PADILLA,consulta externa,nuevas en personas de 60 anos o mas,2006-12-01,134,228,134,228,362
PAILON,consulta externa,nuevas en personas de 60 anos o mas,2006-12-01,14,13,14,13,27
PALCA,consulta externa,nuevas en personas de 60 anos o mas,2006-12-01,26,16,26,16,42
PALOS BLANCOS,consulta externa,nuevas en personas de 60 anos o mas,2006-12-01,40,20,40,20,60
PAMPA AULLAGAS,consulta externa,nuevas en personas de 60 anos o mas,2006-12-01,23,21,23,21,44
PAMPA GRANDE,consulta externa,nuevas en personas de 60 anos o mas,2006-12-01,22,27,22,27,49
PAPEL PAMPA,consulta externa,nuevas en personas de 60 anos o mas,2006-12-01,29,29,29,29,58
PASORAPA,consulta externa,nuevas en personas de 60 anos o mas,2006-12-01,5,10,5,10,15
PATACAMAYA,consulta externa,nuevas en personas de 60 anos o mas,2006-12-01,35,23,35,23,58
PAZÑA,consulta externa,nuevas en personas de 60 anos o mas,2006-12-01,43,59,43,59,102
PELECHUCO,consulta externa,nuevas en personas de 60 anos o mas,2006-12-01,15,20,15,20,35
POCOATA,consulta externa,nuevas en personas de 60 anos o mas,2006-12-01,59,71,59,71,130
POCONA,consulta externa,nuevas en personas de 60 anos o mas,2006-12-01,26,46,26,46,72
POJO (CBBA),consulta externa,nuevas en personas de 60 anos o mas,2006-12-01,4,16,4,16,20
POOPO,consulta externa,nuevas en personas de 60 anos o mas,2006-12-01,37,40,37,40,77
PORCO,consulta externa,nuevas en personas de 60 anos o mas,2006-12-01,15,21,15,21,36
POROMA,consulta externa,nuevas en personas de 60 anos o mas,2006-12-01,53,78,53,78,131
PORONGO,consulta externa,nuevas en personas de 60 anos o mas,2006-12-01,24,20,24,20,44
PORTACHUELO,consulta externa,nuevas en personas de 60 anos o mas,2006-12-01,96,137,96,137,233
PORVENIR,consulta externa,nuevas en personas de 60 anos o mas,2006-12-01,33,22,33,22,55
POSTRER VALLE,consulta externa,nuevas en personas de 60 anos o mas,2006-12-01,39,24,39,24,63
POTOSI,consulta externa,nuevas en personas de 60 anos o mas,2006-12-01,1363,1696,1363,1696,3059
PRESTO,consulta externa,nuevas en personas de 60 anos o mas,2006-12-01,24,42,24,42,66
PUCARA,consulta externa,nuevas en personas de 60 anos o mas,2006-12-01,30,53,30,53,83
PUCARANI,consulta externa,nuevas en personas de 60 anos o mas,2006-12-01,38,30,38,30,68
PUERTO ACOSTA,consulta externa,nuevas en personas de 60 anos o mas,2006-12-01,143,113,143,113,256
PUERTO CARABUCO,consulta externa,nuevas en personas de 60 anos o mas,2006-12-01,47,52,47,52,99
PUERTO GONZALO MORENO,consulta externa,nuevas en personas de 60 anos o mas,2006-12-01,20,7,20,7,27
PUERTO PEREZ,consulta externa,nuevas en personas de 60 anos o mas,2006-12-01,20,21,20,21,41
PUERTO QUIJARRO,consulta externa,nuevas en personas de 60 anos o mas,2006-12-01,104,70,104,70,174
PUERTO RICO,consulta externa,nuevas en personas de 60 anos o mas,2006-12-01,29,18,29,18,47
PUERTO SILES,consulta externa,nuevas en personas de 60 anos o mas,2006-12-01,1,1,1,1,2
PUERTO SUAREZ,consulta externa,nuevas en personas de 60 anos o mas,2006-12-01,116,86,116,86,202
PUERTO VILLARROEL,consulta externa,nuevas en personas de 60 anos o mas,2006-12-01,52,46,52,46,98
PUNA,consulta externa,nuevas en personas de 60 anos o mas,2006-12-01,192,265,192,265,457
PUNATA,consulta externa,nuevas en personas de 60 anos o mas,2006-12-01,185,151,185,151,336
QUIABAYA,consulta externa,nuevas en personas de 60 anos o mas,2006-12-01,16,14,16,14,30
QUILLACOLLO,consulta externa,nuevas en personas de 60 anos o mas,2006-12-01,53,83,53,83,136
QUIME,consulta externa,nuevas en personas de 60 anos o mas,2006-12-01,24,10,24,10,34
QUIRUSILLAS,consulta externa,nuevas en personas de 60 anos o mas,2006-12-01,6,7,6,7,13
RAVELO,consulta externa,nuevas en personas de 60 anos o mas,2006-12-01,32,107,32,107,139
REYES,consulta externa,nuevas en personas de 60 anos o mas,2006-12-01,46,75,46,75,121
RIBERALTA,consulta externa,nuevas en personas de 60 anos o mas,2006-12-01,112,124,112,124,236
ROBORE,consulta externa,nuevas en personas de 60 anos o mas,2006-12-01,182,176,182,176,358
RURRENABAQUE,consulta externa,nuevas en personas de 60 anos o mas,2006-12-01,76,67,76,67,143
SABAYA,consulta externa,nuevas en personas de 60 anos o mas,2006-12-01,77,80,77,80,157
SACABA,consulta externa,nuevas en personas de 60 anos o mas,2006-12-01,154,202,154,202,356
SACABAMBA,consulta externa,nuevas en personas de 60 anos o mas,2006-12-01,25,31,25,31,56
SACACA,consulta externa,nuevas en personas de 60 anos o mas,2006-12-01,31,73,31,73,104
SAIPINA,consulta externa,nuevas en personas de 60 anos o mas,2006-12-01,20,31,20,31,51
SALINAS DE GARCI MENDOZA,consulta externa,nuevas en personas de 60 anos o mas,2006-12-01,53,73,53,73,126
SAMAIPATA,consulta externa,nuevas en personas de 60 anos o mas,2006-12-01,30,42,30,42,72
SAN AGUSTIN,consulta externa,nuevas en personas de 60 anos o mas,2006-12-01,3,7,3,7,10
SAN ANDRES,consulta externa,nuevas en personas de 60 anos o mas,2006-12-01,9,13,9,13,22
SAN ANDRES DE MACHACA,consulta externa,nuevas en personas de 60 anos o mas,2006-12-01,29,26,29,26,55
SAN ANTONIO DE ESMORUCO,consulta externa,nuevas en personas de 60 anos o mas,2006-12-01,8,10,8,10,18
SAN ANTONIO DE LOMERIO,consulta externa,nuevas en personas de 60 anos o mas,2006-12-01,22,19,22,19,41
SAN BENITO,consulta externa,nuevas en personas de 60 anos o mas,2006-12-01,27,46,27,46,73
SAN BORJA,consulta externa,nuevas en personas de 60 anos o mas,2006-12-01,66,68,66,68,134
SAN BUENA VENTURA,consulta externa,nuevas en personas de 60 anos o mas,2006-12-01,60,66,60,66,126
SAN CARLOS,consulta externa,nuevas en personas de 60 anos o mas,2006-12-01,127,152,127,152,279
SAN IGNACIO,consulta externa,nuevas en personas de 60 anos o mas,2006-12-01,44,59,44,59,103
SAN IGNACIO DE VELASCO,consulta externa,nuevas en personas de 60 anos o mas,2006-12-01,263,294,263,294,557
SAN JAVIER(BNI),consulta externa,nuevas en personas de 60 anos o mas,2006-12-01,9,6,9,6,15
SAN JAVIER(STC),consulta externa,nuevas en personas de 60 anos o mas,2006-12-01,59,72,59,72,131
SAN JOAQUIN,consulta externa,nuevas en personas de 60 anos o mas,2006-12-01,107,113,107,113,220
SAN JOSE DE CHIQUITOS,consulta externa,nuevas en personas de 60 anos o mas,2006-12-01,87,76,87,76,163
SAN JUAN DE YAPACANI,consulta externa,nuevas en personas de 60 anos o mas,2006-12-01,79,68,79,68,147
SAN JULIAN,consulta externa,nuevas en personas de 60 anos o mas,2006-12-01,179,204,179,204,383
SAN LORENZO(PND),consulta externa,nuevas en personas de 60 anos o mas,2006-12-01,10,5,10,5,15
SAN LORENZO(TJA),consulta externa,nuevas en personas de 60 anos o mas,2006-12-01,83,103,83,103,186
SAN LUCAS,consulta externa,nuevas en personas de 60 anos o mas,2006-12-01,112,177,112,177,289
SAN MATIAS,consulta externa,nuevas en personas de 60 anos o mas,2006-12-01,7,8,7,8,15
SAN MIGUEL DE VELASCO,consulta externa,nuevas en personas de 60 anos o mas,2006-12-01,78,87,78,87,165
SAN PABLO DE LIPEZ,consulta externa,nuevas en personas de 60 anos o mas,2006-12-01,18,24,18,24,42
SAN PEDRO,consulta externa,nuevas en personas de 60 anos o mas,2006-12-01,48,32,48,32,80
SAN PEDRO DE BUENA VISTA,consulta externa,nuevas en personas de 60 anos o mas,2006-12-01,40,45,40,45,85
SAN PEDRO DE CURAHUARA,consulta externa,nuevas en personas de 60 anos o mas,2006-12-01,24,23,24,23,47
SAN PEDRO DE QUEMES,consulta externa,nuevas en personas de 60 anos o mas,2006-12-01,6,7,6,7,13
SAN PEDRO DE TIQUINA,consulta externa,nuevas en personas de 60 anos o mas,2006-12-01,17,12,17,12,29
SAN PEDRO(PND),consulta externa,nuevas en personas de 60 anos o mas,2006-12-01,2,3,2,3,5
SAN RAFAEL,consulta externa,nuevas en personas de 60 anos o mas,2006-12-01,12,10,12,10,22
SAN RAMON,consulta externa,nuevas en personas de 60 anos o mas,2006-12-01,52,65,52,65,117
SAN RAMON,consulta externa,nuevas en personas de 60 anos o mas,2006-12-01,12,23,12,23,35
SANTA ANA,consulta externa,nuevas en personas de 60 anos o mas,2006-12-01,67,103,67,103,170
SANTA CRUZ DE LA SIERRA,consulta externa,nuevas en personas de 60 anos o mas,2006-12-01,4222,5582,4222,5582,9804
SANTA ROSA,consulta externa,nuevas en personas de 60 anos o mas,2006-12-01,15,24,15,24,39
SANTA ROSA DEL SARA,consulta externa,nuevas en personas de 60 anos o mas,2006-12-01,91,57,91,57,148
SANTIAGO DE CALLAPA,consulta externa,nuevas en personas de 60 anos o mas,2006-12-01,11,41,11,41,52
SANTIAGO DE HUARI,consulta externa,nuevas en personas de 60 anos o mas,2006-12-01,72,76,72,76,148
SANTIAGO DE MACHACA,consulta externa,nuevas en personas de 60 anos o mas,2006-12-01,14,23,14,23,37
SANTIVAÑES,consulta externa,nuevas en personas de 60 anos o mas,2006-12-01,38,65,38,65,103
SANTUARIO DE QUILLACAS,consulta externa,nuevas en personas de 60 anos o mas,2006-12-01,13,20,13,20,33
SAPAHAQUI,consulta externa,nuevas en personas de 60 anos o mas,2006-12-01,19,38,19,38,57
SENA,consulta externa,nuevas en personas de 60 anos o mas,2006-12-01,10,3,10,3,13
SICA SICA (VILLA AROMA),consulta externa,nuevas en personas de 60 anos o mas,2006-12-01,46,44,46,44,90
SICAYA,consulta externa,nuevas en personas de 60 anos o mas,2006-12-01,5,7,5,7,12
SIPE SIPE,consulta externa,nuevas en personas de 60 anos o mas,2006-12-01,23,36,23,36,59
SOPACHUY,consulta externa,nuevas en personas de 60 anos o mas,2006-12-01,48,74,48,74,122
SORACACHI,consulta externa,nuevas en personas de 60 anos o mas,2006-12-01,48,46,48,46,94
SORATA,consulta externa,nuevas en personas de 60 anos o mas,2006-12-01,46,51,46,51,97
SUCRE,consulta externa,nuevas en personas de 60 anos o mas,2006-12-01,1936,2818,1936,2818,4754
TACACHI,consulta externa,nuevas en personas de 60 anos o mas,2006-12-01,2,6,2,6,8
TACACOMA,consulta externa,nuevas en personas de 60 anos o mas,2006-12-01,9,6,9,6,15
TACOBAMBA,consulta externa,nuevas en personas de 60 anos o mas,2006-12-01,30,52,30,52,82
TACOPAYA,consulta externa,nuevas en personas de 60 anos o mas,2006-12-01,22,40,22,40,62
TAHUA,consulta externa,nuevas en personas de 60 anos o mas,2006-12-01,6,10,6,10,16
TAPACARI,consulta externa,nuevas en personas de 60 anos o mas,2006-12-01,45,67,45,67,112
TARABUCO,consulta externa,nuevas en personas de 60 anos o mas,2006-12-01,92,136,92,136,228
TARACO,consulta externa,nuevas en personas de 60 anos o mas,2006-12-01,13,22,13,22,35
TARATA,consulta externa,nuevas en personas de 60 anos o mas,2006-12-01,21,29,21,29,50
TARIJA,consulta externa,nuevas en personas de 60 anos o mas,2006-12-01,603,1304,603,1304,1907
TARVITA,consulta externa,nuevas en personas de 60 anos o mas,2006-12-01,58,96,58,96,154
TEOPONTE,consulta externa,nuevas en personas de 60 anos o mas,2006-12-01,64,51,64,51,115
TIAWANACU,consulta externa,nuevas en personas de 60 anos o mas,2006-12-01,14,14,14,14,28
TINGUIPAYA,consulta externa,nuevas en personas de 60 anos o mas,2006-12-01,41,66,41,66,107
TIPUANI,consulta externa,nuevas en personas de 60 anos o mas,2006-12-01,25,7,25,7,32
TIQUIPAYA,consulta externa,nuevas en personas de 60 anos o mas,2006-12-01,20,33,20,33,53
TIRAQUE (CBBA),consulta externa,nuevas en personas de 60 anos o mas,2006-12-01,57,58,57,58,115
TITO YUPANQUI (PARQUIPUJIO),consulta externa,nuevas en personas de 60 anos o mas,2006-12-01,2,10,2,10,12
TOCO,consulta externa,nuevas en personas de 60 anos o mas,2006-12-01,11,18,11,18,29
TODOS SANTOS,consulta externa,nuevas en personas de 60 anos o mas,2006-12-01,4,6,4,6,10
TOLATA,consulta externa,nuevas en personas de 60 anos o mas,2006-12-01,6,9,6,9,15
TOLEDO,consulta externa,nuevas en personas de 60 anos o mas,2006-12-01,63,62,63,62,125
TOMAVE,consulta externa,nuevas en personas de 60 anos o mas,2006-12-01,46,96,46,96,142
TOMINA,consulta externa,nuevas en personas de 60 anos o mas,2006-12-01,46,102,46,102,148
TORO TORO,consulta externa,nuevas en personas de 60 anos o mas,2006-12-01,29,49,29,49,78
TOTORA(CBBA),consulta externa,nuevas en personas de 60 anos o mas,2006-12-01,8,23,8,23,31
TOTORA(ORR),consulta externa,nuevas en personas de 60 anos o mas,2006-12-01,17,29,17,29,46
TRIGAL,consulta externa,nuevas en personas de 60 anos o mas,2006-12-01,27,29,27,29,56
TRINIDAD,consulta externa,nuevas en personas de 60 anos o mas,2006-12-01,183,276,183,276,459
TUPIZA,consulta externa,nuevas en personas de 60 anos o mas,2006-12-01,344,558,344,558,902
TURCO,consulta externa,nuevas en personas de 60 anos o mas,2006-12-01,39,39,39,39,78
UMALA,consulta externa,nuevas en personas de 60 anos o mas,2006-12-01,11,18,11,18,29
UNCIA,consulta externa,nuevas en personas de 60 anos o mas,2006-12-01,150,224,150,224,374
URIONDO (A. CONCEPCION),consulta externa,nuevas en personas de 60 anos o mas,2006-12-01,28,45,28,45,73
URUBICHA,consulta externa,nuevas en personas de 60 anos o mas,2006-12-01,10,14,10,14,24
UYUNI,consulta externa,nuevas en personas de 60 anos o mas,2006-12-01,40,52,40,52,92
VACAS,consulta externa,nuevas en personas de 60 anos o mas,2006-12-01,24,39,24,39,63
VALLEGRANDE,consulta externa,nuevas en personas de 60 anos o mas,2006-12-01,339,408,339,408,747
VIACHA,consulta externa,nuevas en personas de 60 anos o mas,2006-12-01,339,262,339,262,601
VILA VILA,consulta externa,nuevas en personas de 60 anos o mas,2006-12-01,4,4,4,4,8
VILLA MONTES,consulta externa,nuevas en personas de 60 anos o mas,2006-12-01,189,183,189,183,372
VILLA NUEVA (LOMA ALTA),consulta externa,nuevas en personas de 60 anos o mas,2006-12-01,13,5,13,5,18
VILLA RIVERO,consulta externa,nuevas en personas de 60 anos o mas,2006-12-01,17,15,17,15,32
VILLA SERRANO,consulta externa,nuevas en personas de 60 anos o mas,2006-12-01,56,100,56,100,156
VILLA TUNARI,consulta externa,nuevas en personas de 60 anos o mas,2006-12-01,119,119,119,119,238
VILLA VACA GUZMAN (MUYUPAMPA),consulta externa,nuevas en personas de 60 anos o mas,2006-12-01,46,59,46,59,105
VILLAZON,consulta externa,nuevas en personas de 60 anos o mas,2006-12-01,284,424,284,424,708
VINTO,consulta externa,nuevas en personas de 60 anos o mas,2006-12-01,4,16,4,16,20
VITICHI,consulta externa,nuevas en personas de 60 anos o mas,2006-12-01,53,99,53,99,152
WALDO BALLIVIAN,consulta externa,nuevas en personas de 60 anos o mas,2006-12-01,3,11,3,11,14
WARNES,consulta externa,nuevas en personas de 60 anos o mas,2006-12-01,106,103,106,103,209
YACO,consulta externa,nuevas en personas de 60 anos o mas,2006-12-01,24,30,24,30,54
YACUIBA,consulta externa,nuevas en personas de 60 anos o mas,2006-12-01,603,788,603,788,1391
YAMPARAEZ,consulta externa,nuevas en personas de 60 anos o mas,2006-12-01,37,48,37,48,85
YANACACHI,consulta externa,nuevas en personas de 60 anos o mas,2006-12-01,20,21,20,21,41
YAPACANI,consulta externa,nuevas en personas de 60 anos o mas,2006-12-01,165,172,165,172,337
YOCALLA,consulta externa,nuevas en personas de 60 anos o mas,2006-12-01,61,78,61,78,139
YOTALA,consulta externa,nuevas en personas de 60 anos o mas,2006-12-01,30,62,30,62,92
YUNCHARA,consulta externa,nuevas en personas de 60 anos o mas,2006-12-01,13,17,13,17,30
ZUDAÑEZ,consulta externa,nuevas en personas de 60 anos o mas,2006-12-01,41,80,41,80,121
