municipality,group,variable,month,Métodos naturales: Usuarias Nuevas,Métodos naturales: Usuarias Nuevas1,Métodos naturales: Usuarias Nuevas2,Métodos naturales: Usuarias Nuevas3,Métodos naturales: Usuarias Nuevas4,TOTAL
ACACIO,"anticoncepcion, prevencion de its y de cancer de cuello uterino",metodos naturales: usuarias nuevas,2015-01-01,0,0,2,1,0,3
ACHACACHI,"anticoncepcion, prevencion de its y de cancer de cuello uterino",metodos naturales: usuarias nuevas,2015-01-01,0,0,1,1,0,2
AIQUILE,"anticoncepcion, prevencion de its y de cancer de cuello uterino",metodos naturales: usuarias nuevas,2015-01-01,0,3,9,2,2,16
ALCALA,"anticoncepcion, prevencion de its y de cancer de cuello uterino",metodos naturales: usuarias nuevas,2015-01-01,0,2,1,1,0,4
ANCORAIMES,"anticoncepcion, prevencion de its y de cancer de cuello uterino",metodos naturales: usuarias nuevas,2015-01-01,0,3,4,2,0,9
ANDAMARCA,"anticoncepcion, prevencion de its y de cancer de cuello uterino",metodos naturales: usuarias nuevas,2015-01-01,0,0,2,0,0,2
ANZALDO,"anticoncepcion, prevencion de its y de cancer de cuello uterino",metodos naturales: usuarias nuevas,2015-01-01,0,0,4,0,0,4
APOLO,"anticoncepcion, prevencion de its y de cancer de cuello uterino",metodos naturales: usuarias nuevas,2015-01-01,0,1,3,2,0,6
ARBIETO,"anticoncepcion, prevencion de its y de cancer de cuello uterino",metodos naturales: usuarias nuevas,2015-01-01,0,2,13,2,0,17
ARQUE,"anticoncepcion, prevencion de its y de cancer de cuello uterino",metodos naturales: usuarias nuevas,2015-01-01,0,1,1,0,0,2
ASCENCION DE GUARAYOS,"anticoncepcion, prevencion de its y de cancer de cuello uterino",metodos naturales: usuarias nuevas,2015-01-01,1,1,0,0,0,2
ATOCHA,"anticoncepcion, prevencion de its y de cancer de cuello uterino",metodos naturales: usuarias nuevas,2015-01-01,0,0,4,0,0,4
AYO AYO,"anticoncepcion, prevencion de its y de cancer de cuello uterino",metodos naturales: usuarias nuevas,2015-01-01,0,0,3,0,0,3
AYOPAYA (V. DE INDEPENDENCIA),"anticoncepcion, prevencion de its y de cancer de cuello uterino",metodos naturales: usuarias nuevas,2015-01-01,0,1,1,0,0,2
BELLA FLOR,"anticoncepcion, prevencion de its y de cancer de cuello uterino",metodos naturales: usuarias nuevas,2015-01-01,1,1,0,0,0,2
BETANZOS,"anticoncepcion, prevencion de its y de cancer de cuello uterino",metodos naturales: usuarias nuevas,2015-01-01,0,1,11,3,0,15
BOLPEBRA,"anticoncepcion, prevencion de its y de cancer de cuello uterino",metodos naturales: usuarias nuevas,2015-01-01,0,0,1,0,0,1
BOYUIBE,"anticoncepcion, prevencion de its y de cancer de cuello uterino",metodos naturales: usuarias nuevas,2015-01-01,0,0,1,0,0,1
BUENA VISTA,"anticoncepcion, prevencion de its y de cancer de cuello uterino",metodos naturales: usuarias nuevas,2015-01-01,0,2,1,0,0,3
"CAIZA ""D""","anticoncepcion, prevencion de its y de cancer de cuello uterino",metodos naturales: usuarias nuevas,2015-01-01,0,0,3,1,0,4
CAJUATA,"anticoncepcion, prevencion de its y de cancer de cuello uterino",metodos naturales: usuarias nuevas,2015-01-01,0,4,8,3,0,15
CALAMARCA,"anticoncepcion, prevencion de its y de cancer de cuello uterino",metodos naturales: usuarias nuevas,2015-01-01,0,3,7,2,0,12
CAMARGO,"anticoncepcion, prevencion de its y de cancer de cuello uterino",metodos naturales: usuarias nuevas,2015-01-01,0,0,1,0,0,1
CAMIRI,"anticoncepcion, prevencion de its y de cancer de cuello uterino",metodos naturales: usuarias nuevas,2015-01-01,0,1,4,0,0,5
CARACOLLO,"anticoncepcion, prevencion de its y de cancer de cuello uterino",metodos naturales: usuarias nuevas,2015-01-01,0,4,12,0,0,16
CARAPARI,"anticoncepcion, prevencion de its y de cancer de cuello uterino",metodos naturales: usuarias nuevas,2015-01-01,1,0,0,0,0,1
CARIPUYO,"anticoncepcion, prevencion de its y de cancer de cuello uterino",metodos naturales: usuarias nuevas,2015-01-01,0,2,3,3,0,8
CHALLAPATA,"anticoncepcion, prevencion de its y de cancer de cuello uterino",metodos naturales: usuarias nuevas,2015-01-01,0,13,49,8,0,70
CHAQUI,"anticoncepcion, prevencion de its y de cancer de cuello uterino",metodos naturales: usuarias nuevas,2015-01-01,0,2,3,0,0,5
CHAYANTA,"anticoncepcion, prevencion de its y de cancer de cuello uterino",metodos naturales: usuarias nuevas,2015-01-01,0,7,11,2,0,20
CHIMORE,"anticoncepcion, prevencion de its y de cancer de cuello uterino",metodos naturales: usuarias nuevas,2015-01-01,0,0,2,0,0,2
CHIPAYA,"anticoncepcion, prevencion de its y de cancer de cuello uterino",metodos naturales: usuarias nuevas,2015-01-01,0,0,2,0,0,2
CHUA COCANI,"anticoncepcion, prevencion de its y de cancer de cuello uterino",metodos naturales: usuarias nuevas,2015-01-01,0,0,3,0,0,3
CHULUMANI (V. DE LA LIBERTAD),"anticoncepcion, prevencion de its y de cancer de cuello uterino",metodos naturales: usuarias nuevas,2015-01-01,1,9,24,3,0,37
CKOCHAS,"anticoncepcion, prevencion de its y de cancer de cuello uterino",metodos naturales: usuarias nuevas,2015-01-01,0,2,4,1,0,7
CLIZA,"anticoncepcion, prevencion de its y de cancer de cuello uterino",metodos naturales: usuarias nuevas,2015-01-01,0,2,5,0,0,7
COBIJA,"anticoncepcion, prevencion de its y de cancer de cuello uterino",metodos naturales: usuarias nuevas,2015-01-01,0,4,32,20,0,56
COCHABAMBA,"anticoncepcion, prevencion de its y de cancer de cuello uterino",metodos naturales: usuarias nuevas,2015-01-01,0,22,53,67,0,142
COLCAPIRHUA,"anticoncepcion, prevencion de its y de cancer de cuello uterino",metodos naturales: usuarias nuevas,2015-01-01,0,0,2,0,0,2
"COLCHA ""K""","anticoncepcion, prevencion de its y de cancer de cuello uterino",metodos naturales: usuarias nuevas,2015-01-01,0,0,6,0,0,6
COLOMI,"anticoncepcion, prevencion de its y de cancer de cuello uterino",metodos naturales: usuarias nuevas,2015-01-01,1,2,8,0,0,11
COLPA BELGICA,"anticoncepcion, prevencion de its y de cancer de cuello uterino",metodos naturales: usuarias nuevas,2015-01-01,0,2,2,0,0,4
COLQUECHACA,"anticoncepcion, prevencion de its y de cancer de cuello uterino",metodos naturales: usuarias nuevas,2015-01-01,1,6,3,3,0,13
COLQUIRI,"anticoncepcion, prevencion de its y de cancer de cuello uterino",metodos naturales: usuarias nuevas,2015-01-01,0,1,11,7,0,19
COMANCHE,"anticoncepcion, prevencion de its y de cancer de cuello uterino",metodos naturales: usuarias nuevas,2015-01-01,0,0,2,0,0,2
COMARAPA,"anticoncepcion, prevencion de its y de cancer de cuello uterino",metodos naturales: usuarias nuevas,2015-01-01,0,5,18,7,0,30
CORIPATA,"anticoncepcion, prevencion de its y de cancer de cuello uterino",metodos naturales: usuarias nuevas,2015-01-01,0,2,7,0,0,9
COROICO,"anticoncepcion, prevencion de its y de cancer de cuello uterino",metodos naturales: usuarias nuevas,2015-01-01,0,0,3,0,0,3
CORQUE,"anticoncepcion, prevencion de its y de cancer de cuello uterino",metodos naturales: usuarias nuevas,2015-01-01,0,1,1,2,0,4
COTAGAITA,"anticoncepcion, prevencion de its y de cancer de cuello uterino",metodos naturales: usuarias nuevas,2015-01-01,0,0,1,1,0,2
COTOCA,"anticoncepcion, prevencion de its y de cancer de cuello uterino",metodos naturales: usuarias nuevas,2015-01-01,0,2,4,0,0,6
CRUZ DE MACHACAMARCA,"anticoncepcion, prevencion de its y de cancer de cuello uterino",metodos naturales: usuarias nuevas,2015-01-01,0,0,2,0,0,2
CURAHUARA DE CARANGAS,"anticoncepcion, prevencion de its y de cancer de cuello uterino",metodos naturales: usuarias nuevas,2015-01-01,0,1,1,0,0,2
DESAGUADERO,"anticoncepcion, prevencion de its y de cancer de cuello uterino",metodos naturales: usuarias nuevas,2015-01-01,0,0,1,1,0,2
EL ALTO,"anticoncepcion, prevencion de its y de cancer de cuello uterino",metodos naturales: usuarias nuevas,2015-01-01,1,50,198,410,1,660
EL CHORO,"anticoncepcion, prevencion de its y de cancer de cuello uterino",metodos naturales: usuarias nuevas,2015-01-01,0,0,3,0,0,3
EL PUENTE(STC),"anticoncepcion, prevencion de its y de cancer de cuello uterino",metodos naturales: usuarias nuevas,2015-01-01,0,1,1,1,0,3
EL TORNO,"anticoncepcion, prevencion de its y de cancer de cuello uterino",metodos naturales: usuarias nuevas,2015-01-01,0,0,1,0,0,1
EL VILLAR,"anticoncepcion, prevencion de its y de cancer de cuello uterino",metodos naturales: usuarias nuevas,2015-01-01,0,0,2,0,0,2
ENTRE RIOS TRJ,"anticoncepcion, prevencion de its y de cancer de cuello uterino",metodos naturales: usuarias nuevas,2015-01-01,0,4,5,2,0,11
ENTRE RIOS CBBA,"anticoncepcion, prevencion de its y de cancer de cuello uterino",metodos naturales: usuarias nuevas,2015-01-01,0,2,4,0,0,6
EUCALIPTUS,"anticoncepcion, prevencion de its y de cancer de cuello uterino",metodos naturales: usuarias nuevas,2015-01-01,0,3,5,0,0,8
EUREKA (SANTOS MERCADO),"anticoncepcion, prevencion de its y de cancer de cuello uterino",metodos naturales: usuarias nuevas,2015-01-01,0,0,1,2,0,3
FILADELFIA,"anticoncepcion, prevencion de its y de cancer de cuello uterino",metodos naturales: usuarias nuevas,2015-01-01,0,2,0,0,0,2
GUAQUI,"anticoncepcion, prevencion de its y de cancer de cuello uterino",metodos naturales: usuarias nuevas,2015-01-01,0,0,2,0,0,2
GUAYARAMERIN,"anticoncepcion, prevencion de its y de cancer de cuello uterino",metodos naturales: usuarias nuevas,2015-01-01,2,17,31,4,0,54
HUACARETA,"anticoncepcion, prevencion de its y de cancer de cuello uterino",metodos naturales: usuarias nuevas,2015-01-01,0,0,2,0,0,2
HUACAYA (VILLA DE HUACAYA),"anticoncepcion, prevencion de its y de cancer de cuello uterino",metodos naturales: usuarias nuevas,2015-01-01,0,2,0,0,0,2
HUARACAJE,"anticoncepcion, prevencion de its y de cancer de cuello uterino",metodos naturales: usuarias nuevas,2015-01-01,0,1,1,1,0,3
HUAYLLAMARCA,"anticoncepcion, prevencion de its y de cancer de cuello uterino",metodos naturales: usuarias nuevas,2015-01-01,0,2,1,0,0,3
ICHOCA,"anticoncepcion, prevencion de its y de cancer de cuello uterino",metodos naturales: usuarias nuevas,2015-01-01,0,0,3,1,0,4
ICLA,"anticoncepcion, prevencion de its y de cancer de cuello uterino",metodos naturales: usuarias nuevas,2015-01-01,0,1,3,1,0,5
INCAHUASI,"anticoncepcion, prevencion de its y de cancer de cuello uterino",metodos naturales: usuarias nuevas,2015-01-01,0,5,15,7,0,27
INQUISIVI,"anticoncepcion, prevencion de its y de cancer de cuello uterino",metodos naturales: usuarias nuevas,2015-01-01,0,4,4,0,0,8
IRUPANA (VILLA DE LANZA),"anticoncepcion, prevencion de its y de cancer de cuello uterino",metodos naturales: usuarias nuevas,2015-01-01,1,0,10,0,0,11
IXIAMAS,"anticoncepcion, prevencion de its y de cancer de cuello uterino",metodos naturales: usuarias nuevas,2015-01-01,0,6,6,0,0,12
JESUS DE MACHACA,"anticoncepcion, prevencion de its y de cancer de cuello uterino",metodos naturales: usuarias nuevas,2015-01-01,0,2,8,4,0,14
LA ASUNTA,"anticoncepcion, prevencion de its y de cancer de cuello uterino",metodos naturales: usuarias nuevas,2015-01-01,0,1,6,0,0,7
LA GUARDIA,"anticoncepcion, prevencion de its y de cancer de cuello uterino",metodos naturales: usuarias nuevas,2015-01-01,0,1,3,0,0,4
LA PAZ,"anticoncepcion, prevencion de its y de cancer de cuello uterino",metodos naturales: usuarias nuevas,2015-01-01,1,59,311,56,0,427
LAGUNILLAS,"anticoncepcion, prevencion de its y de cancer de cuello uterino",metodos naturales: usuarias nuevas,2015-01-01,0,4,6,0,0,10
LAJA,"anticoncepcion, prevencion de its y de cancer de cuello uterino",metodos naturales: usuarias nuevas,2015-01-01,0,0,4,0,0,4
LICOMA PAMPA,"anticoncepcion, prevencion de its y de cancer de cuello uterino",metodos naturales: usuarias nuevas,2015-01-01,0,0,1,1,0,2
LLALLAGUA,"anticoncepcion, prevencion de its y de cancer de cuello uterino",metodos naturales: usuarias nuevas,2015-01-01,0,0,6,1,0,7
LORETO,"anticoncepcion, prevencion de its y de cancer de cuello uterino",metodos naturales: usuarias nuevas,2015-01-01,0,0,1,0,0,1
MACHACAMARCA,"anticoncepcion, prevencion de its y de cancer de cuello uterino",metodos naturales: usuarias nuevas,2015-01-01,0,0,2,0,0,2
MAGDALENA,"anticoncepcion, prevencion de its y de cancer de cuello uterino",metodos naturales: usuarias nuevas,2015-01-01,0,2,1,0,0,3
MINEROS,"anticoncepcion, prevencion de its y de cancer de cuello uterino",metodos naturales: usuarias nuevas,2015-01-01,0,0,1,0,0,1
MOCOMOCO,"anticoncepcion, prevencion de its y de cancer de cuello uterino",metodos naturales: usuarias nuevas,2015-01-01,0,0,2,1,0,3
MOJOCOYA,"anticoncepcion, prevencion de its y de cancer de cuello uterino",metodos naturales: usuarias nuevas,2015-01-01,0,5,6,1,0,12
MONTEAGUDO,"anticoncepcion, prevencion de its y de cancer de cuello uterino",metodos naturales: usuarias nuevas,2015-01-01,0,0,3,0,0,3
MOROCHATA,"anticoncepcion, prevencion de its y de cancer de cuello uterino",metodos naturales: usuarias nuevas,2015-01-01,0,0,5,2,0,7
NACEBE (SANTA ROSA DEL ABUNA),"anticoncepcion, prevencion de its y de cancer de cuello uterino",metodos naturales: usuarias nuevas,2015-01-01,0,0,1,0,0,1
NUEVO MANOA (NUEVA ESPERANZA),"anticoncepcion, prevencion de its y de cancer de cuello uterino",metodos naturales: usuarias nuevas,2015-01-01,0,0,3,0,0,3
OCURI,"anticoncepcion, prevencion de its y de cancer de cuello uterino",metodos naturales: usuarias nuevas,2015-01-01,0,2,3,0,0,5
OMEREQUE,"anticoncepcion, prevencion de its y de cancer de cuello uterino",metodos naturales: usuarias nuevas,2015-01-01,0,1,0,1,0,2
ORURO,"anticoncepcion, prevencion de its y de cancer de cuello uterino",metodos naturales: usuarias nuevas,2015-01-01,0,3,30,14,0,47
PADILLA,"anticoncepcion, prevencion de its y de cancer de cuello uterino",metodos naturales: usuarias nuevas,2015-01-01,0,4,5,1,0,10
PAMPA AULLAGAS,"anticoncepcion, prevencion de its y de cancer de cuello uterino",metodos naturales: usuarias nuevas,2015-01-01,0,0,3,2,0,5
PAPEL PAMPA,"anticoncepcion, prevencion de its y de cancer de cuello uterino",metodos naturales: usuarias nuevas,2015-01-01,0,0,2,0,0,2
PAZÑA,"anticoncepcion, prevencion de its y de cancer de cuello uterino",metodos naturales: usuarias nuevas,2015-01-01,0,0,1,0,0,1
PELECHUCO,"anticoncepcion, prevencion de its y de cancer de cuello uterino",metodos naturales: usuarias nuevas,2015-01-01,0,0,1,0,0,1
POCOATA,"anticoncepcion, prevencion de its y de cancer de cuello uterino",metodos naturales: usuarias nuevas,2015-01-01,0,7,19,11,0,37
POCONA,"anticoncepcion, prevencion de its y de cancer de cuello uterino",metodos naturales: usuarias nuevas,2015-01-01,0,2,5,0,0,7
POOPO,"anticoncepcion, prevencion de its y de cancer de cuello uterino",metodos naturales: usuarias nuevas,2015-01-01,0,0,4,0,0,4
PORCO,"anticoncepcion, prevencion de its y de cancer de cuello uterino",metodos naturales: usuarias nuevas,2015-01-01,0,8,10,0,0,18
POROMA,"anticoncepcion, prevencion de its y de cancer de cuello uterino",metodos naturales: usuarias nuevas,2015-01-01,0,1,5,1,0,7
PORONGO,"anticoncepcion, prevencion de its y de cancer de cuello uterino",metodos naturales: usuarias nuevas,2015-01-01,1,3,8,1,0,13
PORTACHUELO,"anticoncepcion, prevencion de its y de cancer de cuello uterino",metodos naturales: usuarias nuevas,2015-01-01,0,7,2,0,0,9
POTOSI,"anticoncepcion, prevencion de its y de cancer de cuello uterino",metodos naturales: usuarias nuevas,2015-01-01,0,11,41,7,0,59
PRESTO,"anticoncepcion, prevencion de its y de cancer de cuello uterino",metodos naturales: usuarias nuevas,2015-01-01,0,1,3,1,0,5
PUCARANI,"anticoncepcion, prevencion de its y de cancer de cuello uterino",metodos naturales: usuarias nuevas,2015-01-01,0,5,8,2,0,15
PUERTO CARABUCO,"anticoncepcion, prevencion de its y de cancer de cuello uterino",metodos naturales: usuarias nuevas,2015-01-01,0,0,7,0,0,7
PUERTO GONZALO MORENO,"anticoncepcion, prevencion de its y de cancer de cuello uterino",metodos naturales: usuarias nuevas,2015-01-01,1,2,2,1,0,6
PUERTO QUIJARRO,"anticoncepcion, prevencion de its y de cancer de cuello uterino",metodos naturales: usuarias nuevas,2015-01-01,0,3,20,2,0,25
PUERTO VILLARROEL,"anticoncepcion, prevencion de its y de cancer de cuello uterino",metodos naturales: usuarias nuevas,2015-01-01,6,1,6,1,0,14
PUNA,"anticoncepcion, prevencion de its y de cancer de cuello uterino",metodos naturales: usuarias nuevas,2015-01-01,0,6,7,1,0,14
PUNATA,"anticoncepcion, prevencion de its y de cancer de cuello uterino",metodos naturales: usuarias nuevas,2015-01-01,0,1,0,0,0,1
QUILLACOLLO,"anticoncepcion, prevencion de its y de cancer de cuello uterino",metodos naturales: usuarias nuevas,2015-01-01,0,0,24,1,0,25
REYES,"anticoncepcion, prevencion de its y de cancer de cuello uterino",metodos naturales: usuarias nuevas,2015-01-01,1,10,20,0,0,31
RIBERALTA,"anticoncepcion, prevencion de its y de cancer de cuello uterino",metodos naturales: usuarias nuevas,2015-01-01,5,39,98,29,0,171
RURRENABAQUE,"anticoncepcion, prevencion de its y de cancer de cuello uterino",metodos naturales: usuarias nuevas,2015-01-01,0,0,2,0,0,2
SABAYA,"anticoncepcion, prevencion de its y de cancer de cuello uterino",metodos naturales: usuarias nuevas,2015-01-01,0,1,2,0,0,3
SACABA,"anticoncepcion, prevencion de its y de cancer de cuello uterino",metodos naturales: usuarias nuevas,2015-01-01,0,15,62,4,0,81
SACACA,"anticoncepcion, prevencion de its y de cancer de cuello uterino",metodos naturales: usuarias nuevas,2015-01-01,0,1,3,2,0,6
SAIPINA,"anticoncepcion, prevencion de its y de cancer de cuello uterino",metodos naturales: usuarias nuevas,2015-01-01,0,0,1,0,0,1
SALINAS DE GARCI MENDOZA,"anticoncepcion, prevencion de its y de cancer de cuello uterino",metodos naturales: usuarias nuevas,2015-01-01,0,4,5,1,0,10
SAN ANDRES,"anticoncepcion, prevencion de its y de cancer de cuello uterino",metodos naturales: usuarias nuevas,2015-01-01,0,0,2,0,0,2
SAN ANDRES DE MACHACA,"anticoncepcion, prevencion de its y de cancer de cuello uterino",metodos naturales: usuarias nuevas,2015-01-01,0,1,2,1,0,4
SAN ANTONIO DE LOMERIO,"anticoncepcion, prevencion de its y de cancer de cuello uterino",metodos naturales: usuarias nuevas,2015-01-01,0,2,8,0,0,10
SAN BORJA,"anticoncepcion, prevencion de its y de cancer de cuello uterino",metodos naturales: usuarias nuevas,2015-01-01,0,14,9,2,0,25
SAN BUENA VENTURA,"anticoncepcion, prevencion de its y de cancer de cuello uterino",metodos naturales: usuarias nuevas,2015-01-01,0,2,6,1,0,9
SAN CARLOS,"anticoncepcion, prevencion de its y de cancer de cuello uterino",metodos naturales: usuarias nuevas,2015-01-01,0,7,18,0,0,25
SAN IGNACIO,"anticoncepcion, prevencion de its y de cancer de cuello uterino",metodos naturales: usuarias nuevas,2015-01-01,1,6,4,0,0,11
SAN JUAN DE YAPACANI,"anticoncepcion, prevencion de its y de cancer de cuello uterino",metodos naturales: usuarias nuevas,2015-01-01,0,0,2,0,0,2
SAN JULIAN,"anticoncepcion, prevencion de its y de cancer de cuello uterino",metodos naturales: usuarias nuevas,2015-01-01,0,0,2,0,0,2
SAN LORENZO(TJA),"anticoncepcion, prevencion de its y de cancer de cuello uterino",metodos naturales: usuarias nuevas,2015-01-01,0,0,1,0,0,1
SAN LUCAS,"anticoncepcion, prevencion de its y de cancer de cuello uterino",metodos naturales: usuarias nuevas,2015-01-01,0,2,3,5,1,11
SAN MATIAS,"anticoncepcion, prevencion de its y de cancer de cuello uterino",metodos naturales: usuarias nuevas,2015-01-01,0,1,0,0,0,1
SAN MIGUEL DE VELASCO,"anticoncepcion, prevencion de its y de cancer de cuello uterino",metodos naturales: usuarias nuevas,2015-01-01,0,2,1,3,0,6
SAN PEDRO,"anticoncepcion, prevencion de its y de cancer de cuello uterino",metodos naturales: usuarias nuevas,2015-01-01,0,0,1,0,0,1
SAN PEDRO DE BUENA VISTA,"anticoncepcion, prevencion de its y de cancer de cuello uterino",metodos naturales: usuarias nuevas,2015-01-01,0,1,8,3,0,12
SAN PEDRO DE TIQUINA,"anticoncepcion, prevencion de its y de cancer de cuello uterino",metodos naturales: usuarias nuevas,2015-01-01,0,1,1,0,0,2
SAN RAFAEL,"anticoncepcion, prevencion de its y de cancer de cuello uterino",metodos naturales: usuarias nuevas,2015-01-01,0,2,3,0,0,5
SAN RAMON BENI,"anticoncepcion, prevencion de its y de cancer de cuello uterino",metodos naturales: usuarias nuevas,2015-01-01,0,0,1,0,0,1
SANTA ANA,"anticoncepcion, prevencion de its y de cancer de cuello uterino",metodos naturales: usuarias nuevas,2015-01-01,6,42,87,12,4,151
SANTA CRUZ DE LA SIERRA,"anticoncepcion, prevencion de its y de cancer de cuello uterino",metodos naturales: usuarias nuevas,2015-01-01,0,77,116,14,0,207
SANTA ROSA DEL SARA,"anticoncepcion, prevencion de its y de cancer de cuello uterino",metodos naturales: usuarias nuevas,2015-01-01,0,0,3,1,0,4
SANTIAGO DE CALLAPA,"anticoncepcion, prevencion de its y de cancer de cuello uterino",metodos naturales: usuarias nuevas,2015-01-01,0,1,0,0,0,1
SANTIAGO DE HUARI,"anticoncepcion, prevencion de its y de cancer de cuello uterino",metodos naturales: usuarias nuevas,2015-01-01,1,0,10,0,0,11
SANTIAGO DE HUATA,"anticoncepcion, prevencion de its y de cancer de cuello uterino",metodos naturales: usuarias nuevas,2015-01-01,0,2,4,1,0,7
SANTIAGO DE MACHACA,"anticoncepcion, prevencion de its y de cancer de cuello uterino",metodos naturales: usuarias nuevas,2015-01-01,0,0,1,0,0,1
SAPAHAQUI,"anticoncepcion, prevencion de its y de cancer de cuello uterino",metodos naturales: usuarias nuevas,2015-01-01,0,0,1,0,0,1
SENA,"anticoncepcion, prevencion de its y de cancer de cuello uterino",metodos naturales: usuarias nuevas,2015-01-01,0,4,1,1,0,6
SHINAOTA,"anticoncepcion, prevencion de its y de cancer de cuello uterino",metodos naturales: usuarias nuevas,2015-01-01,0,1,0,0,0,1
SICA SICA (VILLA AROMA),"anticoncepcion, prevencion de its y de cancer de cuello uterino",metodos naturales: usuarias nuevas,2015-01-01,0,3,4,0,0,7
SOPACHUY,"anticoncepcion, prevencion de its y de cancer de cuello uterino",metodos naturales: usuarias nuevas,2015-01-01,0,0,9,1,0,10
SORACACHI,"anticoncepcion, prevencion de its y de cancer de cuello uterino",metodos naturales: usuarias nuevas,2015-01-01,0,1,2,2,0,5
SUCRE,"anticoncepcion, prevencion de its y de cancer de cuello uterino",metodos naturales: usuarias nuevas,2015-01-01,20,12,96,14,1,143
TACOPAYA,"anticoncepcion, prevencion de its y de cancer de cuello uterino",metodos naturales: usuarias nuevas,2015-01-01,0,0,3,2,0,5
TAPACARI,"anticoncepcion, prevencion de its y de cancer de cuello uterino",metodos naturales: usuarias nuevas,2015-01-01,0,2,2,2,0,6
TARACO,"anticoncepcion, prevencion de its y de cancer de cuello uterino",metodos naturales: usuarias nuevas,2015-01-01,0,0,3,0,0,3
TARIJA,"anticoncepcion, prevencion de its y de cancer de cuello uterino",metodos naturales: usuarias nuevas,2015-01-01,0,3,20,4,0,27
TARVITA,"anticoncepcion, prevencion de its y de cancer de cuello uterino",metodos naturales: usuarias nuevas,2015-01-01,0,2,4,1,0,7
TIAWANACU,"anticoncepcion, prevencion de its y de cancer de cuello uterino",metodos naturales: usuarias nuevas,2015-01-01,0,2,5,0,0,7
TINGUIPAYA,"anticoncepcion, prevencion de its y de cancer de cuello uterino",metodos naturales: usuarias nuevas,2015-01-01,0,0,5,0,0,5
TIPUANI,"anticoncepcion, prevencion de its y de cancer de cuello uterino",metodos naturales: usuarias nuevas,2015-01-01,0,2,2,1,0,5
TIQUIPAYA,"anticoncepcion, prevencion de its y de cancer de cuello uterino",metodos naturales: usuarias nuevas,2015-01-01,0,0,3,0,0,3
TIRAQUE (CBBA),"anticoncepcion, prevencion de its y de cancer de cuello uterino",metodos naturales: usuarias nuevas,2015-01-01,0,2,0,0,0,2
TOLATA,"anticoncepcion, prevencion de its y de cancer de cuello uterino",metodos naturales: usuarias nuevas,2015-01-01,0,0,10,0,0,10
TOLEDO,"anticoncepcion, prevencion de its y de cancer de cuello uterino",metodos naturales: usuarias nuevas,2015-01-01,0,1,4,3,0,8
TOMAVE,"anticoncepcion, prevencion de its y de cancer de cuello uterino",metodos naturales: usuarias nuevas,2015-01-01,0,0,0,1,0,1
TORO TORO,"anticoncepcion, prevencion de its y de cancer de cuello uterino",metodos naturales: usuarias nuevas,2015-01-01,0,4,0,0,0,4
TOTORA(CBBA),"anticoncepcion, prevencion de its y de cancer de cuello uterino",metodos naturales: usuarias nuevas,2015-01-01,0,1,0,0,0,1
TOTORA(ORR),"anticoncepcion, prevencion de its y de cancer de cuello uterino",metodos naturales: usuarias nuevas,2015-01-01,0,0,3,2,0,5
TRINIDAD,"anticoncepcion, prevencion de its y de cancer de cuello uterino",metodos naturales: usuarias nuevas,2015-01-01,3,31,24,2,0,60
TUPIZA,"anticoncepcion, prevencion de its y de cancer de cuello uterino",metodos naturales: usuarias nuevas,2015-01-01,0,0,3,0,0,3
TURCO,"anticoncepcion, prevencion de its y de cancer de cuello uterino",metodos naturales: usuarias nuevas,2015-01-01,0,1,0,0,0,1
UMALA,"anticoncepcion, prevencion de its y de cancer de cuello uterino",metodos naturales: usuarias nuevas,2015-01-01,0,0,4,0,0,4
UNCIA,"anticoncepcion, prevencion de its y de cancer de cuello uterino",metodos naturales: usuarias nuevas,2015-01-01,0,1,7,0,0,8
VACAS,"anticoncepcion, prevencion de its y de cancer de cuello uterino",metodos naturales: usuarias nuevas,2015-01-01,0,5,4,0,0,9
VIACHA,"anticoncepcion, prevencion de its y de cancer de cuello uterino",metodos naturales: usuarias nuevas,2015-01-01,0,1,1,0,0,2
VILLA CHARCAS,"anticoncepcion, prevencion de its y de cancer de cuello uterino",metodos naturales: usuarias nuevas,2015-01-01,0,1,6,3,0,10
VILLA RIVERO,"anticoncepcion, prevencion de its y de cancer de cuello uterino",metodos naturales: usuarias nuevas,2015-01-01,0,1,0,1,0,2
VILLA SERRANO,"anticoncepcion, prevencion de its y de cancer de cuello uterino",metodos naturales: usuarias nuevas,2015-01-01,0,2,3,1,0,6
VILLA TUNARI,"anticoncepcion, prevencion de its y de cancer de cuello uterino",metodos naturales: usuarias nuevas,2015-01-01,0,3,0,0,0,3
VILLAZON,"anticoncepcion, prevencion de its y de cancer de cuello uterino",metodos naturales: usuarias nuevas,2015-01-01,1,8,46,9,0,64
VITICHI,"anticoncepcion, prevencion de its y de cancer de cuello uterino",metodos naturales: usuarias nuevas,2015-01-01,0,0,3,1,0,4
WARNES,"anticoncepcion, prevencion de its y de cancer de cuello uterino",metodos naturales: usuarias nuevas,2015-01-01,0,1,2,0,0,3
YACUIBA,"anticoncepcion, prevencion de its y de cancer de cuello uterino",metodos naturales: usuarias nuevas,2015-01-01,1,2,8,0,0,11
YAMPARAEZ,"anticoncepcion, prevencion de its y de cancer de cuello uterino",metodos naturales: usuarias nuevas,2015-01-01,0,2,0,0,0,2
YAPACANI,"anticoncepcion, prevencion de its y de cancer de cuello uterino",metodos naturales: usuarias nuevas,2015-01-01,2,7,3,0,0,12
YOTALA,"anticoncepcion, prevencion de its y de cancer de cuello uterino",metodos naturales: usuarias nuevas,2015-01-01,0,2,5,2,0,9
ZUDAÑEZ,"anticoncepcion, prevencion de its y de cancer de cuello uterino",metodos naturales: usuarias nuevas,2015-01-01,0,1,1,0,0,2
ACACIO,"anticoncepcion, prevencion de its y de cancer de cuello uterino",metodos naturales: usuarias nuevas,2015-02-01,0,1,2,0,0,3
ACHACACHI,"anticoncepcion, prevencion de its y de cancer de cuello uterino",metodos naturales: usuarias nuevas,2015-02-01,0,0,10,12,0,22
AIQUILE,"anticoncepcion, prevencion de its y de cancer de cuello uterino",metodos naturales: usuarias nuevas,2015-02-01,0,0,1,1,3,5
ALCALA,"anticoncepcion, prevencion de its y de cancer de cuello uterino",metodos naturales: usuarias nuevas,2015-02-01,0,0,2,0,0,2
ANCORAIMES,"anticoncepcion, prevencion de its y de cancer de cuello uterino",metodos naturales: usuarias nuevas,2015-02-01,0,2,5,5,0,12
ANDAMARCA,"anticoncepcion, prevencion de its y de cancer de cuello uterino",metodos naturales: usuarias nuevas,2015-02-01,0,1,0,0,0,1
ANTEQUERA,"anticoncepcion, prevencion de its y de cancer de cuello uterino",metodos naturales: usuarias nuevas,2015-02-01,0,0,1,0,0,1
ANZALDO,"anticoncepcion, prevencion de its y de cancer de cuello uterino",metodos naturales: usuarias nuevas,2015-02-01,0,2,2,0,0,4
APOLO,"anticoncepcion, prevencion de its y de cancer de cuello uterino",metodos naturales: usuarias nuevas,2015-02-01,0,1,0,0,0,1
ARBIETO,"anticoncepcion, prevencion de its y de cancer de cuello uterino",metodos naturales: usuarias nuevas,2015-02-01,0,2,12,3,0,17
ARQUE,"anticoncepcion, prevencion de its y de cancer de cuello uterino",metodos naturales: usuarias nuevas,2015-02-01,0,0,2,0,0,2
ASCENCION DE GUARAYOS,"anticoncepcion, prevencion de its y de cancer de cuello uterino",metodos naturales: usuarias nuevas,2015-02-01,0,1,0,0,0,1
ATOCHA,"anticoncepcion, prevencion de its y de cancer de cuello uterino",metodos naturales: usuarias nuevas,2015-02-01,0,1,1,0,0,2
AZURDUY,"anticoncepcion, prevencion de its y de cancer de cuello uterino",metodos naturales: usuarias nuevas,2015-02-01,0,1,0,0,0,1
BATALLAS,"anticoncepcion, prevencion de its y de cancer de cuello uterino",metodos naturales: usuarias nuevas,2015-02-01,0,0,7,2,0,9
BELEN DE ANDAMARCA,"anticoncepcion, prevencion de its y de cancer de cuello uterino",metodos naturales: usuarias nuevas,2015-02-01,0,1,2,0,0,3
BELLA FLOR,"anticoncepcion, prevencion de its y de cancer de cuello uterino",metodos naturales: usuarias nuevas,2015-02-01,0,0,1,0,0,1
BERMEJO,"anticoncepcion, prevencion de its y de cancer de cuello uterino",metodos naturales: usuarias nuevas,2015-02-01,0,0,0,0,1,1
BETANZOS,"anticoncepcion, prevencion de its y de cancer de cuello uterino",metodos naturales: usuarias nuevas,2015-02-01,0,8,10,2,0,20
BUENA VISTA,"anticoncepcion, prevencion de its y de cancer de cuello uterino",metodos naturales: usuarias nuevas,2015-02-01,0,2,2,1,0,5
CAJUATA,"anticoncepcion, prevencion de its y de cancer de cuello uterino",metodos naturales: usuarias nuevas,2015-02-01,0,4,1,2,0,7
CALAMARCA,"anticoncepcion, prevencion de its y de cancer de cuello uterino",metodos naturales: usuarias nuevas,2015-02-01,0,1,4,4,0,9
CAMIRI,"anticoncepcion, prevencion de its y de cancer de cuello uterino",metodos naturales: usuarias nuevas,2015-02-01,0,1,1,0,0,2
CAPINOTA,"anticoncepcion, prevencion de its y de cancer de cuello uterino",metodos naturales: usuarias nuevas,2015-02-01,0,0,0,1,0,1
CARACOLLO,"anticoncepcion, prevencion de its y de cancer de cuello uterino",metodos naturales: usuarias nuevas,2015-02-01,0,2,16,2,0,20
CARANAVI,"anticoncepcion, prevencion de its y de cancer de cuello uterino",metodos naturales: usuarias nuevas,2015-02-01,0,1,3,0,0,4
CARIPUYO,"anticoncepcion, prevencion de its y de cancer de cuello uterino",metodos naturales: usuarias nuevas,2015-02-01,0,1,1,0,0,2
CHALLAPATA,"anticoncepcion, prevencion de its y de cancer de cuello uterino",metodos naturales: usuarias nuevas,2015-02-01,0,15,34,3,0,52
CHAQUI,"anticoncepcion, prevencion de its y de cancer de cuello uterino",metodos naturales: usuarias nuevas,2015-02-01,0,1,4,1,0,6
CHAYANTA,"anticoncepcion, prevencion de its y de cancer de cuello uterino",metodos naturales: usuarias nuevas,2015-02-01,0,3,6,1,0,10
CHIMORE,"anticoncepcion, prevencion de its y de cancer de cuello uterino",metodos naturales: usuarias nuevas,2015-02-01,0,0,0,1,0,1
CHIPAYA,"anticoncepcion, prevencion de its y de cancer de cuello uterino",metodos naturales: usuarias nuevas,2015-02-01,0,1,0,0,0,1
CHUA COCANI,"anticoncepcion, prevencion de its y de cancer de cuello uterino",metodos naturales: usuarias nuevas,2015-02-01,0,0,1,0,0,1
CHULUMANI (V. DE LA LIBERTAD),"anticoncepcion, prevencion de its y de cancer de cuello uterino",metodos naturales: usuarias nuevas,2015-02-01,2,6,20,3,0,31
CKOCHAS,"anticoncepcion, prevencion de its y de cancer de cuello uterino",metodos naturales: usuarias nuevas,2015-02-01,0,3,2,1,0,6
CLIZA,"anticoncepcion, prevencion de its y de cancer de cuello uterino",metodos naturales: usuarias nuevas,2015-02-01,0,6,6,2,0,14
COBIJA,"anticoncepcion, prevencion de its y de cancer de cuello uterino",metodos naturales: usuarias nuevas,2015-02-01,0,2,7,1,0,10
COCAPATA,"anticoncepcion, prevencion de its y de cancer de cuello uterino",metodos naturales: usuarias nuevas,2015-02-01,0,1,3,1,0,5
COCHABAMBA,"anticoncepcion, prevencion de its y de cancer de cuello uterino",metodos naturales: usuarias nuevas,2015-02-01,0,35,151,320,1,507
COLCAPIRHUA,"anticoncepcion, prevencion de its y de cancer de cuello uterino",metodos naturales: usuarias nuevas,2015-02-01,0,1,0,0,0,1
"COLCHA ""K""","anticoncepcion, prevencion de its y de cancer de cuello uterino",metodos naturales: usuarias nuevas,2015-02-01,0,0,4,0,0,4
COLLANA,"anticoncepcion, prevencion de its y de cancer de cuello uterino",metodos naturales: usuarias nuevas,2015-02-01,0,1,0,0,0,1
COLOMI,"anticoncepcion, prevencion de its y de cancer de cuello uterino",metodos naturales: usuarias nuevas,2015-02-01,0,1,7,1,0,9
COLPA BELGICA,"anticoncepcion, prevencion de its y de cancer de cuello uterino",metodos naturales: usuarias nuevas,2015-02-01,0,1,5,1,0,7
COLQUIRI,"anticoncepcion, prevencion de its y de cancer de cuello uterino",metodos naturales: usuarias nuevas,2015-02-01,0,3,8,4,0,15
COMANCHE,"anticoncepcion, prevencion de its y de cancer de cuello uterino",metodos naturales: usuarias nuevas,2015-02-01,0,0,0,1,0,1
COMARAPA,"anticoncepcion, prevencion de its y de cancer de cuello uterino",metodos naturales: usuarias nuevas,2015-02-01,1,5,13,2,0,21
CORIPATA,"anticoncepcion, prevencion de its y de cancer de cuello uterino",metodos naturales: usuarias nuevas,2015-02-01,0,0,2,0,0,2
CORO CORO,"anticoncepcion, prevencion de its y de cancer de cuello uterino",metodos naturales: usuarias nuevas,2015-02-01,0,0,2,0,0,2
COROICO,"anticoncepcion, prevencion de its y de cancer de cuello uterino",metodos naturales: usuarias nuevas,2015-02-01,0,1,1,0,0,2
CORQUE,"anticoncepcion, prevencion de its y de cancer de cuello uterino",metodos naturales: usuarias nuevas,2015-02-01,0,0,3,0,0,3
COTAGAITA,"anticoncepcion, prevencion de its y de cancer de cuello uterino",metodos naturales: usuarias nuevas,2015-02-01,0,1,3,0,0,4
COTOCA,"anticoncepcion, prevencion de its y de cancer de cuello uterino",metodos naturales: usuarias nuevas,2015-02-01,0,0,3,1,0,4
CRUZ DE MACHACAMARCA,"anticoncepcion, prevencion de its y de cancer de cuello uterino",metodos naturales: usuarias nuevas,2015-02-01,0,0,1,0,0,1
CULPINA,"anticoncepcion, prevencion de its y de cancer de cuello uterino",metodos naturales: usuarias nuevas,2015-02-01,0,0,1,0,0,1
DESAGUADERO,"anticoncepcion, prevencion de its y de cancer de cuello uterino",metodos naturales: usuarias nuevas,2015-02-01,0,1,6,0,0,7
EL ALTO,"anticoncepcion, prevencion de its y de cancer de cuello uterino",metodos naturales: usuarias nuevas,2015-02-01,0,14,173,169,4,360
EL CHORO,"anticoncepcion, prevencion de its y de cancer de cuello uterino",metodos naturales: usuarias nuevas,2015-02-01,0,0,3,0,0,3
EL PUENTE(STC),"anticoncepcion, prevencion de its y de cancer de cuello uterino",metodos naturales: usuarias nuevas,2015-02-01,0,1,3,0,0,4
EL PUENTE(TJA),"anticoncepcion, prevencion de its y de cancer de cuello uterino",metodos naturales: usuarias nuevas,2015-02-01,0,0,1,0,0,1
EL TORNO,"anticoncepcion, prevencion de its y de cancer de cuello uterino",metodos naturales: usuarias nuevas,2015-02-01,0,1,2,0,0,3
EL VILLAR,"anticoncepcion, prevencion de its y de cancer de cuello uterino",metodos naturales: usuarias nuevas,2015-02-01,0,1,2,0,0,3
ENTRE RIOS TRJ,"anticoncepcion, prevencion de its y de cancer de cuello uterino",metodos naturales: usuarias nuevas,2015-02-01,0,10,13,1,0,24
ENTRE RIOS CBBA,"anticoncepcion, prevencion de its y de cancer de cuello uterino",metodos naturales: usuarias nuevas,2015-02-01,0,0,1,0,0,1
EUCALIPTUS,"anticoncepcion, prevencion de its y de cancer de cuello uterino",metodos naturales: usuarias nuevas,2015-02-01,0,0,5,2,0,7
EXALTACION,"anticoncepcion, prevencion de its y de cancer de cuello uterino",metodos naturales: usuarias nuevas,2015-02-01,0,1,0,0,0,1
FILADELFIA,"anticoncepcion, prevencion de its y de cancer de cuello uterino",metodos naturales: usuarias nuevas,2015-02-01,0,0,1,0,0,1
GUAQUI,"anticoncepcion, prevencion de its y de cancer de cuello uterino",metodos naturales: usuarias nuevas,2015-02-01,0,3,5,1,0,9
GUAYARAMERIN,"anticoncepcion, prevencion de its y de cancer de cuello uterino",metodos naturales: usuarias nuevas,2015-02-01,2,19,29,4,0,54
HUACARETA,"anticoncepcion, prevencion de its y de cancer de cuello uterino",metodos naturales: usuarias nuevas,2015-02-01,0,2,0,0,0,2
HUAYLLAMARCA,"anticoncepcion, prevencion de its y de cancer de cuello uterino",metodos naturales: usuarias nuevas,2015-02-01,0,0,1,0,0,1
ICHOCA,"anticoncepcion, prevencion de its y de cancer de cuello uterino",metodos naturales: usuarias nuevas,2015-02-01,0,1,2,1,0,4
ICLA,"anticoncepcion, prevencion de its y de cancer de cuello uterino",metodos naturales: usuarias nuevas,2015-02-01,0,0,2,0,0,2
INCAHUASI,"anticoncepcion, prevencion de its y de cancer de cuello uterino",metodos naturales: usuarias nuevas,2015-02-01,0,3,9,1,0,13
INQUISIVI,"anticoncepcion, prevencion de its y de cancer de cuello uterino",metodos naturales: usuarias nuevas,2015-02-01,0,0,4,3,0,7
IRUPANA (VILLA DE LANZA),"anticoncepcion, prevencion de its y de cancer de cuello uterino",metodos naturales: usuarias nuevas,2015-02-01,0,5,15,1,0,21
IXIAMAS,"anticoncepcion, prevencion de its y de cancer de cuello uterino",metodos naturales: usuarias nuevas,2015-02-01,0,1,2,1,0,4
JESUS DE MACHACA,"anticoncepcion, prevencion de its y de cancer de cuello uterino",metodos naturales: usuarias nuevas,2015-02-01,0,4,6,1,0,11
LA ASUNTA,"anticoncepcion, prevencion de its y de cancer de cuello uterino",metodos naturales: usuarias nuevas,2015-02-01,0,1,13,1,0,15
LA PAZ,"anticoncepcion, prevencion de its y de cancer de cuello uterino",metodos naturales: usuarias nuevas,2015-02-01,0,49,245,21,0,315
LAGUNILLAS,"anticoncepcion, prevencion de its y de cancer de cuello uterino",metodos naturales: usuarias nuevas,2015-02-01,0,0,1,0,0,1
LAJA,"anticoncepcion, prevencion de its y de cancer de cuello uterino",metodos naturales: usuarias nuevas,2015-02-01,2,1,2,0,0,5
LLALLAGUA,"anticoncepcion, prevencion de its y de cancer de cuello uterino",metodos naturales: usuarias nuevas,2015-02-01,0,4,11,2,0,17
LORETO,"anticoncepcion, prevencion de its y de cancer de cuello uterino",metodos naturales: usuarias nuevas,2015-02-01,0,1,24,41,0,66
MACHACAMARCA,"anticoncepcion, prevencion de its y de cancer de cuello uterino",metodos naturales: usuarias nuevas,2015-02-01,0,0,1,0,0,1
MACHARETI,"anticoncepcion, prevencion de its y de cancer de cuello uterino",metodos naturales: usuarias nuevas,2015-02-01,0,2,1,1,0,4
MAGDALENA,"anticoncepcion, prevencion de its y de cancer de cuello uterino",metodos naturales: usuarias nuevas,2015-02-01,0,2,1,0,0,3
MAPIRI,"anticoncepcion, prevencion de its y de cancer de cuello uterino",metodos naturales: usuarias nuevas,2015-02-01,0,2,8,2,0,12
MINEROS,"anticoncepcion, prevencion de its y de cancer de cuello uterino",metodos naturales: usuarias nuevas,2015-02-01,0,1,4,0,0,5
MOCOMOCO,"anticoncepcion, prevencion de its y de cancer de cuello uterino",metodos naturales: usuarias nuevas,2015-02-01,0,4,2,0,0,6
MOJOCOYA,"anticoncepcion, prevencion de its y de cancer de cuello uterino",metodos naturales: usuarias nuevas,2015-02-01,1,2,2,2,0,7
MONTERO,"anticoncepcion, prevencion de its y de cancer de cuello uterino",metodos naturales: usuarias nuevas,2015-02-01,0,1,2,2,0,5
MOROCHATA,"anticoncepcion, prevencion de its y de cancer de cuello uterino",metodos naturales: usuarias nuevas,2015-02-01,0,3,10,0,0,13
NUEVO MANOA (NUEVA ESPERANZA),"anticoncepcion, prevencion de its y de cancer de cuello uterino",metodos naturales: usuarias nuevas,2015-02-01,0,0,2,0,0,2
OMEREQUE,"anticoncepcion, prevencion de its y de cancer de cuello uterino",metodos naturales: usuarias nuevas,2015-02-01,0,1,4,0,0,5
ORURO,"anticoncepcion, prevencion de its y de cancer de cuello uterino",metodos naturales: usuarias nuevas,2015-02-01,0,2,24,3,0,29
PADILLA,"anticoncepcion, prevencion de its y de cancer de cuello uterino",metodos naturales: usuarias nuevas,2015-02-01,0,5,12,1,0,18
PALCA,"anticoncepcion, prevencion de its y de cancer de cuello uterino",metodos naturales: usuarias nuevas,2015-02-01,0,1,3,1,0,5
PAMPA AULLAGAS,"anticoncepcion, prevencion de its y de cancer de cuello uterino",metodos naturales: usuarias nuevas,2015-02-01,0,0,1,0,0,1
PAPEL PAMPA,"anticoncepcion, prevencion de its y de cancer de cuello uterino",metodos naturales: usuarias nuevas,2015-02-01,0,0,4,0,0,4
PAZÑA,"anticoncepcion, prevencion de its y de cancer de cuello uterino",metodos naturales: usuarias nuevas,2015-02-01,0,1,0,0,0,1
PELECHUCO,"anticoncepcion, prevencion de its y de cancer de cuello uterino",metodos naturales: usuarias nuevas,2015-02-01,0,0,1,1,0,2
POCOATA,"anticoncepcion, prevencion de its y de cancer de cuello uterino",metodos naturales: usuarias nuevas,2015-02-01,0,1,14,4,0,19
POCONA,"anticoncepcion, prevencion de its y de cancer de cuello uterino",metodos naturales: usuarias nuevas,2015-02-01,0,2,2,1,0,5
POJO (CBBA),"anticoncepcion, prevencion de its y de cancer de cuello uterino",metodos naturales: usuarias nuevas,2015-02-01,0,2,2,0,0,4
PORCO,"anticoncepcion, prevencion de its y de cancer de cuello uterino",metodos naturales: usuarias nuevas,2015-02-01,0,1,9,2,0,12
POROMA,"anticoncepcion, prevencion de its y de cancer de cuello uterino",metodos naturales: usuarias nuevas,2015-02-01,0,1,2,2,0,5
PORONGO,"anticoncepcion, prevencion de its y de cancer de cuello uterino",metodos naturales: usuarias nuevas,2015-02-01,0,3,8,1,0,12
PORTACHUELO,"anticoncepcion, prevencion de its y de cancer de cuello uterino",metodos naturales: usuarias nuevas,2015-02-01,0,3,2,1,0,6
POTOSI,"anticoncepcion, prevencion de its y de cancer de cuello uterino",metodos naturales: usuarias nuevas,2015-02-01,3,20,161,3,0,187
PUCARANI,"anticoncepcion, prevencion de its y de cancer de cuello uterino",metodos naturales: usuarias nuevas,2015-02-01,0,2,17,0,0,19
PUERTO ACOSTA,"anticoncepcion, prevencion de its y de cancer de cuello uterino",metodos naturales: usuarias nuevas,2015-02-01,0,0,1,2,0,3
PUERTO CARABUCO,"anticoncepcion, prevencion de its y de cancer de cuello uterino",metodos naturales: usuarias nuevas,2015-02-01,0,0,1,0,0,1
PUERTO GONZALO MORENO,"anticoncepcion, prevencion de its y de cancer de cuello uterino",metodos naturales: usuarias nuevas,2015-02-01,0,0,6,0,0,6
PUERTO PEREZ,"anticoncepcion, prevencion de its y de cancer de cuello uterino",metodos naturales: usuarias nuevas,2015-02-01,0,0,5,0,0,5
PUERTO QUIJARRO,"anticoncepcion, prevencion de its y de cancer de cuello uterino",metodos naturales: usuarias nuevas,2015-02-01,0,2,8,2,0,12
PUERTO RICO,"anticoncepcion, prevencion de its y de cancer de cuello uterino",metodos naturales: usuarias nuevas,2015-02-01,0,0,2,0,0,2
PUERTO VILLARROEL,"anticoncepcion, prevencion de its y de cancer de cuello uterino",metodos naturales: usuarias nuevas,2015-02-01,0,2,4,0,0,6
PUNATA,"anticoncepcion, prevencion de its y de cancer de cuello uterino",metodos naturales: usuarias nuevas,2015-02-01,0,1,12,5,0,18
QUILLACOLLO,"anticoncepcion, prevencion de its y de cancer de cuello uterino",metodos naturales: usuarias nuevas,2015-02-01,0,16,16,3,0,35
QUIME,"anticoncepcion, prevencion de its y de cancer de cuello uterino",metodos naturales: usuarias nuevas,2015-02-01,0,3,3,1,0,7
REYES,"anticoncepcion, prevencion de its y de cancer de cuello uterino",metodos naturales: usuarias nuevas,2015-02-01,0,22,25,2,0,49
RIBERALTA,"anticoncepcion, prevencion de its y de cancer de cuello uterino",metodos naturales: usuarias nuevas,2015-02-01,4,43,116,13,0,176
SABAYA,"anticoncepcion, prevencion de its y de cancer de cuello uterino",metodos naturales: usuarias nuevas,2015-02-01,0,0,1,0,0,1
SACABA,"anticoncepcion, prevencion de its y de cancer de cuello uterino",metodos naturales: usuarias nuevas,2015-02-01,1,3,18,20,0,42
SACACA,"anticoncepcion, prevencion de its y de cancer de cuello uterino",metodos naturales: usuarias nuevas,2015-02-01,0,0,5,2,0,7
SALINAS DE GARCI MENDOZA,"anticoncepcion, prevencion de its y de cancer de cuello uterino",metodos naturales: usuarias nuevas,2015-02-01,0,4,10,0,0,14
SAMAIPATA,"anticoncepcion, prevencion de its y de cancer de cuello uterino",metodos naturales: usuarias nuevas,2015-02-01,0,0,1,1,0,2
SAN ANDRES,"anticoncepcion, prevencion de its y de cancer de cuello uterino",metodos naturales: usuarias nuevas,2015-02-01,0,1,5,1,0,7
SAN ANDRES DE MACHACA,"anticoncepcion, prevencion de its y de cancer de cuello uterino",metodos naturales: usuarias nuevas,2015-02-01,0,2,1,0,0,3
SAN ANTONIO DE LOMERIO,"anticoncepcion, prevencion de its y de cancer de cuello uterino",metodos naturales: usuarias nuevas,2015-02-01,0,3,5,0,0,8
SAN BENITO,"anticoncepcion, prevencion de its y de cancer de cuello uterino",metodos naturales: usuarias nuevas,2015-02-01,0,2,2,0,0,4
SAN BORJA,"anticoncepcion, prevencion de its y de cancer de cuello uterino",metodos naturales: usuarias nuevas,2015-02-01,2,7,12,2,0,23
SAN BUENA VENTURA,"anticoncepcion, prevencion de its y de cancer de cuello uterino",metodos naturales: usuarias nuevas,2015-02-01,0,5,6,1,0,12
SAN CARLOS,"anticoncepcion, prevencion de its y de cancer de cuello uterino",metodos naturales: usuarias nuevas,2015-02-01,2,4,5,1,0,12
SAN IGNACIO,"anticoncepcion, prevencion de its y de cancer de cuello uterino",metodos naturales: usuarias nuevas,2015-02-01,0,1,2,0,0,3
SAN JAVIER(BNI),"anticoncepcion, prevencion de its y de cancer de cuello uterino",metodos naturales: usuarias nuevas,2015-02-01,0,1,0,0,0,1
SAN LORENZO(PND),"anticoncepcion, prevencion de its y de cancer de cuello uterino",metodos naturales: usuarias nuevas,2015-02-01,0,0,0,6,0,6
SAN LUCAS,"anticoncepcion, prevencion de its y de cancer de cuello uterino",metodos naturales: usuarias nuevas,2015-02-01,0,0,1,0,0,1
SAN MIGUEL DE VELASCO,"anticoncepcion, prevencion de its y de cancer de cuello uterino",metodos naturales: usuarias nuevas,2015-02-01,1,1,0,0,0,2
SAN PEDRO DE BUENA VISTA,"anticoncepcion, prevencion de its y de cancer de cuello uterino",metodos naturales: usuarias nuevas,2015-02-01,0,0,9,4,0,13
SAN PEDRO DE TIQUINA,"anticoncepcion, prevencion de its y de cancer de cuello uterino",metodos naturales: usuarias nuevas,2015-02-01,0,1,6,1,0,8
SAN RAFAEL,"anticoncepcion, prevencion de its y de cancer de cuello uterino",metodos naturales: usuarias nuevas,2015-02-01,0,1,2,0,0,3
SANTA ANA,"anticoncepcion, prevencion de its y de cancer de cuello uterino",metodos naturales: usuarias nuevas,2015-02-01,3,32,44,6,0,85
SANTA CRUZ DE LA SIERRA,"anticoncepcion, prevencion de its y de cancer de cuello uterino",metodos naturales: usuarias nuevas,2015-02-01,1,7,29,5,0,42
SANTA ROSA,"anticoncepcion, prevencion de its y de cancer de cuello uterino",metodos naturales: usuarias nuevas,2015-02-01,1,3,2,0,0,6
SANTA ROSA DEL SARA,"anticoncepcion, prevencion de its y de cancer de cuello uterino",metodos naturales: usuarias nuevas,2015-02-01,0,0,5,0,0,5
SANTIAGO DE HUARI,"anticoncepcion, prevencion de its y de cancer de cuello uterino",metodos naturales: usuarias nuevas,2015-02-01,0,1,6,1,0,8
SANTIAGO DE HUATA,"anticoncepcion, prevencion de its y de cancer de cuello uterino",metodos naturales: usuarias nuevas,2015-02-01,0,3,4,1,0,8
SANTIAGO DE MACHACA,"anticoncepcion, prevencion de its y de cancer de cuello uterino",metodos naturales: usuarias nuevas,2015-02-01,0,2,1,0,0,3
SANTUARIO DE QUILLACAS,"anticoncepcion, prevencion de its y de cancer de cuello uterino",metodos naturales: usuarias nuevas,2015-02-01,0,1,0,0,0,1
SAPAHAQUI,"anticoncepcion, prevencion de its y de cancer de cuello uterino",metodos naturales: usuarias nuevas,2015-02-01,0,1,3,0,0,4
SENA,"anticoncepcion, prevencion de its y de cancer de cuello uterino",metodos naturales: usuarias nuevas,2015-02-01,0,2,2,0,0,4
SHINAOTA,"anticoncepcion, prevencion de its y de cancer de cuello uterino",metodos naturales: usuarias nuevas,2015-02-01,0,0,1,1,0,2
SICA SICA (VILLA AROMA),"anticoncepcion, prevencion de its y de cancer de cuello uterino",metodos naturales: usuarias nuevas,2015-02-01,0,1,0,0,0,1
SOPACHUY,"anticoncepcion, prevencion de its y de cancer de cuello uterino",metodos naturales: usuarias nuevas,2015-02-01,0,1,2,2,0,5
SORACACHI,"anticoncepcion, prevencion de its y de cancer de cuello uterino",metodos naturales: usuarias nuevas,2015-02-01,0,1,1,1,0,3
SUCRE,"anticoncepcion, prevencion de its y de cancer de cuello uterino",metodos naturales: usuarias nuevas,2015-02-01,0,18,101,3,1,123
TACOPAYA,"anticoncepcion, prevencion de its y de cancer de cuello uterino",metodos naturales: usuarias nuevas,2015-02-01,0,2,2,2,0,6
TAPACARI,"anticoncepcion, prevencion de its y de cancer de cuello uterino",metodos naturales: usuarias nuevas,2015-02-01,0,3,7,3,0,13
TARIJA,"anticoncepcion, prevencion de its y de cancer de cuello uterino",metodos naturales: usuarias nuevas,2015-02-01,0,0,6,5,0,11
TARVITA,"anticoncepcion, prevencion de its y de cancer de cuello uterino",metodos naturales: usuarias nuevas,2015-02-01,0,1,5,1,0,7
TIAWANACU,"anticoncepcion, prevencion de its y de cancer de cuello uterino",metodos naturales: usuarias nuevas,2015-02-01,0,0,5,1,0,6
TINGUIPAYA,"anticoncepcion, prevencion de its y de cancer de cuello uterino",metodos naturales: usuarias nuevas,2015-02-01,2,0,2,0,0,4
TIRAQUE (CBBA),"anticoncepcion, prevencion de its y de cancer de cuello uterino",metodos naturales: usuarias nuevas,2015-02-01,0,1,0,0,0,1
TOCO,"anticoncepcion, prevencion de its y de cancer de cuello uterino",metodos naturales: usuarias nuevas,2015-02-01,0,0,1,0,0,1
TOLATA,"anticoncepcion, prevencion de its y de cancer de cuello uterino",metodos naturales: usuarias nuevas,2015-02-01,0,0,1,1,0,2
TOLEDO,"anticoncepcion, prevencion de its y de cancer de cuello uterino",metodos naturales: usuarias nuevas,2015-02-01,0,1,1,1,0,3
TOMAVE,"anticoncepcion, prevencion de its y de cancer de cuello uterino",metodos naturales: usuarias nuevas,2015-02-01,0,2,0,0,0,2
TOMINA,"anticoncepcion, prevencion de its y de cancer de cuello uterino",metodos naturales: usuarias nuevas,2015-02-01,0,1,4,0,0,5
TORO TORO,"anticoncepcion, prevencion de its y de cancer de cuello uterino",metodos naturales: usuarias nuevas,2015-02-01,0,0,1,1,0,2
TOTORA(CBBA),"anticoncepcion, prevencion de its y de cancer de cuello uterino",metodos naturales: usuarias nuevas,2015-02-01,0,0,0,1,0,1
TOTORA(ORR),"anticoncepcion, prevencion de its y de cancer de cuello uterino",metodos naturales: usuarias nuevas,2015-02-01,0,1,0,0,0,1
TRINIDAD,"anticoncepcion, prevencion de its y de cancer de cuello uterino",metodos naturales: usuarias nuevas,2015-02-01,0,9,36,2,0,47
TUPIZA,"anticoncepcion, prevencion de its y de cancer de cuello uterino",metodos naturales: usuarias nuevas,2015-02-01,0,0,4,0,0,4
UNCIA,"anticoncepcion, prevencion de its y de cancer de cuello uterino",metodos naturales: usuarias nuevas,2015-02-01,0,1,4,0,0,5
VACAS,"anticoncepcion, prevencion de its y de cancer de cuello uterino",metodos naturales: usuarias nuevas,2015-02-01,0,4,5,0,0,9
VIACHA,"anticoncepcion, prevencion de its y de cancer de cuello uterino",metodos naturales: usuarias nuevas,2015-02-01,0,1,5,2,0,8
VILLA CHARCAS,"anticoncepcion, prevencion de its y de cancer de cuello uterino",metodos naturales: usuarias nuevas,2015-02-01,0,6,7,6,0,19
VILLA RIVERO,"anticoncepcion, prevencion de its y de cancer de cuello uterino",metodos naturales: usuarias nuevas,2015-02-01,0,1,6,0,0,7
VILLA SERRANO,"anticoncepcion, prevencion de its y de cancer de cuello uterino",metodos naturales: usuarias nuevas,2015-02-01,0,1,3,0,0,4
VILLA TUNARI,"anticoncepcion, prevencion de its y de cancer de cuello uterino",metodos naturales: usuarias nuevas,2015-02-01,0,0,1,0,0,1
VILLA VACA GUZMAN (MUYUPAMPA),"anticoncepcion, prevencion de its y de cancer de cuello uterino",metodos naturales: usuarias nuevas,2015-02-01,0,0,5,1,0,6
VILLAZON,"anticoncepcion, prevencion de its y de cancer de cuello uterino",metodos naturales: usuarias nuevas,2015-02-01,0,9,18,7,0,34
VINTO,"anticoncepcion, prevencion de its y de cancer de cuello uterino",metodos naturales: usuarias nuevas,2015-02-01,0,0,2,0,0,2
VITICHI,"anticoncepcion, prevencion de its y de cancer de cuello uterino",metodos naturales: usuarias nuevas,2015-02-01,0,1,1,0,0,2
WARNES,"anticoncepcion, prevencion de its y de cancer de cuello uterino",metodos naturales: usuarias nuevas,2015-02-01,0,2,11,0,0,13
YACUIBA,"anticoncepcion, prevencion de its y de cancer de cuello uterino",metodos naturales: usuarias nuevas,2015-02-01,0,1,5,1,0,7
YANACACHI,"anticoncepcion, prevencion de its y de cancer de cuello uterino",metodos naturales: usuarias nuevas,2015-02-01,0,1,1,1,0,3
YAPACANI,"anticoncepcion, prevencion de its y de cancer de cuello uterino",metodos naturales: usuarias nuevas,2015-02-01,0,1,3,0,0,4
YOCALLA,"anticoncepcion, prevencion de its y de cancer de cuello uterino",metodos naturales: usuarias nuevas,2015-02-01,0,0,5,0,0,5
YOTALA,"anticoncepcion, prevencion de its y de cancer de cuello uterino",metodos naturales: usuarias nuevas,2015-02-01,0,2,5,1,0,8
YUNCHARA,"anticoncepcion, prevencion de its y de cancer de cuello uterino",metodos naturales: usuarias nuevas,2015-02-01,0,0,1,0,0,1
ZUDAÑEZ,"anticoncepcion, prevencion de its y de cancer de cuello uterino",metodos naturales: usuarias nuevas,2015-02-01,0,0,0,1,0,1
ACACIO,"anticoncepcion, prevencion de its y de cancer de cuello uterino",metodos naturales: usuarias nuevas,2015-03-01,0,2,0,1,0,3
ACHACACHI,"anticoncepcion, prevencion de its y de cancer de cuello uterino",metodos naturales: usuarias nuevas,2015-03-01,0,4,10,3,1,18
AIQUILE,"anticoncepcion, prevencion de its y de cancer de cuello uterino",metodos naturales: usuarias nuevas,2015-03-01,0,0,7,3,0,10
ALALAY,"anticoncepcion, prevencion de its y de cancer de cuello uterino",metodos naturales: usuarias nuevas,2015-03-01,0,0,0,1,0,1
ALCALA,"anticoncepcion, prevencion de its y de cancer de cuello uterino",metodos naturales: usuarias nuevas,2015-03-01,0,1,1,0,0,2
ANCORAIMES,"anticoncepcion, prevencion de its y de cancer de cuello uterino",metodos naturales: usuarias nuevas,2015-03-01,0,4,6,6,0,16
ANDAMARCA,"anticoncepcion, prevencion de its y de cancer de cuello uterino",metodos naturales: usuarias nuevas,2015-03-01,0,0,1,1,0,2
ANZALDO,"anticoncepcion, prevencion de its y de cancer de cuello uterino",metodos naturales: usuarias nuevas,2015-03-01,0,0,2,0,0,2
APOLO,"anticoncepcion, prevencion de its y de cancer de cuello uterino",metodos naturales: usuarias nuevas,2015-03-01,0,1,3,1,0,5
ARAMPAMPA,"anticoncepcion, prevencion de its y de cancer de cuello uterino",metodos naturales: usuarias nuevas,2015-03-01,0,0,2,0,0,2
ARBIETO,"anticoncepcion, prevencion de its y de cancer de cuello uterino",metodos naturales: usuarias nuevas,2015-03-01,0,6,11,3,0,20
ARQUE,"anticoncepcion, prevencion de its y de cancer de cuello uterino",metodos naturales: usuarias nuevas,2015-03-01,0,0,3,0,0,3
ATOCHA,"anticoncepcion, prevencion de its y de cancer de cuello uterino",metodos naturales: usuarias nuevas,2015-03-01,0,0,1,0,0,1
AZURDUY,"anticoncepcion, prevencion de its y de cancer de cuello uterino",metodos naturales: usuarias nuevas,2015-03-01,0,1,0,1,0,2
BATALLAS,"anticoncepcion, prevencion de its y de cancer de cuello uterino",metodos naturales: usuarias nuevas,2015-03-01,0,0,1,1,0,2
BAURES,"anticoncepcion, prevencion de its y de cancer de cuello uterino",metodos naturales: usuarias nuevas,2015-03-01,0,0,1,0,0,1
BELEN DE ANDAMARCA,"anticoncepcion, prevencion de its y de cancer de cuello uterino",metodos naturales: usuarias nuevas,2015-03-01,0,0,2,0,0,2
BELEN DE URMIRI,"anticoncepcion, prevencion de its y de cancer de cuello uterino",metodos naturales: usuarias nuevas,2015-03-01,0,0,11,7,0,18
BELLA FLOR,"anticoncepcion, prevencion de its y de cancer de cuello uterino",metodos naturales: usuarias nuevas,2015-03-01,0,0,4,0,0,4
BETANZOS,"anticoncepcion, prevencion de its y de cancer de cuello uterino",metodos naturales: usuarias nuevas,2015-03-01,0,3,0,2,0,5
BUENA VISTA,"anticoncepcion, prevencion de its y de cancer de cuello uterino",metodos naturales: usuarias nuevas,2015-03-01,0,0,2,0,0,2
"CAIZA ""D""","anticoncepcion, prevencion de its y de cancer de cuello uterino",metodos naturales: usuarias nuevas,2015-03-01,0,1,2,1,0,4
CAJUATA,"anticoncepcion, prevencion de its y de cancer de cuello uterino",metodos naturales: usuarias nuevas,2015-03-01,0,3,7,0,0,10
CALAMARCA,"anticoncepcion, prevencion de its y de cancer de cuello uterino",metodos naturales: usuarias nuevas,2015-03-01,0,0,0,1,0,1
CAMARGO,"anticoncepcion, prevencion de its y de cancer de cuello uterino",metodos naturales: usuarias nuevas,2015-03-01,0,2,1,2,0,5
CAMIRI,"anticoncepcion, prevencion de its y de cancer de cuello uterino",metodos naturales: usuarias nuevas,2015-03-01,0,0,3,0,0,3
CARACOLLO,"anticoncepcion, prevencion de its y de cancer de cuello uterino",metodos naturales: usuarias nuevas,2015-03-01,0,0,18,5,0,23
CARANAVI,"anticoncepcion, prevencion de its y de cancer de cuello uterino",metodos naturales: usuarias nuevas,2015-03-01,0,1,6,0,0,7
CARIPUYO,"anticoncepcion, prevencion de its y de cancer de cuello uterino",metodos naturales: usuarias nuevas,2015-03-01,0,1,0,1,0,2
CHALLAPATA,"anticoncepcion, prevencion de its y de cancer de cuello uterino",metodos naturales: usuarias nuevas,2015-03-01,0,6,11,5,9,31
CHAQUI,"anticoncepcion, prevencion de its y de cancer de cuello uterino",metodos naturales: usuarias nuevas,2015-03-01,0,2,4,1,0,7
CHAYANTA,"anticoncepcion, prevencion de its y de cancer de cuello uterino",metodos naturales: usuarias nuevas,2015-03-01,1,5,12,3,0,21
CHIMORE,"anticoncepcion, prevencion de its y de cancer de cuello uterino",metodos naturales: usuarias nuevas,2015-03-01,0,0,1,0,0,1
CHIPAYA,"anticoncepcion, prevencion de its y de cancer de cuello uterino",metodos naturales: usuarias nuevas,2015-03-01,0,0,2,1,0,3
CHUA COCANI,"anticoncepcion, prevencion de its y de cancer de cuello uterino",metodos naturales: usuarias nuevas,2015-03-01,0,1,1,0,0,2
CHULUMANI (V. DE LA LIBERTAD),"anticoncepcion, prevencion de its y de cancer de cuello uterino",metodos naturales: usuarias nuevas,2015-03-01,0,3,13,2,0,18
CKOCHAS,"anticoncepcion, prevencion de its y de cancer de cuello uterino",metodos naturales: usuarias nuevas,2015-03-01,0,1,5,2,0,8
COBIJA,"anticoncepcion, prevencion de its y de cancer de cuello uterino",metodos naturales: usuarias nuevas,2015-03-01,0,0,4,0,0,4
COCAPATA,"anticoncepcion, prevencion de its y de cancer de cuello uterino",metodos naturales: usuarias nuevas,2015-03-01,0,0,2,1,0,3
COCHABAMBA,"anticoncepcion, prevencion de its y de cancer de cuello uterino",metodos naturales: usuarias nuevas,2015-03-01,8,70,237,42,0,357
"COLCHA ""K""","anticoncepcion, prevencion de its y de cancer de cuello uterino",metodos naturales: usuarias nuevas,2015-03-01,0,1,3,0,0,4
COLLANA,"anticoncepcion, prevencion de its y de cancer de cuello uterino",metodos naturales: usuarias nuevas,2015-03-01,0,2,0,0,0,2
COLOMI,"anticoncepcion, prevencion de its y de cancer de cuello uterino",metodos naturales: usuarias nuevas,2015-03-01,0,2,6,0,0,8
COLPA BELGICA,"anticoncepcion, prevencion de its y de cancer de cuello uterino",metodos naturales: usuarias nuevas,2015-03-01,0,1,9,0,0,10
COLQUECHACA,"anticoncepcion, prevencion de its y de cancer de cuello uterino",metodos naturales: usuarias nuevas,2015-03-01,0,3,6,0,0,9
COLQUIRI,"anticoncepcion, prevencion de its y de cancer de cuello uterino",metodos naturales: usuarias nuevas,2015-03-01,0,4,8,3,0,15
COMANCHE,"anticoncepcion, prevencion de its y de cancer de cuello uterino",metodos naturales: usuarias nuevas,2015-03-01,0,1,0,0,0,1
COMARAPA,"anticoncepcion, prevencion de its y de cancer de cuello uterino",metodos naturales: usuarias nuevas,2015-03-01,0,8,17,3,0,28
CORIPATA,"anticoncepcion, prevencion de its y de cancer de cuello uterino",metodos naturales: usuarias nuevas,2015-03-01,0,4,9,0,0,13
COROICO,"anticoncepcion, prevencion de its y de cancer de cuello uterino",metodos naturales: usuarias nuevas,2015-03-01,0,0,1,0,0,1
CORQUE,"anticoncepcion, prevencion de its y de cancer de cuello uterino",metodos naturales: usuarias nuevas,2015-03-01,0,1,4,0,0,5
COTAGAITA,"anticoncepcion, prevencion de its y de cancer de cuello uterino",metodos naturales: usuarias nuevas,2015-03-01,0,1,0,1,0,2
COTOCA,"anticoncepcion, prevencion de its y de cancer de cuello uterino",metodos naturales: usuarias nuevas,2015-03-01,0,3,1,3,0,7
CRUZ DE MACHACAMARCA,"anticoncepcion, prevencion de its y de cancer de cuello uterino",metodos naturales: usuarias nuevas,2015-03-01,0,0,0,1,0,1
CUCHUMUELA (V. G. VILLARROEL),"anticoncepcion, prevencion de its y de cancer de cuello uterino",metodos naturales: usuarias nuevas,2015-03-01,0,0,2,0,0,2
CURAHUARA DE CARANGAS,"anticoncepcion, prevencion de its y de cancer de cuello uterino",metodos naturales: usuarias nuevas,2015-03-01,0,4,2,0,0,6
EL ALTO,"anticoncepcion, prevencion de its y de cancer de cuello uterino",metodos naturales: usuarias nuevas,2015-03-01,0,33,190,172,0,395
EL CHORO,"anticoncepcion, prevencion de its y de cancer de cuello uterino",metodos naturales: usuarias nuevas,2015-03-01,0,1,3,1,0,5
EL TORNO,"anticoncepcion, prevencion de its y de cancer de cuello uterino",metodos naturales: usuarias nuevas,2015-03-01,0,0,8,4,0,12
EL VILLAR,"anticoncepcion, prevencion de its y de cancer de cuello uterino",metodos naturales: usuarias nuevas,2015-03-01,0,1,0,0,0,1
ENTRE RIOS TRJ,"anticoncepcion, prevencion de its y de cancer de cuello uterino",metodos naturales: usuarias nuevas,2015-03-01,0,13,15,1,0,29
ENTRE RIOS CBBA,"anticoncepcion, prevencion de its y de cancer de cuello uterino",metodos naturales: usuarias nuevas,2015-03-01,0,4,4,0,0,8
EUCALIPTUS,"anticoncepcion, prevencion de its y de cancer de cuello uterino",metodos naturales: usuarias nuevas,2015-03-01,0,0,2,0,0,2
EXALTACION,"anticoncepcion, prevencion de its y de cancer de cuello uterino",metodos naturales: usuarias nuevas,2015-03-01,0,1,0,0,0,1
FILADELFIA,"anticoncepcion, prevencion de its y de cancer de cuello uterino",metodos naturales: usuarias nuevas,2015-03-01,0,1,0,0,0,1
GUAQUI,"anticoncepcion, prevencion de its y de cancer de cuello uterino",metodos naturales: usuarias nuevas,2015-03-01,0,1,2,0,0,3
GUAYARAMERIN,"anticoncepcion, prevencion de its y de cancer de cuello uterino",metodos naturales: usuarias nuevas,2015-03-01,1,23,31,6,0,61
HUACHACALLA,"anticoncepcion, prevencion de its y de cancer de cuello uterino",metodos naturales: usuarias nuevas,2015-03-01,0,0,1,0,0,1
HUARINA,"anticoncepcion, prevencion de its y de cancer de cuello uterino",metodos naturales: usuarias nuevas,2015-03-01,0,0,1,0,0,1
HUAYLLAMARCA,"anticoncepcion, prevencion de its y de cancer de cuello uterino",metodos naturales: usuarias nuevas,2015-03-01,0,1,2,1,0,4
ICHOCA,"anticoncepcion, prevencion de its y de cancer de cuello uterino",metodos naturales: usuarias nuevas,2015-03-01,0,2,2,0,0,4
INCAHUASI,"anticoncepcion, prevencion de its y de cancer de cuello uterino",metodos naturales: usuarias nuevas,2015-03-01,0,2,5,3,0,10
INQUISIVI,"anticoncepcion, prevencion de its y de cancer de cuello uterino",metodos naturales: usuarias nuevas,2015-03-01,0,2,4,0,0,6
IRUPANA (VILLA DE LANZA),"anticoncepcion, prevencion de its y de cancer de cuello uterino",metodos naturales: usuarias nuevas,2015-03-01,0,2,11,0,0,13
JESUS DE MACHACA,"anticoncepcion, prevencion de its y de cancer de cuello uterino",metodos naturales: usuarias nuevas,2015-03-01,0,3,8,4,0,15
LA ASUNTA,"anticoncepcion, prevencion de its y de cancer de cuello uterino",metodos naturales: usuarias nuevas,2015-03-01,0,2,6,0,0,8
LA GUARDIA,"anticoncepcion, prevencion de its y de cancer de cuello uterino",metodos naturales: usuarias nuevas,2015-03-01,0,0,0,1,0,1
LA PAZ,"anticoncepcion, prevencion de its y de cancer de cuello uterino",metodos naturales: usuarias nuevas,2015-03-01,3,63,220,43,1,330
LAGUNILLAS,"anticoncepcion, prevencion de its y de cancer de cuello uterino",metodos naturales: usuarias nuevas,2015-03-01,0,1,2,0,0,3
LAJA,"anticoncepcion, prevencion de its y de cancer de cuello uterino",metodos naturales: usuarias nuevas,2015-03-01,0,4,3,1,0,8
LAS CARRERAS,"anticoncepcion, prevencion de its y de cancer de cuello uterino",metodos naturales: usuarias nuevas,2015-03-01,0,0,0,1,0,1
LLALLAGUA,"anticoncepcion, prevencion de its y de cancer de cuello uterino",metodos naturales: usuarias nuevas,2015-03-01,0,7,10,0,0,17
LORETO,"anticoncepcion, prevencion de its y de cancer de cuello uterino",metodos naturales: usuarias nuevas,2015-03-01,0,2,0,0,0,2
MACHACAMARCA,"anticoncepcion, prevencion de its y de cancer de cuello uterino",metodos naturales: usuarias nuevas,2015-03-01,0,1,0,1,0,2
MAGDALENA,"anticoncepcion, prevencion de its y de cancer de cuello uterino",metodos naturales: usuarias nuevas,2015-03-01,0,4,3,1,0,8
MAPIRI,"anticoncepcion, prevencion de its y de cancer de cuello uterino",metodos naturales: usuarias nuevas,2015-03-01,0,6,7,1,0,14
MINEROS,"anticoncepcion, prevencion de its y de cancer de cuello uterino",metodos naturales: usuarias nuevas,2015-03-01,0,0,2,0,0,2
MOCOMOCO,"anticoncepcion, prevencion de its y de cancer de cuello uterino",metodos naturales: usuarias nuevas,2015-03-01,1,2,2,0,0,5
MOJINETE,"anticoncepcion, prevencion de its y de cancer de cuello uterino",metodos naturales: usuarias nuevas,2015-03-01,0,0,1,0,0,1
MOJOCOYA,"anticoncepcion, prevencion de its y de cancer de cuello uterino",metodos naturales: usuarias nuevas,2015-03-01,0,2,4,1,0,7
MONTERO,"anticoncepcion, prevencion de its y de cancer de cuello uterino",metodos naturales: usuarias nuevas,2015-03-01,0,0,1,0,0,1
MOROCHATA,"anticoncepcion, prevencion de its y de cancer de cuello uterino",metodos naturales: usuarias nuevas,2015-03-01,0,0,3,4,0,7
NUEVO MANOA (NUEVA ESPERANZA),"anticoncepcion, prevencion de its y de cancer de cuello uterino",metodos naturales: usuarias nuevas,2015-03-01,0,0,6,0,0,6
OCURI,"anticoncepcion, prevencion de its y de cancer de cuello uterino",metodos naturales: usuarias nuevas,2015-03-01,0,3,4,0,0,7
OMEREQUE,"anticoncepcion, prevencion de its y de cancer de cuello uterino",metodos naturales: usuarias nuevas,2015-03-01,0,0,1,0,0,1
ORURO,"anticoncepcion, prevencion de its y de cancer de cuello uterino",metodos naturales: usuarias nuevas,2015-03-01,0,8,48,11,0,67
PADILLA,"anticoncepcion, prevencion de its y de cancer de cuello uterino",metodos naturales: usuarias nuevas,2015-03-01,0,2,6,4,0,12
PALCA,"anticoncepcion, prevencion de its y de cancer de cuello uterino",metodos naturales: usuarias nuevas,2015-03-01,0,2,7,1,0,10
PALOS BLANCOS,"anticoncepcion, prevencion de its y de cancer de cuello uterino",metodos naturales: usuarias nuevas,2015-03-01,0,0,1,0,0,1
POCOATA,"anticoncepcion, prevencion de its y de cancer de cuello uterino",metodos naturales: usuarias nuevas,2015-03-01,0,3,15,6,0,24
POCONA,"anticoncepcion, prevencion de its y de cancer de cuello uterino",metodos naturales: usuarias nuevas,2015-03-01,0,1,2,0,0,3
POJO (CBBA),"anticoncepcion, prevencion de its y de cancer de cuello uterino",metodos naturales: usuarias nuevas,2015-03-01,0,1,1,0,0,2
PORCO,"anticoncepcion, prevencion de its y de cancer de cuello uterino",metodos naturales: usuarias nuevas,2015-03-01,0,2,3,2,0,7
PORONGO,"anticoncepcion, prevencion de its y de cancer de cuello uterino",metodos naturales: usuarias nuevas,2015-03-01,12,7,3,2,0,24
PORTACHUELO,"anticoncepcion, prevencion de its y de cancer de cuello uterino",metodos naturales: usuarias nuevas,2015-03-01,0,2,3,0,0,5
POTOSI,"anticoncepcion, prevencion de its y de cancer de cuello uterino",metodos naturales: usuarias nuevas,2015-03-01,5,34,57,8,0,104
PRESTO,"anticoncepcion, prevencion de its y de cancer de cuello uterino",metodos naturales: usuarias nuevas,2015-03-01,0,2,3,2,0,7
PUCARANI,"anticoncepcion, prevencion de its y de cancer de cuello uterino",metodos naturales: usuarias nuevas,2015-03-01,0,4,16,0,0,20
PUERTO ACOSTA,"anticoncepcion, prevencion de its y de cancer de cuello uterino",metodos naturales: usuarias nuevas,2015-03-01,0,0,1,1,0,2
PUERTO CARABUCO,"anticoncepcion, prevencion de its y de cancer de cuello uterino",metodos naturales: usuarias nuevas,2015-03-01,0,1,0,1,0,2
PUERTO GONZALO MORENO,"anticoncepcion, prevencion de its y de cancer de cuello uterino",metodos naturales: usuarias nuevas,2015-03-01,0,4,3,1,0,8
PUERTO PEREZ,"anticoncepcion, prevencion de its y de cancer de cuello uterino",metodos naturales: usuarias nuevas,2015-03-01,0,1,1,0,0,2
PUERTO QUIJARRO,"anticoncepcion, prevencion de its y de cancer de cuello uterino",metodos naturales: usuarias nuevas,2015-03-01,0,3,20,6,0,29
PUERTO RICO,"anticoncepcion, prevencion de its y de cancer de cuello uterino",metodos naturales: usuarias nuevas,2015-03-01,0,1,1,0,0,2
PUERTO VILLARROEL,"anticoncepcion, prevencion de its y de cancer de cuello uterino",metodos naturales: usuarias nuevas,2015-03-01,0,2,15,4,0,21
PUNA,"anticoncepcion, prevencion de its y de cancer de cuello uterino",metodos naturales: usuarias nuevas,2015-03-01,1,3,2,0,0,6
PUNATA,"anticoncepcion, prevencion de its y de cancer de cuello uterino",metodos naturales: usuarias nuevas,2015-03-01,0,0,2,1,0,3
QUILLACOLLO,"anticoncepcion, prevencion de its y de cancer de cuello uterino",metodos naturales: usuarias nuevas,2015-03-01,0,10,27,2,0,39
QUIME,"anticoncepcion, prevencion de its y de cancer de cuello uterino",metodos naturales: usuarias nuevas,2015-03-01,0,2,8,0,0,10
RAVELO,"anticoncepcion, prevencion de its y de cancer de cuello uterino",metodos naturales: usuarias nuevas,2015-03-01,0,0,3,0,0,3
REYES,"anticoncepcion, prevencion de its y de cancer de cuello uterino",metodos naturales: usuarias nuevas,2015-03-01,5,21,33,2,0,61
RIBERALTA,"anticoncepcion, prevencion de its y de cancer de cuello uterino",metodos naturales: usuarias nuevas,2015-03-01,0,65,237,36,0,338
RURRENABAQUE,"anticoncepcion, prevencion de its y de cancer de cuello uterino",metodos naturales: usuarias nuevas,2015-03-01,0,0,1,0,0,1
SABAYA,"anticoncepcion, prevencion de its y de cancer de cuello uterino",metodos naturales: usuarias nuevas,2015-03-01,0,0,1,1,0,2
SACABA,"anticoncepcion, prevencion de its y de cancer de cuello uterino",metodos naturales: usuarias nuevas,2015-03-01,0,6,19,9,0,34
SACABAMBA,"anticoncepcion, prevencion de its y de cancer de cuello uterino",metodos naturales: usuarias nuevas,2015-03-01,0,0,0,1,0,1
SACACA,"anticoncepcion, prevencion de its y de cancer de cuello uterino",metodos naturales: usuarias nuevas,2015-03-01,0,0,5,1,0,6
SALINAS DE GARCI MENDOZA,"anticoncepcion, prevencion de its y de cancer de cuello uterino",metodos naturales: usuarias nuevas,2015-03-01,1,2,3,2,0,8
SAMAIPATA,"anticoncepcion, prevencion de its y de cancer de cuello uterino",metodos naturales: usuarias nuevas,2015-03-01,0,1,2,0,0,3
SAN ANDRES DE MACHACA,"anticoncepcion, prevencion de its y de cancer de cuello uterino",metodos naturales: usuarias nuevas,2015-03-01,0,0,4,2,0,6
SAN ANTONIO DE LOMERIO,"anticoncepcion, prevencion de its y de cancer de cuello uterino",metodos naturales: usuarias nuevas,2015-03-01,0,3,6,0,0,9
SAN BENITO,"anticoncepcion, prevencion de its y de cancer de cuello uterino",metodos naturales: usuarias nuevas,2015-03-01,0,0,3,0,0,3
SAN BORJA,"anticoncepcion, prevencion de its y de cancer de cuello uterino",metodos naturales: usuarias nuevas,2015-03-01,2,17,17,0,0,36
SAN BUENA VENTURA,"anticoncepcion, prevencion de its y de cancer de cuello uterino",metodos naturales: usuarias nuevas,2015-03-01,1,2,6,5,0,14
SAN CARLOS,"anticoncepcion, prevencion de its y de cancer de cuello uterino",metodos naturales: usuarias nuevas,2015-03-01,1,16,24,4,0,45
SAN IGNACIO,"anticoncepcion, prevencion de its y de cancer de cuello uterino",metodos naturales: usuarias nuevas,2015-03-01,0,1,2,1,0,4
SAN JAVIER(BNI),"anticoncepcion, prevencion de its y de cancer de cuello uterino",metodos naturales: usuarias nuevas,2015-03-01,0,1,3,0,0,4
SAN JUAN DE YAPACANI,"anticoncepcion, prevencion de its y de cancer de cuello uterino",metodos naturales: usuarias nuevas,2015-03-01,0,1,4,2,0,7
SAN JULIAN,"anticoncepcion, prevencion de its y de cancer de cuello uterino",metodos naturales: usuarias nuevas,2015-03-01,0,1,1,0,0,2
SAN LORENZO(TJA),"anticoncepcion, prevencion de its y de cancer de cuello uterino",metodos naturales: usuarias nuevas,2015-03-01,0,0,1,0,0,1
SAN LUCAS,"anticoncepcion, prevencion de its y de cancer de cuello uterino",metodos naturales: usuarias nuevas,2015-03-01,0,4,5,0,0,9
SAN MIGUEL DE VELASCO,"anticoncepcion, prevencion de its y de cancer de cuello uterino",metodos naturales: usuarias nuevas,2015-03-01,0,5,1,1,0,7
SAN PEDRO,"anticoncepcion, prevencion de its y de cancer de cuello uterino",metodos naturales: usuarias nuevas,2015-03-01,0,1,0,0,0,1
SAN PEDRO DE BUENA VISTA,"anticoncepcion, prevencion de its y de cancer de cuello uterino",metodos naturales: usuarias nuevas,2015-03-01,0,1,15,4,0,20
SAN PEDRO DE TIQUINA,"anticoncepcion, prevencion de its y de cancer de cuello uterino",metodos naturales: usuarias nuevas,2015-03-01,0,1,0,0,0,1
SAN RAFAEL,"anticoncepcion, prevencion de its y de cancer de cuello uterino",metodos naturales: usuarias nuevas,2015-03-01,0,2,4,1,0,7
SANTA ANA,"anticoncepcion, prevencion de its y de cancer de cuello uterino",metodos naturales: usuarias nuevas,2015-03-01,3,28,49,3,1,84
SANTA CRUZ DE LA SIERRA,"anticoncepcion, prevencion de its y de cancer de cuello uterino",metodos naturales: usuarias nuevas,2015-03-01,0,38,48,5,1,92
SANTA ROSA,"anticoncepcion, prevencion de its y de cancer de cuello uterino",metodos naturales: usuarias nuevas,2015-03-01,0,2,0,0,0,2
SANTA ROSA DEL SARA,"anticoncepcion, prevencion de its y de cancer de cuello uterino",metodos naturales: usuarias nuevas,2015-03-01,0,3,2,0,0,5
SANTIAGO DE HUARI,"anticoncepcion, prevencion de its y de cancer de cuello uterino",metodos naturales: usuarias nuevas,2015-03-01,0,1,6,1,0,8
SANTIAGO DE HUATA,"anticoncepcion, prevencion de its y de cancer de cuello uterino",metodos naturales: usuarias nuevas,2015-03-01,0,2,3,1,0,6
SANTIAGO DE MACHACA,"anticoncepcion, prevencion de its y de cancer de cuello uterino",metodos naturales: usuarias nuevas,2015-03-01,0,2,1,1,0,4
SANTUARIO DE QUILLACAS,"anticoncepcion, prevencion de its y de cancer de cuello uterino",metodos naturales: usuarias nuevas,2015-03-01,0,1,0,1,0,2
SAPAHAQUI,"anticoncepcion, prevencion de its y de cancer de cuello uterino",metodos naturales: usuarias nuevas,2015-03-01,0,0,1,0,0,1
SENA,"anticoncepcion, prevencion de its y de cancer de cuello uterino",metodos naturales: usuarias nuevas,2015-03-01,0,5,1,0,0,6
SHINAOTA,"anticoncepcion, prevencion de its y de cancer de cuello uterino",metodos naturales: usuarias nuevas,2015-03-01,0,0,1,1,0,2
SICA SICA (VILLA AROMA),"anticoncepcion, prevencion de its y de cancer de cuello uterino",metodos naturales: usuarias nuevas,2015-03-01,0,2,4,0,0,6
SIPE SIPE,"anticoncepcion, prevencion de its y de cancer de cuello uterino",metodos naturales: usuarias nuevas,2015-03-01,0,0,1,0,0,1
SOPACHUY,"anticoncepcion, prevencion de its y de cancer de cuello uterino",metodos naturales: usuarias nuevas,2015-03-01,0,2,7,0,0,9
SORACACHI,"anticoncepcion, prevencion de its y de cancer de cuello uterino",metodos naturales: usuarias nuevas,2015-03-01,0,2,5,1,0,8
SUCRE,"anticoncepcion, prevencion de its y de cancer de cuello uterino",metodos naturales: usuarias nuevas,2015-03-01,0,40,125,22,0,187
TACOPAYA,"anticoncepcion, prevencion de its y de cancer de cuello uterino",metodos naturales: usuarias nuevas,2015-03-01,0,0,1,6,0,7
TAHUA,"anticoncepcion, prevencion de its y de cancer de cuello uterino",metodos naturales: usuarias nuevas,2015-03-01,0,0,2,0,0,2
TAPACARI,"anticoncepcion, prevencion de its y de cancer de cuello uterino",metodos naturales: usuarias nuevas,2015-03-01,0,1,2,0,0,3
TARABUCO,"anticoncepcion, prevencion de its y de cancer de cuello uterino",metodos naturales: usuarias nuevas,2015-03-01,0,1,2,0,0,3
TARATA,"anticoncepcion, prevencion de its y de cancer de cuello uterino",metodos naturales: usuarias nuevas,2015-03-01,0,0,1,0,0,1
TARIJA,"anticoncepcion, prevencion de its y de cancer de cuello uterino",metodos naturales: usuarias nuevas,2015-03-01,0,0,7,4,0,11
TARVITA,"anticoncepcion, prevencion de its y de cancer de cuello uterino",metodos naturales: usuarias nuevas,2015-03-01,0,3,10,2,0,15
TEOPONTE,"anticoncepcion, prevencion de its y de cancer de cuello uterino",metodos naturales: usuarias nuevas,2015-03-01,0,5,21,1,0,27
TIAWANACU,"anticoncepcion, prevencion de its y de cancer de cuello uterino",metodos naturales: usuarias nuevas,2015-03-01,0,0,3,2,0,5
TIQUIPAYA,"anticoncepcion, prevencion de its y de cancer de cuello uterino",metodos naturales: usuarias nuevas,2015-03-01,0,0,0,1,0,1
TIRAQUE (CBBA),"anticoncepcion, prevencion de its y de cancer de cuello uterino",metodos naturales: usuarias nuevas,2015-03-01,0,4,5,0,0,9
TITO YUPANQUI (PARQUIPUJIO),"anticoncepcion, prevencion de its y de cancer de cuello uterino",metodos naturales: usuarias nuevas,2015-03-01,0,0,0,1,0,1
TOCO,"anticoncepcion, prevencion de its y de cancer de cuello uterino",metodos naturales: usuarias nuevas,2015-03-01,0,0,1,0,0,1
TOLATA,"anticoncepcion, prevencion de its y de cancer de cuello uterino",metodos naturales: usuarias nuevas,2015-03-01,0,0,3,2,0,5
TOLEDO,"anticoncepcion, prevencion de its y de cancer de cuello uterino",metodos naturales: usuarias nuevas,2015-03-01,0,1,2,0,0,3
TOMINA,"anticoncepcion, prevencion de its y de cancer de cuello uterino",metodos naturales: usuarias nuevas,2015-03-01,1,2,2,0,0,5
TOTORA(CBBA),"anticoncepcion, prevencion de its y de cancer de cuello uterino",metodos naturales: usuarias nuevas,2015-03-01,0,1,5,1,0,7
TOTORA(ORR),"anticoncepcion, prevencion de its y de cancer de cuello uterino",metodos naturales: usuarias nuevas,2015-03-01,0,2,3,1,0,6
TRINIDAD,"anticoncepcion, prevencion de its y de cancer de cuello uterino",metodos naturales: usuarias nuevas,2015-03-01,1,44,54,7,0,106
TUPIZA,"anticoncepcion, prevencion de its y de cancer de cuello uterino",metodos naturales: usuarias nuevas,2015-03-01,0,1,0,0,0,1
UNCIA,"anticoncepcion, prevencion de its y de cancer de cuello uterino",metodos naturales: usuarias nuevas,2015-03-01,0,0,2,0,0,2
VACAS,"anticoncepcion, prevencion de its y de cancer de cuello uterino",metodos naturales: usuarias nuevas,2015-03-01,0,4,8,2,0,14
VIACHA,"anticoncepcion, prevencion de its y de cancer de cuello uterino",metodos naturales: usuarias nuevas,2015-03-01,0,0,15,0,0,15
VILLA CHARCAS,"anticoncepcion, prevencion de its y de cancer de cuello uterino",metodos naturales: usuarias nuevas,2015-03-01,0,3,2,3,0,8
VILLA RIVERO,"anticoncepcion, prevencion de its y de cancer de cuello uterino",metodos naturales: usuarias nuevas,2015-03-01,0,1,3,0,0,4
VILLA SERRANO,"anticoncepcion, prevencion de its y de cancer de cuello uterino",metodos naturales: usuarias nuevas,2015-03-01,0,1,6,1,0,8
VILLAZON,"anticoncepcion, prevencion de its y de cancer de cuello uterino",metodos naturales: usuarias nuevas,2015-03-01,0,6,12,0,0,18
VITICHI,"anticoncepcion, prevencion de its y de cancer de cuello uterino",metodos naturales: usuarias nuevas,2015-03-01,0,2,2,2,0,6
WARNES,"anticoncepcion, prevencion de its y de cancer de cuello uterino",metodos naturales: usuarias nuevas,2015-03-01,0,3,25,1,0,29
YACUIBA,"anticoncepcion, prevencion de its y de cancer de cuello uterino",metodos naturales: usuarias nuevas,2015-03-01,0,0,17,3,0,20
YANACACHI,"anticoncepcion, prevencion de its y de cancer de cuello uterino",metodos naturales: usuarias nuevas,2015-03-01,0,1,5,0,0,6
YAPACANI,"anticoncepcion, prevencion de its y de cancer de cuello uterino",metodos naturales: usuarias nuevas,2015-03-01,0,0,12,1,0,13
YOCALLA,"anticoncepcion, prevencion de its y de cancer de cuello uterino",metodos naturales: usuarias nuevas,2015-03-01,0,1,4,0,0,5
YOTALA,"anticoncepcion, prevencion de its y de cancer de cuello uterino",metodos naturales: usuarias nuevas,2015-03-01,0,5,6,2,0,13
ZUDAÑEZ,"anticoncepcion, prevencion de its y de cancer de cuello uterino",metodos naturales: usuarias nuevas,2015-03-01,0,5,0,2,0,7
ACACIO,"anticoncepcion, prevencion de its y de cancer de cuello uterino",metodos naturales: usuarias nuevas,2015-04-01,0,0,1,0,0,1
ALALAY,"anticoncepcion, prevencion de its y de cancer de cuello uterino",metodos naturales: usuarias nuevas,2015-04-01,0,1,0,0,0,1
ALCALA,"anticoncepcion, prevencion de its y de cancer de cuello uterino",metodos naturales: usuarias nuevas,2015-04-01,0,0,1,0,0,1
ANCORAIMES,"anticoncepcion, prevencion de its y de cancer de cuello uterino",metodos naturales: usuarias nuevas,2015-04-01,0,0,11,1,0,12
ANDAMARCA,"anticoncepcion, prevencion de its y de cancer de cuello uterino",metodos naturales: usuarias nuevas,2015-04-01,0,2,1,0,0,3
ANTEQUERA,"anticoncepcion, prevencion de its y de cancer de cuello uterino",metodos naturales: usuarias nuevas,2015-04-01,0,1,0,0,0,1
ANZALDO,"anticoncepcion, prevencion de its y de cancer de cuello uterino",metodos naturales: usuarias nuevas,2015-04-01,0,1,4,0,0,5
APOLO,"anticoncepcion, prevencion de its y de cancer de cuello uterino",metodos naturales: usuarias nuevas,2015-04-01,0,1,0,1,0,2
ARBIETO,"anticoncepcion, prevencion de its y de cancer de cuello uterino",metodos naturales: usuarias nuevas,2015-04-01,0,2,6,1,0,9
ARQUE,"anticoncepcion, prevencion de its y de cancer de cuello uterino",metodos naturales: usuarias nuevas,2015-04-01,0,0,1,1,0,2
ATOCHA,"anticoncepcion, prevencion de its y de cancer de cuello uterino",metodos naturales: usuarias nuevas,2015-04-01,0,0,1,0,0,1
BATALLAS,"anticoncepcion, prevencion de its y de cancer de cuello uterino",metodos naturales: usuarias nuevas,2015-04-01,1,1,5,1,0,8
BELEN DE ANDAMARCA,"anticoncepcion, prevencion de its y de cancer de cuello uterino",metodos naturales: usuarias nuevas,2015-04-01,0,0,1,1,0,2
BETANZOS,"anticoncepcion, prevencion de its y de cancer de cuello uterino",metodos naturales: usuarias nuevas,2015-04-01,0,4,5,3,0,12
BUENA VISTA,"anticoncepcion, prevencion de its y de cancer de cuello uterino",metodos naturales: usuarias nuevas,2015-04-01,0,0,4,0,0,4
"CAIZA ""D""","anticoncepcion, prevencion de its y de cancer de cuello uterino",metodos naturales: usuarias nuevas,2015-04-01,0,0,4,0,0,4
CAJUATA,"anticoncepcion, prevencion de its y de cancer de cuello uterino",metodos naturales: usuarias nuevas,2015-04-01,0,1,8,4,0,13
CALAMARCA,"anticoncepcion, prevencion de its y de cancer de cuello uterino",metodos naturales: usuarias nuevas,2015-04-01,0,1,7,2,0,10
CAMARGO,"anticoncepcion, prevencion de its y de cancer de cuello uterino",metodos naturales: usuarias nuevas,2015-04-01,1,3,7,2,0,13
CAMATAQUI (C. VILLA ABECIA),"anticoncepcion, prevencion de its y de cancer de cuello uterino",metodos naturales: usuarias nuevas,2015-04-01,0,0,2,0,0,2
CAMIRI,"anticoncepcion, prevencion de its y de cancer de cuello uterino",metodos naturales: usuarias nuevas,2015-04-01,0,1,0,0,0,1
CARACOLLO,"anticoncepcion, prevencion de its y de cancer de cuello uterino",metodos naturales: usuarias nuevas,2015-04-01,0,4,11,1,0,16
CARANAVI,"anticoncepcion, prevencion de its y de cancer de cuello uterino",metodos naturales: usuarias nuevas,2015-04-01,0,1,3,1,0,5
CARIPUYO,"anticoncepcion, prevencion de its y de cancer de cuello uterino",metodos naturales: usuarias nuevas,2015-04-01,0,0,5,0,0,5
CHALLAPATA,"anticoncepcion, prevencion de its y de cancer de cuello uterino",metodos naturales: usuarias nuevas,2015-04-01,0,5,14,30,0,49
CHAQUI,"anticoncepcion, prevencion de its y de cancer de cuello uterino",metodos naturales: usuarias nuevas,2015-04-01,0,1,6,0,0,7
CHAYANTA,"anticoncepcion, prevencion de its y de cancer de cuello uterino",metodos naturales: usuarias nuevas,2015-04-01,0,9,14,4,0,27
CHIMORE,"anticoncepcion, prevencion de its y de cancer de cuello uterino",metodos naturales: usuarias nuevas,2015-04-01,0,0,0,1,0,1
CHIPAYA,"anticoncepcion, prevencion de its y de cancer de cuello uterino",metodos naturales: usuarias nuevas,2015-04-01,0,0,0,2,0,2
CHUA COCANI,"anticoncepcion, prevencion de its y de cancer de cuello uterino",metodos naturales: usuarias nuevas,2015-04-01,0,1,1,2,0,4
CHULUMANI (V. DE LA LIBERTAD),"anticoncepcion, prevencion de its y de cancer de cuello uterino",metodos naturales: usuarias nuevas,2015-04-01,0,3,10,3,0,16
CKOCHAS,"anticoncepcion, prevencion de its y de cancer de cuello uterino",metodos naturales: usuarias nuevas,2015-04-01,0,7,16,1,0,24
CLIZA,"anticoncepcion, prevencion de its y de cancer de cuello uterino",metodos naturales: usuarias nuevas,2015-04-01,0,0,1,0,0,1
COBIJA,"anticoncepcion, prevencion de its y de cancer de cuello uterino",metodos naturales: usuarias nuevas,2015-04-01,1,2,14,5,0,22
COCAPATA,"anticoncepcion, prevencion de its y de cancer de cuello uterino",metodos naturales: usuarias nuevas,2015-04-01,0,0,3,0,0,3
COCHABAMBA,"anticoncepcion, prevencion de its y de cancer de cuello uterino",metodos naturales: usuarias nuevas,2015-04-01,9,34,105,20,2,170
COLCAPIRHUA,"anticoncepcion, prevencion de its y de cancer de cuello uterino",metodos naturales: usuarias nuevas,2015-04-01,0,0,0,1,0,1
COLLANA,"anticoncepcion, prevencion de its y de cancer de cuello uterino",metodos naturales: usuarias nuevas,2015-04-01,0,0,2,2,0,4
COLOMI,"anticoncepcion, prevencion de its y de cancer de cuello uterino",metodos naturales: usuarias nuevas,2015-04-01,0,4,9,0,0,13
COLPA BELGICA,"anticoncepcion, prevencion de its y de cancer de cuello uterino",metodos naturales: usuarias nuevas,2015-04-01,0,0,3,0,0,3
COLQUECHACA,"anticoncepcion, prevencion de its y de cancer de cuello uterino",metodos naturales: usuarias nuevas,2015-04-01,0,1,3,2,0,6
COLQUIRI,"anticoncepcion, prevencion de its y de cancer de cuello uterino",metodos naturales: usuarias nuevas,2015-04-01,0,4,4,4,0,12
COMANCHE,"anticoncepcion, prevencion de its y de cancer de cuello uterino",metodos naturales: usuarias nuevas,2015-04-01,0,0,2,0,0,2
COMARAPA,"anticoncepcion, prevencion de its y de cancer de cuello uterino",metodos naturales: usuarias nuevas,2015-04-01,0,9,22,3,0,34
CORIPATA,"anticoncepcion, prevencion de its y de cancer de cuello uterino",metodos naturales: usuarias nuevas,2015-04-01,0,1,4,0,0,5
COROICO,"anticoncepcion, prevencion de its y de cancer de cuello uterino",metodos naturales: usuarias nuevas,2015-04-01,0,1,1,0,0,2
CORQUE,"anticoncepcion, prevencion de its y de cancer de cuello uterino",metodos naturales: usuarias nuevas,2015-04-01,0,1,1,1,0,3
COTAGAITA,"anticoncepcion, prevencion de its y de cancer de cuello uterino",metodos naturales: usuarias nuevas,2015-04-01,0,1,0,0,0,1
COTOCA,"anticoncepcion, prevencion de its y de cancer de cuello uterino",metodos naturales: usuarias nuevas,2015-04-01,0,0,2,0,0,2
CULPINA,"anticoncepcion, prevencion de its y de cancer de cuello uterino",metodos naturales: usuarias nuevas,2015-04-01,0,1,5,3,0,9
CURAHUARA DE CARANGAS,"anticoncepcion, prevencion de its y de cancer de cuello uterino",metodos naturales: usuarias nuevas,2015-04-01,0,1,0,0,0,1
DESAGUADERO,"anticoncepcion, prevencion de its y de cancer de cuello uterino",metodos naturales: usuarias nuevas,2015-04-01,0,0,4,0,0,4
EL ALTO,"anticoncepcion, prevencion de its y de cancer de cuello uterino",metodos naturales: usuarias nuevas,2015-04-01,0,41,185,121,1,348
EL CHORO,"anticoncepcion, prevencion de its y de cancer de cuello uterino",metodos naturales: usuarias nuevas,2015-04-01,0,1,3,2,0,6
EL PUENTE(STC),"anticoncepcion, prevencion de its y de cancer de cuello uterino",metodos naturales: usuarias nuevas,2015-04-01,0,0,7,0,0,7
EL VILLAR,"anticoncepcion, prevencion de its y de cancer de cuello uterino",metodos naturales: usuarias nuevas,2015-04-01,0,1,1,0,0,2
ENTRE RIOS TRJ,"anticoncepcion, prevencion de its y de cancer de cuello uterino",metodos naturales: usuarias nuevas,2015-04-01,0,2,15,3,0,20
ENTRE RIOS CBBA,"anticoncepcion, prevencion de its y de cancer de cuello uterino",metodos naturales: usuarias nuevas,2015-04-01,0,0,1,0,0,1
EUCALIPTUS,"anticoncepcion, prevencion de its y de cancer de cuello uterino",metodos naturales: usuarias nuevas,2015-04-01,0,1,4,0,0,5
EXALTACION,"anticoncepcion, prevencion de its y de cancer de cuello uterino",metodos naturales: usuarias nuevas,2015-04-01,0,0,0,1,0,1
FERNANDEZ ALONSO,"anticoncepcion, prevencion de its y de cancer de cuello uterino",metodos naturales: usuarias nuevas,2015-04-01,0,0,1,0,0,1
FILADELFIA,"anticoncepcion, prevencion de its y de cancer de cuello uterino",metodos naturales: usuarias nuevas,2015-04-01,1,1,2,0,0,4
GUAQUI,"anticoncepcion, prevencion de its y de cancer de cuello uterino",metodos naturales: usuarias nuevas,2015-04-01,0,1,6,3,0,10
GUAYARAMERIN,"anticoncepcion, prevencion de its y de cancer de cuello uterino",metodos naturales: usuarias nuevas,2015-04-01,1,33,69,9,1,113
HUACARETA,"anticoncepcion, prevencion de its y de cancer de cuello uterino",metodos naturales: usuarias nuevas,2015-04-01,0,2,0,0,0,2
HUACAYA (VILLA DE HUACAYA),"anticoncepcion, prevencion de its y de cancer de cuello uterino",metodos naturales: usuarias nuevas,2015-04-01,0,0,4,1,0,5
HUANUNI,"anticoncepcion, prevencion de its y de cancer de cuello uterino",metodos naturales: usuarias nuevas,2015-04-01,0,0,10,4,0,14
HUATAJATA,"anticoncepcion, prevencion de its y de cancer de cuello uterino",metodos naturales: usuarias nuevas,2015-04-01,0,1,0,0,0,1
HUAYLLAMARCA,"anticoncepcion, prevencion de its y de cancer de cuello uterino",metodos naturales: usuarias nuevas,2015-04-01,0,1,5,0,0,6
HUMANATA,"anticoncepcion, prevencion de its y de cancer de cuello uterino",metodos naturales: usuarias nuevas,2015-04-01,0,1,2,0,0,3
ICHOCA,"anticoncepcion, prevencion de its y de cancer de cuello uterino",metodos naturales: usuarias nuevas,2015-04-01,0,1,3,1,0,5
ICLA,"anticoncepcion, prevencion de its y de cancer de cuello uterino",metodos naturales: usuarias nuevas,2015-04-01,0,2,4,1,0,7
INCAHUASI,"anticoncepcion, prevencion de its y de cancer de cuello uterino",metodos naturales: usuarias nuevas,2015-04-01,1,4,9,4,0,18
INGAVI (HUMAITA),"anticoncepcion, prevencion de its y de cancer de cuello uterino",metodos naturales: usuarias nuevas,2015-04-01,0,1,2,0,0,3
INQUISIVI,"anticoncepcion, prevencion de its y de cancer de cuello uterino",metodos naturales: usuarias nuevas,2015-04-01,0,1,5,1,0,7
IRUPANA (VILLA DE LANZA),"anticoncepcion, prevencion de its y de cancer de cuello uterino",metodos naturales: usuarias nuevas,2015-04-01,0,0,7,0,0,7
IXIAMAS,"anticoncepcion, prevencion de its y de cancer de cuello uterino",metodos naturales: usuarias nuevas,2015-04-01,1,3,7,0,0,11
JESUS DE MACHACA,"anticoncepcion, prevencion de its y de cancer de cuello uterino",metodos naturales: usuarias nuevas,2015-04-01,0,0,2,0,0,2
LA ASUNTA,"anticoncepcion, prevencion de its y de cancer de cuello uterino",metodos naturales: usuarias nuevas,2015-04-01,0,0,6,1,0,7
LA GUARDIA,"anticoncepcion, prevencion de its y de cancer de cuello uterino",metodos naturales: usuarias nuevas,2015-04-01,0,0,2,0,0,2
LA PAZ,"anticoncepcion, prevencion de its y de cancer de cuello uterino",metodos naturales: usuarias nuevas,2015-04-01,1,62,342,67,0,472
LAGUNILLAS,"anticoncepcion, prevencion de its y de cancer de cuello uterino",metodos naturales: usuarias nuevas,2015-04-01,0,2,3,0,0,5
LAJA,"anticoncepcion, prevencion de its y de cancer de cuello uterino",metodos naturales: usuarias nuevas,2015-04-01,0,5,1,4,0,10
LAS CARRERAS,"anticoncepcion, prevencion de its y de cancer de cuello uterino",metodos naturales: usuarias nuevas,2015-04-01,0,1,0,0,0,1
LICOMA PAMPA,"anticoncepcion, prevencion de its y de cancer de cuello uterino",metodos naturales: usuarias nuevas,2015-04-01,0,1,2,0,0,3
LLALLAGUA,"anticoncepcion, prevencion de its y de cancer de cuello uterino",metodos naturales: usuarias nuevas,2015-04-01,0,3,7,0,0,10
LORETO,"anticoncepcion, prevencion de its y de cancer de cuello uterino",metodos naturales: usuarias nuevas,2015-04-01,1,2,2,1,0,6
MACHACAMARCA,"anticoncepcion, prevencion de its y de cancer de cuello uterino",metodos naturales: usuarias nuevas,2015-04-01,0,0,2,1,0,3
MACHARETI,"anticoncepcion, prevencion de its y de cancer de cuello uterino",metodos naturales: usuarias nuevas,2015-04-01,0,0,1,0,0,1
MAGDALENA,"anticoncepcion, prevencion de its y de cancer de cuello uterino",metodos naturales: usuarias nuevas,2015-04-01,0,2,3,2,0,7
MALLA,"anticoncepcion, prevencion de its y de cancer de cuello uterino",metodos naturales: usuarias nuevas,2015-04-01,0,0,1,0,0,1
MAPIRI,"anticoncepcion, prevencion de its y de cancer de cuello uterino",metodos naturales: usuarias nuevas,2015-04-01,0,2,14,1,0,17
MECAPACA,"anticoncepcion, prevencion de its y de cancer de cuello uterino",metodos naturales: usuarias nuevas,2015-04-01,0,0,2,0,0,2
MINEROS,"anticoncepcion, prevencion de its y de cancer de cuello uterino",metodos naturales: usuarias nuevas,2015-04-01,0,0,1,0,0,1
MOCOMOCO,"anticoncepcion, prevencion de its y de cancer de cuello uterino",metodos naturales: usuarias nuevas,2015-04-01,0,1,3,2,0,6
MOJINETE,"anticoncepcion, prevencion de its y de cancer de cuello uterino",metodos naturales: usuarias nuevas,2015-04-01,0,1,0,0,0,1
MOJOCOYA,"anticoncepcion, prevencion de its y de cancer de cuello uterino",metodos naturales: usuarias nuevas,2015-04-01,0,3,7,0,0,10
MONTERO,"anticoncepcion, prevencion de its y de cancer de cuello uterino",metodos naturales: usuarias nuevas,2015-04-01,0,0,1,1,0,2
MOROCHATA,"anticoncepcion, prevencion de its y de cancer de cuello uterino",metodos naturales: usuarias nuevas,2015-04-01,0,1,1,2,0,4
NUEVO MANOA (NUEVA ESPERANZA),"anticoncepcion, prevencion de its y de cancer de cuello uterino",metodos naturales: usuarias nuevas,2015-04-01,0,1,3,1,0,5
OCURI,"anticoncepcion, prevencion de its y de cancer de cuello uterino",metodos naturales: usuarias nuevas,2015-04-01,0,6,4,1,0,11
OMEREQUE,"anticoncepcion, prevencion de its y de cancer de cuello uterino",metodos naturales: usuarias nuevas,2015-04-01,0,0,0,2,0,2
ORURO,"anticoncepcion, prevencion de its y de cancer de cuello uterino",metodos naturales: usuarias nuevas,2015-04-01,0,16,75,31,0,122
PADILLA,"anticoncepcion, prevencion de its y de cancer de cuello uterino",metodos naturales: usuarias nuevas,2015-04-01,1,5,6,2,0,14
PALCA,"anticoncepcion, prevencion de its y de cancer de cuello uterino",metodos naturales: usuarias nuevas,2015-04-01,0,0,1,0,0,1
PAMPA AULLAGAS,"anticoncepcion, prevencion de its y de cancer de cuello uterino",metodos naturales: usuarias nuevas,2015-04-01,0,3,5,1,0,9
PAZÑA,"anticoncepcion, prevencion de its y de cancer de cuello uterino",metodos naturales: usuarias nuevas,2015-04-01,0,3,2,1,0,6
PELECHUCO,"anticoncepcion, prevencion de its y de cancer de cuello uterino",metodos naturales: usuarias nuevas,2015-04-01,0,0,1,0,0,1
POCOATA,"anticoncepcion, prevencion de its y de cancer de cuello uterino",metodos naturales: usuarias nuevas,2015-04-01,0,5,13,7,0,25
POJO (CBBA),"anticoncepcion, prevencion de its y de cancer de cuello uterino",metodos naturales: usuarias nuevas,2015-04-01,0,1,5,1,0,7
POOPO,"anticoncepcion, prevencion de its y de cancer de cuello uterino",metodos naturales: usuarias nuevas,2015-04-01,1,0,0,0,0,1
PORCO,"anticoncepcion, prevencion de its y de cancer de cuello uterino",metodos naturales: usuarias nuevas,2015-04-01,0,1,6,0,0,7
POROMA,"anticoncepcion, prevencion de its y de cancer de cuello uterino",metodos naturales: usuarias nuevas,2015-04-01,0,2,3,1,0,6
PORONGO,"anticoncepcion, prevencion de its y de cancer de cuello uterino",metodos naturales: usuarias nuevas,2015-04-01,2,9,8,0,0,19
PORTACHUELO,"anticoncepcion, prevencion de its y de cancer de cuello uterino",metodos naturales: usuarias nuevas,2015-04-01,0,8,4,0,0,12
POTOSI,"anticoncepcion, prevencion de its y de cancer de cuello uterino",metodos naturales: usuarias nuevas,2015-04-01,1,20,167,18,0,206
PRESTO,"anticoncepcion, prevencion de its y de cancer de cuello uterino",metodos naturales: usuarias nuevas,2015-04-01,0,1,2,2,0,5
PUCARANI,"anticoncepcion, prevencion de its y de cancer de cuello uterino",metodos naturales: usuarias nuevas,2015-04-01,0,5,6,0,0,11
PUERTO ACOSTA,"anticoncepcion, prevencion de its y de cancer de cuello uterino",metodos naturales: usuarias nuevas,2015-04-01,0,0,1,0,0,1
PUERTO CARABUCO,"anticoncepcion, prevencion de its y de cancer de cuello uterino",metodos naturales: usuarias nuevas,2015-04-01,0,0,3,1,0,4
PUERTO GONZALO MORENO,"anticoncepcion, prevencion de its y de cancer de cuello uterino",metodos naturales: usuarias nuevas,2015-04-01,2,4,6,3,0,15
PUERTO PEREZ,"anticoncepcion, prevencion de its y de cancer de cuello uterino",metodos naturales: usuarias nuevas,2015-04-01,0,2,2,1,0,5
PUERTO QUIJARRO,"anticoncepcion, prevencion de its y de cancer de cuello uterino",metodos naturales: usuarias nuevas,2015-04-01,0,10,12,20,0,42
PUERTO RICO,"anticoncepcion, prevencion de its y de cancer de cuello uterino",metodos naturales: usuarias nuevas,2015-04-01,0,11,0,0,0,11
PUERTO VILLARROEL,"anticoncepcion, prevencion de its y de cancer de cuello uterino",metodos naturales: usuarias nuevas,2015-04-01,1,2,8,2,0,13
PUNA,"anticoncepcion, prevencion de its y de cancer de cuello uterino",metodos naturales: usuarias nuevas,2015-04-01,0,1,3,0,0,4
PUNATA,"anticoncepcion, prevencion de its y de cancer de cuello uterino",metodos naturales: usuarias nuevas,2015-04-01,0,0,8,2,0,10
QUILLACOLLO,"anticoncepcion, prevencion de its y de cancer de cuello uterino",metodos naturales: usuarias nuevas,2015-04-01,0,0,7,0,0,7
QUIME,"anticoncepcion, prevencion de its y de cancer de cuello uterino",metodos naturales: usuarias nuevas,2015-04-01,0,3,6,2,0,11
RAVELO,"anticoncepcion, prevencion de its y de cancer de cuello uterino",metodos naturales: usuarias nuevas,2015-04-01,0,2,6,3,0,11
REYES,"anticoncepcion, prevencion de its y de cancer de cuello uterino",metodos naturales: usuarias nuevas,2015-04-01,0,11,46,10,0,67
RIBERALTA,"anticoncepcion, prevencion de its y de cancer de cuello uterino",metodos naturales: usuarias nuevas,2015-04-01,2,33,95,26,0,156
RURRENABAQUE,"anticoncepcion, prevencion de its y de cancer de cuello uterino",metodos naturales: usuarias nuevas,2015-04-01,0,1,5,0,0,6
SABAYA,"anticoncepcion, prevencion de its y de cancer de cuello uterino",metodos naturales: usuarias nuevas,2015-04-01,0,0,1,0,0,1
SACABA,"anticoncepcion, prevencion de its y de cancer de cuello uterino",metodos naturales: usuarias nuevas,2015-04-01,0,4,43,16,0,63
SACACA,"anticoncepcion, prevencion de its y de cancer de cuello uterino",metodos naturales: usuarias nuevas,2015-04-01,0,1,2,0,0,3
SAIPINA,"anticoncepcion, prevencion de its y de cancer de cuello uterino",metodos naturales: usuarias nuevas,2015-04-01,0,0,1,0,0,1
SALINAS DE GARCI MENDOZA,"anticoncepcion, prevencion de its y de cancer de cuello uterino",metodos naturales: usuarias nuevas,2015-04-01,0,1,10,3,0,14
SAMAIPATA,"anticoncepcion, prevencion de its y de cancer de cuello uterino",metodos naturales: usuarias nuevas,2015-04-01,0,1,0,0,0,1
SAN ANDRES,"anticoncepcion, prevencion de its y de cancer de cuello uterino",metodos naturales: usuarias nuevas,2015-04-01,0,2,5,0,0,7
SAN ANDRES DE MACHACA,"anticoncepcion, prevencion de its y de cancer de cuello uterino",metodos naturales: usuarias nuevas,2015-04-01,0,1,2,0,0,3
SAN ANTONIO DE LOMERIO,"anticoncepcion, prevencion de its y de cancer de cuello uterino",metodos naturales: usuarias nuevas,2015-04-01,0,2,5,1,0,8
SAN BENITO,"anticoncepcion, prevencion de its y de cancer de cuello uterino",metodos naturales: usuarias nuevas,2015-04-01,0,0,1,0,0,1
SAN BORJA,"anticoncepcion, prevencion de its y de cancer de cuello uterino",metodos naturales: usuarias nuevas,2015-04-01,2,10,8,2,0,22
SAN BUENA VENTURA,"anticoncepcion, prevencion de its y de cancer de cuello uterino",metodos naturales: usuarias nuevas,2015-04-01,0,8,7,1,0,16
SAN CARLOS,"anticoncepcion, prevencion de its y de cancer de cuello uterino",metodos naturales: usuarias nuevas,2015-04-01,3,5,20,3,0,31
SAN IGNACIO,"anticoncepcion, prevencion de its y de cancer de cuello uterino",metodos naturales: usuarias nuevas,2015-04-01,0,6,4,1,0,11
SAN JAVIER(BNI),"anticoncepcion, prevencion de its y de cancer de cuello uterino",metodos naturales: usuarias nuevas,2015-04-01,1,1,3,0,0,5
SAN JOSE DE CHIQUITOS,"anticoncepcion, prevencion de its y de cancer de cuello uterino",metodos naturales: usuarias nuevas,2015-04-01,0,1,0,0,0,1
SAN JUAN DE YAPACANI,"anticoncepcion, prevencion de its y de cancer de cuello uterino",metodos naturales: usuarias nuevas,2015-04-01,0,1,4,0,0,5
SAN JULIAN,"anticoncepcion, prevencion de its y de cancer de cuello uterino",metodos naturales: usuarias nuevas,2015-04-01,2,10,2,4,0,18
SAN LORENZO(PND),"anticoncepcion, prevencion de its y de cancer de cuello uterino",metodos naturales: usuarias nuevas,2015-04-01,0,1,0,0,0,1
SAN LUCAS,"anticoncepcion, prevencion de its y de cancer de cuello uterino",metodos naturales: usuarias nuevas,2015-04-01,0,4,6,3,0,13
SAN MIGUEL DE VELASCO,"anticoncepcion, prevencion de its y de cancer de cuello uterino",metodos naturales: usuarias nuevas,2015-04-01,0,1,3,1,0,5
SAN PEDRO DE BUENA VISTA,"anticoncepcion, prevencion de its y de cancer de cuello uterino",metodos naturales: usuarias nuevas,2015-04-01,0,0,1,0,0,1
SAN PEDRO DE TIQUINA,"anticoncepcion, prevencion de its y de cancer de cuello uterino",metodos naturales: usuarias nuevas,2015-04-01,0,1,2,0,0,3
SAN RAFAEL,"anticoncepcion, prevencion de its y de cancer de cuello uterino",metodos naturales: usuarias nuevas,2015-04-01,0,0,3,0,0,3
SAN RAMON BENI,"anticoncepcion, prevencion de its y de cancer de cuello uterino",metodos naturales: usuarias nuevas,2015-04-01,0,0,2,0,0,2
SANTA ANA,"anticoncepcion, prevencion de its y de cancer de cuello uterino",metodos naturales: usuarias nuevas,2015-04-01,2,23,46,9,0,80
SANTA CRUZ DE LA SIERRA,"anticoncepcion, prevencion de its y de cancer de cuello uterino",metodos naturales: usuarias nuevas,2015-04-01,0,7,28,22,1,58
SANTIAGO DE HUARI,"anticoncepcion, prevencion de its y de cancer de cuello uterino",metodos naturales: usuarias nuevas,2015-04-01,0,6,4,4,0,14
SANTIAGO DE MACHACA,"anticoncepcion, prevencion de its y de cancer de cuello uterino",metodos naturales: usuarias nuevas,2015-04-01,0,0,2,0,0,2
SANTUARIO DE QUILLACAS,"anticoncepcion, prevencion de its y de cancer de cuello uterino",metodos naturales: usuarias nuevas,2015-04-01,0,1,2,0,0,3
SAPAHAQUI,"anticoncepcion, prevencion de its y de cancer de cuello uterino",metodos naturales: usuarias nuevas,2015-04-01,0,1,2,0,0,3
SENA,"anticoncepcion, prevencion de its y de cancer de cuello uterino",metodos naturales: usuarias nuevas,2015-04-01,0,3,4,0,0,7
SHINAOTA,"anticoncepcion, prevencion de its y de cancer de cuello uterino",metodos naturales: usuarias nuevas,2015-04-01,0,0,2,0,0,2
SICA SICA (VILLA AROMA),"anticoncepcion, prevencion de its y de cancer de cuello uterino",metodos naturales: usuarias nuevas,2015-04-01,0,2,2,0,0,4
SIPE SIPE,"anticoncepcion, prevencion de its y de cancer de cuello uterino",metodos naturales: usuarias nuevas,2015-04-01,0,8,25,6,0,39
SOPACHUY,"anticoncepcion, prevencion de its y de cancer de cuello uterino",metodos naturales: usuarias nuevas,2015-04-01,0,1,5,0,0,6
SORACACHI,"anticoncepcion, prevencion de its y de cancer de cuello uterino",metodos naturales: usuarias nuevas,2015-04-01,0,0,3,1,0,4
SUCRE,"anticoncepcion, prevencion de its y de cancer de cuello uterino",metodos naturales: usuarias nuevas,2015-04-01,1,30,189,11,0,231
TACOPAYA,"anticoncepcion, prevencion de its y de cancer de cuello uterino",metodos naturales: usuarias nuevas,2015-04-01,0,4,5,4,0,13
TAPACARI,"anticoncepcion, prevencion de its y de cancer de cuello uterino",metodos naturales: usuarias nuevas,2015-04-01,1,1,3,3,0,8
TARACO,"anticoncepcion, prevencion de its y de cancer de cuello uterino",metodos naturales: usuarias nuevas,2015-04-01,0,1,4,0,0,5
TARATA,"anticoncepcion, prevencion de its y de cancer de cuello uterino",metodos naturales: usuarias nuevas,2015-04-01,0,5,4,3,0,12
TARIJA,"anticoncepcion, prevencion de its y de cancer de cuello uterino",metodos naturales: usuarias nuevas,2015-04-01,0,0,8,5,0,13
TARVITA,"anticoncepcion, prevencion de its y de cancer de cuello uterino",metodos naturales: usuarias nuevas,2015-04-01,0,0,1,0,0,1
TEOPONTE,"anticoncepcion, prevencion de its y de cancer de cuello uterino",metodos naturales: usuarias nuevas,2015-04-01,0,2,6,0,0,8
TIAWANACU,"anticoncepcion, prevencion de its y de cancer de cuello uterino",metodos naturales: usuarias nuevas,2015-04-01,0,4,4,0,0,8
TIPUANI,"anticoncepcion, prevencion de its y de cancer de cuello uterino",metodos naturales: usuarias nuevas,2015-04-01,0,2,0,0,0,2
TIQUIPAYA,"anticoncepcion, prevencion de its y de cancer de cuello uterino",metodos naturales: usuarias nuevas,2015-04-01,0,1,6,6,1,14
TIRAQUE (CBBA),"anticoncepcion, prevencion de its y de cancer de cuello uterino",metodos naturales: usuarias nuevas,2015-04-01,0,1,5,3,0,9
TITO YUPANQUI (PARQUIPUJIO),"anticoncepcion, prevencion de its y de cancer de cuello uterino",metodos naturales: usuarias nuevas,2015-04-01,0,0,1,0,0,1
TOLEDO,"anticoncepcion, prevencion de its y de cancer de cuello uterino",metodos naturales: usuarias nuevas,2015-04-01,0,2,3,1,0,6
TOMAVE,"anticoncepcion, prevencion de its y de cancer de cuello uterino",metodos naturales: usuarias nuevas,2015-04-01,0,0,2,1,0,3
TOMINA,"anticoncepcion, prevencion de its y de cancer de cuello uterino",metodos naturales: usuarias nuevas,2015-04-01,0,1,2,1,0,4
TOTORA(CBBA),"anticoncepcion, prevencion de its y de cancer de cuello uterino",metodos naturales: usuarias nuevas,2015-04-01,0,1,2,3,0,6
TOTORA(ORR),"anticoncepcion, prevencion de its y de cancer de cuello uterino",metodos naturales: usuarias nuevas,2015-04-01,0,0,4,0,0,4
TRINIDAD,"anticoncepcion, prevencion de its y de cancer de cuello uterino",metodos naturales: usuarias nuevas,2015-04-01,0,15,35,4,0,54
TUPIZA,"anticoncepcion, prevencion de its y de cancer de cuello uterino",metodos naturales: usuarias nuevas,2015-04-01,0,0,4,0,0,4
TURCO,"anticoncepcion, prevencion de its y de cancer de cuello uterino",metodos naturales: usuarias nuevas,2015-04-01,0,1,1,0,0,2
UMALA,"anticoncepcion, prevencion de its y de cancer de cuello uterino",metodos naturales: usuarias nuevas,2015-04-01,0,3,3,1,0,7
UNCIA,"anticoncepcion, prevencion de its y de cancer de cuello uterino",metodos naturales: usuarias nuevas,2015-04-01,0,0,1,1,0,2
UYUNI,"anticoncepcion, prevencion de its y de cancer de cuello uterino",metodos naturales: usuarias nuevas,2015-04-01,0,0,2,0,0,2
VACAS,"anticoncepcion, prevencion de its y de cancer de cuello uterino",metodos naturales: usuarias nuevas,2015-04-01,0,5,3,2,0,10
VIACHA,"anticoncepcion, prevencion de its y de cancer de cuello uterino",metodos naturales: usuarias nuevas,2015-04-01,0,0,12,15,0,27
VILLA RIVERO,"anticoncepcion, prevencion de its y de cancer de cuello uterino",metodos naturales: usuarias nuevas,2015-04-01,0,4,8,0,0,12
VILLA TUNARI,"anticoncepcion, prevencion de its y de cancer de cuello uterino",metodos naturales: usuarias nuevas,2015-04-01,0,1,7,1,0,9
VILLA VACA GUZMAN (MUYUPAMPA),"anticoncepcion, prevencion de its y de cancer de cuello uterino",metodos naturales: usuarias nuevas,2015-04-01,0,2,0,0,0,2
VINTO,"anticoncepcion, prevencion de its y de cancer de cuello uterino",metodos naturales: usuarias nuevas,2015-04-01,1,1,25,2,0,29
VITICHI,"anticoncepcion, prevencion de its y de cancer de cuello uterino",metodos naturales: usuarias nuevas,2015-04-01,0,1,2,2,0,5
WARNES,"anticoncepcion, prevencion de its y de cancer de cuello uterino",metodos naturales: usuarias nuevas,2015-04-01,0,1,14,0,0,15
YACUIBA,"anticoncepcion, prevencion de its y de cancer de cuello uterino",metodos naturales: usuarias nuevas,2015-04-01,0,0,1,0,0,1
YANACACHI,"anticoncepcion, prevencion de its y de cancer de cuello uterino",metodos naturales: usuarias nuevas,2015-04-01,0,1,2,0,0,3
YAPACANI,"anticoncepcion, prevencion de its y de cancer de cuello uterino",metodos naturales: usuarias nuevas,2015-04-01,2,4,20,1,0,27
YOCALLA,"anticoncepcion, prevencion de its y de cancer de cuello uterino",metodos naturales: usuarias nuevas,2015-04-01,0,0,3,0,0,3
YUNCHARA,"anticoncepcion, prevencion de its y de cancer de cuello uterino",metodos naturales: usuarias nuevas,2015-04-01,0,0,1,0,0,1
ZUDAÑEZ,"anticoncepcion, prevencion de its y de cancer de cuello uterino",metodos naturales: usuarias nuevas,2015-04-01,0,2,3,0,0,5
ACACIO,"anticoncepcion, prevencion de its y de cancer de cuello uterino",metodos naturales: usuarias nuevas,2015-05-01,0,1,1,0,0,2
ACHACACHI,"anticoncepcion, prevencion de its y de cancer de cuello uterino",metodos naturales: usuarias nuevas,2015-05-01,0,0,1,0,0,1
AIQUILE,"anticoncepcion, prevencion de its y de cancer de cuello uterino",metodos naturales: usuarias nuevas,2015-05-01,0,0,1,3,0,4
ALCALA,"anticoncepcion, prevencion de its y de cancer de cuello uterino",metodos naturales: usuarias nuevas,2015-05-01,0,1,2,0,0,3
ALTO BENI,"anticoncepcion, prevencion de its y de cancer de cuello uterino",metodos naturales: usuarias nuevas,2015-05-01,0,0,1,0,0,1
ANCORAIMES,"anticoncepcion, prevencion de its y de cancer de cuello uterino",metodos naturales: usuarias nuevas,2015-05-01,0,0,8,5,0,13
ANDAMARCA,"anticoncepcion, prevencion de its y de cancer de cuello uterino",metodos naturales: usuarias nuevas,2015-05-01,0,4,1,1,0,6
APOLO,"anticoncepcion, prevencion de its y de cancer de cuello uterino",metodos naturales: usuarias nuevas,2015-05-01,0,0,5,0,0,5
ARAMPAMPA,"anticoncepcion, prevencion de its y de cancer de cuello uterino",metodos naturales: usuarias nuevas,2015-05-01,0,0,1,0,0,1
ARBIETO,"anticoncepcion, prevencion de its y de cancer de cuello uterino",metodos naturales: usuarias nuevas,2015-05-01,0,3,7,3,0,13
ATOCHA,"anticoncepcion, prevencion de its y de cancer de cuello uterino",metodos naturales: usuarias nuevas,2015-05-01,0,0,1,0,0,1
AYO AYO,"anticoncepcion, prevencion de its y de cancer de cuello uterino",metodos naturales: usuarias nuevas,2015-05-01,0,1,5,2,0,8
AYOPAYA (V. DE INDEPENDENCIA),"anticoncepcion, prevencion de its y de cancer de cuello uterino",metodos naturales: usuarias nuevas,2015-05-01,0,0,2,0,0,2
AZURDUY,"anticoncepcion, prevencion de its y de cancer de cuello uterino",metodos naturales: usuarias nuevas,2015-05-01,0,0,2,0,0,2
BELEN DE ANDAMARCA,"anticoncepcion, prevencion de its y de cancer de cuello uterino",metodos naturales: usuarias nuevas,2015-05-01,0,1,0,0,0,1
BELEN DE URMIRI,"anticoncepcion, prevencion de its y de cancer de cuello uterino",metodos naturales: usuarias nuevas,2015-05-01,0,0,1,0,0,1
BETANZOS,"anticoncepcion, prevencion de its y de cancer de cuello uterino",metodos naturales: usuarias nuevas,2015-05-01,0,4,5,0,0,9
BOLIVAR,"anticoncepcion, prevencion de its y de cancer de cuello uterino",metodos naturales: usuarias nuevas,2015-05-01,0,0,0,1,0,1
BUENA VISTA,"anticoncepcion, prevencion de its y de cancer de cuello uterino",metodos naturales: usuarias nuevas,2015-05-01,0,0,1,0,0,1
"CAIZA ""D""","anticoncepcion, prevencion de its y de cancer de cuello uterino",metodos naturales: usuarias nuevas,2015-05-01,0,1,0,1,0,2
CAJUATA,"anticoncepcion, prevencion de its y de cancer de cuello uterino",metodos naturales: usuarias nuevas,2015-05-01,0,4,11,3,0,18
CALAMARCA,"anticoncepcion, prevencion de its y de cancer de cuello uterino",metodos naturales: usuarias nuevas,2015-05-01,0,4,0,1,0,5
CAMARGO,"anticoncepcion, prevencion de its y de cancer de cuello uterino",metodos naturales: usuarias nuevas,2015-05-01,0,4,23,0,0,27
CAMATAQUI (C. VILLA ABECIA),"anticoncepcion, prevencion de its y de cancer de cuello uterino",metodos naturales: usuarias nuevas,2015-05-01,0,0,1,0,0,1
CAMIRI,"anticoncepcion, prevencion de its y de cancer de cuello uterino",metodos naturales: usuarias nuevas,2015-05-01,0,0,2,0,0,2
CAPINOTA,"anticoncepcion, prevencion de its y de cancer de cuello uterino",metodos naturales: usuarias nuevas,2015-05-01,0,1,0,0,0,1
CARACOLLO,"anticoncepcion, prevencion de its y de cancer de cuello uterino",metodos naturales: usuarias nuevas,2015-05-01,0,9,15,5,0,29
CARANAVI,"anticoncepcion, prevencion de its y de cancer de cuello uterino",metodos naturales: usuarias nuevas,2015-05-01,0,2,3,0,0,5
CARIPUYO,"anticoncepcion, prevencion de its y de cancer de cuello uterino",metodos naturales: usuarias nuevas,2015-05-01,0,0,0,2,0,2
CHALLAPATA,"anticoncepcion, prevencion de its y de cancer de cuello uterino",metodos naturales: usuarias nuevas,2015-05-01,0,10,47,29,0,86
CHAQUI,"anticoncepcion, prevencion de its y de cancer de cuello uterino",metodos naturales: usuarias nuevas,2015-05-01,0,0,6,0,0,6
CHAYANTA,"anticoncepcion, prevencion de its y de cancer de cuello uterino",metodos naturales: usuarias nuevas,2015-05-01,0,10,9,3,0,22
CHUA COCANI,"anticoncepcion, prevencion de its y de cancer de cuello uterino",metodos naturales: usuarias nuevas,2015-05-01,0,1,3,1,0,5
CHULUMANI (V. DE LA LIBERTAD),"anticoncepcion, prevencion de its y de cancer de cuello uterino",metodos naturales: usuarias nuevas,2015-05-01,0,10,14,12,0,36
CKOCHAS,"anticoncepcion, prevencion de its y de cancer de cuello uterino",metodos naturales: usuarias nuevas,2015-05-01,0,1,4,0,0,5
CLIZA,"anticoncepcion, prevencion de its y de cancer de cuello uterino",metodos naturales: usuarias nuevas,2015-05-01,0,1,2,0,0,3
COBIJA,"anticoncepcion, prevencion de its y de cancer de cuello uterino",metodos naturales: usuarias nuevas,2015-05-01,0,4,13,9,0,26
COCHABAMBA,"anticoncepcion, prevencion de its y de cancer de cuello uterino",metodos naturales: usuarias nuevas,2015-05-01,0,5,54,21,0,80
COIPASA,"anticoncepcion, prevencion de its y de cancer de cuello uterino",metodos naturales: usuarias nuevas,2015-05-01,0,0,1,0,0,1
"COLCHA ""K""","anticoncepcion, prevencion de its y de cancer de cuello uterino",metodos naturales: usuarias nuevas,2015-05-01,0,4,3,0,0,7
COLOMI,"anticoncepcion, prevencion de its y de cancer de cuello uterino",metodos naturales: usuarias nuevas,2015-05-01,0,0,2,0,0,2
COLPA BELGICA,"anticoncepcion, prevencion de its y de cancer de cuello uterino",metodos naturales: usuarias nuevas,2015-05-01,0,1,5,0,0,6
COLQUECHACA,"anticoncepcion, prevencion de its y de cancer de cuello uterino",metodos naturales: usuarias nuevas,2015-05-01,0,1,3,0,0,4
COLQUIRI,"anticoncepcion, prevencion de its y de cancer de cuello uterino",metodos naturales: usuarias nuevas,2015-05-01,0,3,11,2,0,16
COMARAPA,"anticoncepcion, prevencion de its y de cancer de cuello uterino",metodos naturales: usuarias nuevas,2015-05-01,0,7,20,3,0,30
CONCEPCION,"anticoncepcion, prevencion de its y de cancer de cuello uterino",metodos naturales: usuarias nuevas,2015-05-01,0,0,1,0,0,1
CORIPATA,"anticoncepcion, prevencion de its y de cancer de cuello uterino",metodos naturales: usuarias nuevas,2015-05-01,0,0,16,0,0,16
CORQUE,"anticoncepcion, prevencion de its y de cancer de cuello uterino",metodos naturales: usuarias nuevas,2015-05-01,0,1,5,1,0,7
COTOCA,"anticoncepcion, prevencion de its y de cancer de cuello uterino",metodos naturales: usuarias nuevas,2015-05-01,0,3,1,1,0,5
CUCHUMUELA (V. G. VILLARROEL),"anticoncepcion, prevencion de its y de cancer de cuello uterino",metodos naturales: usuarias nuevas,2015-05-01,0,0,1,0,0,1
CULPINA,"anticoncepcion, prevencion de its y de cancer de cuello uterino",metodos naturales: usuarias nuevas,2015-05-01,0,0,1,1,0,2
CURAHUARA DE CARANGAS,"anticoncepcion, prevencion de its y de cancer de cuello uterino",metodos naturales: usuarias nuevas,2015-05-01,0,0,2,1,0,3
EL ALTO,"anticoncepcion, prevencion de its y de cancer de cuello uterino",metodos naturales: usuarias nuevas,2015-05-01,2,27,192,257,0,478
EL CHORO,"anticoncepcion, prevencion de its y de cancer de cuello uterino",metodos naturales: usuarias nuevas,2015-05-01,0,1,2,2,0,5
EL PUENTE(STC),"anticoncepcion, prevencion de its y de cancer de cuello uterino",metodos naturales: usuarias nuevas,2015-05-01,0,1,2,0,0,3
EL TORNO,"anticoncepcion, prevencion de its y de cancer de cuello uterino",metodos naturales: usuarias nuevas,2015-05-01,0,3,4,2,0,9
EL VILLAR,"anticoncepcion, prevencion de its y de cancer de cuello uterino",metodos naturales: usuarias nuevas,2015-05-01,0,2,1,0,0,3
ENTRE RIOS TRJ,"anticoncepcion, prevencion de its y de cancer de cuello uterino",metodos naturales: usuarias nuevas,2015-05-01,0,4,12,0,0,16
ENTRE RIOS CBBA,"anticoncepcion, prevencion de its y de cancer de cuello uterino",metodos naturales: usuarias nuevas,2015-05-01,0,0,2,0,0,2
EUCALIPTUS,"anticoncepcion, prevencion de its y de cancer de cuello uterino",metodos naturales: usuarias nuevas,2015-05-01,0,0,3,1,0,4
EXALTACION,"anticoncepcion, prevencion de its y de cancer de cuello uterino",metodos naturales: usuarias nuevas,2015-05-01,0,0,1,1,0,2
FILADELFIA,"anticoncepcion, prevencion de its y de cancer de cuello uterino",metodos naturales: usuarias nuevas,2015-05-01,0,1,1,0,0,2
GUAQUI,"anticoncepcion, prevencion de its y de cancer de cuello uterino",metodos naturales: usuarias nuevas,2015-05-01,0,0,7,1,0,8
GUAYARAMERIN,"anticoncepcion, prevencion de its y de cancer de cuello uterino",metodos naturales: usuarias nuevas,2015-05-01,3,21,57,6,3,90
HUACARETA,"anticoncepcion, prevencion de its y de cancer de cuello uterino",metodos naturales: usuarias nuevas,2015-05-01,0,2,0,1,0,3
HUANUNI,"anticoncepcion, prevencion de its y de cancer de cuello uterino",metodos naturales: usuarias nuevas,2015-05-01,0,1,9,2,0,12
HUAYLLAMARCA,"anticoncepcion, prevencion de its y de cancer de cuello uterino",metodos naturales: usuarias nuevas,2015-05-01,0,3,3,0,0,6
ICHOCA,"anticoncepcion, prevencion de its y de cancer de cuello uterino",metodos naturales: usuarias nuevas,2015-05-01,0,1,1,0,0,2
ICLA,"anticoncepcion, prevencion de its y de cancer de cuello uterino",metodos naturales: usuarias nuevas,2015-05-01,0,1,4,1,0,6
INCAHUASI,"anticoncepcion, prevencion de its y de cancer de cuello uterino",metodos naturales: usuarias nuevas,2015-05-01,0,1,8,1,0,10
INQUISIVI,"anticoncepcion, prevencion de its y de cancer de cuello uterino",metodos naturales: usuarias nuevas,2015-05-01,0,5,5,1,0,11
IRUPANA (VILLA DE LANZA),"anticoncepcion, prevencion de its y de cancer de cuello uterino",metodos naturales: usuarias nuevas,2015-05-01,0,2,11,0,0,13
IXIAMAS,"anticoncepcion, prevencion de its y de cancer de cuello uterino",metodos naturales: usuarias nuevas,2015-05-01,0,6,7,1,0,14
JESUS DE MACHACA,"anticoncepcion, prevencion de its y de cancer de cuello uterino",metodos naturales: usuarias nuevas,2015-05-01,0,0,8,0,0,8
LA ASUNTA,"anticoncepcion, prevencion de its y de cancer de cuello uterino",metodos naturales: usuarias nuevas,2015-05-01,0,1,11,2,0,14
LA PAZ,"anticoncepcion, prevencion de its y de cancer de cuello uterino",metodos naturales: usuarias nuevas,2015-05-01,1,34,308,68,0,411
LAGUNILLAS,"anticoncepcion, prevencion de its y de cancer de cuello uterino",metodos naturales: usuarias nuevas,2015-05-01,0,2,1,0,0,3
LAJA,"anticoncepcion, prevencion de its y de cancer de cuello uterino",metodos naturales: usuarias nuevas,2015-05-01,0,2,6,0,0,8
LICOMA PAMPA,"anticoncepcion, prevencion de its y de cancer de cuello uterino",metodos naturales: usuarias nuevas,2015-05-01,0,1,0,1,0,2
LLALLAGUA,"anticoncepcion, prevencion de its y de cancer de cuello uterino",metodos naturales: usuarias nuevas,2015-05-01,0,1,3,1,0,5
LORETO,"anticoncepcion, prevencion de its y de cancer de cuello uterino",metodos naturales: usuarias nuevas,2015-05-01,0,2,3,0,0,5
MECAPACA,"anticoncepcion, prevencion de its y de cancer de cuello uterino",metodos naturales: usuarias nuevas,2015-05-01,0,1,0,0,0,1
MINEROS,"anticoncepcion, prevencion de its y de cancer de cuello uterino",metodos naturales: usuarias nuevas,2015-05-01,0,0,1,0,0,1
MIZQUE,"anticoncepcion, prevencion de its y de cancer de cuello uterino",metodos naturales: usuarias nuevas,2015-05-01,0,0,1,0,0,1
MOCOMOCO,"anticoncepcion, prevencion de its y de cancer de cuello uterino",metodos naturales: usuarias nuevas,2015-05-01,0,1,0,3,0,4
MOJOCOYA,"anticoncepcion, prevencion de its y de cancer de cuello uterino",metodos naturales: usuarias nuevas,2015-05-01,0,2,5,0,0,7
MONTERO,"anticoncepcion, prevencion de its y de cancer de cuello uterino",metodos naturales: usuarias nuevas,2015-05-01,0,1,2,1,0,4
MOROCHATA,"anticoncepcion, prevencion de its y de cancer de cuello uterino",metodos naturales: usuarias nuevas,2015-05-01,1,4,8,4,0,17
NUEVO MANOA (NUEVA ESPERANZA),"anticoncepcion, prevencion de its y de cancer de cuello uterino",metodos naturales: usuarias nuevas,2015-05-01,0,0,7,0,0,7
OCURI,"anticoncepcion, prevencion de its y de cancer de cuello uterino",metodos naturales: usuarias nuevas,2015-05-01,0,2,3,0,0,5
OMEREQUE,"anticoncepcion, prevencion de its y de cancer de cuello uterino",metodos naturales: usuarias nuevas,2015-05-01,0,6,4,0,0,10
ORURO,"anticoncepcion, prevencion de its y de cancer de cuello uterino",metodos naturales: usuarias nuevas,2015-05-01,0,3,13,3,0,19
PADILLA,"anticoncepcion, prevencion de its y de cancer de cuello uterino",metodos naturales: usuarias nuevas,2015-05-01,2,8,13,3,0,26
PALCA,"anticoncepcion, prevencion de its y de cancer de cuello uterino",metodos naturales: usuarias nuevas,2015-05-01,0,0,2,0,0,2
PAMPA AULLAGAS,"anticoncepcion, prevencion de its y de cancer de cuello uterino",metodos naturales: usuarias nuevas,2015-05-01,0,0,4,5,0,9
PAPEL PAMPA,"anticoncepcion, prevencion de its y de cancer de cuello uterino",metodos naturales: usuarias nuevas,2015-05-01,0,0,1,0,0,1
PASORAPA,"anticoncepcion, prevencion de its y de cancer de cuello uterino",metodos naturales: usuarias nuevas,2015-05-01,0,1,0,0,0,1
PAZÑA,"anticoncepcion, prevencion de its y de cancer de cuello uterino",metodos naturales: usuarias nuevas,2015-05-01,0,1,2,0,0,3
POCOATA,"anticoncepcion, prevencion de its y de cancer de cuello uterino",metodos naturales: usuarias nuevas,2015-05-01,0,3,15,6,0,24
POCONA,"anticoncepcion, prevencion de its y de cancer de cuello uterino",metodos naturales: usuarias nuevas,2015-05-01,0,2,7,2,0,11
POJO (CBBA),"anticoncepcion, prevencion de its y de cancer de cuello uterino",metodos naturales: usuarias nuevas,2015-05-01,0,1,0,0,0,1
PORCO,"anticoncepcion, prevencion de its y de cancer de cuello uterino",metodos naturales: usuarias nuevas,2015-05-01,0,1,4,1,0,6
POROMA,"anticoncepcion, prevencion de its y de cancer de cuello uterino",metodos naturales: usuarias nuevas,2015-05-01,0,5,1,2,0,8
PORONGO,"anticoncepcion, prevencion de its y de cancer de cuello uterino",metodos naturales: usuarias nuevas,2015-05-01,1,2,6,0,0,9
PORTACHUELO,"anticoncepcion, prevencion de its y de cancer de cuello uterino",metodos naturales: usuarias nuevas,2015-05-01,1,7,0,0,0,8
POTOSI,"anticoncepcion, prevencion de its y de cancer de cuello uterino",metodos naturales: usuarias nuevas,2015-05-01,1,12,46,164,0,223
PRESTO,"anticoncepcion, prevencion de its y de cancer de cuello uterino",metodos naturales: usuarias nuevas,2015-05-01,0,1,0,2,0,3
PUCARANI,"anticoncepcion, prevencion de its y de cancer de cuello uterino",metodos naturales: usuarias nuevas,2015-05-01,0,4,6,1,0,11
PUERTO ACOSTA,"anticoncepcion, prevencion de its y de cancer de cuello uterino",metodos naturales: usuarias nuevas,2015-05-01,0,0,2,0,0,2
PUERTO CARABUCO,"anticoncepcion, prevencion de its y de cancer de cuello uterino",metodos naturales: usuarias nuevas,2015-05-01,0,2,1,1,0,4
PUERTO GONZALO MORENO,"anticoncepcion, prevencion de its y de cancer de cuello uterino",metodos naturales: usuarias nuevas,2015-05-01,0,7,0,0,0,7
PUERTO PEREZ,"anticoncepcion, prevencion de its y de cancer de cuello uterino",metodos naturales: usuarias nuevas,2015-05-01,0,0,1,0,0,1
PUERTO QUIJARRO,"anticoncepcion, prevencion de its y de cancer de cuello uterino",metodos naturales: usuarias nuevas,2015-05-01,0,8,21,0,0,29
PUERTO RICO,"anticoncepcion, prevencion de its y de cancer de cuello uterino",metodos naturales: usuarias nuevas,2015-05-01,1,5,3,0,0,9
PUERTO VILLARROEL,"anticoncepcion, prevencion de its y de cancer de cuello uterino",metodos naturales: usuarias nuevas,2015-05-01,0,1,2,1,0,4
PUNA,"anticoncepcion, prevencion de its y de cancer de cuello uterino",metodos naturales: usuarias nuevas,2015-05-01,0,1,3,3,0,7
PUNATA,"anticoncepcion, prevencion de its y de cancer de cuello uterino",metodos naturales: usuarias nuevas,2015-05-01,0,1,8,2,0,11
QUILLACOLLO,"anticoncepcion, prevencion de its y de cancer de cuello uterino",metodos naturales: usuarias nuevas,2015-05-01,0,26,172,28,1,227
QUIME,"anticoncepcion, prevencion de its y de cancer de cuello uterino",metodos naturales: usuarias nuevas,2015-05-01,0,2,5,1,0,8
RAVELO,"anticoncepcion, prevencion de its y de cancer de cuello uterino",metodos naturales: usuarias nuevas,2015-05-01,0,3,7,3,0,13
REYES,"anticoncepcion, prevencion de its y de cancer de cuello uterino",metodos naturales: usuarias nuevas,2015-05-01,14,16,42,6,0,78
RIBERALTA,"anticoncepcion, prevencion de its y de cancer de cuello uterino",metodos naturales: usuarias nuevas,2015-05-01,6,37,101,13,0,157
RURRENABAQUE,"anticoncepcion, prevencion de its y de cancer de cuello uterino",metodos naturales: usuarias nuevas,2015-05-01,1,4,7,1,0,13
SABAYA,"anticoncepcion, prevencion de its y de cancer de cuello uterino",metodos naturales: usuarias nuevas,2015-05-01,0,0,1,0,0,1
SACABA,"anticoncepcion, prevencion de its y de cancer de cuello uterino",metodos naturales: usuarias nuevas,2015-05-01,0,3,19,5,0,27
SAIPINA,"anticoncepcion, prevencion de its y de cancer de cuello uterino",metodos naturales: usuarias nuevas,2015-05-01,0,1,4,0,0,5
SALINAS DE GARCI MENDOZA,"anticoncepcion, prevencion de its y de cancer de cuello uterino",metodos naturales: usuarias nuevas,2015-05-01,0,3,8,2,0,13
SAMAIPATA,"anticoncepcion, prevencion de its y de cancer de cuello uterino",metodos naturales: usuarias nuevas,2015-05-01,0,1,0,0,0,1
SAN ANDRES,"anticoncepcion, prevencion de its y de cancer de cuello uterino",metodos naturales: usuarias nuevas,2015-05-01,0,3,5,0,0,8
SAN ANDRES DE MACHACA,"anticoncepcion, prevencion de its y de cancer de cuello uterino",metodos naturales: usuarias nuevas,2015-05-01,0,2,3,1,0,6
SAN ANTONIO DE LOMERIO,"anticoncepcion, prevencion de its y de cancer de cuello uterino",metodos naturales: usuarias nuevas,2015-05-01,0,0,7,0,0,7
SAN BENITO,"anticoncepcion, prevencion de its y de cancer de cuello uterino",metodos naturales: usuarias nuevas,2015-05-01,0,0,2,1,0,3
SAN BORJA,"anticoncepcion, prevencion de its y de cancer de cuello uterino",metodos naturales: usuarias nuevas,2015-05-01,3,10,10,3,0,26
SAN BUENA VENTURA,"anticoncepcion, prevencion de its y de cancer de cuello uterino",metodos naturales: usuarias nuevas,2015-05-01,0,1,9,0,0,10
SAN CARLOS,"anticoncepcion, prevencion de its y de cancer de cuello uterino",metodos naturales: usuarias nuevas,2015-05-01,0,0,6,0,0,6
SAN IGNACIO,"anticoncepcion, prevencion de its y de cancer de cuello uterino",metodos naturales: usuarias nuevas,2015-05-01,0,0,1,0,0,1
SAN JAVIER(BNI),"anticoncepcion, prevencion de its y de cancer de cuello uterino",metodos naturales: usuarias nuevas,2015-05-01,0,0,1,1,0,2
SAN JOSE DE CHIQUITOS,"anticoncepcion, prevencion de its y de cancer de cuello uterino",metodos naturales: usuarias nuevas,2015-05-01,1,0,0,0,0,1
SAN JULIAN,"anticoncepcion, prevencion de its y de cancer de cuello uterino",metodos naturales: usuarias nuevas,2015-05-01,0,0,1,0,0,1
SAN LORENZO(TJA),"anticoncepcion, prevencion de its y de cancer de cuello uterino",metodos naturales: usuarias nuevas,2015-05-01,0,1,1,1,0,3
SAN LUCAS,"anticoncepcion, prevencion de its y de cancer de cuello uterino",metodos naturales: usuarias nuevas,2015-05-01,0,1,5,1,0,7
SAN MATIAS,"anticoncepcion, prevencion de its y de cancer de cuello uterino",metodos naturales: usuarias nuevas,2015-05-01,0,0,1,0,0,1
SAN MIGUEL DE VELASCO,"anticoncepcion, prevencion de its y de cancer de cuello uterino",metodos naturales: usuarias nuevas,2015-05-01,0,1,0,0,0,1
SAN PEDRO,"anticoncepcion, prevencion de its y de cancer de cuello uterino",metodos naturales: usuarias nuevas,2015-05-01,0,0,1,0,0,1
SAN PEDRO DE BUENA VISTA,"anticoncepcion, prevencion de its y de cancer de cuello uterino",metodos naturales: usuarias nuevas,2015-05-01,0,4,8,1,0,13
SAN PEDRO DE CURAHUARA,"anticoncepcion, prevencion de its y de cancer de cuello uterino",metodos naturales: usuarias nuevas,2015-05-01,0,0,2,1,0,3
SAN PEDRO DE TIQUINA,"anticoncepcion, prevencion de its y de cancer de cuello uterino",metodos naturales: usuarias nuevas,2015-05-01,0,0,2,1,0,3
SAN RAFAEL,"anticoncepcion, prevencion de its y de cancer de cuello uterino",metodos naturales: usuarias nuevas,2015-05-01,0,2,2,2,0,6
SAN RAMON BENI,"anticoncepcion, prevencion de its y de cancer de cuello uterino",metodos naturales: usuarias nuevas,2015-05-01,0,0,1,0,0,1
SANTA ANA,"anticoncepcion, prevencion de its y de cancer de cuello uterino",metodos naturales: usuarias nuevas,2015-05-01,2,13,17,5,0,37
SANTA CRUZ DE LA SIERRA,"anticoncepcion, prevencion de its y de cancer de cuello uterino",metodos naturales: usuarias nuevas,2015-05-01,0,19,40,4,0,63
SANTA ROSA,"anticoncepcion, prevencion de its y de cancer de cuello uterino",metodos naturales: usuarias nuevas,2015-05-01,0,3,0,0,0,3
SANTIAGO DE HUARI,"anticoncepcion, prevencion de its y de cancer de cuello uterino",metodos naturales: usuarias nuevas,2015-05-01,0,3,2,1,0,6
SANTIAGO DE HUATA,"anticoncepcion, prevencion de its y de cancer de cuello uterino",metodos naturales: usuarias nuevas,2015-05-01,0,0,1,1,0,2
SANTIAGO DE MACHACA,"anticoncepcion, prevencion de its y de cancer de cuello uterino",metodos naturales: usuarias nuevas,2015-05-01,0,0,1,2,0,3
SANTUARIO DE QUILLACAS,"anticoncepcion, prevencion de its y de cancer de cuello uterino",metodos naturales: usuarias nuevas,2015-05-01,0,0,1,1,0,2
SENA,"anticoncepcion, prevencion de its y de cancer de cuello uterino",metodos naturales: usuarias nuevas,2015-05-01,0,2,0,0,0,2
SHINAOTA,"anticoncepcion, prevencion de its y de cancer de cuello uterino",metodos naturales: usuarias nuevas,2015-05-01,0,1,0,0,0,1
SICA SICA (VILLA AROMA),"anticoncepcion, prevencion de its y de cancer de cuello uterino",metodos naturales: usuarias nuevas,2015-05-01,0,1,1,0,0,2
SIPE SIPE,"anticoncepcion, prevencion de its y de cancer de cuello uterino",metodos naturales: usuarias nuevas,2015-05-01,0,0,1,0,0,1
SOPACHUY,"anticoncepcion, prevencion de its y de cancer de cuello uterino",metodos naturales: usuarias nuevas,2015-05-01,0,4,3,1,0,8
SORACACHI,"anticoncepcion, prevencion de its y de cancer de cuello uterino",metodos naturales: usuarias nuevas,2015-05-01,0,1,3,1,0,5
SUCRE,"anticoncepcion, prevencion de its y de cancer de cuello uterino",metodos naturales: usuarias nuevas,2015-05-01,0,13,41,7,0,61
TACOBAMBA,"anticoncepcion, prevencion de its y de cancer de cuello uterino",metodos naturales: usuarias nuevas,2015-05-01,0,0,1,0,0,1
TACOPAYA,"anticoncepcion, prevencion de its y de cancer de cuello uterino",metodos naturales: usuarias nuevas,2015-05-01,0,5,5,0,0,10
TAPACARI,"anticoncepcion, prevencion de its y de cancer de cuello uterino",metodos naturales: usuarias nuevas,2015-05-01,0,2,5,1,0,8
TARACO,"anticoncepcion, prevencion de its y de cancer de cuello uterino",metodos naturales: usuarias nuevas,2015-05-01,0,1,2,0,0,3
TARIJA,"anticoncepcion, prevencion de its y de cancer de cuello uterino",metodos naturales: usuarias nuevas,2015-05-01,0,0,5,6,0,11
TARVITA,"anticoncepcion, prevencion de its y de cancer de cuello uterino",metodos naturales: usuarias nuevas,2015-05-01,0,0,1,0,0,1
TEOPONTE,"anticoncepcion, prevencion de its y de cancer de cuello uterino",metodos naturales: usuarias nuevas,2015-05-01,1,5,18,2,0,26
TIAWANACU,"anticoncepcion, prevencion de its y de cancer de cuello uterino",metodos naturales: usuarias nuevas,2015-05-01,0,0,5,0,0,5
TINGUIPAYA,"anticoncepcion, prevencion de its y de cancer de cuello uterino",metodos naturales: usuarias nuevas,2015-05-01,0,0,1,0,0,1
TIPUANI,"anticoncepcion, prevencion de its y de cancer de cuello uterino",metodos naturales: usuarias nuevas,2015-05-01,0,0,2,0,0,2
TIRAQUE (CBBA),"anticoncepcion, prevencion de its y de cancer de cuello uterino",metodos naturales: usuarias nuevas,2015-05-01,0,2,5,0,0,7
TITO YUPANQUI (PARQUIPUJIO),"anticoncepcion, prevencion de its y de cancer de cuello uterino",metodos naturales: usuarias nuevas,2015-05-01,0,0,3,0,0,3
TOCO,"anticoncepcion, prevencion de its y de cancer de cuello uterino",metodos naturales: usuarias nuevas,2015-05-01,0,2,4,0,0,6
TOLATA,"anticoncepcion, prevencion de its y de cancer de cuello uterino",metodos naturales: usuarias nuevas,2015-05-01,0,5,5,0,0,10
TOLEDO,"anticoncepcion, prevencion de its y de cancer de cuello uterino",metodos naturales: usuarias nuevas,2015-05-01,0,2,2,0,0,4
TOMAVE,"anticoncepcion, prevencion de its y de cancer de cuello uterino",metodos naturales: usuarias nuevas,2015-05-01,0,1,0,0,0,1
TOMINA,"anticoncepcion, prevencion de its y de cancer de cuello uterino",metodos naturales: usuarias nuevas,2015-05-01,0,3,2,2,0,7
TORO TORO,"anticoncepcion, prevencion de its y de cancer de cuello uterino",metodos naturales: usuarias nuevas,2015-05-01,0,2,2,0,0,4
TOTORA(ORR),"anticoncepcion, prevencion de its y de cancer de cuello uterino",metodos naturales: usuarias nuevas,2015-05-01,0,3,1,1,0,5
TRINIDAD,"anticoncepcion, prevencion de its y de cancer de cuello uterino",metodos naturales: usuarias nuevas,2015-05-01,1,5,36,1,0,43
UMALA,"anticoncepcion, prevencion de its y de cancer de cuello uterino",metodos naturales: usuarias nuevas,2015-05-01,0,2,2,0,0,4
UNCIA,"anticoncepcion, prevencion de its y de cancer de cuello uterino",metodos naturales: usuarias nuevas,2015-05-01,0,1,3,0,0,4
URIONDO (A. CONCEPCION),"anticoncepcion, prevencion de its y de cancer de cuello uterino",metodos naturales: usuarias nuevas,2015-05-01,0,0,0,1,0,1
VACAS,"anticoncepcion, prevencion de its y de cancer de cuello uterino",metodos naturales: usuarias nuevas,2015-05-01,0,4,6,5,0,15
VIACHA,"anticoncepcion, prevencion de its y de cancer de cuello uterino",metodos naturales: usuarias nuevas,2015-05-01,0,2,7,1,0,10
VILLA CHARCAS,"anticoncepcion, prevencion de its y de cancer de cuello uterino",metodos naturales: usuarias nuevas,2015-05-01,0,7,0,0,0,7
VILLA RIVERO,"anticoncepcion, prevencion de its y de cancer de cuello uterino",metodos naturales: usuarias nuevas,2015-05-01,0,0,7,1,0,8
VILLA SERRANO,"anticoncepcion, prevencion de its y de cancer de cuello uterino",metodos naturales: usuarias nuevas,2015-05-01,0,0,4,0,0,4
VILLA TUNARI,"anticoncepcion, prevencion de its y de cancer de cuello uterino",metodos naturales: usuarias nuevas,2015-05-01,1,4,2,0,0,7
VILLAZON,"anticoncepcion, prevencion de its y de cancer de cuello uterino",metodos naturales: usuarias nuevas,2015-05-01,0,5,32,7,0,44
VINTO,"anticoncepcion, prevencion de its y de cancer de cuello uterino",metodos naturales: usuarias nuevas,2015-05-01,0,0,2,5,3,10
VITICHI,"anticoncepcion, prevencion de its y de cancer de cuello uterino",metodos naturales: usuarias nuevas,2015-05-01,0,0,4,1,0,5
WARNES,"anticoncepcion, prevencion de its y de cancer de cuello uterino",metodos naturales: usuarias nuevas,2015-05-01,0,2,6,0,0,8
YACO,"anticoncepcion, prevencion de its y de cancer de cuello uterino",metodos naturales: usuarias nuevas,2015-05-01,0,3,0,0,0,3
YACUIBA,"anticoncepcion, prevencion de its y de cancer de cuello uterino",metodos naturales: usuarias nuevas,2015-05-01,0,2,13,3,0,18
YANACACHI,"anticoncepcion, prevencion de its y de cancer de cuello uterino",metodos naturales: usuarias nuevas,2015-05-01,1,0,3,0,0,4
YAPACANI,"anticoncepcion, prevencion de its y de cancer de cuello uterino",metodos naturales: usuarias nuevas,2015-05-01,0,2,28,1,0,31
ZUDAÑEZ,"anticoncepcion, prevencion de its y de cancer de cuello uterino",metodos naturales: usuarias nuevas,2015-05-01,0,3,5,7,0,15
ACACIO,"anticoncepcion, prevencion de its y de cancer de cuello uterino",metodos naturales: usuarias nuevas,2015-06-01,0,1,2,0,0,3
ACHACACHI,"anticoncepcion, prevencion de its y de cancer de cuello uterino",metodos naturales: usuarias nuevas,2015-06-01,0,0,4,2,1,7
ACHOCALLA,"anticoncepcion, prevencion de its y de cancer de cuello uterino",metodos naturales: usuarias nuevas,2015-06-01,0,0,1,0,0,1
AIQUILE,"anticoncepcion, prevencion de its y de cancer de cuello uterino",metodos naturales: usuarias nuevas,2015-06-01,0,2,5,1,0,8
ALCALA,"anticoncepcion, prevencion de its y de cancer de cuello uterino",metodos naturales: usuarias nuevas,2015-06-01,0,1,0,1,0,2
ANCORAIMES,"anticoncepcion, prevencion de its y de cancer de cuello uterino",metodos naturales: usuarias nuevas,2015-06-01,0,3,13,1,0,17
ANDAMARCA,"anticoncepcion, prevencion de its y de cancer de cuello uterino",metodos naturales: usuarias nuevas,2015-06-01,0,1,5,1,0,7
ANTEQUERA,"anticoncepcion, prevencion de its y de cancer de cuello uterino",metodos naturales: usuarias nuevas,2015-06-01,0,0,1,0,0,1
ANZALDO,"anticoncepcion, prevencion de its y de cancer de cuello uterino",metodos naturales: usuarias nuevas,2015-06-01,0,2,0,0,0,2
APOLO,"anticoncepcion, prevencion de its y de cancer de cuello uterino",metodos naturales: usuarias nuevas,2015-06-01,0,0,1,1,0,2
ARBIETO,"anticoncepcion, prevencion de its y de cancer de cuello uterino",metodos naturales: usuarias nuevas,2015-06-01,0,3,6,1,0,10
ATOCHA,"anticoncepcion, prevencion de its y de cancer de cuello uterino",metodos naturales: usuarias nuevas,2015-06-01,0,0,1,0,0,1
AZURDUY,"anticoncepcion, prevencion de its y de cancer de cuello uterino",metodos naturales: usuarias nuevas,2015-06-01,0,1,0,0,0,1
BATALLAS,"anticoncepcion, prevencion de its y de cancer de cuello uterino",metodos naturales: usuarias nuevas,2015-06-01,0,0,0,1,0,1
BELEN DE URMIRI,"anticoncepcion, prevencion de its y de cancer de cuello uterino",metodos naturales: usuarias nuevas,2015-06-01,0,0,1,0,0,1
BELLA FLOR,"anticoncepcion, prevencion de its y de cancer de cuello uterino",metodos naturales: usuarias nuevas,2015-06-01,0,0,1,0,0,1
BERMEJO,"anticoncepcion, prevencion de its y de cancer de cuello uterino",metodos naturales: usuarias nuevas,2015-06-01,0,0,0,1,0,1
BETANZOS,"anticoncepcion, prevencion de its y de cancer de cuello uterino",metodos naturales: usuarias nuevas,2015-06-01,1,1,6,1,0,9
BUENA VISTA,"anticoncepcion, prevencion de its y de cancer de cuello uterino",metodos naturales: usuarias nuevas,2015-06-01,0,1,0,0,0,1
CABEZAS,"anticoncepcion, prevencion de its y de cancer de cuello uterino",metodos naturales: usuarias nuevas,2015-06-01,0,3,2,0,0,5
"CAIZA ""D""","anticoncepcion, prevencion de its y de cancer de cuello uterino",metodos naturales: usuarias nuevas,2015-06-01,0,0,1,0,0,1
CAJUATA,"anticoncepcion, prevencion de its y de cancer de cuello uterino",metodos naturales: usuarias nuevas,2015-06-01,0,3,12,1,0,16
CALAMARCA,"anticoncepcion, prevencion de its y de cancer de cuello uterino",metodos naturales: usuarias nuevas,2015-06-01,1,2,5,0,0,8
CAMARGO,"anticoncepcion, prevencion de its y de cancer de cuello uterino",metodos naturales: usuarias nuevas,2015-06-01,0,5,14,2,0,21
CAPINOTA,"anticoncepcion, prevencion de its y de cancer de cuello uterino",metodos naturales: usuarias nuevas,2015-06-01,0,1,0,0,0,1
CARACOLLO,"anticoncepcion, prevencion de its y de cancer de cuello uterino",metodos naturales: usuarias nuevas,2015-06-01,0,5,18,2,0,25
CARIPUYO,"anticoncepcion, prevencion de its y de cancer de cuello uterino",metodos naturales: usuarias nuevas,2015-06-01,0,1,4,2,0,7
CHALLAPATA,"anticoncepcion, prevencion de its y de cancer de cuello uterino",metodos naturales: usuarias nuevas,2015-06-01,0,7,49,4,0,60
CHAQUI,"anticoncepcion, prevencion de its y de cancer de cuello uterino",metodos naturales: usuarias nuevas,2015-06-01,1,2,3,1,0,7
CHAYANTA,"anticoncepcion, prevencion de its y de cancer de cuello uterino",metodos naturales: usuarias nuevas,2015-06-01,0,2,13,0,0,15
CHIPAYA,"anticoncepcion, prevencion de its y de cancer de cuello uterino",metodos naturales: usuarias nuevas,2015-06-01,0,2,0,0,0,2
CHUA COCANI,"anticoncepcion, prevencion de its y de cancer de cuello uterino",metodos naturales: usuarias nuevas,2015-06-01,0,0,1,1,0,2
CHULUMANI (V. DE LA LIBERTAD),"anticoncepcion, prevencion de its y de cancer de cuello uterino",metodos naturales: usuarias nuevas,2015-06-01,1,7,14,1,0,23
CHUQUIHUTA AYLLU JUCUMANI,"anticoncepcion, prevencion de its y de cancer de cuello uterino",metodos naturales: usuarias nuevas,2015-06-01,0,0,1,0,0,1
CKOCHAS,"anticoncepcion, prevencion de its y de cancer de cuello uterino",metodos naturales: usuarias nuevas,2015-06-01,0,5,6,3,0,14
COBIJA,"anticoncepcion, prevencion de its y de cancer de cuello uterino",metodos naturales: usuarias nuevas,2015-06-01,1,13,24,9,0,47
COCAPATA,"anticoncepcion, prevencion de its y de cancer de cuello uterino",metodos naturales: usuarias nuevas,2015-06-01,0,1,5,0,0,6
COCHABAMBA,"anticoncepcion, prevencion de its y de cancer de cuello uterino",metodos naturales: usuarias nuevas,2015-06-01,0,33,123,450,9,615
COIPASA,"anticoncepcion, prevencion de its y de cancer de cuello uterino",metodos naturales: usuarias nuevas,2015-06-01,0,0,1,0,0,1
COLCAPIRHUA,"anticoncepcion, prevencion de its y de cancer de cuello uterino",metodos naturales: usuarias nuevas,2015-06-01,0,0,1,0,0,1
"COLCHA ""K""","anticoncepcion, prevencion de its y de cancer de cuello uterino",metodos naturales: usuarias nuevas,2015-06-01,0,1,5,0,0,6
COLOMI,"anticoncepcion, prevencion de its y de cancer de cuello uterino",metodos naturales: usuarias nuevas,2015-06-01,0,3,7,2,0,12
COLQUECHACA,"anticoncepcion, prevencion de its y de cancer de cuello uterino",metodos naturales: usuarias nuevas,2015-06-01,0,2,7,5,0,14
COLQUIRI,"anticoncepcion, prevencion de its y de cancer de cuello uterino",metodos naturales: usuarias nuevas,2015-06-01,0,6,12,4,0,22
COMANCHE,"anticoncepcion, prevencion de its y de cancer de cuello uterino",metodos naturales: usuarias nuevas,2015-06-01,0,0,0,1,0,1
COMARAPA,"anticoncepcion, prevencion de its y de cancer de cuello uterino",metodos naturales: usuarias nuevas,2015-06-01,0,11,22,4,0,37
CORIPATA,"anticoncepcion, prevencion de its y de cancer de cuello uterino",metodos naturales: usuarias nuevas,2015-06-01,0,4,10,0,0,14
CORO CORO,"anticoncepcion, prevencion de its y de cancer de cuello uterino",metodos naturales: usuarias nuevas,2015-06-01,0,1,3,1,0,5
CORQUE,"anticoncepcion, prevencion de its y de cancer de cuello uterino",metodos naturales: usuarias nuevas,2015-06-01,0,0,1,0,0,1
COTAGAITA,"anticoncepcion, prevencion de its y de cancer de cuello uterino",metodos naturales: usuarias nuevas,2015-06-01,0,0,0,1,0,1
COTOCA,"anticoncepcion, prevencion de its y de cancer de cuello uterino",metodos naturales: usuarias nuevas,2015-06-01,0,1,2,1,0,4
CUCHUMUELA (V. G. VILLARROEL),"anticoncepcion, prevencion de its y de cancer de cuello uterino",metodos naturales: usuarias nuevas,2015-06-01,0,0,1,0,0,1
CULPINA,"anticoncepcion, prevencion de its y de cancer de cuello uterino",metodos naturales: usuarias nuevas,2015-06-01,0,0,2,0,0,2
DESAGUADERO,"anticoncepcion, prevencion de its y de cancer de cuello uterino",metodos naturales: usuarias nuevas,2015-06-01,0,0,1,0,0,1
EL ALTO,"anticoncepcion, prevencion de its y de cancer de cuello uterino",metodos naturales: usuarias nuevas,2015-06-01,0,16,190,102,0,308
EL CHORO,"anticoncepcion, prevencion de its y de cancer de cuello uterino",metodos naturales: usuarias nuevas,2015-06-01,0,1,4,2,0,7
EL PUENTE(STC),"anticoncepcion, prevencion de its y de cancer de cuello uterino",metodos naturales: usuarias nuevas,2015-06-01,0,1,2,1,0,4
EL TORNO,"anticoncepcion, prevencion de its y de cancer de cuello uterino",metodos naturales: usuarias nuevas,2015-06-01,0,4,0,4,0,8
EL VILLAR,"anticoncepcion, prevencion de its y de cancer de cuello uterino",metodos naturales: usuarias nuevas,2015-06-01,0,2,0,0,0,2
ENTRE RIOS TRJ,"anticoncepcion, prevencion de its y de cancer de cuello uterino",metodos naturales: usuarias nuevas,2015-06-01,0,7,7,1,0,15
EUCALIPTUS,"anticoncepcion, prevencion de its y de cancer de cuello uterino",metodos naturales: usuarias nuevas,2015-06-01,0,1,7,0,0,8
EUREKA (SANTOS MERCADO),"anticoncepcion, prevencion de its y de cancer de cuello uterino",metodos naturales: usuarias nuevas,2015-06-01,0,1,0,0,0,1
FERNANDEZ ALONSO,"anticoncepcion, prevencion de its y de cancer de cuello uterino",metodos naturales: usuarias nuevas,2015-06-01,0,0,1,0,0,1
FILADELFIA,"anticoncepcion, prevencion de its y de cancer de cuello uterino",metodos naturales: usuarias nuevas,2015-06-01,0,0,2,0,0,2
GUAQUI,"anticoncepcion, prevencion de its y de cancer de cuello uterino",metodos naturales: usuarias nuevas,2015-06-01,0,1,7,1,0,9
GUAYARAMERIN,"anticoncepcion, prevencion de its y de cancer de cuello uterino",metodos naturales: usuarias nuevas,2015-06-01,2,21,54,3,0,80
HUACARETA,"anticoncepcion, prevencion de its y de cancer de cuello uterino",metodos naturales: usuarias nuevas,2015-06-01,0,2,0,0,0,2
HUACAYA (VILLA DE HUACAYA),"anticoncepcion, prevencion de its y de cancer de cuello uterino",metodos naturales: usuarias nuevas,2015-06-01,0,0,3,0,0,3
HUACHACALLA,"anticoncepcion, prevencion de its y de cancer de cuello uterino",metodos naturales: usuarias nuevas,2015-06-01,0,1,2,1,0,4
HUANUNI,"anticoncepcion, prevencion de its y de cancer de cuello uterino",metodos naturales: usuarias nuevas,2015-06-01,0,0,12,3,0,15
HUATAJATA,"anticoncepcion, prevencion de its y de cancer de cuello uterino",metodos naturales: usuarias nuevas,2015-06-01,0,0,1,0,0,1
HUAYLLAMARCA,"anticoncepcion, prevencion de its y de cancer de cuello uterino",metodos naturales: usuarias nuevas,2015-06-01,0,1,2,1,0,4
ICHOCA,"anticoncepcion, prevencion de its y de cancer de cuello uterino",metodos naturales: usuarias nuevas,2015-06-01,0,0,3,3,0,6
ICLA,"anticoncepcion, prevencion de its y de cancer de cuello uterino",metodos naturales: usuarias nuevas,2015-06-01,0,0,1,1,0,2
INCAHUASI,"anticoncepcion, prevencion de its y de cancer de cuello uterino",metodos naturales: usuarias nuevas,2015-06-01,0,5,10,3,0,18
INQUISIVI,"anticoncepcion, prevencion de its y de cancer de cuello uterino",metodos naturales: usuarias nuevas,2015-06-01,0,0,4,2,0,6
IRUPANA (VILLA DE LANZA),"anticoncepcion, prevencion de its y de cancer de cuello uterino",metodos naturales: usuarias nuevas,2015-06-01,0,0,3,0,0,3
IXIAMAS,"anticoncepcion, prevencion de its y de cancer de cuello uterino",metodos naturales: usuarias nuevas,2015-06-01,0,4,5,0,0,9
JESUS DE MACHACA,"anticoncepcion, prevencion de its y de cancer de cuello uterino",metodos naturales: usuarias nuevas,2015-06-01,0,0,4,1,0,5
LA ASUNTA,"anticoncepcion, prevencion de its y de cancer de cuello uterino",metodos naturales: usuarias nuevas,2015-06-01,0,2,9,3,0,14
LA PAZ,"anticoncepcion, prevencion de its y de cancer de cuello uterino",metodos naturales: usuarias nuevas,2015-06-01,1,42,190,41,0,274
LAGUNILLAS,"anticoncepcion, prevencion de its y de cancer de cuello uterino",metodos naturales: usuarias nuevas,2015-06-01,0,2,4,0,0,6
LAJA,"anticoncepcion, prevencion de its y de cancer de cuello uterino",metodos naturales: usuarias nuevas,2015-06-01,0,3,8,0,0,11
LICOMA PAMPA,"anticoncepcion, prevencion de its y de cancer de cuello uterino",metodos naturales: usuarias nuevas,2015-06-01,0,0,1,0,0,1
LLALLAGUA,"anticoncepcion, prevencion de its y de cancer de cuello uterino",metodos naturales: usuarias nuevas,2015-06-01,0,0,1,0,0,1
LORETO,"anticoncepcion, prevencion de its y de cancer de cuello uterino",metodos naturales: usuarias nuevas,2015-06-01,0,0,3,0,0,3
MACHACAMARCA,"anticoncepcion, prevencion de its y de cancer de cuello uterino",metodos naturales: usuarias nuevas,2015-06-01,0,0,1,0,0,1
MAGDALENA,"anticoncepcion, prevencion de its y de cancer de cuello uterino",metodos naturales: usuarias nuevas,2015-06-01,2,0,2,0,0,4
MAPIRI,"anticoncepcion, prevencion de its y de cancer de cuello uterino",metodos naturales: usuarias nuevas,2015-06-01,0,2,8,2,1,13
MINEROS,"anticoncepcion, prevencion de its y de cancer de cuello uterino",metodos naturales: usuarias nuevas,2015-06-01,0,1,0,0,0,1
MOCOMOCO,"anticoncepcion, prevencion de its y de cancer de cuello uterino",metodos naturales: usuarias nuevas,2015-06-01,0,1,6,2,0,9
MOJINETE,"anticoncepcion, prevencion de its y de cancer de cuello uterino",metodos naturales: usuarias nuevas,2015-06-01,0,0,2,0,0,2
MOJOCOYA,"anticoncepcion, prevencion de its y de cancer de cuello uterino",metodos naturales: usuarias nuevas,2015-06-01,0,1,6,0,0,7
MONTEAGUDO,"anticoncepcion, prevencion de its y de cancer de cuello uterino",metodos naturales: usuarias nuevas,2015-06-01,1,0,0,0,0,1
MONTERO,"anticoncepcion, prevencion de its y de cancer de cuello uterino",metodos naturales: usuarias nuevas,2015-06-01,0,3,3,0,0,6
MOROCHATA,"anticoncepcion, prevencion de its y de cancer de cuello uterino",metodos naturales: usuarias nuevas,2015-06-01,0,2,8,2,0,12
NUEVO MANOA (NUEVA ESPERANZA),"anticoncepcion, prevencion de its y de cancer de cuello uterino",metodos naturales: usuarias nuevas,2015-06-01,0,0,1,0,0,1
OCURI,"anticoncepcion, prevencion de its y de cancer de cuello uterino",metodos naturales: usuarias nuevas,2015-06-01,0,3,8,6,0,17
OMEREQUE,"anticoncepcion, prevencion de its y de cancer de cuello uterino",metodos naturales: usuarias nuevas,2015-06-01,0,5,1,2,0,8
ORURO,"anticoncepcion, prevencion de its y de cancer de cuello uterino",metodos naturales: usuarias nuevas,2015-06-01,0,4,8,2,0,14
PADILLA,"anticoncepcion, prevencion de its y de cancer de cuello uterino",metodos naturales: usuarias nuevas,2015-06-01,0,2,11,0,0,13
PAILON,"anticoncepcion, prevencion de its y de cancer de cuello uterino",metodos naturales: usuarias nuevas,2015-06-01,0,1,0,0,0,1
PALCA,"anticoncepcion, prevencion de its y de cancer de cuello uterino",metodos naturales: usuarias nuevas,2015-06-01,0,1,4,0,0,5
PAMPA AULLAGAS,"anticoncepcion, prevencion de its y de cancer de cuello uterino",metodos naturales: usuarias nuevas,2015-06-01,0,0,1,1,0,2
PAPEL PAMPA,"anticoncepcion, prevencion de its y de cancer de cuello uterino",metodos naturales: usuarias nuevas,2015-06-01,0,0,2,0,0,2
PAZÑA,"anticoncepcion, prevencion de its y de cancer de cuello uterino",metodos naturales: usuarias nuevas,2015-06-01,0,0,3,1,0,4
PELECHUCO,"anticoncepcion, prevencion de its y de cancer de cuello uterino",metodos naturales: usuarias nuevas,2015-06-01,0,0,3,2,0,5
POCOATA,"anticoncepcion, prevencion de its y de cancer de cuello uterino",metodos naturales: usuarias nuevas,2015-06-01,0,8,16,8,0,32
POCONA,"anticoncepcion, prevencion de its y de cancer de cuello uterino",metodos naturales: usuarias nuevas,2015-06-01,0,2,2,2,0,6
POOPO,"anticoncepcion, prevencion de its y de cancer de cuello uterino",metodos naturales: usuarias nuevas,2015-06-01,0,0,0,1,0,1
PORCO,"anticoncepcion, prevencion de its y de cancer de cuello uterino",metodos naturales: usuarias nuevas,2015-06-01,0,3,7,1,0,11
POROMA,"anticoncepcion, prevencion de its y de cancer de cuello uterino",metodos naturales: usuarias nuevas,2015-06-01,0,2,1,0,0,3
PORONGO,"anticoncepcion, prevencion de its y de cancer de cuello uterino",metodos naturales: usuarias nuevas,2015-06-01,0,3,4,0,0,7
PORTACHUELO,"anticoncepcion, prevencion de its y de cancer de cuello uterino",metodos naturales: usuarias nuevas,2015-06-01,1,1,2,0,0,4
POTOSI,"anticoncepcion, prevencion de its y de cancer de cuello uterino",metodos naturales: usuarias nuevas,2015-06-01,0,15,39,130,0,184
PRESTO,"anticoncepcion, prevencion de its y de cancer de cuello uterino",metodos naturales: usuarias nuevas,2015-06-01,0,0,1,1,0,2
PUCARANI,"anticoncepcion, prevencion de its y de cancer de cuello uterino",metodos naturales: usuarias nuevas,2015-06-01,0,4,11,2,0,17
PUERTO ACOSTA,"anticoncepcion, prevencion de its y de cancer de cuello uterino",metodos naturales: usuarias nuevas,2015-06-01,0,2,2,0,0,4
PUERTO CARABUCO,"anticoncepcion, prevencion de its y de cancer de cuello uterino",metodos naturales: usuarias nuevas,2015-06-01,0,1,2,1,0,4
PUERTO GONZALO MORENO,"anticoncepcion, prevencion de its y de cancer de cuello uterino",metodos naturales: usuarias nuevas,2015-06-01,0,4,3,0,0,7
PUERTO PEREZ,"anticoncepcion, prevencion de its y de cancer de cuello uterino",metodos naturales: usuarias nuevas,2015-06-01,0,0,1,1,0,2
PUERTO QUIJARRO,"anticoncepcion, prevencion de its y de cancer de cuello uterino",metodos naturales: usuarias nuevas,2015-06-01,1,4,5,5,0,15
PUERTO RICO,"anticoncepcion, prevencion de its y de cancer de cuello uterino",metodos naturales: usuarias nuevas,2015-06-01,0,0,1,0,0,1
PUERTO VILLARROEL,"anticoncepcion, prevencion de its y de cancer de cuello uterino",metodos naturales: usuarias nuevas,2015-06-01,4,5,17,2,0,28
PUNA,"anticoncepcion, prevencion de its y de cancer de cuello uterino",metodos naturales: usuarias nuevas,2015-06-01,0,1,2,0,0,3
PUNATA,"anticoncepcion, prevencion de its y de cancer de cuello uterino",metodos naturales: usuarias nuevas,2015-06-01,0,0,8,1,0,9
QUILLACOLLO,"anticoncepcion, prevencion de its y de cancer de cuello uterino",metodos naturales: usuarias nuevas,2015-06-01,0,2,7,3,0,12
QUIME,"anticoncepcion, prevencion de its y de cancer de cuello uterino",metodos naturales: usuarias nuevas,2015-06-01,0,0,5,1,0,6
RAVELO,"anticoncepcion, prevencion de its y de cancer de cuello uterino",metodos naturales: usuarias nuevas,2015-06-01,0,2,5,4,0,11
REYES,"anticoncepcion, prevencion de its y de cancer de cuello uterino",metodos naturales: usuarias nuevas,2015-06-01,3,23,40,17,0,83
RIBERALTA,"anticoncepcion, prevencion de its y de cancer de cuello uterino",metodos naturales: usuarias nuevas,2015-06-01,3,53,121,17,0,194
RURRENABAQUE,"anticoncepcion, prevencion de its y de cancer de cuello uterino",metodos naturales: usuarias nuevas,2015-06-01,0,1,0,0,0,1
SABAYA,"anticoncepcion, prevencion de its y de cancer de cuello uterino",metodos naturales: usuarias nuevas,2015-06-01,0,0,4,0,0,4
SACABA,"anticoncepcion, prevencion de its y de cancer de cuello uterino",metodos naturales: usuarias nuevas,2015-06-01,0,0,19,21,0,40
SACACA,"anticoncepcion, prevencion de its y de cancer de cuello uterino",metodos naturales: usuarias nuevas,2015-06-01,1,2,5,0,0,8
SALINAS DE GARCI MENDOZA,"anticoncepcion, prevencion de its y de cancer de cuello uterino",metodos naturales: usuarias nuevas,2015-06-01,0,1,1,0,0,2
SAMAIPATA,"anticoncepcion, prevencion de its y de cancer de cuello uterino",metodos naturales: usuarias nuevas,2015-06-01,0,0,1,0,0,1
SAN ANDRES,"anticoncepcion, prevencion de its y de cancer de cuello uterino",metodos naturales: usuarias nuevas,2015-06-01,0,2,1,0,0,3
SAN ANDRES DE MACHACA,"anticoncepcion, prevencion de its y de cancer de cuello uterino",metodos naturales: usuarias nuevas,2015-06-01,0,1,6,0,0,7
SAN ANTONIO DE ESMORUCO,"anticoncepcion, prevencion de its y de cancer de cuello uterino",metodos naturales: usuarias nuevas,2015-06-01,0,2,1,0,0,3
SAN ANTONIO DE LOMERIO,"anticoncepcion, prevencion de its y de cancer de cuello uterino",metodos naturales: usuarias nuevas,2015-06-01,0,2,9,0,0,11
SAN BENITO,"anticoncepcion, prevencion de its y de cancer de cuello uterino",metodos naturales: usuarias nuevas,2015-06-01,0,1,0,0,0,1
SAN BORJA,"anticoncepcion, prevencion de its y de cancer de cuello uterino",metodos naturales: usuarias nuevas,2015-06-01,1,14,5,1,0,21
SAN BUENA VENTURA,"anticoncepcion, prevencion de its y de cancer de cuello uterino",metodos naturales: usuarias nuevas,2015-06-01,0,5,17,0,0,22
SAN CARLOS,"anticoncepcion, prevencion de its y de cancer de cuello uterino",metodos naturales: usuarias nuevas,2015-06-01,0,7,33,6,0,46
SAN IGNACIO,"anticoncepcion, prevencion de its y de cancer de cuello uterino",metodos naturales: usuarias nuevas,2015-06-01,0,1,0,0,0,1
SAN JOSE DE CHIQUITOS,"anticoncepcion, prevencion de its y de cancer de cuello uterino",metodos naturales: usuarias nuevas,2015-06-01,0,0,4,0,0,4
SAN JUAN DE YAPACANI,"anticoncepcion, prevencion de its y de cancer de cuello uterino",metodos naturales: usuarias nuevas,2015-06-01,0,2,0,0,0,2
SAN JULIAN,"anticoncepcion, prevencion de its y de cancer de cuello uterino",metodos naturales: usuarias nuevas,2015-06-01,0,2,0,0,0,2
SAN LORENZO(PND),"anticoncepcion, prevencion de its y de cancer de cuello uterino",metodos naturales: usuarias nuevas,2015-06-01,0,3,1,0,0,4
SAN LORENZO(TJA),"anticoncepcion, prevencion de its y de cancer de cuello uterino",metodos naturales: usuarias nuevas,2015-06-01,0,1,0,0,0,1
SAN LUCAS,"anticoncepcion, prevencion de its y de cancer de cuello uterino",metodos naturales: usuarias nuevas,2015-06-01,0,4,7,2,0,13
SAN MATIAS,"anticoncepcion, prevencion de its y de cancer de cuello uterino",metodos naturales: usuarias nuevas,2015-06-01,0,4,16,3,0,23
SAN MIGUEL DE VELASCO,"anticoncepcion, prevencion de its y de cancer de cuello uterino",metodos naturales: usuarias nuevas,2015-06-01,1,6,2,0,0,9
SAN PEDRO,"anticoncepcion, prevencion de its y de cancer de cuello uterino",metodos naturales: usuarias nuevas,2015-06-01,0,0,1,1,0,2
SAN PEDRO DE BUENA VISTA,"anticoncepcion, prevencion de its y de cancer de cuello uterino",metodos naturales: usuarias nuevas,2015-06-01,0,2,9,3,0,14
SAN PEDRO DE QUEMES,"anticoncepcion, prevencion de its y de cancer de cuello uterino",metodos naturales: usuarias nuevas,2015-06-01,1,0,0,0,0,1
SAN PEDRO DE TIQUINA,"anticoncepcion, prevencion de its y de cancer de cuello uterino",metodos naturales: usuarias nuevas,2015-06-01,0,0,2,1,0,3
SAN RAFAEL,"anticoncepcion, prevencion de its y de cancer de cuello uterino",metodos naturales: usuarias nuevas,2015-06-01,2,2,3,1,0,8
SANTA ANA,"anticoncepcion, prevencion de its y de cancer de cuello uterino",metodos naturales: usuarias nuevas,2015-06-01,8,10,12,2,0,32
SANTA CRUZ DE LA SIERRA,"anticoncepcion, prevencion de its y de cancer de cuello uterino",metodos naturales: usuarias nuevas,2015-06-01,1,8,65,27,0,101
SANTA ROSA,"anticoncepcion, prevencion de its y de cancer de cuello uterino",metodos naturales: usuarias nuevas,2015-06-01,0,3,2,0,0,5
SANTA ROSA DEL SARA,"anticoncepcion, prevencion de its y de cancer de cuello uterino",metodos naturales: usuarias nuevas,2015-06-01,0,2,5,2,0,9
SANTIAGO DE HUARI,"anticoncepcion, prevencion de its y de cancer de cuello uterino",metodos naturales: usuarias nuevas,2015-06-01,0,2,7,1,0,10
SANTIAGO DE HUATA,"anticoncepcion, prevencion de its y de cancer de cuello uterino",metodos naturales: usuarias nuevas,2015-06-01,0,0,1,0,0,1
SANTIAGO DE MACHACA,"anticoncepcion, prevencion de its y de cancer de cuello uterino",metodos naturales: usuarias nuevas,2015-06-01,0,1,0,1,0,2
SAPAHAQUI,"anticoncepcion, prevencion de its y de cancer de cuello uterino",metodos naturales: usuarias nuevas,2015-06-01,0,0,0,1,0,1
SENA,"anticoncepcion, prevencion de its y de cancer de cuello uterino",metodos naturales: usuarias nuevas,2015-06-01,0,3,3,2,0,8
SHINAOTA,"anticoncepcion, prevencion de its y de cancer de cuello uterino",metodos naturales: usuarias nuevas,2015-06-01,0,0,0,1,0,1
SIPE SIPE,"anticoncepcion, prevencion de its y de cancer de cuello uterino",metodos naturales: usuarias nuevas,2015-06-01,0,0,1,0,0,1
SOPACHUY,"anticoncepcion, prevencion de its y de cancer de cuello uterino",metodos naturales: usuarias nuevas,2015-06-01,0,1,4,3,0,8
SORACACHI,"anticoncepcion, prevencion de its y de cancer de cuello uterino",metodos naturales: usuarias nuevas,2015-06-01,0,1,5,0,0,6
SUCRE,"anticoncepcion, prevencion de its y de cancer de cuello uterino",metodos naturales: usuarias nuevas,2015-06-01,1,31,107,28,0,167
TACOPAYA,"anticoncepcion, prevencion de its y de cancer de cuello uterino",metodos naturales: usuarias nuevas,2015-06-01,0,3,4,1,0,8
TAHUA,"anticoncepcion, prevencion de its y de cancer de cuello uterino",metodos naturales: usuarias nuevas,2015-06-01,0,1,1,0,0,2
TAPACARI,"anticoncepcion, prevencion de its y de cancer de cuello uterino",metodos naturales: usuarias nuevas,2015-06-01,0,0,7,3,0,10
TARACO,"anticoncepcion, prevencion de its y de cancer de cuello uterino",metodos naturales: usuarias nuevas,2015-06-01,0,3,2,0,0,5
TARIJA,"anticoncepcion, prevencion de its y de cancer de cuello uterino",metodos naturales: usuarias nuevas,2015-06-01,0,0,10,4,0,14
TARVITA,"anticoncepcion, prevencion de its y de cancer de cuello uterino",metodos naturales: usuarias nuevas,2015-06-01,0,1,1,1,0,3
TIAWANACU,"anticoncepcion, prevencion de its y de cancer de cuello uterino",metodos naturales: usuarias nuevas,2015-06-01,0,4,4,1,0,9
TIQUIPAYA,"anticoncepcion, prevencion de its y de cancer de cuello uterino",metodos naturales: usuarias nuevas,2015-06-01,0,1,0,0,0,1
TIRAQUE (CBBA),"anticoncepcion, prevencion de its y de cancer de cuello uterino",metodos naturales: usuarias nuevas,2015-06-01,0,1,0,1,0,2
TITO YUPANQUI (PARQUIPUJIO),"anticoncepcion, prevencion de its y de cancer de cuello uterino",metodos naturales: usuarias nuevas,2015-06-01,0,0,10,0,0,10
TOLATA,"anticoncepcion, prevencion de its y de cancer de cuello uterino",metodos naturales: usuarias nuevas,2015-06-01,0,1,0,0,0,1
TOMINA,"anticoncepcion, prevencion de its y de cancer de cuello uterino",metodos naturales: usuarias nuevas,2015-06-01,0,3,10,0,0,13
TOTORA(CBBA),"anticoncepcion, prevencion de its y de cancer de cuello uterino",metodos naturales: usuarias nuevas,2015-06-01,0,1,0,0,0,1
TOTORA(ORR),"anticoncepcion, prevencion de its y de cancer de cuello uterino",metodos naturales: usuarias nuevas,2015-06-01,0,4,1,0,0,5
TRINIDAD,"anticoncepcion, prevencion de its y de cancer de cuello uterino",metodos naturales: usuarias nuevas,2015-06-01,0,19,27,6,0,52
TURCO,"anticoncepcion, prevencion de its y de cancer de cuello uterino",metodos naturales: usuarias nuevas,2015-06-01,0,0,0,1,0,1
UNCIA,"anticoncepcion, prevencion de its y de cancer de cuello uterino",metodos naturales: usuarias nuevas,2015-06-01,0,1,6,0,0,7
VACAS,"anticoncepcion, prevencion de its y de cancer de cuello uterino",metodos naturales: usuarias nuevas,2015-06-01,0,1,4,3,0,8
VILLA CHARCAS,"anticoncepcion, prevencion de its y de cancer de cuello uterino",metodos naturales: usuarias nuevas,2015-06-01,0,5,1,0,0,6
VILLA RIVERO,"anticoncepcion, prevencion de its y de cancer de cuello uterino",metodos naturales: usuarias nuevas,2015-06-01,0,1,2,0,0,3
VILLA SERRANO,"anticoncepcion, prevencion de its y de cancer de cuello uterino",metodos naturales: usuarias nuevas,2015-06-01,1,2,1,0,0,4
VILLA TUNARI,"anticoncepcion, prevencion de its y de cancer de cuello uterino",metodos naturales: usuarias nuevas,2015-06-01,0,1,8,2,0,11
VILLA VACA GUZMAN (MUYUPAMPA),"anticoncepcion, prevencion de its y de cancer de cuello uterino",metodos naturales: usuarias nuevas,2015-06-01,0,2,1,0,0,3
VINTO,"anticoncepcion, prevencion de its y de cancer de cuello uterino",metodos naturales: usuarias nuevas,2015-06-01,0,1,6,2,0,9
VITICHI,"anticoncepcion, prevencion de its y de cancer de cuello uterino",metodos naturales: usuarias nuevas,2015-06-01,0,0,2,0,0,2
WARNES,"anticoncepcion, prevencion de its y de cancer de cuello uterino",metodos naturales: usuarias nuevas,2015-06-01,0,4,18,1,0,23
YACO,"anticoncepcion, prevencion de its y de cancer de cuello uterino",metodos naturales: usuarias nuevas,2015-06-01,0,1,2,0,0,3
YACUIBA,"anticoncepcion, prevencion de its y de cancer de cuello uterino",metodos naturales: usuarias nuevas,2015-06-01,0,8,15,1,0,24
YANACACHI,"anticoncepcion, prevencion de its y de cancer de cuello uterino",metodos naturales: usuarias nuevas,2015-06-01,0,2,2,0,0,4
YAPACANI,"anticoncepcion, prevencion de its y de cancer de cuello uterino",metodos naturales: usuarias nuevas,2015-06-01,0,9,19,1,0,29
YOCALLA,"anticoncepcion, prevencion de its y de cancer de cuello uterino",metodos naturales: usuarias nuevas,2015-06-01,0,0,2,0,0,2
YOTALA,"anticoncepcion, prevencion de its y de cancer de cuello uterino",metodos naturales: usuarias nuevas,2015-06-01,0,1,3,0,0,4
ZUDAÑEZ,"anticoncepcion, prevencion de its y de cancer de cuello uterino",metodos naturales: usuarias nuevas,2015-06-01,0,2,2,2,0,6
ACACIO,"anticoncepcion, prevencion de its y de cancer de cuello uterino",metodos naturales: usuarias nuevas,2015-07-01,0,2,2,1,0,5
ACHACACHI,"anticoncepcion, prevencion de its y de cancer de cuello uterino",metodos naturales: usuarias nuevas,2015-07-01,0,1,8,1,0,10
ACHOCALLA,"anticoncepcion, prevencion de its y de cancer de cuello uterino",metodos naturales: usuarias nuevas,2015-07-01,0,0,2,0,0,2
AIQUILE,"anticoncepcion, prevencion de its y de cancer de cuello uterino",metodos naturales: usuarias nuevas,2015-07-01,0,0,0,2,0,2
ALALAY,"anticoncepcion, prevencion de its y de cancer de cuello uterino",metodos naturales: usuarias nuevas,2015-07-01,0,0,2,0,0,2
ALCALA,"anticoncepcion, prevencion de its y de cancer de cuello uterino",metodos naturales: usuarias nuevas,2015-07-01,0,0,0,2,0,2
ANCORAIMES,"anticoncepcion, prevencion de its y de cancer de cuello uterino",metodos naturales: usuarias nuevas,2015-07-01,0,5,12,6,0,23
ANDAMARCA,"anticoncepcion, prevencion de its y de cancer de cuello uterino",metodos naturales: usuarias nuevas,2015-07-01,0,1,0,1,0,2
ANTEQUERA,"anticoncepcion, prevencion de its y de cancer de cuello uterino",metodos naturales: usuarias nuevas,2015-07-01,0,0,1,0,0,1
ANZALDO,"anticoncepcion, prevencion de its y de cancer de cuello uterino",metodos naturales: usuarias nuevas,2015-07-01,0,0,1,1,0,2
APOLO,"anticoncepcion, prevencion de its y de cancer de cuello uterino",metodos naturales: usuarias nuevas,2015-07-01,0,0,3,0,0,3
ARAMPAMPA,"anticoncepcion, prevencion de its y de cancer de cuello uterino",metodos naturales: usuarias nuevas,2015-07-01,0,0,1,0,0,1
ARBIETO,"anticoncepcion, prevencion de its y de cancer de cuello uterino",metodos naturales: usuarias nuevas,2015-07-01,0,11,6,3,0,20
ARQUE,"anticoncepcion, prevencion de its y de cancer de cuello uterino",metodos naturales: usuarias nuevas,2015-07-01,0,0,1,0,0,1
ATOCHA,"anticoncepcion, prevencion de its y de cancer de cuello uterino",metodos naturales: usuarias nuevas,2015-07-01,0,0,1,0,0,1
AYO AYO,"anticoncepcion, prevencion de its y de cancer de cuello uterino",metodos naturales: usuarias nuevas,2015-07-01,0,2,1,0,0,3
BATALLAS,"anticoncepcion, prevencion de its y de cancer de cuello uterino",metodos naturales: usuarias nuevas,2015-07-01,0,1,1,1,0,3
BAURES,"anticoncepcion, prevencion de its y de cancer de cuello uterino",metodos naturales: usuarias nuevas,2015-07-01,0,0,2,0,0,2
BELLA FLOR,"anticoncepcion, prevencion de its y de cancer de cuello uterino",metodos naturales: usuarias nuevas,2015-07-01,0,0,1,0,0,1
BETANZOS,"anticoncepcion, prevencion de its y de cancer de cuello uterino",metodos naturales: usuarias nuevas,2015-07-01,0,4,10,4,0,18
BUENA VISTA,"anticoncepcion, prevencion de its y de cancer de cuello uterino",metodos naturales: usuarias nuevas,2015-07-01,0,2,0,0,0,2
CAJUATA,"anticoncepcion, prevencion de its y de cancer de cuello uterino",metodos naturales: usuarias nuevas,2015-07-01,0,8,9,0,0,17
CALAMARCA,"anticoncepcion, prevencion de its y de cancer de cuello uterino",metodos naturales: usuarias nuevas,2015-07-01,0,3,3,0,0,6
CAMARGO,"anticoncepcion, prevencion de its y de cancer de cuello uterino",metodos naturales: usuarias nuevas,2015-07-01,0,0,1,0,0,1
CAPINOTA,"anticoncepcion, prevencion de its y de cancer de cuello uterino",metodos naturales: usuarias nuevas,2015-07-01,0,0,0,1,0,1
CARACOLLO,"anticoncepcion, prevencion de its y de cancer de cuello uterino",metodos naturales: usuarias nuevas,2015-07-01,0,4,19,3,0,26
CHALLAPATA,"anticoncepcion, prevencion de its y de cancer de cuello uterino",metodos naturales: usuarias nuevas,2015-07-01,0,3,48,7,0,58
CHAQUI,"anticoncepcion, prevencion de its y de cancer de cuello uterino",metodos naturales: usuarias nuevas,2015-07-01,0,2,5,1,0,8
CHAYANTA,"anticoncepcion, prevencion de its y de cancer de cuello uterino",metodos naturales: usuarias nuevas,2015-07-01,0,9,8,9,0,26
CHOQUE COTA,"anticoncepcion, prevencion de its y de cancer de cuello uterino",metodos naturales: usuarias nuevas,2015-07-01,0,1,2,0,0,3
CHUA COCANI,"anticoncepcion, prevencion de its y de cancer de cuello uterino",metodos naturales: usuarias nuevas,2015-07-01,0,0,3,1,0,4
CHULUMANI (V. DE LA LIBERTAD),"anticoncepcion, prevencion de its y de cancer de cuello uterino",metodos naturales: usuarias nuevas,2015-07-01,1,8,13,5,0,27
CHUQUIHUTA AYLLU JUCUMANI,"anticoncepcion, prevencion de its y de cancer de cuello uterino",metodos naturales: usuarias nuevas,2015-07-01,0,1,0,2,0,3
CKOCHAS,"anticoncepcion, prevencion de its y de cancer de cuello uterino",metodos naturales: usuarias nuevas,2015-07-01,0,3,8,2,0,13
CLIZA,"anticoncepcion, prevencion de its y de cancer de cuello uterino",metodos naturales: usuarias nuevas,2015-07-01,1,0,1,1,0,3
COBIJA,"anticoncepcion, prevencion de its y de cancer de cuello uterino",metodos naturales: usuarias nuevas,2015-07-01,0,7,33,16,0,56
COCAPATA,"anticoncepcion, prevencion de its y de cancer de cuello uterino",metodos naturales: usuarias nuevas,2015-07-01,0,1,7,0,0,8
COCHABAMBA,"anticoncepcion, prevencion de its y de cancer de cuello uterino",metodos naturales: usuarias nuevas,2015-07-01,1,18,63,35,0,117
COLCAPIRHUA,"anticoncepcion, prevencion de its y de cancer de cuello uterino",metodos naturales: usuarias nuevas,2015-07-01,0,0,1,0,0,1
"COLCHA ""K""","anticoncepcion, prevencion de its y de cancer de cuello uterino",metodos naturales: usuarias nuevas,2015-07-01,0,3,1,1,0,5
COLLANA,"anticoncepcion, prevencion de its y de cancer de cuello uterino",metodos naturales: usuarias nuevas,2015-07-01,0,2,0,0,0,2
COLOMI,"anticoncepcion, prevencion de its y de cancer de cuello uterino",metodos naturales: usuarias nuevas,2015-07-01,0,1,3,0,0,4
COLPA BELGICA,"anticoncepcion, prevencion de its y de cancer de cuello uterino",metodos naturales: usuarias nuevas,2015-07-01,0,1,0,0,0,1
COLQUECHACA,"anticoncepcion, prevencion de its y de cancer de cuello uterino",metodos naturales: usuarias nuevas,2015-07-01,0,2,8,2,0,12
COLQUIRI,"anticoncepcion, prevencion de its y de cancer de cuello uterino",metodos naturales: usuarias nuevas,2015-07-01,0,7,13,4,0,24
COMANCHE,"anticoncepcion, prevencion de its y de cancer de cuello uterino",metodos naturales: usuarias nuevas,2015-07-01,0,1,2,0,0,3
COMARAPA,"anticoncepcion, prevencion de its y de cancer de cuello uterino",metodos naturales: usuarias nuevas,2015-07-01,1,8,21,4,0,34
CORIPATA,"anticoncepcion, prevencion de its y de cancer de cuello uterino",metodos naturales: usuarias nuevas,2015-07-01,0,1,4,0,0,5
CORO CORO,"anticoncepcion, prevencion de its y de cancer de cuello uterino",metodos naturales: usuarias nuevas,2015-07-01,0,0,1,2,0,3
CORQUE,"anticoncepcion, prevencion de its y de cancer de cuello uterino",metodos naturales: usuarias nuevas,2015-07-01,0,0,1,0,0,1
COTAGAITA,"anticoncepcion, prevencion de its y de cancer de cuello uterino",metodos naturales: usuarias nuevas,2015-07-01,0,3,0,0,0,3
COTOCA,"anticoncepcion, prevencion de its y de cancer de cuello uterino",metodos naturales: usuarias nuevas,2015-07-01,0,6,3,1,0,10
CULPINA,"anticoncepcion, prevencion de its y de cancer de cuello uterino",metodos naturales: usuarias nuevas,2015-07-01,1,5,5,3,0,14
EL ALTO,"anticoncepcion, prevencion de its y de cancer de cuello uterino",metodos naturales: usuarias nuevas,2015-07-01,1,45,155,322,2,525
EL CHORO,"anticoncepcion, prevencion de its y de cancer de cuello uterino",metodos naturales: usuarias nuevas,2015-07-01,0,0,2,0,0,2
EL PUENTE(STC),"anticoncepcion, prevencion de its y de cancer de cuello uterino",metodos naturales: usuarias nuevas,2015-07-01,0,2,2,2,0,6
EL VILLAR,"anticoncepcion, prevencion de its y de cancer de cuello uterino",metodos naturales: usuarias nuevas,2015-07-01,0,0,1,0,0,1
ENTRE RIOS TRJ,"anticoncepcion, prevencion de its y de cancer de cuello uterino",metodos naturales: usuarias nuevas,2015-07-01,1,3,12,2,0,18
ENTRE RIOS CBBA,"anticoncepcion, prevencion de its y de cancer de cuello uterino",metodos naturales: usuarias nuevas,2015-07-01,0,1,0,0,0,1
EUCALIPTUS,"anticoncepcion, prevencion de its y de cancer de cuello uterino",metodos naturales: usuarias nuevas,2015-07-01,0,2,2,2,0,6
EUREKA (SANTOS MERCADO),"anticoncepcion, prevencion de its y de cancer de cuello uterino",metodos naturales: usuarias nuevas,2015-07-01,0,0,2,0,0,2
EXALTACION,"anticoncepcion, prevencion de its y de cancer de cuello uterino",metodos naturales: usuarias nuevas,2015-07-01,1,0,1,0,0,2
FERNANDEZ ALONSO,"anticoncepcion, prevencion de its y de cancer de cuello uterino",metodos naturales: usuarias nuevas,2015-07-01,0,0,0,1,0,1
FILADELFIA,"anticoncepcion, prevencion de its y de cancer de cuello uterino",metodos naturales: usuarias nuevas,2015-07-01,0,0,1,0,0,1
GUAQUI,"anticoncepcion, prevencion de its y de cancer de cuello uterino",metodos naturales: usuarias nuevas,2015-07-01,0,5,3,1,0,9
GUAYARAMERIN,"anticoncepcion, prevencion de its y de cancer de cuello uterino",metodos naturales: usuarias nuevas,2015-07-01,0,21,49,4,0,74
HUACARETA,"anticoncepcion, prevencion de its y de cancer de cuello uterino",metodos naturales: usuarias nuevas,2015-07-01,0,3,4,2,0,9
HUACAYA (VILLA DE HUACAYA),"anticoncepcion, prevencion de its y de cancer de cuello uterino",metodos naturales: usuarias nuevas,2015-07-01,0,0,1,0,0,1
HUACHACALLA,"anticoncepcion, prevencion de its y de cancer de cuello uterino",metodos naturales: usuarias nuevas,2015-07-01,0,1,6,1,0,8
HUANUNI,"anticoncepcion, prevencion de its y de cancer de cuello uterino",metodos naturales: usuarias nuevas,2015-07-01,0,3,19,5,0,27
HUAYLLAMARCA,"anticoncepcion, prevencion de its y de cancer de cuello uterino",metodos naturales: usuarias nuevas,2015-07-01,0,0,3,0,0,3
ICHOCA,"anticoncepcion, prevencion de its y de cancer de cuello uterino",metodos naturales: usuarias nuevas,2015-07-01,0,3,2,0,0,5
ICLA,"anticoncepcion, prevencion de its y de cancer de cuello uterino",metodos naturales: usuarias nuevas,2015-07-01,0,0,5,2,0,7
INCAHUASI,"anticoncepcion, prevencion de its y de cancer de cuello uterino",metodos naturales: usuarias nuevas,2015-07-01,1,4,12,2,0,19
INGAVI (HUMAITA),"anticoncepcion, prevencion de its y de cancer de cuello uterino",metodos naturales: usuarias nuevas,2015-07-01,0,0,2,0,0,2
INQUISIVI,"anticoncepcion, prevencion de its y de cancer de cuello uterino",metodos naturales: usuarias nuevas,2015-07-01,0,3,8,0,0,11
IRUPANA (VILLA DE LANZA),"anticoncepcion, prevencion de its y de cancer de cuello uterino",metodos naturales: usuarias nuevas,2015-07-01,0,0,2,0,0,2
IXIAMAS,"anticoncepcion, prevencion de its y de cancer de cuello uterino",metodos naturales: usuarias nuevas,2015-07-01,0,0,1,0,0,1
JESUS DE MACHACA,"anticoncepcion, prevencion de its y de cancer de cuello uterino",metodos naturales: usuarias nuevas,2015-07-01,0,3,11,2,0,16
LA ASUNTA,"anticoncepcion, prevencion de its y de cancer de cuello uterino",metodos naturales: usuarias nuevas,2015-07-01,0,2,8,2,0,12
LA GUARDIA,"anticoncepcion, prevencion de its y de cancer de cuello uterino",metodos naturales: usuarias nuevas,2015-07-01,0,0,1,0,0,1
LA PAZ,"anticoncepcion, prevencion de its y de cancer de cuello uterino",metodos naturales: usuarias nuevas,2015-07-01,0,45,192,39,0,276
LAGUNILLAS,"anticoncepcion, prevencion de its y de cancer de cuello uterino",metodos naturales: usuarias nuevas,2015-07-01,0,0,1,0,0,1
LAJA,"anticoncepcion, prevencion de its y de cancer de cuello uterino",metodos naturales: usuarias nuevas,2015-07-01,0,2,9,0,0,11
LICOMA PAMPA,"anticoncepcion, prevencion de its y de cancer de cuello uterino",metodos naturales: usuarias nuevas,2015-07-01,0,0,3,0,0,3
LLALLAGUA,"anticoncepcion, prevencion de its y de cancer de cuello uterino",metodos naturales: usuarias nuevas,2015-07-01,0,1,1,0,0,2
LORETO,"anticoncepcion, prevencion de its y de cancer de cuello uterino",metodos naturales: usuarias nuevas,2015-07-01,0,1,3,0,0,4
MACHACAMARCA,"anticoncepcion, prevencion de its y de cancer de cuello uterino",metodos naturales: usuarias nuevas,2015-07-01,0,0,1,0,0,1
MAGDALENA,"anticoncepcion, prevencion de its y de cancer de cuello uterino",metodos naturales: usuarias nuevas,2015-07-01,0,4,2,0,0,6
MECAPACA,"anticoncepcion, prevencion de its y de cancer de cuello uterino",metodos naturales: usuarias nuevas,2015-07-01,0,0,0,1,0,1
MINEROS,"anticoncepcion, prevencion de its y de cancer de cuello uterino",metodos naturales: usuarias nuevas,2015-07-01,0,0,1,0,0,1
MOCOMOCO,"anticoncepcion, prevencion de its y de cancer de cuello uterino",metodos naturales: usuarias nuevas,2015-07-01,0,2,4,0,0,6
MOJOCOYA,"anticoncepcion, prevencion de its y de cancer de cuello uterino",metodos naturales: usuarias nuevas,2015-07-01,0,2,1,0,0,3
MONTEAGUDO,"anticoncepcion, prevencion de its y de cancer de cuello uterino",metodos naturales: usuarias nuevas,2015-07-01,0,1,0,0,0,1
MONTERO,"anticoncepcion, prevencion de its y de cancer de cuello uterino",metodos naturales: usuarias nuevas,2015-07-01,0,0,3,0,0,3
MOROCHATA,"anticoncepcion, prevencion de its y de cancer de cuello uterino",metodos naturales: usuarias nuevas,2015-07-01,0,0,2,2,0,4
NACEBE (SANTA ROSA DEL ABUNA),"anticoncepcion, prevencion de its y de cancer de cuello uterino",metodos naturales: usuarias nuevas,2015-07-01,0,2,0,0,0,2
NUEVO MANOA (NUEVA ESPERANZA),"anticoncepcion, prevencion de its y de cancer de cuello uterino",metodos naturales: usuarias nuevas,2015-07-01,0,2,5,0,0,7
OCURI,"anticoncepcion, prevencion de its y de cancer de cuello uterino",metodos naturales: usuarias nuevas,2015-07-01,0,1,3,2,0,6
OMEREQUE,"anticoncepcion, prevencion de its y de cancer de cuello uterino",metodos naturales: usuarias nuevas,2015-07-01,0,2,3,1,0,6
ORURO,"anticoncepcion, prevencion de its y de cancer de cuello uterino",metodos naturales: usuarias nuevas,2015-07-01,0,4,18,3,0,25
PADILLA,"anticoncepcion, prevencion de its y de cancer de cuello uterino",metodos naturales: usuarias nuevas,2015-07-01,0,5,11,1,0,17
PALCA,"anticoncepcion, prevencion de its y de cancer de cuello uterino",metodos naturales: usuarias nuevas,2015-07-01,0,1,3,0,0,4
PAMPA AULLAGAS,"anticoncepcion, prevencion de its y de cancer de cuello uterino",metodos naturales: usuarias nuevas,2015-07-01,0,2,3,1,0,6
PAPEL PAMPA,"anticoncepcion, prevencion de its y de cancer de cuello uterino",metodos naturales: usuarias nuevas,2015-07-01,0,0,1,0,0,1
PAZÑA,"anticoncepcion, prevencion de its y de cancer de cuello uterino",metodos naturales: usuarias nuevas,2015-07-01,0,1,1,0,0,2
PELECHUCO,"anticoncepcion, prevencion de its y de cancer de cuello uterino",metodos naturales: usuarias nuevas,2015-07-01,0,0,3,2,0,5
POCOATA,"anticoncepcion, prevencion de its y de cancer de cuello uterino",metodos naturales: usuarias nuevas,2015-07-01,0,9,26,8,0,43
POCONA,"anticoncepcion, prevencion de its y de cancer de cuello uterino",metodos naturales: usuarias nuevas,2015-07-01,0,2,2,1,0,5
PORCO,"anticoncepcion, prevencion de its y de cancer de cuello uterino",metodos naturales: usuarias nuevas,2015-07-01,0,2,5,0,0,7
POROMA,"anticoncepcion, prevencion de its y de cancer de cuello uterino",metodos naturales: usuarias nuevas,2015-07-01,0,5,3,2,0,10
PORONGO,"anticoncepcion, prevencion de its y de cancer de cuello uterino",metodos naturales: usuarias nuevas,2015-07-01,0,3,6,0,0,9
PORTACHUELO,"anticoncepcion, prevencion de its y de cancer de cuello uterino",metodos naturales: usuarias nuevas,2015-07-01,0,5,11,2,0,18
POTOSI,"anticoncepcion, prevencion de its y de cancer de cuello uterino",metodos naturales: usuarias nuevas,2015-07-01,0,4,9,41,0,54
PRESTO,"anticoncepcion, prevencion de its y de cancer de cuello uterino",metodos naturales: usuarias nuevas,2015-07-01,0,1,2,1,0,4
PUCARANI,"anticoncepcion, prevencion de its y de cancer de cuello uterino",metodos naturales: usuarias nuevas,2015-07-01,0,4,17,2,0,23
PUERTO ACOSTA,"anticoncepcion, prevencion de its y de cancer de cuello uterino",metodos naturales: usuarias nuevas,2015-07-01,0,2,0,0,0,2
PUERTO CARABUCO,"anticoncepcion, prevencion de its y de cancer de cuello uterino",metodos naturales: usuarias nuevas,2015-07-01,1,1,0,0,0,2
PUERTO GONZALO MORENO,"anticoncepcion, prevencion de its y de cancer de cuello uterino",metodos naturales: usuarias nuevas,2015-07-01,0,4,3,0,0,7
PUERTO PEREZ,"anticoncepcion, prevencion de its y de cancer de cuello uterino",metodos naturales: usuarias nuevas,2015-07-01,0,0,1,0,0,1
PUERTO RICO,"anticoncepcion, prevencion de its y de cancer de cuello uterino",metodos naturales: usuarias nuevas,2015-07-01,0,2,0,0,0,2
PUERTO VILLARROEL,"anticoncepcion, prevencion de its y de cancer de cuello uterino",metodos naturales: usuarias nuevas,2015-07-01,0,2,10,1,0,13
PUNA,"anticoncepcion, prevencion de its y de cancer de cuello uterino",metodos naturales: usuarias nuevas,2015-07-01,0,2,3,0,0,5
PUNATA,"anticoncepcion, prevencion de its y de cancer de cuello uterino",metodos naturales: usuarias nuevas,2015-07-01,0,0,8,2,0,10
QUILLACOLLO,"anticoncepcion, prevencion de its y de cancer de cuello uterino",metodos naturales: usuarias nuevas,2015-07-01,0,1,9,1,0,11
QUIME,"anticoncepcion, prevencion de its y de cancer de cuello uterino",metodos naturales: usuarias nuevas,2015-07-01,0,4,5,0,0,9
RAVELO,"anticoncepcion, prevencion de its y de cancer de cuello uterino",metodos naturales: usuarias nuevas,2015-07-01,0,1,0,0,0,1
REYES,"anticoncepcion, prevencion de its y de cancer de cuello uterino",metodos naturales: usuarias nuevas,2015-07-01,13,15,21,2,0,51
RIBERALTA,"anticoncepcion, prevencion de its y de cancer de cuello uterino",metodos naturales: usuarias nuevas,2015-07-01,2,43,99,13,0,157
RURRENABAQUE,"anticoncepcion, prevencion de its y de cancer de cuello uterino",metodos naturales: usuarias nuevas,2015-07-01,0,4,6,0,0,10
SACABA,"anticoncepcion, prevencion de its y de cancer de cuello uterino",metodos naturales: usuarias nuevas,2015-07-01,0,2,15,23,0,40
SACABAMBA,"anticoncepcion, prevencion de its y de cancer de cuello uterino",metodos naturales: usuarias nuevas,2015-07-01,0,1,1,0,0,2
SACACA,"anticoncepcion, prevencion de its y de cancer de cuello uterino",metodos naturales: usuarias nuevas,2015-07-01,0,0,0,2,0,2
SALINAS DE GARCI MENDOZA,"anticoncepcion, prevencion de its y de cancer de cuello uterino",metodos naturales: usuarias nuevas,2015-07-01,0,2,10,0,0,12
SAN ANDRES,"anticoncepcion, prevencion de its y de cancer de cuello uterino",metodos naturales: usuarias nuevas,2015-07-01,0,1,1,0,0,2
SAN ANDRES DE MACHACA,"anticoncepcion, prevencion de its y de cancer de cuello uterino",metodos naturales: usuarias nuevas,2015-07-01,0,0,1,1,0,2
SAN ANTONIO DE LOMERIO,"anticoncepcion, prevencion de its y de cancer de cuello uterino",metodos naturales: usuarias nuevas,2015-07-01,0,1,2,0,0,3
SAN BENITO,"anticoncepcion, prevencion de its y de cancer de cuello uterino",metodos naturales: usuarias nuevas,2015-07-01,0,0,7,2,0,9
SAN BORJA,"anticoncepcion, prevencion de its y de cancer de cuello uterino",metodos naturales: usuarias nuevas,2015-07-01,2,19,15,1,0,37
SAN BUENA VENTURA,"anticoncepcion, prevencion de its y de cancer de cuello uterino",metodos naturales: usuarias nuevas,2015-07-01,0,3,8,2,0,13
SAN CARLOS,"anticoncepcion, prevencion de its y de cancer de cuello uterino",metodos naturales: usuarias nuevas,2015-07-01,5,2,8,0,0,15
SAN IGNACIO,"anticoncepcion, prevencion de its y de cancer de cuello uterino",metodos naturales: usuarias nuevas,2015-07-01,1,2,4,0,0,7
SAN JAVIER(BNI),"anticoncepcion, prevencion de its y de cancer de cuello uterino",metodos naturales: usuarias nuevas,2015-07-01,0,2,1,0,0,3
SAN LORENZO(PND),"anticoncepcion, prevencion de its y de cancer de cuello uterino",metodos naturales: usuarias nuevas,2015-07-01,0,2,2,2,0,6
SAN LUCAS,"anticoncepcion, prevencion de its y de cancer de cuello uterino",metodos naturales: usuarias nuevas,2015-07-01,0,0,1,2,0,3
SAN MIGUEL DE VELASCO,"anticoncepcion, prevencion de its y de cancer de cuello uterino",metodos naturales: usuarias nuevas,2015-07-01,0,4,1,0,0,5
SAN PEDRO,"anticoncepcion, prevencion de its y de cancer de cuello uterino",metodos naturales: usuarias nuevas,2015-07-01,0,1,5,1,0,7
SAN PEDRO DE BUENA VISTA,"anticoncepcion, prevencion de its y de cancer de cuello uterino",metodos naturales: usuarias nuevas,2015-07-01,0,5,9,0,0,14
SAN PEDRO DE QUEMES,"anticoncepcion, prevencion de its y de cancer de cuello uterino",metodos naturales: usuarias nuevas,2015-07-01,0,1,0,0,0,1
SAN PEDRO DE TIQUINA,"anticoncepcion, prevencion de its y de cancer de cuello uterino",metodos naturales: usuarias nuevas,2015-07-01,0,1,3,2,0,6
SAN RAFAEL,"anticoncepcion, prevencion de its y de cancer de cuello uterino",metodos naturales: usuarias nuevas,2015-07-01,0,2,2,1,0,5
SAN RAMON BENI,"anticoncepcion, prevencion de its y de cancer de cuello uterino",metodos naturales: usuarias nuevas,2015-07-01,0,1,3,0,0,4
SANTA ANA,"anticoncepcion, prevencion de its y de cancer de cuello uterino",metodos naturales: usuarias nuevas,2015-07-01,1,15,24,0,0,40
SANTA CRUZ DE LA SIERRA,"anticoncepcion, prevencion de its y de cancer de cuello uterino",metodos naturales: usuarias nuevas,2015-07-01,0,7,54,8,0,69
SANTA ROSA,"anticoncepcion, prevencion de its y de cancer de cuello uterino",metodos naturales: usuarias nuevas,2015-07-01,0,3,0,0,0,3
SANTA ROSA DEL SARA,"anticoncepcion, prevencion de its y de cancer de cuello uterino",metodos naturales: usuarias nuevas,2015-07-01,0,1,3,0,0,4
SANTIAGO DE HUARI,"anticoncepcion, prevencion de its y de cancer de cuello uterino",metodos naturales: usuarias nuevas,2015-07-01,0,0,4,1,0,5
SANTIAGO DE HUATA,"anticoncepcion, prevencion de its y de cancer de cuello uterino",metodos naturales: usuarias nuevas,2015-07-01,0,0,0,1,0,1
SANTIAGO DE MACHACA,"anticoncepcion, prevencion de its y de cancer de cuello uterino",metodos naturales: usuarias nuevas,2015-07-01,0,0,3,0,0,3
SAPAHAQUI,"anticoncepcion, prevencion de its y de cancer de cuello uterino",metodos naturales: usuarias nuevas,2015-07-01,0,1,0,0,0,1
SENA,"anticoncepcion, prevencion de its y de cancer de cuello uterino",metodos naturales: usuarias nuevas,2015-07-01,0,4,1,0,0,5
SICAYA,"anticoncepcion, prevencion de its y de cancer de cuello uterino",metodos naturales: usuarias nuevas,2015-07-01,0,0,2,0,0,2
SIPE SIPE,"anticoncepcion, prevencion de its y de cancer de cuello uterino",metodos naturales: usuarias nuevas,2015-07-01,0,2,0,0,0,2
SOPACHUY,"anticoncepcion, prevencion de its y de cancer de cuello uterino",metodos naturales: usuarias nuevas,2015-07-01,0,4,5,7,0,16
SORACACHI,"anticoncepcion, prevencion de its y de cancer de cuello uterino",metodos naturales: usuarias nuevas,2015-07-01,0,1,3,1,0,5
SUCRE,"anticoncepcion, prevencion de its y de cancer de cuello uterino",metodos naturales: usuarias nuevas,2015-07-01,0,25,100,12,1,138
TACOBAMBA,"anticoncepcion, prevencion de its y de cancer de cuello uterino",metodos naturales: usuarias nuevas,2015-07-01,0,0,0,1,0,1
TACOPAYA,"anticoncepcion, prevencion de its y de cancer de cuello uterino",metodos naturales: usuarias nuevas,2015-07-01,1,2,0,0,0,3
TAPACARI,"anticoncepcion, prevencion de its y de cancer de cuello uterino",metodos naturales: usuarias nuevas,2015-07-01,0,0,2,0,0,2
TARACO,"anticoncepcion, prevencion de its y de cancer de cuello uterino",metodos naturales: usuarias nuevas,2015-07-01,0,3,2,0,0,5
TARATA,"anticoncepcion, prevencion de its y de cancer de cuello uterino",metodos naturales: usuarias nuevas,2015-07-01,0,0,4,2,0,6
TARIJA,"anticoncepcion, prevencion de its y de cancer de cuello uterino",metodos naturales: usuarias nuevas,2015-07-01,0,0,7,3,0,10
TARVITA,"anticoncepcion, prevencion de its y de cancer de cuello uterino",metodos naturales: usuarias nuevas,2015-07-01,1,2,1,1,0,5
TEOPONTE,"anticoncepcion, prevencion de its y de cancer de cuello uterino",metodos naturales: usuarias nuevas,2015-07-01,0,5,8,2,0,15
TIAWANACU,"anticoncepcion, prevencion de its y de cancer de cuello uterino",metodos naturales: usuarias nuevas,2015-07-01,0,1,7,2,0,10
TINGUIPAYA,"anticoncepcion, prevencion de its y de cancer de cuello uterino",metodos naturales: usuarias nuevas,2015-07-01,0,0,1,0,0,1
TIPUANI,"anticoncepcion, prevencion de its y de cancer de cuello uterino",metodos naturales: usuarias nuevas,2015-07-01,0,2,0,1,0,3
TIQUIPAYA,"anticoncepcion, prevencion de its y de cancer de cuello uterino",metodos naturales: usuarias nuevas,2015-07-01,0,6,16,7,0,29
TIRAQUE (CBBA),"anticoncepcion, prevencion de its y de cancer de cuello uterino",metodos naturales: usuarias nuevas,2015-07-01,0,2,2,0,0,4
TITO YUPANQUI (PARQUIPUJIO),"anticoncepcion, prevencion de its y de cancer de cuello uterino",metodos naturales: usuarias nuevas,2015-07-01,0,0,0,1,0,1
TOCO,"anticoncepcion, prevencion de its y de cancer de cuello uterino",metodos naturales: usuarias nuevas,2015-07-01,0,0,4,0,0,4
TOLATA,"anticoncepcion, prevencion de its y de cancer de cuello uterino",metodos naturales: usuarias nuevas,2015-07-01,0,0,1,0,0,1
TOMAVE,"anticoncepcion, prevencion de its y de cancer de cuello uterino",metodos naturales: usuarias nuevas,2015-07-01,0,0,1,0,0,1
TOMINA,"anticoncepcion, prevencion de its y de cancer de cuello uterino",metodos naturales: usuarias nuevas,2015-07-01,0,6,8,1,0,15
TOTORA(ORR),"anticoncepcion, prevencion de its y de cancer de cuello uterino",metodos naturales: usuarias nuevas,2015-07-01,0,3,2,0,0,5
TRINIDAD,"anticoncepcion, prevencion de its y de cancer de cuello uterino",metodos naturales: usuarias nuevas,2015-07-01,1,10,26,2,0,39
TUPIZA,"anticoncepcion, prevencion de its y de cancer de cuello uterino",metodos naturales: usuarias nuevas,2015-07-01,0,1,3,0,0,4
TURCO,"anticoncepcion, prevencion de its y de cancer de cuello uterino",metodos naturales: usuarias nuevas,2015-07-01,0,0,1,1,0,2
UMALA,"anticoncepcion, prevencion de its y de cancer de cuello uterino",metodos naturales: usuarias nuevas,2015-07-01,0,1,1,0,0,2
UNCIA,"anticoncepcion, prevencion de its y de cancer de cuello uterino",metodos naturales: usuarias nuevas,2015-07-01,0,0,1,0,0,1
VACAS,"anticoncepcion, prevencion de its y de cancer de cuello uterino",metodos naturales: usuarias nuevas,2015-07-01,0,2,4,2,0,8
VIACHA,"anticoncepcion, prevencion de its y de cancer de cuello uterino",metodos naturales: usuarias nuevas,2015-07-01,0,1,3,1,0,5
VILLA CHARCAS,"anticoncepcion, prevencion de its y de cancer de cuello uterino",metodos naturales: usuarias nuevas,2015-07-01,0,1,1,0,0,2
VILLA RIVERO,"anticoncepcion, prevencion de its y de cancer de cuello uterino",metodos naturales: usuarias nuevas,2015-07-01,0,0,3,0,0,3
VILLA SERRANO,"anticoncepcion, prevencion de its y de cancer de cuello uterino",metodos naturales: usuarias nuevas,2015-07-01,0,0,6,0,0,6
VILLA TUNARI,"anticoncepcion, prevencion de its y de cancer de cuello uterino",metodos naturales: usuarias nuevas,2015-07-01,0,0,3,1,0,4
VILLA VACA GUZMAN (MUYUPAMPA),"anticoncepcion, prevencion de its y de cancer de cuello uterino",metodos naturales: usuarias nuevas,2015-07-01,0,0,2,0,0,2
VILLAZON,"anticoncepcion, prevencion de its y de cancer de cuello uterino",metodos naturales: usuarias nuevas,2015-07-01,1,15,29,7,0,52
VINTO,"anticoncepcion, prevencion de its y de cancer de cuello uterino",metodos naturales: usuarias nuevas,2015-07-01,0,10,21,4,0,35
VITICHI,"anticoncepcion, prevencion de its y de cancer de cuello uterino",metodos naturales: usuarias nuevas,2015-07-01,0,3,6,2,0,11
WARNES,"anticoncepcion, prevencion de its y de cancer de cuello uterino",metodos naturales: usuarias nuevas,2015-07-01,0,2,2,1,0,5
YACO,"anticoncepcion, prevencion de its y de cancer de cuello uterino",metodos naturales: usuarias nuevas,2015-07-01,0,0,2,0,0,2
YACUIBA,"anticoncepcion, prevencion de its y de cancer de cuello uterino",metodos naturales: usuarias nuevas,2015-07-01,0,6,6,1,0,13
YANACACHI,"anticoncepcion, prevencion de its y de cancer de cuello uterino",metodos naturales: usuarias nuevas,2015-07-01,1,1,1,0,0,3
YAPACANI,"anticoncepcion, prevencion de its y de cancer de cuello uterino",metodos naturales: usuarias nuevas,2015-07-01,0,0,9,1,0,10
YOCALLA,"anticoncepcion, prevencion de its y de cancer de cuello uterino",metodos naturales: usuarias nuevas,2015-07-01,0,0,1,1,0,2
YOTALA,"anticoncepcion, prevencion de its y de cancer de cuello uterino",metodos naturales: usuarias nuevas,2015-07-01,0,4,11,0,0,15
ZUDAÑEZ,"anticoncepcion, prevencion de its y de cancer de cuello uterino",metodos naturales: usuarias nuevas,2015-07-01,0,1,7,1,0,9
ACACIO,"anticoncepcion, prevencion de its y de cancer de cuello uterino",metodos naturales: usuarias nuevas,2015-08-01,0,0,2,0,0,2
ACHACACHI,"anticoncepcion, prevencion de its y de cancer de cuello uterino",metodos naturales: usuarias nuevas,2015-08-01,0,4,4,0,0,8
ALALAY,"anticoncepcion, prevencion de its y de cancer de cuello uterino",metodos naturales: usuarias nuevas,2015-08-01,0,0,1,0,0,1
ALCALA,"anticoncepcion, prevencion de its y de cancer de cuello uterino",metodos naturales: usuarias nuevas,2015-08-01,0,1,1,0,0,2
ANCORAIMES,"anticoncepcion, prevencion de its y de cancer de cuello uterino",metodos naturales: usuarias nuevas,2015-08-01,1,3,9,2,0,15
ANDAMARCA,"anticoncepcion, prevencion de its y de cancer de cuello uterino",metodos naturales: usuarias nuevas,2015-08-01,0,0,2,0,0,2
ANZALDO,"anticoncepcion, prevencion de its y de cancer de cuello uterino",metodos naturales: usuarias nuevas,2015-08-01,0,1,0,0,0,1
APOLO,"anticoncepcion, prevencion de its y de cancer de cuello uterino",metodos naturales: usuarias nuevas,2015-08-01,0,1,4,0,0,5
ARAMPAMPA,"anticoncepcion, prevencion de its y de cancer de cuello uterino",metodos naturales: usuarias nuevas,2015-08-01,0,0,1,0,0,1
ARBIETO,"anticoncepcion, prevencion de its y de cancer de cuello uterino",metodos naturales: usuarias nuevas,2015-08-01,0,3,11,0,0,14
ASCENCION DE GUARAYOS,"anticoncepcion, prevencion de its y de cancer de cuello uterino",metodos naturales: usuarias nuevas,2015-08-01,0,0,0,1,0,1
ATOCHA,"anticoncepcion, prevencion de its y de cancer de cuello uterino",metodos naturales: usuarias nuevas,2015-08-01,0,2,4,2,0,8
AYO AYO,"anticoncepcion, prevencion de its y de cancer de cuello uterino",metodos naturales: usuarias nuevas,2015-08-01,0,0,2,0,0,2
AYOPAYA (V. DE INDEPENDENCIA),"anticoncepcion, prevencion de its y de cancer de cuello uterino",metodos naturales: usuarias nuevas,2015-08-01,0,2,1,0,0,3
AZURDUY,"anticoncepcion, prevencion de its y de cancer de cuello uterino",metodos naturales: usuarias nuevas,2015-08-01,0,0,0,1,0,1
BAURES,"anticoncepcion, prevencion de its y de cancer de cuello uterino",metodos naturales: usuarias nuevas,2015-08-01,0,1,1,0,0,2
BELEN DE URMIRI,"anticoncepcion, prevencion de its y de cancer de cuello uterino",metodos naturales: usuarias nuevas,2015-08-01,0,1,1,0,0,2
BELLA FLOR,"anticoncepcion, prevencion de its y de cancer de cuello uterino",metodos naturales: usuarias nuevas,2015-08-01,0,2,0,0,0,2
BETANZOS,"anticoncepcion, prevencion de its y de cancer de cuello uterino",metodos naturales: usuarias nuevas,2015-08-01,0,3,5,1,0,9
BOLIVAR,"anticoncepcion, prevencion de its y de cancer de cuello uterino",metodos naturales: usuarias nuevas,2015-08-01,0,0,1,0,0,1
BUENA VISTA,"anticoncepcion, prevencion de its y de cancer de cuello uterino",metodos naturales: usuarias nuevas,2015-08-01,0,0,5,0,0,5
CABEZAS,"anticoncepcion, prevencion de its y de cancer de cuello uterino",metodos naturales: usuarias nuevas,2015-08-01,0,0,2,0,0,2
"CAIZA ""D""","anticoncepcion, prevencion de its y de cancer de cuello uterino",metodos naturales: usuarias nuevas,2015-08-01,0,1,1,0,0,2
CAJUATA,"anticoncepcion, prevencion de its y de cancer de cuello uterino",metodos naturales: usuarias nuevas,2015-08-01,0,1,7,2,0,10
CALAMARCA,"anticoncepcion, prevencion de its y de cancer de cuello uterino",metodos naturales: usuarias nuevas,2015-08-01,0,3,4,0,0,7
CAMARGO,"anticoncepcion, prevencion de its y de cancer de cuello uterino",metodos naturales: usuarias nuevas,2015-08-01,0,7,14,4,0,25
CAMIRI,"anticoncepcion, prevencion de its y de cancer de cuello uterino",metodos naturales: usuarias nuevas,2015-08-01,0,3,5,0,0,8
CARACOLLO,"anticoncepcion, prevencion de its y de cancer de cuello uterino",metodos naturales: usuarias nuevas,2015-08-01,0,6,22,6,0,34
CARIPUYO,"anticoncepcion, prevencion de its y de cancer de cuello uterino",metodos naturales: usuarias nuevas,2015-08-01,0,2,3,1,0,6
CHALLAPATA,"anticoncepcion, prevencion de its y de cancer de cuello uterino",metodos naturales: usuarias nuevas,2015-08-01,0,2,18,6,0,26
CHAQUI,"anticoncepcion, prevencion de its y de cancer de cuello uterino",metodos naturales: usuarias nuevas,2015-08-01,0,1,3,0,2,6
CHAYANTA,"anticoncepcion, prevencion de its y de cancer de cuello uterino",metodos naturales: usuarias nuevas,2015-08-01,0,5,19,1,0,25
CHIMORE,"anticoncepcion, prevencion de its y de cancer de cuello uterino",metodos naturales: usuarias nuevas,2015-08-01,0,0,1,1,0,2
CHIPAYA,"anticoncepcion, prevencion de its y de cancer de cuello uterino",metodos naturales: usuarias nuevas,2015-08-01,0,0,1,0,0,1
CHUA COCANI,"anticoncepcion, prevencion de its y de cancer de cuello uterino",metodos naturales: usuarias nuevas,2015-08-01,0,0,1,1,0,2
CHULUMANI (V. DE LA LIBERTAD),"anticoncepcion, prevencion de its y de cancer de cuello uterino",metodos naturales: usuarias nuevas,2015-08-01,0,2,13,0,0,15
CHUQUIHUTA AYLLU JUCUMANI,"anticoncepcion, prevencion de its y de cancer de cuello uterino",metodos naturales: usuarias nuevas,2015-08-01,0,3,7,0,0,10
CKOCHAS,"anticoncepcion, prevencion de its y de cancer de cuello uterino",metodos naturales: usuarias nuevas,2015-08-01,0,5,11,9,0,25
COBIJA,"anticoncepcion, prevencion de its y de cancer de cuello uterino",metodos naturales: usuarias nuevas,2015-08-01,0,10,27,11,0,48
COCHABAMBA,"anticoncepcion, prevencion de its y de cancer de cuello uterino",metodos naturales: usuarias nuevas,2015-08-01,0,16,65,15,0,96
COIPASA,"anticoncepcion, prevencion de its y de cancer de cuello uterino",metodos naturales: usuarias nuevas,2015-08-01,0,0,3,0,0,3
"COLCHA ""K""","anticoncepcion, prevencion de its y de cancer de cuello uterino",metodos naturales: usuarias nuevas,2015-08-01,0,0,1,3,0,4
COLLANA,"anticoncepcion, prevencion de its y de cancer de cuello uterino",metodos naturales: usuarias nuevas,2015-08-01,0,1,0,1,0,2
COLOMI,"anticoncepcion, prevencion de its y de cancer de cuello uterino",metodos naturales: usuarias nuevas,2015-08-01,0,1,4,2,0,7
COLPA BELGICA,"anticoncepcion, prevencion de its y de cancer de cuello uterino",metodos naturales: usuarias nuevas,2015-08-01,0,1,2,1,0,4
COLQUECHACA,"anticoncepcion, prevencion de its y de cancer de cuello uterino",metodos naturales: usuarias nuevas,2015-08-01,0,8,9,5,0,22
COLQUIRI,"anticoncepcion, prevencion de its y de cancer de cuello uterino",metodos naturales: usuarias nuevas,2015-08-01,0,2,12,2,0,16
COMARAPA,"anticoncepcion, prevencion de its y de cancer de cuello uterino",metodos naturales: usuarias nuevas,2015-08-01,1,7,15,3,0,26
CORIPATA,"anticoncepcion, prevencion de its y de cancer de cuello uterino",metodos naturales: usuarias nuevas,2015-08-01,0,0,7,0,0,7
CORO CORO,"anticoncepcion, prevencion de its y de cancer de cuello uterino",metodos naturales: usuarias nuevas,2015-08-01,0,0,1,0,0,1
CORQUE,"anticoncepcion, prevencion de its y de cancer de cuello uterino",metodos naturales: usuarias nuevas,2015-08-01,0,1,2,1,0,4
COTAGAITA,"anticoncepcion, prevencion de its y de cancer de cuello uterino",metodos naturales: usuarias nuevas,2015-08-01,0,3,1,0,0,4
COTOCA,"anticoncepcion, prevencion de its y de cancer de cuello uterino",metodos naturales: usuarias nuevas,2015-08-01,0,1,5,2,0,8
CUATRO CAÑADAS,"anticoncepcion, prevencion de its y de cancer de cuello uterino",metodos naturales: usuarias nuevas,2015-08-01,0,0,3,0,0,3
CULPINA,"anticoncepcion, prevencion de its y de cancer de cuello uterino",metodos naturales: usuarias nuevas,2015-08-01,0,3,15,8,0,26
CURAHUARA DE CARANGAS,"anticoncepcion, prevencion de its y de cancer de cuello uterino",metodos naturales: usuarias nuevas,2015-08-01,0,0,2,1,0,3
EL ALTO,"anticoncepcion, prevencion de its y de cancer de cuello uterino",metodos naturales: usuarias nuevas,2015-08-01,0,19,119,239,0,377
EL CHORO,"anticoncepcion, prevencion de its y de cancer de cuello uterino",metodos naturales: usuarias nuevas,2015-08-01,0,1,3,0,0,4
EL PUENTE(STC),"anticoncepcion, prevencion de its y de cancer de cuello uterino",metodos naturales: usuarias nuevas,2015-08-01,0,0,2,3,0,5
EL VILLAR,"anticoncepcion, prevencion de its y de cancer de cuello uterino",metodos naturales: usuarias nuevas,2015-08-01,0,2,1,1,0,4
ENTRE RIOS TRJ,"anticoncepcion, prevencion de its y de cancer de cuello uterino",metodos naturales: usuarias nuevas,2015-08-01,0,5,3,0,0,8
EUCALIPTUS,"anticoncepcion, prevencion de its y de cancer de cuello uterino",metodos naturales: usuarias nuevas,2015-08-01,0,0,5,0,0,5
EUREKA (SANTOS MERCADO),"anticoncepcion, prevencion de its y de cancer de cuello uterino",metodos naturales: usuarias nuevas,2015-08-01,0,0,0,1,0,1
GUAQUI,"anticoncepcion, prevencion de its y de cancer de cuello uterino",metodos naturales: usuarias nuevas,2015-08-01,1,2,3,0,0,6
GUAYARAMERIN,"anticoncepcion, prevencion de its y de cancer de cuello uterino",metodos naturales: usuarias nuevas,2015-08-01,2,22,54,8,0,86
HUACARETA,"anticoncepcion, prevencion de its y de cancer de cuello uterino",metodos naturales: usuarias nuevas,2015-08-01,0,2,3,1,0,6
HUANUNI,"anticoncepcion, prevencion de its y de cancer de cuello uterino",metodos naturales: usuarias nuevas,2015-08-01,0,4,7,1,0,12
HUATAJATA,"anticoncepcion, prevencion de its y de cancer de cuello uterino",metodos naturales: usuarias nuevas,2015-08-01,0,0,10,8,1,19
HUAYLLAMARCA,"anticoncepcion, prevencion de its y de cancer de cuello uterino",metodos naturales: usuarias nuevas,2015-08-01,0,1,2,0,0,3
ICHOCA,"anticoncepcion, prevencion de its y de cancer de cuello uterino",metodos naturales: usuarias nuevas,2015-08-01,0,0,6,0,0,6
ICLA,"anticoncepcion, prevencion de its y de cancer de cuello uterino",metodos naturales: usuarias nuevas,2015-08-01,0,1,2,0,0,3
INCAHUASI,"anticoncepcion, prevencion de its y de cancer de cuello uterino",metodos naturales: usuarias nuevas,2015-08-01,0,4,11,5,0,20
INGAVI (HUMAITA),"anticoncepcion, prevencion de its y de cancer de cuello uterino",metodos naturales: usuarias nuevas,2015-08-01,0,0,0,1,0,1
INQUISIVI,"anticoncepcion, prevencion de its y de cancer de cuello uterino",metodos naturales: usuarias nuevas,2015-08-01,0,2,5,3,0,10
IRUPANA (VILLA DE LANZA),"anticoncepcion, prevencion de its y de cancer de cuello uterino",metodos naturales: usuarias nuevas,2015-08-01,0,1,7,2,0,10
IXIAMAS,"anticoncepcion, prevencion de its y de cancer de cuello uterino",metodos naturales: usuarias nuevas,2015-08-01,0,0,1,2,0,3
JESUS DE MACHACA,"anticoncepcion, prevencion de its y de cancer de cuello uterino",metodos naturales: usuarias nuevas,2015-08-01,0,1,2,0,0,3
LA ASUNTA,"anticoncepcion, prevencion de its y de cancer de cuello uterino",metodos naturales: usuarias nuevas,2015-08-01,0,3,7,2,0,12
LA GUARDIA,"anticoncepcion, prevencion de its y de cancer de cuello uterino",metodos naturales: usuarias nuevas,2015-08-01,0,0,1,1,0,2
LA PAZ,"anticoncepcion, prevencion de its y de cancer de cuello uterino",metodos naturales: usuarias nuevas,2015-08-01,0,59,239,48,1,347
LAGUNILLAS,"anticoncepcion, prevencion de its y de cancer de cuello uterino",metodos naturales: usuarias nuevas,2015-08-01,0,1,1,0,0,2
LAJA,"anticoncepcion, prevencion de its y de cancer de cuello uterino",metodos naturales: usuarias nuevas,2015-08-01,0,2,4,0,0,6
LLALLAGUA,"anticoncepcion, prevencion de its y de cancer de cuello uterino",metodos naturales: usuarias nuevas,2015-08-01,0,3,8,1,0,12
LORETO,"anticoncepcion, prevencion de its y de cancer de cuello uterino",metodos naturales: usuarias nuevas,2015-08-01,0,0,4,0,0,4
MAGDALENA,"anticoncepcion, prevencion de its y de cancer de cuello uterino",metodos naturales: usuarias nuevas,2015-08-01,0,0,2,0,0,2
MAPIRI,"anticoncepcion, prevencion de its y de cancer de cuello uterino",metodos naturales: usuarias nuevas,2015-08-01,0,0,3,1,0,4
MECAPACA,"anticoncepcion, prevencion de its y de cancer de cuello uterino",metodos naturales: usuarias nuevas,2015-08-01,0,1,0,0,0,1
MINEROS,"anticoncepcion, prevencion de its y de cancer de cuello uterino",metodos naturales: usuarias nuevas,2015-08-01,0,1,2,0,0,3
MOCOMOCO,"anticoncepcion, prevencion de its y de cancer de cuello uterino",metodos naturales: usuarias nuevas,2015-08-01,0,2,3,1,0,6
MOJOCOYA,"anticoncepcion, prevencion de its y de cancer de cuello uterino",metodos naturales: usuarias nuevas,2015-08-01,0,1,1,0,0,2
MONTERO,"anticoncepcion, prevencion de its y de cancer de cuello uterino",metodos naturales: usuarias nuevas,2015-08-01,0,1,0,0,0,1
MOROCHATA,"anticoncepcion, prevencion de its y de cancer de cuello uterino",metodos naturales: usuarias nuevas,2015-08-01,1,0,2,4,0,7
NUEVO MANOA (NUEVA ESPERANZA),"anticoncepcion, prevencion de its y de cancer de cuello uterino",metodos naturales: usuarias nuevas,2015-08-01,0,0,4,0,0,4
OCURI,"anticoncepcion, prevencion de its y de cancer de cuello uterino",metodos naturales: usuarias nuevas,2015-08-01,0,1,4,4,0,9
OMEREQUE,"anticoncepcion, prevencion de its y de cancer de cuello uterino",metodos naturales: usuarias nuevas,2015-08-01,0,2,4,0,0,6
ORURO,"anticoncepcion, prevencion de its y de cancer de cuello uterino",metodos naturales: usuarias nuevas,2015-08-01,0,14,44,4,0,62
PADILLA,"anticoncepcion, prevencion de its y de cancer de cuello uterino",metodos naturales: usuarias nuevas,2015-08-01,0,7,12,1,0,20
PAMPA GRANDE,"anticoncepcion, prevencion de its y de cancer de cuello uterino",metodos naturales: usuarias nuevas,2015-08-01,0,0,1,0,0,1
PAZÑA,"anticoncepcion, prevencion de its y de cancer de cuello uterino",metodos naturales: usuarias nuevas,2015-08-01,0,4,3,0,0,7
PELECHUCO,"anticoncepcion, prevencion de its y de cancer de cuello uterino",metodos naturales: usuarias nuevas,2015-08-01,0,0,2,0,0,2
POCOATA,"anticoncepcion, prevencion de its y de cancer de cuello uterino",metodos naturales: usuarias nuevas,2015-08-01,0,12,18,4,0,34
POCONA,"anticoncepcion, prevencion de its y de cancer de cuello uterino",metodos naturales: usuarias nuevas,2015-08-01,0,1,4,1,0,6
PORCO,"anticoncepcion, prevencion de its y de cancer de cuello uterino",metodos naturales: usuarias nuevas,2015-08-01,0,2,8,1,0,11
POROMA,"anticoncepcion, prevencion de its y de cancer de cuello uterino",metodos naturales: usuarias nuevas,2015-08-01,0,4,1,0,0,5
PORONGO,"anticoncepcion, prevencion de its y de cancer de cuello uterino",metodos naturales: usuarias nuevas,2015-08-01,1,2,5,1,0,9
POTOSI,"anticoncepcion, prevencion de its y de cancer de cuello uterino",metodos naturales: usuarias nuevas,2015-08-01,2,16,41,111,0,170
PRESTO,"anticoncepcion, prevencion de its y de cancer de cuello uterino",metodos naturales: usuarias nuevas,2015-08-01,0,1,1,3,0,5
PUCARANI,"anticoncepcion, prevencion de its y de cancer de cuello uterino",metodos naturales: usuarias nuevas,2015-08-01,0,4,8,4,0,16
PUERTO ACOSTA,"anticoncepcion, prevencion de its y de cancer de cuello uterino",metodos naturales: usuarias nuevas,2015-08-01,0,1,2,0,0,3
PUERTO CARABUCO,"anticoncepcion, prevencion de its y de cancer de cuello uterino",metodos naturales: usuarias nuevas,2015-08-01,0,1,1,0,0,2
PUERTO GONZALO MORENO,"anticoncepcion, prevencion de its y de cancer de cuello uterino",metodos naturales: usuarias nuevas,2015-08-01,1,5,1,0,0,7
PUERTO PEREZ,"anticoncepcion, prevencion de its y de cancer de cuello uterino",metodos naturales: usuarias nuevas,2015-08-01,0,2,1,0,0,3
PUERTO RICO,"anticoncepcion, prevencion de its y de cancer de cuello uterino",metodos naturales: usuarias nuevas,2015-08-01,0,2,1,0,0,3
PUERTO VILLARROEL,"anticoncepcion, prevencion de its y de cancer de cuello uterino",metodos naturales: usuarias nuevas,2015-08-01,0,4,6,1,0,11
PUNA,"anticoncepcion, prevencion de its y de cancer de cuello uterino",metodos naturales: usuarias nuevas,2015-08-01,0,1,4,1,0,6
PUNATA,"anticoncepcion, prevencion de its y de cancer de cuello uterino",metodos naturales: usuarias nuevas,2015-08-01,0,1,4,0,0,5
QUILLACOLLO,"anticoncepcion, prevencion de its y de cancer de cuello uterino",metodos naturales: usuarias nuevas,2015-08-01,0,2,3,0,0,5
REYES,"anticoncepcion, prevencion de its y de cancer de cuello uterino",metodos naturales: usuarias nuevas,2015-08-01,7,23,25,24,0,79
RIBERALTA,"anticoncepcion, prevencion de its y de cancer de cuello uterino",metodos naturales: usuarias nuevas,2015-08-01,4,41,158,26,0,229
ROBORE,"anticoncepcion, prevencion de its y de cancer de cuello uterino",metodos naturales: usuarias nuevas,2015-08-01,0,0,1,0,0,1
RURRENABAQUE,"anticoncepcion, prevencion de its y de cancer de cuello uterino",metodos naturales: usuarias nuevas,2015-08-01,0,4,6,1,0,11
SABAYA,"anticoncepcion, prevencion de its y de cancer de cuello uterino",metodos naturales: usuarias nuevas,2015-08-01,0,0,3,0,0,3
SACABA,"anticoncepcion, prevencion de its y de cancer de cuello uterino",metodos naturales: usuarias nuevas,2015-08-01,0,5,17,3,1,26
SACACA,"anticoncepcion, prevencion de its y de cancer de cuello uterino",metodos naturales: usuarias nuevas,2015-08-01,0,1,6,1,0,8
SAIPINA,"anticoncepcion, prevencion de its y de cancer de cuello uterino",metodos naturales: usuarias nuevas,2015-08-01,0,0,1,0,0,1
SALINAS DE GARCI MENDOZA,"anticoncepcion, prevencion de its y de cancer de cuello uterino",metodos naturales: usuarias nuevas,2015-08-01,0,2,8,1,0,11
SAN ANDRES,"anticoncepcion, prevencion de its y de cancer de cuello uterino",metodos naturales: usuarias nuevas,2015-08-01,0,3,1,0,0,4
SAN ANDRES DE MACHACA,"anticoncepcion, prevencion de its y de cancer de cuello uterino",metodos naturales: usuarias nuevas,2015-08-01,0,0,1,0,0,1
SAN ANTONIO DE ESMORUCO,"anticoncepcion, prevencion de its y de cancer de cuello uterino",metodos naturales: usuarias nuevas,2015-08-01,0,1,1,0,0,2
SAN ANTONIO DE LOMERIO,"anticoncepcion, prevencion de its y de cancer de cuello uterino",metodos naturales: usuarias nuevas,2015-08-01,0,0,5,1,0,6
SAN BENITO,"anticoncepcion, prevencion de its y de cancer de cuello uterino",metodos naturales: usuarias nuevas,2015-08-01,0,0,3,0,0,3
SAN BORJA,"anticoncepcion, prevencion de its y de cancer de cuello uterino",metodos naturales: usuarias nuevas,2015-08-01,0,16,14,2,0,32
SAN BUENA VENTURA,"anticoncepcion, prevencion de its y de cancer de cuello uterino",metodos naturales: usuarias nuevas,2015-08-01,0,0,8,1,0,9
SAN CARLOS,"anticoncepcion, prevencion de its y de cancer de cuello uterino",metodos naturales: usuarias nuevas,2015-08-01,1,9,9,0,0,19
SAN IGNACIO,"anticoncepcion, prevencion de its y de cancer de cuello uterino",metodos naturales: usuarias nuevas,2015-08-01,1,3,2,0,0,6
SAN JUAN DE YAPACANI,"anticoncepcion, prevencion de its y de cancer de cuello uterino",metodos naturales: usuarias nuevas,2015-08-01,0,1,0,0,0,1
SAN JULIAN,"anticoncepcion, prevencion de its y de cancer de cuello uterino",metodos naturales: usuarias nuevas,2015-08-01,0,0,1,0,0,1
SAN LORENZO(PND),"anticoncepcion, prevencion de its y de cancer de cuello uterino",metodos naturales: usuarias nuevas,2015-08-01,1,1,0,1,0,3
SAN LUCAS,"anticoncepcion, prevencion de its y de cancer de cuello uterino",metodos naturales: usuarias nuevas,2015-08-01,0,4,6,5,0,15
SAN MATIAS,"anticoncepcion, prevencion de its y de cancer de cuello uterino",metodos naturales: usuarias nuevas,2015-08-01,0,7,12,2,0,21
SAN MIGUEL DE VELASCO,"anticoncepcion, prevencion de its y de cancer de cuello uterino",metodos naturales: usuarias nuevas,2015-08-01,0,2,2,0,0,4
SAN PEDRO,"anticoncepcion, prevencion de its y de cancer de cuello uterino",metodos naturales: usuarias nuevas,2015-08-01,0,0,2,0,0,2
SAN PEDRO DE BUENA VISTA,"anticoncepcion, prevencion de its y de cancer de cuello uterino",metodos naturales: usuarias nuevas,2015-08-01,1,6,18,2,0,27
SAN PEDRO DE TIQUINA,"anticoncepcion, prevencion de its y de cancer de cuello uterino",metodos naturales: usuarias nuevas,2015-08-01,0,2,7,0,0,9
SAN RAFAEL,"anticoncepcion, prevencion de its y de cancer de cuello uterino",metodos naturales: usuarias nuevas,2015-08-01,0,2,5,1,0,8
SANTA ANA,"anticoncepcion, prevencion de its y de cancer de cuello uterino",metodos naturales: usuarias nuevas,2015-08-01,1,16,26,3,0,46
SANTA CRUZ DE LA SIERRA,"anticoncepcion, prevencion de its y de cancer de cuello uterino",metodos naturales: usuarias nuevas,2015-08-01,1,0,17,0,0,18
SANTA ROSA,"anticoncepcion, prevencion de its y de cancer de cuello uterino",metodos naturales: usuarias nuevas,2015-08-01,1,4,0,0,0,5
SANTA ROSA DEL SARA,"anticoncepcion, prevencion de its y de cancer de cuello uterino",metodos naturales: usuarias nuevas,2015-08-01,1,4,12,0,0,17
SANTIAGO DE HUARI,"anticoncepcion, prevencion de its y de cancer de cuello uterino",metodos naturales: usuarias nuevas,2015-08-01,0,0,4,0,0,4
SANTIAGO DE HUATA,"anticoncepcion, prevencion de its y de cancer de cuello uterino",metodos naturales: usuarias nuevas,2015-08-01,0,0,5,0,0,5
SANTIAGO DE MACHACA,"anticoncepcion, prevencion de its y de cancer de cuello uterino",metodos naturales: usuarias nuevas,2015-08-01,0,0,2,1,0,3
SANTUARIO DE QUILLACAS,"anticoncepcion, prevencion de its y de cancer de cuello uterino",metodos naturales: usuarias nuevas,2015-08-01,0,1,5,0,0,6
SAPAHAQUI,"anticoncepcion, prevencion de its y de cancer de cuello uterino",metodos naturales: usuarias nuevas,2015-08-01,0,2,2,1,0,5
SIPE SIPE,"anticoncepcion, prevencion de its y de cancer de cuello uterino",metodos naturales: usuarias nuevas,2015-08-01,0,5,18,2,0,25
SOPACHUY,"anticoncepcion, prevencion de its y de cancer de cuello uterino",metodos naturales: usuarias nuevas,2015-08-01,0,4,3,1,0,8
SORACACHI,"anticoncepcion, prevencion de its y de cancer de cuello uterino",metodos naturales: usuarias nuevas,2015-08-01,0,0,2,4,0,6
SUCRE,"anticoncepcion, prevencion de its y de cancer de cuello uterino",metodos naturales: usuarias nuevas,2015-08-01,0,23,76,14,0,113
TACOPAYA,"anticoncepcion, prevencion de its y de cancer de cuello uterino",metodos naturales: usuarias nuevas,2015-08-01,0,0,7,1,0,8
TAPACARI,"anticoncepcion, prevencion de its y de cancer de cuello uterino",metodos naturales: usuarias nuevas,2015-08-01,0,0,3,2,0,5
TARACO,"anticoncepcion, prevencion de its y de cancer de cuello uterino",metodos naturales: usuarias nuevas,2015-08-01,0,1,2,0,0,3
TARATA,"anticoncepcion, prevencion de its y de cancer de cuello uterino",metodos naturales: usuarias nuevas,2015-08-01,0,2,2,2,0,6
TARIJA,"anticoncepcion, prevencion de its y de cancer de cuello uterino",metodos naturales: usuarias nuevas,2015-08-01,0,0,7,4,0,11
TARVITA,"anticoncepcion, prevencion de its y de cancer de cuello uterino",metodos naturales: usuarias nuevas,2015-08-01,1,6,3,0,0,10
TEOPONTE,"anticoncepcion, prevencion de its y de cancer de cuello uterino",metodos naturales: usuarias nuevas,2015-08-01,1,4,2,2,0,9
TIAWANACU,"anticoncepcion, prevencion de its y de cancer de cuello uterino",metodos naturales: usuarias nuevas,2015-08-01,0,2,10,1,0,13
TINGUIPAYA,"anticoncepcion, prevencion de its y de cancer de cuello uterino",metodos naturales: usuarias nuevas,2015-08-01,0,0,3,3,0,6
TIQUIPAYA,"anticoncepcion, prevencion de its y de cancer de cuello uterino",metodos naturales: usuarias nuevas,2015-08-01,0,0,5,3,0,8
TIRAQUE (CBBA),"anticoncepcion, prevencion de its y de cancer de cuello uterino",metodos naturales: usuarias nuevas,2015-08-01,0,1,3,0,0,4
TOMINA,"anticoncepcion, prevencion de its y de cancer de cuello uterino",metodos naturales: usuarias nuevas,2015-08-01,0,7,6,0,0,13
TORO TORO,"anticoncepcion, prevencion de its y de cancer de cuello uterino",metodos naturales: usuarias nuevas,2015-08-01,0,0,3,0,0,3
TOTORA(ORR),"anticoncepcion, prevencion de its y de cancer de cuello uterino",metodos naturales: usuarias nuevas,2015-08-01,0,0,5,0,0,5
TRINIDAD,"anticoncepcion, prevencion de its y de cancer de cuello uterino",metodos naturales: usuarias nuevas,2015-08-01,3,18,41,7,0,69
TUPIZA,"anticoncepcion, prevencion de its y de cancer de cuello uterino",metodos naturales: usuarias nuevas,2015-08-01,0,1,1,0,0,2
TURCO,"anticoncepcion, prevencion de its y de cancer de cuello uterino",metodos naturales: usuarias nuevas,2015-08-01,0,0,4,0,0,4
UMALA,"anticoncepcion, prevencion de its y de cancer de cuello uterino",metodos naturales: usuarias nuevas,2015-08-01,0,0,1,0,0,1
UNCIA,"anticoncepcion, prevencion de its y de cancer de cuello uterino",metodos naturales: usuarias nuevas,2015-08-01,0,1,2,0,0,3
VACAS,"anticoncepcion, prevencion de its y de cancer de cuello uterino",metodos naturales: usuarias nuevas,2015-08-01,0,2,5,3,0,10
VIACHA,"anticoncepcion, prevencion de its y de cancer de cuello uterino",metodos naturales: usuarias nuevas,2015-08-01,0,1,4,1,0,6
VILLA CHARCAS,"anticoncepcion, prevencion de its y de cancer de cuello uterino",metodos naturales: usuarias nuevas,2015-08-01,0,4,2,0,0,6
VILLA MONTES,"anticoncepcion, prevencion de its y de cancer de cuello uterino",metodos naturales: usuarias nuevas,2015-08-01,0,0,55,0,0,55
VILLA RIVERO,"anticoncepcion, prevencion de its y de cancer de cuello uterino",metodos naturales: usuarias nuevas,2015-08-01,1,2,4,0,0,7
VILLA SERRANO,"anticoncepcion, prevencion de its y de cancer de cuello uterino",metodos naturales: usuarias nuevas,2015-08-01,0,1,2,0,0,3
VILLA TUNARI,"anticoncepcion, prevencion de its y de cancer de cuello uterino",metodos naturales: usuarias nuevas,2015-08-01,0,2,3,0,0,5
VILLA VACA GUZMAN (MUYUPAMPA),"anticoncepcion, prevencion de its y de cancer de cuello uterino",metodos naturales: usuarias nuevas,2015-08-01,1,0,0,0,0,1
VILLAZON,"anticoncepcion, prevencion de its y de cancer de cuello uterino",metodos naturales: usuarias nuevas,2015-08-01,0,15,30,12,0,57
VINTO,"anticoncepcion, prevencion de its y de cancer de cuello uterino",metodos naturales: usuarias nuevas,2015-08-01,0,0,21,6,0,27
VITICHI,"anticoncepcion, prevencion de its y de cancer de cuello uterino",metodos naturales: usuarias nuevas,2015-08-01,0,4,3,2,0,9
WARNES,"anticoncepcion, prevencion de its y de cancer de cuello uterino",metodos naturales: usuarias nuevas,2015-08-01,0,1,6,0,0,7
YACUIBA,"anticoncepcion, prevencion de its y de cancer de cuello uterino",metodos naturales: usuarias nuevas,2015-08-01,0,6,13,1,0,20
YANACACHI,"anticoncepcion, prevencion de its y de cancer de cuello uterino",metodos naturales: usuarias nuevas,2015-08-01,0,1,2,2,0,5
YAPACANI,"anticoncepcion, prevencion de its y de cancer de cuello uterino",metodos naturales: usuarias nuevas,2015-08-01,0,2,10,5,0,17
YOCALLA,"anticoncepcion, prevencion de its y de cancer de cuello uterino",metodos naturales: usuarias nuevas,2015-08-01,0,1,0,0,0,1
YOTALA,"anticoncepcion, prevencion de its y de cancer de cuello uterino",metodos naturales: usuarias nuevas,2015-08-01,0,1,4,0,0,5
ZUDAÑEZ,"anticoncepcion, prevencion de its y de cancer de cuello uterino",metodos naturales: usuarias nuevas,2015-08-01,0,4,1,0,0,5
ACACIO,"anticoncepcion, prevencion de its y de cancer de cuello uterino",metodos naturales: usuarias nuevas,2015-09-01,0,0,1,0,0,1
ACHACACHI,"anticoncepcion, prevencion de its y de cancer de cuello uterino",metodos naturales: usuarias nuevas,2015-09-01,0,0,5,1,0,6
ALALAY,"anticoncepcion, prevencion de its y de cancer de cuello uterino",metodos naturales: usuarias nuevas,2015-09-01,0,0,2,0,0,2
ALCALA,"anticoncepcion, prevencion de its y de cancer de cuello uterino",metodos naturales: usuarias nuevas,2015-09-01,0,2,1,0,0,3
ANCORAIMES,"anticoncepcion, prevencion de its y de cancer de cuello uterino",metodos naturales: usuarias nuevas,2015-09-01,0,6,5,1,0,12
ANZALDO,"anticoncepcion, prevencion de its y de cancer de cuello uterino",metodos naturales: usuarias nuevas,2015-09-01,0,0,1,0,0,1
APOLO,"anticoncepcion, prevencion de its y de cancer de cuello uterino",metodos naturales: usuarias nuevas,2015-09-01,1,4,6,6,0,17
ARBIETO,"anticoncepcion, prevencion de its y de cancer de cuello uterino",metodos naturales: usuarias nuevas,2015-09-01,0,7,10,3,0,20
ATOCHA,"anticoncepcion, prevencion de its y de cancer de cuello uterino",metodos naturales: usuarias nuevas,2015-09-01,0,0,1,2,0,3
AYO AYO,"anticoncepcion, prevencion de its y de cancer de cuello uterino",metodos naturales: usuarias nuevas,2015-09-01,0,0,2,0,0,2
AZURDUY,"anticoncepcion, prevencion de its y de cancer de cuello uterino",metodos naturales: usuarias nuevas,2015-09-01,0,0,2,3,0,5
BATALLAS,"anticoncepcion, prevencion de its y de cancer de cuello uterino",metodos naturales: usuarias nuevas,2015-09-01,0,0,0,1,0,1
BAURES,"anticoncepcion, prevencion de its y de cancer de cuello uterino",metodos naturales: usuarias nuevas,2015-09-01,0,0,2,0,0,2
BELEN DE ANDAMARCA,"anticoncepcion, prevencion de its y de cancer de cuello uterino",metodos naturales: usuarias nuevas,2015-09-01,0,0,1,0,0,1
BELLA FLOR,"anticoncepcion, prevencion de its y de cancer de cuello uterino",metodos naturales: usuarias nuevas,2015-09-01,0,2,0,0,0,2
BERMEJO,"anticoncepcion, prevencion de its y de cancer de cuello uterino",metodos naturales: usuarias nuevas,2015-09-01,0,1,0,0,0,1
BETANZOS,"anticoncepcion, prevencion de its y de cancer de cuello uterino",metodos naturales: usuarias nuevas,2015-09-01,0,5,3,2,0,10
BUENA VISTA,"anticoncepcion, prevencion de its y de cancer de cuello uterino",metodos naturales: usuarias nuevas,2015-09-01,0,0,6,0,0,6
"CAIZA ""D""","anticoncepcion, prevencion de its y de cancer de cuello uterino",metodos naturales: usuarias nuevas,2015-09-01,0,0,1,0,0,1
CAJUATA,"anticoncepcion, prevencion de its y de cancer de cuello uterino",metodos naturales: usuarias nuevas,2015-09-01,0,1,5,2,0,8
CALAMARCA,"anticoncepcion, prevencion de its y de cancer de cuello uterino",metodos naturales: usuarias nuevas,2015-09-01,0,2,12,6,0,20
CAMIRI,"anticoncepcion, prevencion de its y de cancer de cuello uterino",metodos naturales: usuarias nuevas,2015-09-01,0,1,1,0,0,2
CAQUIAVIRI,"anticoncepcion, prevencion de its y de cancer de cuello uterino",metodos naturales: usuarias nuevas,2015-09-01,0,0,2,0,0,2
CARACOLLO,"anticoncepcion, prevencion de its y de cancer de cuello uterino",metodos naturales: usuarias nuevas,2015-09-01,0,2,10,3,0,15
CARANAVI,"anticoncepcion, prevencion de its y de cancer de cuello uterino",metodos naturales: usuarias nuevas,2015-09-01,0,2,0,0,0,2
CARIPUYO,"anticoncepcion, prevencion de its y de cancer de cuello uterino",metodos naturales: usuarias nuevas,2015-09-01,0,1,3,3,0,7
CHALLAPATA,"anticoncepcion, prevencion de its y de cancer de cuello uterino",metodos naturales: usuarias nuevas,2015-09-01,1,17,32,11,0,61
CHAQUI,"anticoncepcion, prevencion de its y de cancer de cuello uterino",metodos naturales: usuarias nuevas,2015-09-01,0,3,3,0,0,6
CHAYANTA,"anticoncepcion, prevencion de its y de cancer de cuello uterino",metodos naturales: usuarias nuevas,2015-09-01,0,7,14,4,0,25
CHIMORE,"anticoncepcion, prevencion de its y de cancer de cuello uterino",metodos naturales: usuarias nuevas,2015-09-01,0,0,0,1,0,1
CHIPAYA,"anticoncepcion, prevencion de its y de cancer de cuello uterino",metodos naturales: usuarias nuevas,2015-09-01,0,1,0,0,0,1
CHOQUE COTA,"anticoncepcion, prevencion de its y de cancer de cuello uterino",metodos naturales: usuarias nuevas,2015-09-01,0,0,1,0,0,1
CHUA COCANI,"anticoncepcion, prevencion de its y de cancer de cuello uterino",metodos naturales: usuarias nuevas,2015-09-01,0,1,3,0,0,4
CHULUMANI (V. DE LA LIBERTAD),"anticoncepcion, prevencion de its y de cancer de cuello uterino",metodos naturales: usuarias nuevas,2015-09-01,0,5,12,0,0,17
CHUQUIHUTA AYLLU JUCUMANI,"anticoncepcion, prevencion de its y de cancer de cuello uterino",metodos naturales: usuarias nuevas,2015-09-01,0,1,7,2,0,10
CKOCHAS,"anticoncepcion, prevencion de its y de cancer de cuello uterino",metodos naturales: usuarias nuevas,2015-09-01,0,3,7,2,0,12
CLIZA,"anticoncepcion, prevencion de its y de cancer de cuello uterino",metodos naturales: usuarias nuevas,2015-09-01,0,0,1,0,0,1
COBIJA,"anticoncepcion, prevencion de its y de cancer de cuello uterino",metodos naturales: usuarias nuevas,2015-09-01,0,8,34,19,0,61
COCAPATA,"anticoncepcion, prevencion de its y de cancer de cuello uterino",metodos naturales: usuarias nuevas,2015-09-01,0,2,2,0,0,4
COCHABAMBA,"anticoncepcion, prevencion de its y de cancer de cuello uterino",metodos naturales: usuarias nuevas,2015-09-01,1,33,91,288,0,413
"COLCHA ""K""","anticoncepcion, prevencion de its y de cancer de cuello uterino",metodos naturales: usuarias nuevas,2015-09-01,0,3,3,1,0,7
COLOMI,"anticoncepcion, prevencion de its y de cancer de cuello uterino",metodos naturales: usuarias nuevas,2015-09-01,0,0,4,2,0,6
COLPA BELGICA,"anticoncepcion, prevencion de its y de cancer de cuello uterino",metodos naturales: usuarias nuevas,2015-09-01,0,2,3,0,0,5
COLQUECHACA,"anticoncepcion, prevencion de its y de cancer de cuello uterino",metodos naturales: usuarias nuevas,2015-09-01,0,3,8,2,0,13
COLQUIRI,"anticoncepcion, prevencion de its y de cancer de cuello uterino",metodos naturales: usuarias nuevas,2015-09-01,0,10,14,4,0,28
COMANCHE,"anticoncepcion, prevencion de its y de cancer de cuello uterino",metodos naturales: usuarias nuevas,2015-09-01,0,1,1,1,0,3
COMARAPA,"anticoncepcion, prevencion de its y de cancer de cuello uterino",metodos naturales: usuarias nuevas,2015-09-01,0,12,12,5,0,29
CORIPATA,"anticoncepcion, prevencion de its y de cancer de cuello uterino",metodos naturales: usuarias nuevas,2015-09-01,0,2,5,0,0,7
COTOCA,"anticoncepcion, prevencion de its y de cancer de cuello uterino",metodos naturales: usuarias nuevas,2015-09-01,1,9,30,2,0,42
CUATRO CAÑADAS,"anticoncepcion, prevencion de its y de cancer de cuello uterino",metodos naturales: usuarias nuevas,2015-09-01,0,1,1,0,0,2
CUCHUMUELA (V. G. VILLARROEL),"anticoncepcion, prevencion de its y de cancer de cuello uterino",metodos naturales: usuarias nuevas,2015-09-01,0,0,0,1,0,1
CULPINA,"anticoncepcion, prevencion de its y de cancer de cuello uterino",metodos naturales: usuarias nuevas,2015-09-01,0,1,5,1,0,7
CURAHUARA DE CARANGAS,"anticoncepcion, prevencion de its y de cancer de cuello uterino",metodos naturales: usuarias nuevas,2015-09-01,0,0,1,0,0,1
EL ALTO,"anticoncepcion, prevencion de its y de cancer de cuello uterino",metodos naturales: usuarias nuevas,2015-09-01,0,31,229,471,0,731
EL CHORO,"anticoncepcion, prevencion de its y de cancer de cuello uterino",metodos naturales: usuarias nuevas,2015-09-01,0,0,7,0,0,7
EL PUENTE(STC),"anticoncepcion, prevencion de its y de cancer de cuello uterino",metodos naturales: usuarias nuevas,2015-09-01,0,2,1,0,0,3
EL PUENTE(TJA),"anticoncepcion, prevencion de its y de cancer de cuello uterino",metodos naturales: usuarias nuevas,2015-09-01,0,0,1,0,0,1
EL VILLAR,"anticoncepcion, prevencion de its y de cancer de cuello uterino",metodos naturales: usuarias nuevas,2015-09-01,0,3,0,1,0,4
ENTRE RIOS TRJ,"anticoncepcion, prevencion de its y de cancer de cuello uterino",metodos naturales: usuarias nuevas,2015-09-01,0,6,7,2,0,15
EUCALIPTUS,"anticoncepcion, prevencion de its y de cancer de cuello uterino",metodos naturales: usuarias nuevas,2015-09-01,0,1,2,0,0,3
FILADELFIA,"anticoncepcion, prevencion de its y de cancer de cuello uterino",metodos naturales: usuarias nuevas,2015-09-01,0,0,1,0,0,1
GUAQUI,"anticoncepcion, prevencion de its y de cancer de cuello uterino",metodos naturales: usuarias nuevas,2015-09-01,0,3,7,1,0,11
GUAYARAMERIN,"anticoncepcion, prevencion de its y de cancer de cuello uterino",metodos naturales: usuarias nuevas,2015-09-01,1,16,53,10,0,80
HUACARETA,"anticoncepcion, prevencion de its y de cancer de cuello uterino",metodos naturales: usuarias nuevas,2015-09-01,0,1,4,0,0,5
HUACHACALLA,"anticoncepcion, prevencion de its y de cancer de cuello uterino",metodos naturales: usuarias nuevas,2015-09-01,0,0,1,0,0,1
HUANUNI,"anticoncepcion, prevencion de its y de cancer de cuello uterino",metodos naturales: usuarias nuevas,2015-09-01,0,0,6,2,0,8
HUATAJATA,"anticoncepcion, prevencion de its y de cancer de cuello uterino",metodos naturales: usuarias nuevas,2015-09-01,0,0,1,0,0,1
HUAYLLAMARCA,"anticoncepcion, prevencion de its y de cancer de cuello uterino",metodos naturales: usuarias nuevas,2015-09-01,1,1,0,3,0,5
ICHOCA,"anticoncepcion, prevencion de its y de cancer de cuello uterino",metodos naturales: usuarias nuevas,2015-09-01,0,0,1,2,0,3
ICLA,"anticoncepcion, prevencion de its y de cancer de cuello uterino",metodos naturales: usuarias nuevas,2015-09-01,0,1,6,0,0,7
INCAHUASI,"anticoncepcion, prevencion de its y de cancer de cuello uterino",metodos naturales: usuarias nuevas,2015-09-01,1,2,14,6,0,23
INQUISIVI,"anticoncepcion, prevencion de its y de cancer de cuello uterino",metodos naturales: usuarias nuevas,2015-09-01,0,4,5,4,0,13
IRUPANA (VILLA DE LANZA),"anticoncepcion, prevencion de its y de cancer de cuello uterino",metodos naturales: usuarias nuevas,2015-09-01,0,0,7,0,0,7
IXIAMAS,"anticoncepcion, prevencion de its y de cancer de cuello uterino",metodos naturales: usuarias nuevas,2015-09-01,0,2,10,2,0,14
JESUS DE MACHACA,"anticoncepcion, prevencion de its y de cancer de cuello uterino",metodos naturales: usuarias nuevas,2015-09-01,0,1,3,1,0,5
LA ASUNTA,"anticoncepcion, prevencion de its y de cancer de cuello uterino",metodos naturales: usuarias nuevas,2015-09-01,0,2,13,1,0,16
LA GUARDIA,"anticoncepcion, prevencion de its y de cancer de cuello uterino",metodos naturales: usuarias nuevas,2015-09-01,0,0,1,1,0,2
LA PAZ,"anticoncepcion, prevencion de its y de cancer de cuello uterino",metodos naturales: usuarias nuevas,2015-09-01,3,41,167,28,0,239
LAJA,"anticoncepcion, prevencion de its y de cancer de cuello uterino",metodos naturales: usuarias nuevas,2015-09-01,0,1,2,0,0,3
LORETO,"anticoncepcion, prevencion de its y de cancer de cuello uterino",metodos naturales: usuarias nuevas,2015-09-01,0,2,1,0,0,3
MACHACAMARCA,"anticoncepcion, prevencion de its y de cancer de cuello uterino",metodos naturales: usuarias nuevas,2015-09-01,0,0,3,0,0,3
MACHARETI,"anticoncepcion, prevencion de its y de cancer de cuello uterino",metodos naturales: usuarias nuevas,2015-09-01,0,0,1,0,0,1
MAGDALENA,"anticoncepcion, prevencion de its y de cancer de cuello uterino",metodos naturales: usuarias nuevas,2015-09-01,0,0,3,0,0,3
MAIRANA,"anticoncepcion, prevencion de its y de cancer de cuello uterino",metodos naturales: usuarias nuevas,2015-09-01,0,0,1,0,0,1
MALLA,"anticoncepcion, prevencion de its y de cancer de cuello uterino",metodos naturales: usuarias nuevas,2015-09-01,0,0,1,0,0,1
MINEROS,"anticoncepcion, prevencion de its y de cancer de cuello uterino",metodos naturales: usuarias nuevas,2015-09-01,0,0,1,2,0,3
MIZQUE,"anticoncepcion, prevencion de its y de cancer de cuello uterino",metodos naturales: usuarias nuevas,2015-09-01,0,1,6,4,0,11
MOCOMOCO,"anticoncepcion, prevencion de its y de cancer de cuello uterino",metodos naturales: usuarias nuevas,2015-09-01,0,1,1,0,0,2
MOJINETE,"anticoncepcion, prevencion de its y de cancer de cuello uterino",metodos naturales: usuarias nuevas,2015-09-01,0,0,1,0,0,1
MOJOCOYA,"anticoncepcion, prevencion de its y de cancer de cuello uterino",metodos naturales: usuarias nuevas,2015-09-01,0,1,3,3,0,7
MONTEAGUDO,"anticoncepcion, prevencion de its y de cancer de cuello uterino",metodos naturales: usuarias nuevas,2015-09-01,0,0,1,0,0,1
MONTERO,"anticoncepcion, prevencion de its y de cancer de cuello uterino",metodos naturales: usuarias nuevas,2015-09-01,0,1,3,0,0,4
MOROCHATA,"anticoncepcion, prevencion de its y de cancer de cuello uterino",metodos naturales: usuarias nuevas,2015-09-01,0,3,7,0,0,10
NUEVO MANOA (NUEVA ESPERANZA),"anticoncepcion, prevencion de its y de cancer de cuello uterino",metodos naturales: usuarias nuevas,2015-09-01,0,0,14,0,0,14
OCURI,"anticoncepcion, prevencion de its y de cancer de cuello uterino",metodos naturales: usuarias nuevas,2015-09-01,0,1,4,4,0,9
OMEREQUE,"anticoncepcion, prevencion de its y de cancer de cuello uterino",metodos naturales: usuarias nuevas,2015-09-01,0,1,3,1,0,5
ORURO,"anticoncepcion, prevencion de its y de cancer de cuello uterino",metodos naturales: usuarias nuevas,2015-09-01,0,20,38,7,0,65
PADILLA,"anticoncepcion, prevencion de its y de cancer de cuello uterino",metodos naturales: usuarias nuevas,2015-09-01,0,1,3,0,0,4
PAILON,"anticoncepcion, prevencion de its y de cancer de cuello uterino",metodos naturales: usuarias nuevas,2015-09-01,0,0,1,0,0,1
PAMPA AULLAGAS,"anticoncepcion, prevencion de its y de cancer de cuello uterino",metodos naturales: usuarias nuevas,2015-09-01,0,0,1,0,0,1
PAPEL PAMPA,"anticoncepcion, prevencion de its y de cancer de cuello uterino",metodos naturales: usuarias nuevas,2015-09-01,0,0,2,1,0,3
PASORAPA,"anticoncepcion, prevencion de its y de cancer de cuello uterino",metodos naturales: usuarias nuevas,2015-09-01,0,2,0,0,0,2
PAZÑA,"anticoncepcion, prevencion de its y de cancer de cuello uterino",metodos naturales: usuarias nuevas,2015-09-01,0,2,0,1,0,3
POCOATA,"anticoncepcion, prevencion de its y de cancer de cuello uterino",metodos naturales: usuarias nuevas,2015-09-01,0,5,13,7,0,25
POCONA,"anticoncepcion, prevencion de its y de cancer de cuello uterino",metodos naturales: usuarias nuevas,2015-09-01,0,0,1,0,0,1
POJO (CBBA),"anticoncepcion, prevencion de its y de cancer de cuello uterino",metodos naturales: usuarias nuevas,2015-09-01,0,0,1,0,0,1
POROMA,"anticoncepcion, prevencion de its y de cancer de cuello uterino",metodos naturales: usuarias nuevas,2015-09-01,0,0,2,1,0,3
PORONGO,"anticoncepcion, prevencion de its y de cancer de cuello uterino",metodos naturales: usuarias nuevas,2015-09-01,0,3,1,0,0,4
PORTACHUELO,"anticoncepcion, prevencion de its y de cancer de cuello uterino",metodos naturales: usuarias nuevas,2015-09-01,1,1,2,0,0,4
POTOSI,"anticoncepcion, prevencion de its y de cancer de cuello uterino",metodos naturales: usuarias nuevas,2015-09-01,0,10,27,74,0,111
PRESTO,"anticoncepcion, prevencion de its y de cancer de cuello uterino",metodos naturales: usuarias nuevas,2015-09-01,1,0,5,0,0,6
PUCARANI,"anticoncepcion, prevencion de its y de cancer de cuello uterino",metodos naturales: usuarias nuevas,2015-09-01,0,9,13,1,0,23
PUERTO ACOSTA,"anticoncepcion, prevencion de its y de cancer de cuello uterino",metodos naturales: usuarias nuevas,2015-09-01,0,0,2,0,0,2
PUERTO GONZALO MORENO,"anticoncepcion, prevencion de its y de cancer de cuello uterino",metodos naturales: usuarias nuevas,2015-09-01,1,2,1,0,0,4
PUERTO PEREZ,"anticoncepcion, prevencion de its y de cancer de cuello uterino",metodos naturales: usuarias nuevas,2015-09-01,0,1,2,0,0,3
PUERTO RICO,"anticoncepcion, prevencion de its y de cancer de cuello uterino",metodos naturales: usuarias nuevas,2015-09-01,0,3,1,0,0,4
PUERTO VILLARROEL,"anticoncepcion, prevencion de its y de cancer de cuello uterino",metodos naturales: usuarias nuevas,2015-09-01,1,1,7,3,0,12
PUNA,"anticoncepcion, prevencion de its y de cancer de cuello uterino",metodos naturales: usuarias nuevas,2015-09-01,0,3,8,1,0,12
PUNATA,"anticoncepcion, prevencion de its y de cancer de cuello uterino",metodos naturales: usuarias nuevas,2015-09-01,0,28,60,1,0,89
QUILLACOLLO,"anticoncepcion, prevencion de its y de cancer de cuello uterino",metodos naturales: usuarias nuevas,2015-09-01,0,0,7,0,0,7
QUIME,"anticoncepcion, prevencion de its y de cancer de cuello uterino",metodos naturales: usuarias nuevas,2015-09-01,0,1,7,2,0,10
RAVELO,"anticoncepcion, prevencion de its y de cancer de cuello uterino",metodos naturales: usuarias nuevas,2015-09-01,0,0,1,3,0,4
REYES,"anticoncepcion, prevencion de its y de cancer de cuello uterino",metodos naturales: usuarias nuevas,2015-09-01,13,6,18,6,0,43
RIBERALTA,"anticoncepcion, prevencion de its y de cancer de cuello uterino",metodos naturales: usuarias nuevas,2015-09-01,7,45,101,17,0,170
RURRENABAQUE,"anticoncepcion, prevencion de its y de cancer de cuello uterino",metodos naturales: usuarias nuevas,2015-09-01,1,8,14,1,1,25
SABAYA,"anticoncepcion, prevencion de its y de cancer de cuello uterino",metodos naturales: usuarias nuevas,2015-09-01,0,1,1,0,0,2
SACABA,"anticoncepcion, prevencion de its y de cancer de cuello uterino",metodos naturales: usuarias nuevas,2015-09-01,0,1,34,31,0,66
SACACA,"anticoncepcion, prevencion de its y de cancer de cuello uterino",metodos naturales: usuarias nuevas,2015-09-01,0,0,3,1,0,4
SAIPINA,"anticoncepcion, prevencion de its y de cancer de cuello uterino",metodos naturales: usuarias nuevas,2015-09-01,0,1,0,0,0,1
SALINAS DE GARCI MENDOZA,"anticoncepcion, prevencion de its y de cancer de cuello uterino",metodos naturales: usuarias nuevas,2015-09-01,0,1,8,2,0,11
SAN ANDRES,"anticoncepcion, prevencion de its y de cancer de cuello uterino",metodos naturales: usuarias nuevas,2015-09-01,0,1,0,0,0,1
SAN ANDRES DE MACHACA,"anticoncepcion, prevencion de its y de cancer de cuello uterino",metodos naturales: usuarias nuevas,2015-09-01,0,1,3,1,0,5
SAN ANTONIO DE LOMERIO,"anticoncepcion, prevencion de its y de cancer de cuello uterino",metodos naturales: usuarias nuevas,2015-09-01,0,0,8,5,0,13
SAN BENITO,"anticoncepcion, prevencion de its y de cancer de cuello uterino",metodos naturales: usuarias nuevas,2015-09-01,0,1,1,1,0,3
SAN BORJA,"anticoncepcion, prevencion de its y de cancer de cuello uterino",metodos naturales: usuarias nuevas,2015-09-01,3,12,23,6,0,44
SAN BUENA VENTURA,"anticoncepcion, prevencion de its y de cancer de cuello uterino",metodos naturales: usuarias nuevas,2015-09-01,0,6,19,6,0,31
SAN CARLOS,"anticoncepcion, prevencion de its y de cancer de cuello uterino",metodos naturales: usuarias nuevas,2015-09-01,1,6,26,3,0,36
SAN IGNACIO,"anticoncepcion, prevencion de its y de cancer de cuello uterino",metodos naturales: usuarias nuevas,2015-09-01,0,5,10,1,0,16
SAN JOSE DE CHIQUITOS,"anticoncepcion, prevencion de its y de cancer de cuello uterino",metodos naturales: usuarias nuevas,2015-09-01,0,0,1,0,0,1
SAN JUAN DE YAPACANI,"anticoncepcion, prevencion de its y de cancer de cuello uterino",metodos naturales: usuarias nuevas,2015-09-01,0,3,3,0,0,6
SAN JULIAN,"anticoncepcion, prevencion de its y de cancer de cuello uterino",metodos naturales: usuarias nuevas,2015-09-01,0,3,5,1,0,9
SAN LUCAS,"anticoncepcion, prevencion de its y de cancer de cuello uterino",metodos naturales: usuarias nuevas,2015-09-01,0,2,6,3,0,11
SAN MATIAS,"anticoncepcion, prevencion de its y de cancer de cuello uterino",metodos naturales: usuarias nuevas,2015-09-01,0,7,12,2,0,21
SAN MIGUEL DE VELASCO,"anticoncepcion, prevencion de its y de cancer de cuello uterino",metodos naturales: usuarias nuevas,2015-09-01,0,3,2,0,0,5
SAN PEDRO,"anticoncepcion, prevencion de its y de cancer de cuello uterino",metodos naturales: usuarias nuevas,2015-09-01,0,0,2,0,0,2
SAN PEDRO DE BUENA VISTA,"anticoncepcion, prevencion de its y de cancer de cuello uterino",metodos naturales: usuarias nuevas,2015-09-01,0,5,10,2,0,17
SAN PEDRO DE TIQUINA,"anticoncepcion, prevencion de its y de cancer de cuello uterino",metodos naturales: usuarias nuevas,2015-09-01,0,0,1,0,0,1
SAN RAFAEL,"anticoncepcion, prevencion de its y de cancer de cuello uterino",metodos naturales: usuarias nuevas,2015-09-01,0,4,2,0,0,6
SAN RAMON BENI,"anticoncepcion, prevencion de its y de cancer de cuello uterino",metodos naturales: usuarias nuevas,2015-09-01,0,0,2,0,0,2
SANTA ANA,"anticoncepcion, prevencion de its y de cancer de cuello uterino",metodos naturales: usuarias nuevas,2015-09-01,6,11,26,4,0,47
SANTA CRUZ DE LA SIERRA,"anticoncepcion, prevencion de its y de cancer de cuello uterino",metodos naturales: usuarias nuevas,2015-09-01,1,19,48,7,0,75
SANTA ROSA,"anticoncepcion, prevencion de its y de cancer de cuello uterino",metodos naturales: usuarias nuevas,2015-09-01,0,9,1,2,0,12
SANTA ROSA DEL SARA,"anticoncepcion, prevencion de its y de cancer de cuello uterino",metodos naturales: usuarias nuevas,2015-09-01,0,2,11,0,0,13
SANTIAGO DE HUARI,"anticoncepcion, prevencion de its y de cancer de cuello uterino",metodos naturales: usuarias nuevas,2015-09-01,0,0,8,1,0,9
SANTIAGO DE HUATA,"anticoncepcion, prevencion de its y de cancer de cuello uterino",metodos naturales: usuarias nuevas,2015-09-01,0,1,1,0,0,2
SANTIAGO DE MACHACA,"anticoncepcion, prevencion de its y de cancer de cuello uterino",metodos naturales: usuarias nuevas,2015-09-01,0,0,1,0,0,1
SANTIVAÑES,"anticoncepcion, prevencion de its y de cancer de cuello uterino",metodos naturales: usuarias nuevas,2015-09-01,1,0,0,0,0,1
SAPAHAQUI,"anticoncepcion, prevencion de its y de cancer de cuello uterino",metodos naturales: usuarias nuevas,2015-09-01,0,1,2,1,0,4
SENA,"anticoncepcion, prevencion de its y de cancer de cuello uterino",metodos naturales: usuarias nuevas,2015-09-01,1,2,3,0,0,6
SHINAOTA,"anticoncepcion, prevencion de its y de cancer de cuello uterino",metodos naturales: usuarias nuevas,2015-09-01,0,0,1,0,0,1
SIPE SIPE,"anticoncepcion, prevencion de its y de cancer de cuello uterino",metodos naturales: usuarias nuevas,2015-09-01,0,5,19,3,0,27
SOPACHUY,"anticoncepcion, prevencion de its y de cancer de cuello uterino",metodos naturales: usuarias nuevas,2015-09-01,0,2,7,2,0,11
SORACACHI,"anticoncepcion, prevencion de its y de cancer de cuello uterino",metodos naturales: usuarias nuevas,2015-09-01,0,2,4,1,0,7
SUCRE,"anticoncepcion, prevencion de its y de cancer de cuello uterino",metodos naturales: usuarias nuevas,2015-09-01,3,23,118,19,0,163
TACOBAMBA,"anticoncepcion, prevencion de its y de cancer de cuello uterino",metodos naturales: usuarias nuevas,2015-09-01,0,0,0,1,0,1
TACOPAYA,"anticoncepcion, prevencion de its y de cancer de cuello uterino",metodos naturales: usuarias nuevas,2015-09-01,0,1,2,1,0,4
TAPACARI,"anticoncepcion, prevencion de its y de cancer de cuello uterino",metodos naturales: usuarias nuevas,2015-09-01,0,0,3,0,0,3
TARABUCO,"anticoncepcion, prevencion de its y de cancer de cuello uterino",metodos naturales: usuarias nuevas,2015-09-01,0,1,1,0,0,2
TARACO,"anticoncepcion, prevencion de its y de cancer de cuello uterino",metodos naturales: usuarias nuevas,2015-09-01,1,2,1,1,0,5
TARATA,"anticoncepcion, prevencion de its y de cancer de cuello uterino",metodos naturales: usuarias nuevas,2015-09-01,0,2,6,1,0,9
TARIJA,"anticoncepcion, prevencion de its y de cancer de cuello uterino",metodos naturales: usuarias nuevas,2015-09-01,0,0,7,3,0,10
TARVITA,"anticoncepcion, prevencion de its y de cancer de cuello uterino",metodos naturales: usuarias nuevas,2015-09-01,0,0,0,2,0,2
TEOPONTE,"anticoncepcion, prevencion de its y de cancer de cuello uterino",metodos naturales: usuarias nuevas,2015-09-01,0,1,1,0,0,2
TIAWANACU,"anticoncepcion, prevencion de its y de cancer de cuello uterino",metodos naturales: usuarias nuevas,2015-09-01,0,2,4,2,0,8
TINGUIPAYA,"anticoncepcion, prevencion de its y de cancer de cuello uterino",metodos naturales: usuarias nuevas,2015-09-01,0,0,1,0,0,1
TIQUIPAYA,"anticoncepcion, prevencion de its y de cancer de cuello uterino",metodos naturales: usuarias nuevas,2015-09-01,0,0,4,0,0,4
TIRAQUE (CBBA),"anticoncepcion, prevencion de its y de cancer de cuello uterino",metodos naturales: usuarias nuevas,2015-09-01,0,2,1,2,0,5
TOLATA,"anticoncepcion, prevencion de its y de cancer de cuello uterino",metodos naturales: usuarias nuevas,2015-09-01,0,0,3,3,0,6
TOMINA,"anticoncepcion, prevencion de its y de cancer de cuello uterino",metodos naturales: usuarias nuevas,2015-09-01,0,2,4,1,0,7
TORO TORO,"anticoncepcion, prevencion de its y de cancer de cuello uterino",metodos naturales: usuarias nuevas,2015-09-01,0,1,0,0,0,1
TOTORA(CBBA),"anticoncepcion, prevencion de its y de cancer de cuello uterino",metodos naturales: usuarias nuevas,2015-09-01,2,0,0,1,0,3
TOTORA(ORR),"anticoncepcion, prevencion de its y de cancer de cuello uterino",metodos naturales: usuarias nuevas,2015-09-01,0,0,4,0,0,4
TRINIDAD,"anticoncepcion, prevencion de its y de cancer de cuello uterino",metodos naturales: usuarias nuevas,2015-09-01,1,25,38,3,0,67
TUPIZA,"anticoncepcion, prevencion de its y de cancer de cuello uterino",metodos naturales: usuarias nuevas,2015-09-01,0,0,3,1,0,4
TURCO,"anticoncepcion, prevencion de its y de cancer de cuello uterino",metodos naturales: usuarias nuevas,2015-09-01,0,0,2,1,0,3
UMALA,"anticoncepcion, prevencion de its y de cancer de cuello uterino",metodos naturales: usuarias nuevas,2015-09-01,0,0,1,0,0,1
UNCIA,"anticoncepcion, prevencion de its y de cancer de cuello uterino",metodos naturales: usuarias nuevas,2015-09-01,0,0,5,2,0,7
URIONDO (A. CONCEPCION),"anticoncepcion, prevencion de its y de cancer de cuello uterino",metodos naturales: usuarias nuevas,2015-09-01,0,1,1,0,0,2
VACAS,"anticoncepcion, prevencion de its y de cancer de cuello uterino",metodos naturales: usuarias nuevas,2015-09-01,0,3,5,1,0,9
VIACHA,"anticoncepcion, prevencion de its y de cancer de cuello uterino",metodos naturales: usuarias nuevas,2015-09-01,0,0,0,1,0,1
VILLA CHARCAS,"anticoncepcion, prevencion de its y de cancer de cuello uterino",metodos naturales: usuarias nuevas,2015-09-01,0,0,4,0,0,4
VILLA SERRANO,"anticoncepcion, prevencion de its y de cancer de cuello uterino",metodos naturales: usuarias nuevas,2015-09-01,0,1,2,0,0,3
VILLA TUNARI,"anticoncepcion, prevencion de its y de cancer de cuello uterino",metodos naturales: usuarias nuevas,2015-09-01,0,0,5,0,0,5
VILLAZON,"anticoncepcion, prevencion de its y de cancer de cuello uterino",metodos naturales: usuarias nuevas,2015-09-01,0,14,39,4,0,57
VINTO,"anticoncepcion, prevencion de its y de cancer de cuello uterino",metodos naturales: usuarias nuevas,2015-09-01,1,5,14,7,1,28
VITICHI,"anticoncepcion, prevencion de its y de cancer de cuello uterino",metodos naturales: usuarias nuevas,2015-09-01,1,2,5,0,0,8
WARNES,"anticoncepcion, prevencion de its y de cancer de cuello uterino",metodos naturales: usuarias nuevas,2015-09-01,0,0,1,1,0,2
YACUIBA,"anticoncepcion, prevencion de its y de cancer de cuello uterino",metodos naturales: usuarias nuevas,2015-09-01,0,2,5,3,0,10
YAMPARAEZ,"anticoncepcion, prevencion de its y de cancer de cuello uterino",metodos naturales: usuarias nuevas,2015-09-01,0,1,0,0,0,1
YANACACHI,"anticoncepcion, prevencion de its y de cancer de cuello uterino",metodos naturales: usuarias nuevas,2015-09-01,0,1,5,0,0,6
YAPACANI,"anticoncepcion, prevencion de its y de cancer de cuello uterino",metodos naturales: usuarias nuevas,2015-09-01,1,2,0,0,0,3
YOCALLA,"anticoncepcion, prevencion de its y de cancer de cuello uterino",metodos naturales: usuarias nuevas,2015-09-01,0,1,3,1,0,5
YOTALA,"anticoncepcion, prevencion de its y de cancer de cuello uterino",metodos naturales: usuarias nuevas,2015-09-01,0,0,7,0,0,7
ZUDAÑEZ,"anticoncepcion, prevencion de its y de cancer de cuello uterino",metodos naturales: usuarias nuevas,2015-09-01,0,1,1,0,0,2
ACACIO,"anticoncepcion, prevencion de its y de cancer de cuello uterino",metodos naturales: usuarias nuevas,2015-10-01,0,2,1,1,0,4
ACHACACHI,"anticoncepcion, prevencion de its y de cancer de cuello uterino",metodos naturales: usuarias nuevas,2015-10-01,0,0,1,1,4,6
ALALAY,"anticoncepcion, prevencion de its y de cancer de cuello uterino",metodos naturales: usuarias nuevas,2015-10-01,0,1,0,0,0,1
ALCALA,"anticoncepcion, prevencion de its y de cancer de cuello uterino",metodos naturales: usuarias nuevas,2015-10-01,0,2,3,0,0,5
ANCORAIMES,"anticoncepcion, prevencion de its y de cancer de cuello uterino",metodos naturales: usuarias nuevas,2015-10-01,0,6,11,2,0,19
ANDAMARCA,"anticoncepcion, prevencion de its y de cancer de cuello uterino",metodos naturales: usuarias nuevas,2015-10-01,0,0,3,1,0,4
ANZALDO,"anticoncepcion, prevencion de its y de cancer de cuello uterino",metodos naturales: usuarias nuevas,2015-10-01,0,0,1,0,0,1
APOLO,"anticoncepcion, prevencion de its y de cancer de cuello uterino",metodos naturales: usuarias nuevas,2015-10-01,0,2,7,2,0,11
ARAMPAMPA,"anticoncepcion, prevencion de its y de cancer de cuello uterino",metodos naturales: usuarias nuevas,2015-10-01,0,0,1,0,0,1
ARBIETO,"anticoncepcion, prevencion de its y de cancer de cuello uterino",metodos naturales: usuarias nuevas,2015-10-01,0,1,4,2,0,7
AYO AYO,"anticoncepcion, prevencion de its y de cancer de cuello uterino",metodos naturales: usuarias nuevas,2015-10-01,0,0,2,1,0,3
AYOPAYA (V. DE INDEPENDENCIA),"anticoncepcion, prevencion de its y de cancer de cuello uterino",metodos naturales: usuarias nuevas,2015-10-01,1,1,3,0,0,5
AZURDUY,"anticoncepcion, prevencion de its y de cancer de cuello uterino",metodos naturales: usuarias nuevas,2015-10-01,0,0,1,0,0,1
BATALLAS,"anticoncepcion, prevencion de its y de cancer de cuello uterino",metodos naturales: usuarias nuevas,2015-10-01,0,4,5,2,0,11
BETANZOS,"anticoncepcion, prevencion de its y de cancer de cuello uterino",metodos naturales: usuarias nuevas,2015-10-01,0,2,6,2,0,10
BOLPEBRA,"anticoncepcion, prevencion de its y de cancer de cuello uterino",metodos naturales: usuarias nuevas,2015-10-01,0,0,1,0,0,1
BUENA VISTA,"anticoncepcion, prevencion de its y de cancer de cuello uterino",metodos naturales: usuarias nuevas,2015-10-01,0,1,0,0,0,1
CABEZAS,"anticoncepcion, prevencion de its y de cancer de cuello uterino",metodos naturales: usuarias nuevas,2015-10-01,0,0,1,0,0,1
"CAIZA ""D""","anticoncepcion, prevencion de its y de cancer de cuello uterino",metodos naturales: usuarias nuevas,2015-10-01,0,0,3,1,0,4
CAJUATA,"anticoncepcion, prevencion de its y de cancer de cuello uterino",metodos naturales: usuarias nuevas,2015-10-01,0,6,9,0,0,15
CALAMARCA,"anticoncepcion, prevencion de its y de cancer de cuello uterino",metodos naturales: usuarias nuevas,2015-10-01,0,2,6,1,0,9
CAMIRI,"anticoncepcion, prevencion de its y de cancer de cuello uterino",metodos naturales: usuarias nuevas,2015-10-01,0,2,1,0,0,3
CARACOLLO,"anticoncepcion, prevencion de its y de cancer de cuello uterino",metodos naturales: usuarias nuevas,2015-10-01,1,3,11,4,0,19
CARIPUYO,"anticoncepcion, prevencion de its y de cancer de cuello uterino",metodos naturales: usuarias nuevas,2015-10-01,0,1,4,1,0,6
CHALLAPATA,"anticoncepcion, prevencion de its y de cancer de cuello uterino",metodos naturales: usuarias nuevas,2015-10-01,0,15,41,8,0,64
CHAQUI,"anticoncepcion, prevencion de its y de cancer de cuello uterino",metodos naturales: usuarias nuevas,2015-10-01,0,0,1,1,0,2
CHAYANTA,"anticoncepcion, prevencion de its y de cancer de cuello uterino",metodos naturales: usuarias nuevas,2015-10-01,0,10,12,0,0,22
CHIMORE,"anticoncepcion, prevencion de its y de cancer de cuello uterino",metodos naturales: usuarias nuevas,2015-10-01,0,0,1,0,0,1
CHOQUE COTA,"anticoncepcion, prevencion de its y de cancer de cuello uterino",metodos naturales: usuarias nuevas,2015-10-01,0,0,2,0,0,2
CHUA COCANI,"anticoncepcion, prevencion de its y de cancer de cuello uterino",metodos naturales: usuarias nuevas,2015-10-01,0,1,4,0,0,5
CHULUMANI (V. DE LA LIBERTAD),"anticoncepcion, prevencion de its y de cancer de cuello uterino",metodos naturales: usuarias nuevas,2015-10-01,0,0,34,1,0,35
CKOCHAS,"anticoncepcion, prevencion de its y de cancer de cuello uterino",metodos naturales: usuarias nuevas,2015-10-01,0,3,5,3,1,12
CLIZA,"anticoncepcion, prevencion de its y de cancer de cuello uterino",metodos naturales: usuarias nuevas,2015-10-01,0,0,0,1,0,1
COBIJA,"anticoncepcion, prevencion de its y de cancer de cuello uterino",metodos naturales: usuarias nuevas,2015-10-01,1,11,37,8,0,57
COCAPATA,"anticoncepcion, prevencion de its y de cancer de cuello uterino",metodos naturales: usuarias nuevas,2015-10-01,0,1,1,1,0,3
COCHABAMBA,"anticoncepcion, prevencion de its y de cancer de cuello uterino",metodos naturales: usuarias nuevas,2015-10-01,8,19,58,21,0,106
"COLCHA ""K""","anticoncepcion, prevencion de its y de cancer de cuello uterino",metodos naturales: usuarias nuevas,2015-10-01,0,3,2,0,0,5
COLOMI,"anticoncepcion, prevencion de its y de cancer de cuello uterino",metodos naturales: usuarias nuevas,2015-10-01,0,0,8,0,0,8
COLPA BELGICA,"anticoncepcion, prevencion de its y de cancer de cuello uterino",metodos naturales: usuarias nuevas,2015-10-01,0,2,2,0,0,4
COLQUECHACA,"anticoncepcion, prevencion de its y de cancer de cuello uterino",metodos naturales: usuarias nuevas,2015-10-01,0,2,4,0,0,6
COLQUIRI,"anticoncepcion, prevencion de its y de cancer de cuello uterino",metodos naturales: usuarias nuevas,2015-10-01,0,3,11,2,0,16
COMARAPA,"anticoncepcion, prevencion de its y de cancer de cuello uterino",metodos naturales: usuarias nuevas,2015-10-01,0,7,19,2,0,28
CORIPATA,"anticoncepcion, prevencion de its y de cancer de cuello uterino",metodos naturales: usuarias nuevas,2015-10-01,0,1,8,0,0,9
CORO CORO,"anticoncepcion, prevencion de its y de cancer de cuello uterino",metodos naturales: usuarias nuevas,2015-10-01,0,0,0,2,0,2
CORQUE,"anticoncepcion, prevencion de its y de cancer de cuello uterino",metodos naturales: usuarias nuevas,2015-10-01,0,0,4,4,0,8
COTAGAITA,"anticoncepcion, prevencion de its y de cancer de cuello uterino",metodos naturales: usuarias nuevas,2015-10-01,0,2,1,0,0,3
COTOCA,"anticoncepcion, prevencion de its y de cancer de cuello uterino",metodos naturales: usuarias nuevas,2015-10-01,0,4,6,1,0,11
CULPINA,"anticoncepcion, prevencion de its y de cancer de cuello uterino",metodos naturales: usuarias nuevas,2015-10-01,0,4,14,3,0,21
CURAHUARA DE CARANGAS,"anticoncepcion, prevencion de its y de cancer de cuello uterino",metodos naturales: usuarias nuevas,2015-10-01,0,1,1,1,0,3
EL ALTO,"anticoncepcion, prevencion de its y de cancer de cuello uterino",metodos naturales: usuarias nuevas,2015-10-01,0,18,247,403,0,668
EL PUENTE(STC),"anticoncepcion, prevencion de its y de cancer de cuello uterino",metodos naturales: usuarias nuevas,2015-10-01,0,0,3,1,0,4
EL PUENTE(TJA),"anticoncepcion, prevencion de its y de cancer de cuello uterino",metodos naturales: usuarias nuevas,2015-10-01,0,0,1,0,0,1
EL TORNO,"anticoncepcion, prevencion de its y de cancer de cuello uterino",metodos naturales: usuarias nuevas,2015-10-01,0,0,1,0,0,1
EL VILLAR,"anticoncepcion, prevencion de its y de cancer de cuello uterino",metodos naturales: usuarias nuevas,2015-10-01,0,0,1,0,0,1
ENTRE RIOS TRJ,"anticoncepcion, prevencion de its y de cancer de cuello uterino",metodos naturales: usuarias nuevas,2015-10-01,0,1,9,1,0,11
ESCOMA,"anticoncepcion, prevencion de its y de cancer de cuello uterino",metodos naturales: usuarias nuevas,2015-10-01,0,0,1,0,0,1
EUCALIPTUS,"anticoncepcion, prevencion de its y de cancer de cuello uterino",metodos naturales: usuarias nuevas,2015-10-01,0,1,3,0,0,4
EXALTACION,"anticoncepcion, prevencion de its y de cancer de cuello uterino",metodos naturales: usuarias nuevas,2015-10-01,0,1,0,0,0,1
FERNANDEZ ALONSO,"anticoncepcion, prevencion de its y de cancer de cuello uterino",metodos naturales: usuarias nuevas,2015-10-01,0,1,2,0,0,3
GENERAL SAAVEDRA,"anticoncepcion, prevencion de its y de cancer de cuello uterino",metodos naturales: usuarias nuevas,2015-10-01,0,0,1,0,0,1
GUAQUI,"anticoncepcion, prevencion de its y de cancer de cuello uterino",metodos naturales: usuarias nuevas,2015-10-01,0,1,6,0,0,7
GUAYARAMERIN,"anticoncepcion, prevencion de its y de cancer de cuello uterino",metodos naturales: usuarias nuevas,2015-10-01,0,13,40,6,0,59
HUACARETA,"anticoncepcion, prevencion de its y de cancer de cuello uterino",metodos naturales: usuarias nuevas,2015-10-01,0,0,4,0,0,4
HUANUNI,"anticoncepcion, prevencion de its y de cancer de cuello uterino",metodos naturales: usuarias nuevas,2015-10-01,0,1,14,2,0,17
HUATAJATA,"anticoncepcion, prevencion de its y de cancer de cuello uterino",metodos naturales: usuarias nuevas,2015-10-01,0,0,1,0,0,1
HUAYLLAMARCA,"anticoncepcion, prevencion de its y de cancer de cuello uterino",metodos naturales: usuarias nuevas,2015-10-01,0,1,1,1,0,3
ICLA,"anticoncepcion, prevencion de its y de cancer de cuello uterino",metodos naturales: usuarias nuevas,2015-10-01,0,1,2,1,0,4
INCAHUASI,"anticoncepcion, prevencion de its y de cancer de cuello uterino",metodos naturales: usuarias nuevas,2015-10-01,0,2,15,4,0,21
INGAVI (HUMAITA),"anticoncepcion, prevencion de its y de cancer de cuello uterino",metodos naturales: usuarias nuevas,2015-10-01,0,0,2,0,0,2
INQUISIVI,"anticoncepcion, prevencion de its y de cancer de cuello uterino",metodos naturales: usuarias nuevas,2015-10-01,0,3,6,1,0,10
IRUPANA (VILLA DE LANZA),"anticoncepcion, prevencion de its y de cancer de cuello uterino",metodos naturales: usuarias nuevas,2015-10-01,0,1,2,0,0,3
JESUS DE MACHACA,"anticoncepcion, prevencion de its y de cancer de cuello uterino",metodos naturales: usuarias nuevas,2015-10-01,0,1,5,1,0,7
LA ASUNTA,"anticoncepcion, prevencion de its y de cancer de cuello uterino",metodos naturales: usuarias nuevas,2015-10-01,1,3,12,1,0,17
LA GUARDIA,"anticoncepcion, prevencion de its y de cancer de cuello uterino",metodos naturales: usuarias nuevas,2015-10-01,0,0,6,0,0,6
LA PAZ,"anticoncepcion, prevencion de its y de cancer de cuello uterino",metodos naturales: usuarias nuevas,2015-10-01,0,28,162,36,2,228
LAGUNILLAS,"anticoncepcion, prevencion de its y de cancer de cuello uterino",metodos naturales: usuarias nuevas,2015-10-01,0,1,0,0,0,1
LLALLAGUA,"anticoncepcion, prevencion de its y de cancer de cuello uterino",metodos naturales: usuarias nuevas,2015-10-01,0,0,0,3,0,3
MAGDALENA,"anticoncepcion, prevencion de its y de cancer de cuello uterino",metodos naturales: usuarias nuevas,2015-10-01,0,1,0,0,0,1
MIZQUE,"anticoncepcion, prevencion de its y de cancer de cuello uterino",metodos naturales: usuarias nuevas,2015-10-01,0,0,4,0,0,4
MOCOMOCO,"anticoncepcion, prevencion de its y de cancer de cuello uterino",metodos naturales: usuarias nuevas,2015-10-01,0,1,2,1,0,4
MOJOCOYA,"anticoncepcion, prevencion de its y de cancer de cuello uterino",metodos naturales: usuarias nuevas,2015-10-01,0,0,4,1,0,5
MONTEAGUDO,"anticoncepcion, prevencion de its y de cancer de cuello uterino",metodos naturales: usuarias nuevas,2015-10-01,0,0,1,0,0,1
MONTERO,"anticoncepcion, prevencion de its y de cancer de cuello uterino",metodos naturales: usuarias nuevas,2015-10-01,0,2,5,0,0,7
NUEVO MANOA (NUEVA ESPERANZA),"anticoncepcion, prevencion de its y de cancer de cuello uterino",metodos naturales: usuarias nuevas,2015-10-01,0,0,2,0,0,2
OCURI,"anticoncepcion, prevencion de its y de cancer de cuello uterino",metodos naturales: usuarias nuevas,2015-10-01,0,4,5,3,0,12
OMEREQUE,"anticoncepcion, prevencion de its y de cancer de cuello uterino",metodos naturales: usuarias nuevas,2015-10-01,0,1,2,2,0,5
ORURO,"anticoncepcion, prevencion de its y de cancer de cuello uterino",metodos naturales: usuarias nuevas,2015-10-01,0,12,80,8,0,100
PADILLA,"anticoncepcion, prevencion de its y de cancer de cuello uterino",metodos naturales: usuarias nuevas,2015-10-01,0,4,6,2,0,12
PALCA,"anticoncepcion, prevencion de its y de cancer de cuello uterino",metodos naturales: usuarias nuevas,2015-10-01,0,0,2,0,0,2
PAMPA AULLAGAS,"anticoncepcion, prevencion de its y de cancer de cuello uterino",metodos naturales: usuarias nuevas,2015-10-01,0,0,1,0,0,1
PASORAPA,"anticoncepcion, prevencion de its y de cancer de cuello uterino",metodos naturales: usuarias nuevas,2015-10-01,1,0,0,1,0,2
PAZÑA,"anticoncepcion, prevencion de its y de cancer de cuello uterino",metodos naturales: usuarias nuevas,2015-10-01,0,0,2,0,0,2
PELECHUCO,"anticoncepcion, prevencion de its y de cancer de cuello uterino",metodos naturales: usuarias nuevas,2015-10-01,0,1,10,11,0,22
POCOATA,"anticoncepcion, prevencion de its y de cancer de cuello uterino",metodos naturales: usuarias nuevas,2015-10-01,0,3,12,3,0,18
POCONA,"anticoncepcion, prevencion de its y de cancer de cuello uterino",metodos naturales: usuarias nuevas,2015-10-01,0,0,3,0,0,3
PORCO,"anticoncepcion, prevencion de its y de cancer de cuello uterino",metodos naturales: usuarias nuevas,2015-10-01,0,0,7,0,0,7
POROMA,"anticoncepcion, prevencion de its y de cancer de cuello uterino",metodos naturales: usuarias nuevas,2015-10-01,0,2,1,0,0,3
PORONGO,"anticoncepcion, prevencion de its y de cancer de cuello uterino",metodos naturales: usuarias nuevas,2015-10-01,0,2,5,0,0,7
POTOSI,"anticoncepcion, prevencion de its y de cancer de cuello uterino",metodos naturales: usuarias nuevas,2015-10-01,1,21,33,23,0,78
PRESTO,"anticoncepcion, prevencion de its y de cancer de cuello uterino",metodos naturales: usuarias nuevas,2015-10-01,0,2,2,0,0,4
PUCARANI,"anticoncepcion, prevencion de its y de cancer de cuello uterino",metodos naturales: usuarias nuevas,2015-10-01,0,2,11,3,0,16
PUERTO ACOSTA,"anticoncepcion, prevencion de its y de cancer de cuello uterino",metodos naturales: usuarias nuevas,2015-10-01,0,0,2,0,0,2
PUERTO CARABUCO,"anticoncepcion, prevencion de its y de cancer de cuello uterino",metodos naturales: usuarias nuevas,2015-10-01,0,0,5,1,0,6
PUERTO GONZALO MORENO,"anticoncepcion, prevencion de its y de cancer de cuello uterino",metodos naturales: usuarias nuevas,2015-10-01,0,2,0,0,0,2
PUERTO PEREZ,"anticoncepcion, prevencion de its y de cancer de cuello uterino",metodos naturales: usuarias nuevas,2015-10-01,0,1,1,0,0,2
PUERTO RICO,"anticoncepcion, prevencion de its y de cancer de cuello uterino",metodos naturales: usuarias nuevas,2015-10-01,1,1,0,0,0,2
PUERTO VILLARROEL,"anticoncepcion, prevencion de its y de cancer de cuello uterino",metodos naturales: usuarias nuevas,2015-10-01,1,4,9,0,0,14
PUNA,"anticoncepcion, prevencion de its y de cancer de cuello uterino",metodos naturales: usuarias nuevas,2015-10-01,0,1,6,2,0,9
PUNATA,"anticoncepcion, prevencion de its y de cancer de cuello uterino",metodos naturales: usuarias nuevas,2015-10-01,3,18,68,14,0,103
QUILLACOLLO,"anticoncepcion, prevencion de its y de cancer de cuello uterino",metodos naturales: usuarias nuevas,2015-10-01,0,2,6,0,0,8
QUIME,"anticoncepcion, prevencion de its y de cancer de cuello uterino",metodos naturales: usuarias nuevas,2015-10-01,0,0,5,2,0,7
RAVELO,"anticoncepcion, prevencion de its y de cancer de cuello uterino",metodos naturales: usuarias nuevas,2015-10-01,0,2,4,2,0,8
REYES,"anticoncepcion, prevencion de its y de cancer de cuello uterino",metodos naturales: usuarias nuevas,2015-10-01,8,31,39,1,0,79
RIBERALTA,"anticoncepcion, prevencion de its y de cancer de cuello uterino",metodos naturales: usuarias nuevas,2015-10-01,3,55,122,12,0,192
RURRENABAQUE,"anticoncepcion, prevencion de its y de cancer de cuello uterino",metodos naturales: usuarias nuevas,2015-10-01,0,3,7,0,0,10
SABAYA,"anticoncepcion, prevencion de its y de cancer de cuello uterino",metodos naturales: usuarias nuevas,2015-10-01,0,2,0,0,0,2
SACABA,"anticoncepcion, prevencion de its y de cancer de cuello uterino",metodos naturales: usuarias nuevas,2015-10-01,0,5,27,38,0,70
SACABAMBA,"anticoncepcion, prevencion de its y de cancer de cuello uterino",metodos naturales: usuarias nuevas,2015-10-01,0,2,2,2,0,6
SACACA,"anticoncepcion, prevencion de its y de cancer de cuello uterino",metodos naturales: usuarias nuevas,2015-10-01,0,0,1,3,0,4
SAIPINA,"anticoncepcion, prevencion de its y de cancer de cuello uterino",metodos naturales: usuarias nuevas,2015-10-01,0,0,2,0,0,2
SALINAS DE GARCI MENDOZA,"anticoncepcion, prevencion de its y de cancer de cuello uterino",metodos naturales: usuarias nuevas,2015-10-01,0,5,5,0,0,10
SAMAIPATA,"anticoncepcion, prevencion de its y de cancer de cuello uterino",metodos naturales: usuarias nuevas,2015-10-01,1,5,9,2,0,17
SAN ANDRES,"anticoncepcion, prevencion de its y de cancer de cuello uterino",metodos naturales: usuarias nuevas,2015-10-01,0,0,1,0,0,1
SAN ANDRES DE MACHACA,"anticoncepcion, prevencion de its y de cancer de cuello uterino",metodos naturales: usuarias nuevas,2015-10-01,0,0,1,0,0,1
SAN ANTONIO DE LOMERIO,"anticoncepcion, prevencion de its y de cancer de cuello uterino",metodos naturales: usuarias nuevas,2015-10-01,0,1,0,0,0,1
SAN BENITO,"anticoncepcion, prevencion de its y de cancer de cuello uterino",metodos naturales: usuarias nuevas,2015-10-01,0,1,2,1,0,4
SAN BORJA,"anticoncepcion, prevencion de its y de cancer de cuello uterino",metodos naturales: usuarias nuevas,2015-10-01,0,13,23,4,0,40
SAN BUENA VENTURA,"anticoncepcion, prevencion de its y de cancer de cuello uterino",metodos naturales: usuarias nuevas,2015-10-01,0,5,11,0,0,16
SAN CARLOS,"anticoncepcion, prevencion de its y de cancer de cuello uterino",metodos naturales: usuarias nuevas,2015-10-01,0,8,29,2,0,39
SAN IGNACIO,"anticoncepcion, prevencion de its y de cancer de cuello uterino",metodos naturales: usuarias nuevas,2015-10-01,1,6,1,0,0,8
SAN JULIAN,"anticoncepcion, prevencion de its y de cancer de cuello uterino",metodos naturales: usuarias nuevas,2015-10-01,0,0,2,0,0,2
SAN LORENZO(PND),"anticoncepcion, prevencion de its y de cancer de cuello uterino",metodos naturales: usuarias nuevas,2015-10-01,0,2,0,0,0,2
SAN LUCAS,"anticoncepcion, prevencion de its y de cancer de cuello uterino",metodos naturales: usuarias nuevas,2015-10-01,0,0,2,0,0,2
SAN MATIAS,"anticoncepcion, prevencion de its y de cancer de cuello uterino",metodos naturales: usuarias nuevas,2015-10-01,0,1,3,0,0,4
SAN MIGUEL DE VELASCO,"anticoncepcion, prevencion de its y de cancer de cuello uterino",metodos naturales: usuarias nuevas,2015-10-01,0,2,3,0,0,5
SAN PEDRO,"anticoncepcion, prevencion de its y de cancer de cuello uterino",metodos naturales: usuarias nuevas,2015-10-01,0,0,1,0,0,1
SAN PEDRO DE BUENA VISTA,"anticoncepcion, prevencion de its y de cancer de cuello uterino",metodos naturales: usuarias nuevas,2015-10-01,0,7,8,2,0,17
SAN PEDRO DE TIQUINA,"anticoncepcion, prevencion de its y de cancer de cuello uterino",metodos naturales: usuarias nuevas,2015-10-01,0,0,5,0,0,5
SAN PEDRO(PND),"anticoncepcion, prevencion de its y de cancer de cuello uterino",metodos naturales: usuarias nuevas,2015-10-01,0,2,0,0,0,2
SAN RAFAEL,"anticoncepcion, prevencion de its y de cancer de cuello uterino",metodos naturales: usuarias nuevas,2015-10-01,0,2,3,1,0,6
SANTA ANA,"anticoncepcion, prevencion de its y de cancer de cuello uterino",metodos naturales: usuarias nuevas,2015-10-01,3,14,22,8,0,47
SANTA CRUZ DE LA SIERRA,"anticoncepcion, prevencion de its y de cancer de cuello uterino",metodos naturales: usuarias nuevas,2015-10-01,14,34,73,15,0,136
SANTA ROSA DEL SARA,"anticoncepcion, prevencion de its y de cancer de cuello uterino",metodos naturales: usuarias nuevas,2015-10-01,1,0,2,1,0,4
SANTIAGO DE HUARI,"anticoncepcion, prevencion de its y de cancer de cuello uterino",metodos naturales: usuarias nuevas,2015-10-01,0,1,7,1,0,9
SANTIAGO DE HUATA,"anticoncepcion, prevencion de its y de cancer de cuello uterino",metodos naturales: usuarias nuevas,2015-10-01,0,0,2,1,0,3
SANTIAGO DE MACHACA,"anticoncepcion, prevencion de its y de cancer de cuello uterino",metodos naturales: usuarias nuevas,2015-10-01,0,1,2,0,0,3
SANTUARIO DE QUILLACAS,"anticoncepcion, prevencion de its y de cancer de cuello uterino",metodos naturales: usuarias nuevas,2015-10-01,0,1,1,0,0,2
SENA,"anticoncepcion, prevencion de its y de cancer de cuello uterino",metodos naturales: usuarias nuevas,2015-10-01,0,3,0,0,0,3
SHINAOTA,"anticoncepcion, prevencion de its y de cancer de cuello uterino",metodos naturales: usuarias nuevas,2015-10-01,0,0,4,4,0,8
SIPE SIPE,"anticoncepcion, prevencion de its y de cancer de cuello uterino",metodos naturales: usuarias nuevas,2015-10-01,0,11,17,3,0,31
SOPACHUY,"anticoncepcion, prevencion de its y de cancer de cuello uterino",metodos naturales: usuarias nuevas,2015-10-01,0,1,6,2,0,9
SORACACHI,"anticoncepcion, prevencion de its y de cancer de cuello uterino",metodos naturales: usuarias nuevas,2015-10-01,0,0,5,1,0,6
SUCRE,"anticoncepcion, prevencion de its y de cancer de cuello uterino",metodos naturales: usuarias nuevas,2015-10-01,6,48,245,46,1,346
TACOPAYA,"anticoncepcion, prevencion de its y de cancer de cuello uterino",metodos naturales: usuarias nuevas,2015-10-01,0,0,2,4,0,6
TAPACARI,"anticoncepcion, prevencion de its y de cancer de cuello uterino",metodos naturales: usuarias nuevas,2015-10-01,0,0,5,2,0,7
TARABUCO,"anticoncepcion, prevencion de its y de cancer de cuello uterino",metodos naturales: usuarias nuevas,2015-10-01,0,2,1,0,0,3
TARACO,"anticoncepcion, prevencion de its y de cancer de cuello uterino",metodos naturales: usuarias nuevas,2015-10-01,0,1,5,0,0,6
TARATA,"anticoncepcion, prevencion de its y de cancer de cuello uterino",metodos naturales: usuarias nuevas,2015-10-01,1,2,3,0,0,6
TARIJA,"anticoncepcion, prevencion de its y de cancer de cuello uterino",metodos naturales: usuarias nuevas,2015-10-01,0,0,5,3,0,8
TARVITA,"anticoncepcion, prevencion de its y de cancer de cuello uterino",metodos naturales: usuarias nuevas,2015-10-01,0,0,1,1,0,2
TEOPONTE,"anticoncepcion, prevencion de its y de cancer de cuello uterino",metodos naturales: usuarias nuevas,2015-10-01,0,1,2,1,0,4
TIAWANACU,"anticoncepcion, prevencion de its y de cancer de cuello uterino",metodos naturales: usuarias nuevas,2015-10-01,0,0,7,1,0,8
TINGUIPAYA,"anticoncepcion, prevencion de its y de cancer de cuello uterino",metodos naturales: usuarias nuevas,2015-10-01,0,1,4,0,0,5
TIPUANI,"anticoncepcion, prevencion de its y de cancer de cuello uterino",metodos naturales: usuarias nuevas,2015-10-01,0,0,3,0,0,3
TIQUIPAYA,"anticoncepcion, prevencion de its y de cancer de cuello uterino",metodos naturales: usuarias nuevas,2015-10-01,0,1,0,0,0,1
TIRAQUE (CBBA),"anticoncepcion, prevencion de its y de cancer de cuello uterino",metodos naturales: usuarias nuevas,2015-10-01,0,2,2,1,0,5
TOLEDO,"anticoncepcion, prevencion de its y de cancer de cuello uterino",metodos naturales: usuarias nuevas,2015-10-01,0,0,7,0,0,7
TOMAVE,"anticoncepcion, prevencion de its y de cancer de cuello uterino",metodos naturales: usuarias nuevas,2015-10-01,0,0,1,1,0,2
TOMINA,"anticoncepcion, prevencion de its y de cancer de cuello uterino",metodos naturales: usuarias nuevas,2015-10-01,0,5,2,1,0,8
TOTORA(CBBA),"anticoncepcion, prevencion de its y de cancer de cuello uterino",metodos naturales: usuarias nuevas,2015-10-01,0,0,1,0,0,1
TOTORA(ORR),"anticoncepcion, prevencion de its y de cancer de cuello uterino",metodos naturales: usuarias nuevas,2015-10-01,0,0,2,2,0,4
TRINIDAD,"anticoncepcion, prevencion de its y de cancer de cuello uterino",metodos naturales: usuarias nuevas,2015-10-01,1,17,60,7,0,85
TUPIZA,"anticoncepcion, prevencion de its y de cancer de cuello uterino",metodos naturales: usuarias nuevas,2015-10-01,0,1,1,1,0,3
UNCIA,"anticoncepcion, prevencion de its y de cancer de cuello uterino",metodos naturales: usuarias nuevas,2015-10-01,0,1,6,2,0,9
VACAS,"anticoncepcion, prevencion de its y de cancer de cuello uterino",metodos naturales: usuarias nuevas,2015-10-01,1,2,5,4,0,12
VILLA CHARCAS,"anticoncepcion, prevencion de its y de cancer de cuello uterino",metodos naturales: usuarias nuevas,2015-10-01,0,0,4,0,0,4
VILLA MONTES,"anticoncepcion, prevencion de its y de cancer de cuello uterino",metodos naturales: usuarias nuevas,2015-10-01,1,8,11,7,0,27
VILLA RIVERO,"anticoncepcion, prevencion de its y de cancer de cuello uterino",metodos naturales: usuarias nuevas,2015-10-01,0,1,1,1,0,3
VILLA SERRANO,"anticoncepcion, prevencion de its y de cancer de cuello uterino",metodos naturales: usuarias nuevas,2015-10-01,0,1,2,0,0,3
VILLA TUNARI,"anticoncepcion, prevencion de its y de cancer de cuello uterino",metodos naturales: usuarias nuevas,2015-10-01,1,3,5,3,0,12
VILLAZON,"anticoncepcion, prevencion de its y de cancer de cuello uterino",metodos naturales: usuarias nuevas,2015-10-01,0,3,25,4,0,32
VINTO,"anticoncepcion, prevencion de its y de cancer de cuello uterino",metodos naturales: usuarias nuevas,2015-10-01,0,8,25,3,0,36
VITICHI,"anticoncepcion, prevencion de its y de cancer de cuello uterino",metodos naturales: usuarias nuevas,2015-10-01,0,0,2,1,0,3
WARNES,"anticoncepcion, prevencion de its y de cancer de cuello uterino",metodos naturales: usuarias nuevas,2015-10-01,0,1,1,0,0,2
YACUIBA,"anticoncepcion, prevencion de its y de cancer de cuello uterino",metodos naturales: usuarias nuevas,2015-10-01,0,0,15,3,0,18
YANACACHI,"anticoncepcion, prevencion de its y de cancer de cuello uterino",metodos naturales: usuarias nuevas,2015-10-01,0,0,3,0,0,3
YAPACANI,"anticoncepcion, prevencion de its y de cancer de cuello uterino",metodos naturales: usuarias nuevas,2015-10-01,0,5,8,0,0,13
YOTALA,"anticoncepcion, prevencion de its y de cancer de cuello uterino",metodos naturales: usuarias nuevas,2015-10-01,0,6,7,0,0,13
ZUDAÑEZ,"anticoncepcion, prevencion de its y de cancer de cuello uterino",metodos naturales: usuarias nuevas,2015-10-01,0,2,2,3,0,7
ACHACACHI,"anticoncepcion, prevencion de its y de cancer de cuello uterino",metodos naturales: usuarias nuevas,2015-11-01,0,0,8,1,0,9
ALTO BENI,"anticoncepcion, prevencion de its y de cancer de cuello uterino",metodos naturales: usuarias nuevas,2015-11-01,0,0,1,0,0,1
ANCORAIMES,"anticoncepcion, prevencion de its y de cancer de cuello uterino",metodos naturales: usuarias nuevas,2015-11-01,0,5,3,1,0,9
ANDAMARCA,"anticoncepcion, prevencion de its y de cancer de cuello uterino",metodos naturales: usuarias nuevas,2015-11-01,0,1,1,1,0,3
ANZALDO,"anticoncepcion, prevencion de its y de cancer de cuello uterino",metodos naturales: usuarias nuevas,2015-11-01,0,0,1,2,0,3
APOLO,"anticoncepcion, prevencion de its y de cancer de cuello uterino",metodos naturales: usuarias nuevas,2015-11-01,1,1,1,2,0,5
ARAMPAMPA,"anticoncepcion, prevencion de its y de cancer de cuello uterino",metodos naturales: usuarias nuevas,2015-11-01,0,0,3,0,0,3
ARBIETO,"anticoncepcion, prevencion de its y de cancer de cuello uterino",metodos naturales: usuarias nuevas,2015-11-01,0,6,10,1,0,17
ARQUE,"anticoncepcion, prevencion de its y de cancer de cuello uterino",metodos naturales: usuarias nuevas,2015-11-01,0,0,4,1,0,5
ATOCHA,"anticoncepcion, prevencion de its y de cancer de cuello uterino",metodos naturales: usuarias nuevas,2015-11-01,0,1,2,0,0,3
AYO AYO,"anticoncepcion, prevencion de its y de cancer de cuello uterino",metodos naturales: usuarias nuevas,2015-11-01,0,0,0,1,0,1
AYOPAYA (V. DE INDEPENDENCIA),"anticoncepcion, prevencion de its y de cancer de cuello uterino",metodos naturales: usuarias nuevas,2015-11-01,0,2,2,0,0,4
AZURDUY,"anticoncepcion, prevencion de its y de cancer de cuello uterino",metodos naturales: usuarias nuevas,2015-11-01,0,2,0,0,0,2
BAURES,"anticoncepcion, prevencion de its y de cancer de cuello uterino",metodos naturales: usuarias nuevas,2015-11-01,0,1,1,1,0,3
BETANZOS,"anticoncepcion, prevencion de its y de cancer de cuello uterino",metodos naturales: usuarias nuevas,2015-11-01,0,7,4,3,0,14
BOLIVAR,"anticoncepcion, prevencion de its y de cancer de cuello uterino",metodos naturales: usuarias nuevas,2015-11-01,0,0,0,2,0,2
BUENA VISTA,"anticoncepcion, prevencion de its y de cancer de cuello uterino",metodos naturales: usuarias nuevas,2015-11-01,0,1,3,0,0,4
"CAIZA ""D""","anticoncepcion, prevencion de its y de cancer de cuello uterino",metodos naturales: usuarias nuevas,2015-11-01,0,1,3,0,0,4
CAJUATA,"anticoncepcion, prevencion de its y de cancer de cuello uterino",metodos naturales: usuarias nuevas,2015-11-01,0,3,10,3,0,16
CALAMARCA,"anticoncepcion, prevencion de its y de cancer de cuello uterino",metodos naturales: usuarias nuevas,2015-11-01,0,2,5,1,0,8
CAMATAQUI (C. VILLA ABECIA),"anticoncepcion, prevencion de its y de cancer de cuello uterino",metodos naturales: usuarias nuevas,2015-11-01,0,0,1,0,0,1
CAMIRI,"anticoncepcion, prevencion de its y de cancer de cuello uterino",metodos naturales: usuarias nuevas,2015-11-01,0,0,1,0,0,1
CARACOLLO,"anticoncepcion, prevencion de its y de cancer de cuello uterino",metodos naturales: usuarias nuevas,2015-11-01,0,2,14,2,0,18
CARANAVI,"anticoncepcion, prevencion de its y de cancer de cuello uterino",metodos naturales: usuarias nuevas,2015-11-01,0,0,1,0,0,1
CARIPUYO,"anticoncepcion, prevencion de its y de cancer de cuello uterino",metodos naturales: usuarias nuevas,2015-11-01,0,1,0,1,0,2
CHALLAPATA,"anticoncepcion, prevencion de its y de cancer de cuello uterino",metodos naturales: usuarias nuevas,2015-11-01,1,9,45,12,1,68
CHAQUI,"anticoncepcion, prevencion de its y de cancer de cuello uterino",metodos naturales: usuarias nuevas,2015-11-01,0,4,4,0,0,8
CHAYANTA,"anticoncepcion, prevencion de its y de cancer de cuello uterino",metodos naturales: usuarias nuevas,2015-11-01,0,7,13,5,0,25
CHIMORE,"anticoncepcion, prevencion de its y de cancer de cuello uterino",metodos naturales: usuarias nuevas,2015-11-01,0,3,0,2,0,5
CHIPAYA,"anticoncepcion, prevencion de its y de cancer de cuello uterino",metodos naturales: usuarias nuevas,2015-11-01,1,0,0,0,0,1
CHOQUE COTA,"anticoncepcion, prevencion de its y de cancer de cuello uterino",metodos naturales: usuarias nuevas,2015-11-01,1,0,0,0,0,1
CHUA COCANI,"anticoncepcion, prevencion de its y de cancer de cuello uterino",metodos naturales: usuarias nuevas,2015-11-01,0,2,4,0,0,6
CHULUMANI (V. DE LA LIBERTAD),"anticoncepcion, prevencion de its y de cancer de cuello uterino",metodos naturales: usuarias nuevas,2015-11-01,0,3,18,2,0,23
CHUQUIHUTA AYLLU JUCUMANI,"anticoncepcion, prevencion de its y de cancer de cuello uterino",metodos naturales: usuarias nuevas,2015-11-01,0,1,0,6,0,7
CKOCHAS,"anticoncepcion, prevencion de its y de cancer de cuello uterino",metodos naturales: usuarias nuevas,2015-11-01,0,2,10,1,0,13
COBIJA,"anticoncepcion, prevencion de its y de cancer de cuello uterino",metodos naturales: usuarias nuevas,2015-11-01,5,24,50,11,0,90
COCHABAMBA,"anticoncepcion, prevencion de its y de cancer de cuello uterino",metodos naturales: usuarias nuevas,2015-11-01,5,9,49,22,0,85
COLCAPIRHUA,"anticoncepcion, prevencion de its y de cancer de cuello uterino",metodos naturales: usuarias nuevas,2015-11-01,0,0,2,0,0,2
"COLCHA ""K""","anticoncepcion, prevencion de its y de cancer de cuello uterino",metodos naturales: usuarias nuevas,2015-11-01,0,0,4,0,0,4
COLOMI,"anticoncepcion, prevencion de its y de cancer de cuello uterino",metodos naturales: usuarias nuevas,2015-11-01,0,1,2,0,0,3
COLPA BELGICA,"anticoncepcion, prevencion de its y de cancer de cuello uterino",metodos naturales: usuarias nuevas,2015-11-01,0,0,2,0,0,2
COLQUECHACA,"anticoncepcion, prevencion de its y de cancer de cuello uterino",metodos naturales: usuarias nuevas,2015-11-01,0,2,1,2,0,5
COLQUIRI,"anticoncepcion, prevencion de its y de cancer de cuello uterino",metodos naturales: usuarias nuevas,2015-11-01,1,3,17,0,0,21
COMARAPA,"anticoncepcion, prevencion de its y de cancer de cuello uterino",metodos naturales: usuarias nuevas,2015-11-01,0,11,11,6,0,28
CORIPATA,"anticoncepcion, prevencion de its y de cancer de cuello uterino",metodos naturales: usuarias nuevas,2015-11-01,0,3,7,0,0,10
CORO CORO,"anticoncepcion, prevencion de its y de cancer de cuello uterino",metodos naturales: usuarias nuevas,2015-11-01,0,1,0,0,0,1
COROICO,"anticoncepcion, prevencion de its y de cancer de cuello uterino",metodos naturales: usuarias nuevas,2015-11-01,0,0,2,0,0,2
CORQUE,"anticoncepcion, prevencion de its y de cancer de cuello uterino",metodos naturales: usuarias nuevas,2015-11-01,0,1,5,2,0,8
COTOCA,"anticoncepcion, prevencion de its y de cancer de cuello uterino",metodos naturales: usuarias nuevas,2015-11-01,1,3,2,0,0,6
CUATRO CAÑADAS,"anticoncepcion, prevencion de its y de cancer de cuello uterino",metodos naturales: usuarias nuevas,2015-11-01,0,0,1,0,0,1
CULPINA,"anticoncepcion, prevencion de its y de cancer de cuello uterino",metodos naturales: usuarias nuevas,2015-11-01,0,7,15,2,0,24
CURAHUARA DE CARANGAS,"anticoncepcion, prevencion de its y de cancer de cuello uterino",metodos naturales: usuarias nuevas,2015-11-01,0,0,3,0,0,3
EL ALTO,"anticoncepcion, prevencion de its y de cancer de cuello uterino",metodos naturales: usuarias nuevas,2015-11-01,0,16,125,300,4,445
EL CHORO,"anticoncepcion, prevencion de its y de cancer de cuello uterino",metodos naturales: usuarias nuevas,2015-11-01,0,0,3,0,0,3
EL PUENTE(STC),"anticoncepcion, prevencion de its y de cancer de cuello uterino",metodos naturales: usuarias nuevas,2015-11-01,0,1,5,0,0,6
EL VILLAR,"anticoncepcion, prevencion de its y de cancer de cuello uterino",metodos naturales: usuarias nuevas,2015-11-01,0,0,0,1,0,1
ENTRE RIOS TRJ,"anticoncepcion, prevencion de its y de cancer de cuello uterino",metodos naturales: usuarias nuevas,2015-11-01,1,2,9,2,0,14
ENTRE RIOS CBBA,"anticoncepcion, prevencion de its y de cancer de cuello uterino",metodos naturales: usuarias nuevas,2015-11-01,1,1,0,1,0,3
EUCALIPTUS,"anticoncepcion, prevencion de its y de cancer de cuello uterino",metodos naturales: usuarias nuevas,2015-11-01,0,0,3,0,0,3
FILADELFIA,"anticoncepcion, prevencion de its y de cancer de cuello uterino",metodos naturales: usuarias nuevas,2015-11-01,0,3,0,1,0,4
GENERAL SAAVEDRA,"anticoncepcion, prevencion de its y de cancer de cuello uterino",metodos naturales: usuarias nuevas,2015-11-01,0,0,0,1,0,1
GUAQUI,"anticoncepcion, prevencion de its y de cancer de cuello uterino",metodos naturales: usuarias nuevas,2015-11-01,0,2,5,0,0,7
GUAYARAMERIN,"anticoncepcion, prevencion de its y de cancer de cuello uterino",metodos naturales: usuarias nuevas,2015-11-01,2,13,39,5,0,59
HUACARETA,"anticoncepcion, prevencion de its y de cancer de cuello uterino",metodos naturales: usuarias nuevas,2015-11-01,0,2,2,0,0,4
HUANUNI,"anticoncepcion, prevencion de its y de cancer de cuello uterino",metodos naturales: usuarias nuevas,2015-11-01,0,2,11,4,0,17
HUAYLLAMARCA,"anticoncepcion, prevencion de its y de cancer de cuello uterino",metodos naturales: usuarias nuevas,2015-11-01,0,3,0,0,0,3
ICHOCA,"anticoncepcion, prevencion de its y de cancer de cuello uterino",metodos naturales: usuarias nuevas,2015-11-01,0,0,1,0,0,1
ICLA,"anticoncepcion, prevencion de its y de cancer de cuello uterino",metodos naturales: usuarias nuevas,2015-11-01,0,0,1,0,0,1
INCAHUASI,"anticoncepcion, prevencion de its y de cancer de cuello uterino",metodos naturales: usuarias nuevas,2015-11-01,0,2,12,3,0,17
INQUISIVI,"anticoncepcion, prevencion de its y de cancer de cuello uterino",metodos naturales: usuarias nuevas,2015-11-01,0,4,8,3,0,15
IRUPANA (VILLA DE LANZA),"anticoncepcion, prevencion de its y de cancer de cuello uterino",metodos naturales: usuarias nuevas,2015-11-01,0,4,0,0,0,4
IXIAMAS,"anticoncepcion, prevencion de its y de cancer de cuello uterino",metodos naturales: usuarias nuevas,2015-11-01,0,0,3,0,0,3
JESUS DE MACHACA,"anticoncepcion, prevencion de its y de cancer de cuello uterino",metodos naturales: usuarias nuevas,2015-11-01,0,0,4,1,0,5
LA ASUNTA,"anticoncepcion, prevencion de its y de cancer de cuello uterino",metodos naturales: usuarias nuevas,2015-11-01,0,11,40,4,0,55
LA PAZ,"anticoncepcion, prevencion de its y de cancer de cuello uterino",metodos naturales: usuarias nuevas,2015-11-01,1,16,126,31,0,174
LAGUNILLAS,"anticoncepcion, prevencion de its y de cancer de cuello uterino",metodos naturales: usuarias nuevas,2015-11-01,0,1,2,1,0,4
LLALLAGUA,"anticoncepcion, prevencion de its y de cancer de cuello uterino",metodos naturales: usuarias nuevas,2015-11-01,0,0,3,0,0,3
LORETO,"anticoncepcion, prevencion de its y de cancer de cuello uterino",metodos naturales: usuarias nuevas,2015-11-01,0,0,2,0,0,2
MACHACAMARCA,"anticoncepcion, prevencion de its y de cancer de cuello uterino",metodos naturales: usuarias nuevas,2015-11-01,0,1,1,1,0,3
MAGDALENA,"anticoncepcion, prevencion de its y de cancer de cuello uterino",metodos naturales: usuarias nuevas,2015-11-01,0,1,1,0,0,2
MINEROS,"anticoncepcion, prevencion de its y de cancer de cuello uterino",metodos naturales: usuarias nuevas,2015-11-01,0,1,4,0,0,5
MIZQUE,"anticoncepcion, prevencion de its y de cancer de cuello uterino",metodos naturales: usuarias nuevas,2015-11-01,0,2,0,1,0,3
MOCOMOCO,"anticoncepcion, prevencion de its y de cancer de cuello uterino",metodos naturales: usuarias nuevas,2015-11-01,0,1,4,0,0,5
MOJOCOYA,"anticoncepcion, prevencion de its y de cancer de cuello uterino",metodos naturales: usuarias nuevas,2015-11-01,0,4,5,2,0,11
MONTEAGUDO,"anticoncepcion, prevencion de its y de cancer de cuello uterino",metodos naturales: usuarias nuevas,2015-11-01,0,0,0,3,0,3
MONTERO,"anticoncepcion, prevencion de its y de cancer de cuello uterino",metodos naturales: usuarias nuevas,2015-11-01,0,0,5,1,0,6
MOROCHATA,"anticoncepcion, prevencion de its y de cancer de cuello uterino",metodos naturales: usuarias nuevas,2015-11-01,0,3,5,1,0,9
NUEVO MANOA (NUEVA ESPERANZA),"anticoncepcion, prevencion de its y de cancer de cuello uterino",metodos naturales: usuarias nuevas,2015-11-01,0,1,2,0,0,3
OCURI,"anticoncepcion, prevencion de its y de cancer de cuello uterino",metodos naturales: usuarias nuevas,2015-11-01,0,1,5,2,0,8
OMEREQUE,"anticoncepcion, prevencion de its y de cancer de cuello uterino",metodos naturales: usuarias nuevas,2015-11-01,0,2,5,1,0,8
ORURO,"anticoncepcion, prevencion de its y de cancer de cuello uterino",metodos naturales: usuarias nuevas,2015-11-01,0,23,65,6,0,94
PADCAYA,"anticoncepcion, prevencion de its y de cancer de cuello uterino",metodos naturales: usuarias nuevas,2015-11-01,0,1,0,0,0,1
PADILLA,"anticoncepcion, prevencion de its y de cancer de cuello uterino",metodos naturales: usuarias nuevas,2015-11-01,0,10,13,1,0,24
PALCA,"anticoncepcion, prevencion de its y de cancer de cuello uterino",metodos naturales: usuarias nuevas,2015-11-01,0,0,2,0,0,2
PALOS BLANCOS,"anticoncepcion, prevencion de its y de cancer de cuello uterino",metodos naturales: usuarias nuevas,2015-11-01,0,1,1,0,0,2
PAMPA AULLAGAS,"anticoncepcion, prevencion de its y de cancer de cuello uterino",metodos naturales: usuarias nuevas,2015-11-01,0,1,0,0,0,1
PAZÑA,"anticoncepcion, prevencion de its y de cancer de cuello uterino",metodos naturales: usuarias nuevas,2015-11-01,0,1,1,0,0,2
PELECHUCO,"anticoncepcion, prevencion de its y de cancer de cuello uterino",metodos naturales: usuarias nuevas,2015-11-01,0,0,3,0,0,3
POCOATA,"anticoncepcion, prevencion de its y de cancer de cuello uterino",metodos naturales: usuarias nuevas,2015-11-01,0,8,9,7,0,24
POCONA,"anticoncepcion, prevencion de its y de cancer de cuello uterino",metodos naturales: usuarias nuevas,2015-11-01,0,1,3,1,0,5
POJO (CBBA),"anticoncepcion, prevencion de its y de cancer de cuello uterino",metodos naturales: usuarias nuevas,2015-11-01,0,1,1,0,0,2
PORCO,"anticoncepcion, prevencion de its y de cancer de cuello uterino",metodos naturales: usuarias nuevas,2015-11-01,0,0,3,0,0,3
POROMA,"anticoncepcion, prevencion de its y de cancer de cuello uterino",metodos naturales: usuarias nuevas,2015-11-01,0,1,4,1,0,6
PORONGO,"anticoncepcion, prevencion de its y de cancer de cuello uterino",metodos naturales: usuarias nuevas,2015-11-01,0,0,2,0,0,2
POTOSI,"anticoncepcion, prevencion de its y de cancer de cuello uterino",metodos naturales: usuarias nuevas,2015-11-01,1,15,38,71,0,125
PRESTO,"anticoncepcion, prevencion de its y de cancer de cuello uterino",metodos naturales: usuarias nuevas,2015-11-01,0,1,2,0,0,3
PUCARANI,"anticoncepcion, prevencion de its y de cancer de cuello uterino",metodos naturales: usuarias nuevas,2015-11-01,1,2,13,2,0,18
PUERTO GONZALO MORENO,"anticoncepcion, prevencion de its y de cancer de cuello uterino",metodos naturales: usuarias nuevas,2015-11-01,0,2,1,0,0,3
PUERTO RICO,"anticoncepcion, prevencion de its y de cancer de cuello uterino",metodos naturales: usuarias nuevas,2015-11-01,0,2,0,0,0,2
PUERTO VILLARROEL,"anticoncepcion, prevencion de its y de cancer de cuello uterino",metodos naturales: usuarias nuevas,2015-11-01,0,1,6,0,0,7
PUNA,"anticoncepcion, prevencion de its y de cancer de cuello uterino",metodos naturales: usuarias nuevas,2015-11-01,0,1,9,3,0,13
PUNATA,"anticoncepcion, prevencion de its y de cancer de cuello uterino",metodos naturales: usuarias nuevas,2015-11-01,0,18,53,9,0,80
QUILLACOLLO,"anticoncepcion, prevencion de its y de cancer de cuello uterino",metodos naturales: usuarias nuevas,2015-11-01,0,0,7,0,0,7
QUIME,"anticoncepcion, prevencion de its y de cancer de cuello uterino",metodos naturales: usuarias nuevas,2015-11-01,0,4,6,4,0,14
RAVELO,"anticoncepcion, prevencion de its y de cancer de cuello uterino",metodos naturales: usuarias nuevas,2015-11-01,0,4,7,1,0,12
REYES,"anticoncepcion, prevencion de its y de cancer de cuello uterino",metodos naturales: usuarias nuevas,2015-11-01,10,28,24,1,0,63
RIBERALTA,"anticoncepcion, prevencion de its y de cancer de cuello uterino",metodos naturales: usuarias nuevas,2015-11-01,3,32,77,11,0,123
RURRENABAQUE,"anticoncepcion, prevencion de its y de cancer de cuello uterino",metodos naturales: usuarias nuevas,2015-11-01,1,1,7,2,0,11
SABAYA,"anticoncepcion, prevencion de its y de cancer de cuello uterino",metodos naturales: usuarias nuevas,2015-11-01,0,0,2,2,0,4
SACABA,"anticoncepcion, prevencion de its y de cancer de cuello uterino",metodos naturales: usuarias nuevas,2015-11-01,0,5,35,31,0,71
SACACA,"anticoncepcion, prevencion de its y de cancer de cuello uterino",metodos naturales: usuarias nuevas,2015-11-01,0,2,8,1,0,11
SAIPINA,"anticoncepcion, prevencion de its y de cancer de cuello uterino",metodos naturales: usuarias nuevas,2015-11-01,0,0,1,0,0,1
SALINAS DE GARCI MENDOZA,"anticoncepcion, prevencion de its y de cancer de cuello uterino",metodos naturales: usuarias nuevas,2015-11-01,0,2,10,2,0,14
SAMAIPATA,"anticoncepcion, prevencion de its y de cancer de cuello uterino",metodos naturales: usuarias nuevas,2015-11-01,0,0,2,0,0,2
SAN ANDRES DE MACHACA,"anticoncepcion, prevencion de its y de cancer de cuello uterino",metodos naturales: usuarias nuevas,2015-11-01,0,1,2,0,0,3
SAN ANTONIO DE LOMERIO,"anticoncepcion, prevencion de its y de cancer de cuello uterino",metodos naturales: usuarias nuevas,2015-11-01,0,1,1,1,0,3
SAN BENITO,"anticoncepcion, prevencion de its y de cancer de cuello uterino",metodos naturales: usuarias nuevas,2015-11-01,0,2,4,0,0,6
SAN BORJA,"anticoncepcion, prevencion de its y de cancer de cuello uterino",metodos naturales: usuarias nuevas,2015-11-01,1,10,7,0,0,18
SAN BUENA VENTURA,"anticoncepcion, prevencion de its y de cancer de cuello uterino",metodos naturales: usuarias nuevas,2015-11-01,0,5,10,0,0,15
SAN CARLOS,"anticoncepcion, prevencion de its y de cancer de cuello uterino",metodos naturales: usuarias nuevas,2015-11-01,0,4,6,1,0,11
SAN IGNACIO,"anticoncepcion, prevencion de its y de cancer de cuello uterino",metodos naturales: usuarias nuevas,2015-11-01,0,2,10,0,0,12
SAN JAVIER(BNI),"anticoncepcion, prevencion de its y de cancer de cuello uterino",metodos naturales: usuarias nuevas,2015-11-01,0,1,0,3,0,4
SAN JUAN DE YAPACANI,"anticoncepcion, prevencion de its y de cancer de cuello uterino",metodos naturales: usuarias nuevas,2015-11-01,0,2,0,0,0,2
SAN JULIAN,"anticoncepcion, prevencion de its y de cancer de cuello uterino",metodos naturales: usuarias nuevas,2015-11-01,0,0,0,1,0,1
SAN LUCAS,"anticoncepcion, prevencion de its y de cancer de cuello uterino",metodos naturales: usuarias nuevas,2015-11-01,0,12,8,5,0,25
SAN MIGUEL DE VELASCO,"anticoncepcion, prevencion de its y de cancer de cuello uterino",metodos naturales: usuarias nuevas,2015-11-01,0,4,1,0,0,5
SAN PEDRO DE BUENA VISTA,"anticoncepcion, prevencion de its y de cancer de cuello uterino",metodos naturales: usuarias nuevas,2015-11-01,1,5,10,2,0,18
SAN PEDRO DE TIQUINA,"anticoncepcion, prevencion de its y de cancer de cuello uterino",metodos naturales: usuarias nuevas,2015-11-01,0,2,3,1,0,6
SAN RAFAEL,"anticoncepcion, prevencion de its y de cancer de cuello uterino",metodos naturales: usuarias nuevas,2015-11-01,0,0,3,0,0,3
SAN RAMON BENI,"anticoncepcion, prevencion de its y de cancer de cuello uterino",metodos naturales: usuarias nuevas,2015-11-01,0,1,0,0,0,1
SANTA ANA,"anticoncepcion, prevencion de its y de cancer de cuello uterino",metodos naturales: usuarias nuevas,2015-11-01,0,14,14,2,0,30
SANTA CRUZ DE LA SIERRA,"anticoncepcion, prevencion de its y de cancer de cuello uterino",metodos naturales: usuarias nuevas,2015-11-01,2,35,81,7,0,125
SANTA ROSA,"anticoncepcion, prevencion de its y de cancer de cuello uterino",metodos naturales: usuarias nuevas,2015-11-01,0,4,5,1,0,10
SANTA ROSA DEL SARA,"anticoncepcion, prevencion de its y de cancer de cuello uterino",metodos naturales: usuarias nuevas,2015-11-01,0,1,7,0,0,8
SANTIAGO DE HUARI,"anticoncepcion, prevencion de its y de cancer de cuello uterino",metodos naturales: usuarias nuevas,2015-11-01,0,4,8,0,0,12
SANTIAGO DE HUATA,"anticoncepcion, prevencion de its y de cancer de cuello uterino",metodos naturales: usuarias nuevas,2015-11-01,0,0,3,0,0,3
SANTIAGO DE MACHACA,"anticoncepcion, prevencion de its y de cancer de cuello uterino",metodos naturales: usuarias nuevas,2015-11-01,0,0,1,2,0,3
SANTUARIO DE QUILLACAS,"anticoncepcion, prevencion de its y de cancer de cuello uterino",metodos naturales: usuarias nuevas,2015-11-01,0,2,2,0,0,4
SAPAHAQUI,"anticoncepcion, prevencion de its y de cancer de cuello uterino",metodos naturales: usuarias nuevas,2015-11-01,0,0,2,1,0,3
SENA,"anticoncepcion, prevencion de its y de cancer de cuello uterino",metodos naturales: usuarias nuevas,2015-11-01,0,5,0,0,0,5
SHINAOTA,"anticoncepcion, prevencion de its y de cancer de cuello uterino",metodos naturales: usuarias nuevas,2015-11-01,0,0,1,0,0,1
SIPE SIPE,"anticoncepcion, prevencion de its y de cancer de cuello uterino",metodos naturales: usuarias nuevas,2015-11-01,0,5,19,4,0,28
SOPACHUY,"anticoncepcion, prevencion de its y de cancer de cuello uterino",metodos naturales: usuarias nuevas,2015-11-01,0,1,6,1,0,8
SORACACHI,"anticoncepcion, prevencion de its y de cancer de cuello uterino",metodos naturales: usuarias nuevas,2015-11-01,0,1,9,0,0,10
SORATA,"anticoncepcion, prevencion de its y de cancer de cuello uterino",metodos naturales: usuarias nuevas,2015-11-01,0,1,0,0,0,1
SUCRE,"anticoncepcion, prevencion de its y de cancer de cuello uterino",metodos naturales: usuarias nuevas,2015-11-01,0,47,186,36,1,270
TACOPAYA,"anticoncepcion, prevencion de its y de cancer de cuello uterino",metodos naturales: usuarias nuevas,2015-11-01,1,1,6,1,0,9
TAPACARI,"anticoncepcion, prevencion de its y de cancer de cuello uterino",metodos naturales: usuarias nuevas,2015-11-01,0,0,0,1,0,1
TARABUCO,"anticoncepcion, prevencion de its y de cancer de cuello uterino",metodos naturales: usuarias nuevas,2015-11-01,0,3,11,3,0,17
TARACO,"anticoncepcion, prevencion de its y de cancer de cuello uterino",metodos naturales: usuarias nuevas,2015-11-01,0,2,2,0,0,4
TARATA,"anticoncepcion, prevencion de its y de cancer de cuello uterino",metodos naturales: usuarias nuevas,2015-11-01,0,0,14,1,0,15
TARIJA,"anticoncepcion, prevencion de its y de cancer de cuello uterino",metodos naturales: usuarias nuevas,2015-11-01,0,0,4,5,0,9
TARVITA,"anticoncepcion, prevencion de its y de cancer de cuello uterino",metodos naturales: usuarias nuevas,2015-11-01,0,3,1,1,0,5
TEOPONTE,"anticoncepcion, prevencion de its y de cancer de cuello uterino",metodos naturales: usuarias nuevas,2015-11-01,0,0,3,1,0,4
TIAWANACU,"anticoncepcion, prevencion de its y de cancer de cuello uterino",metodos naturales: usuarias nuevas,2015-11-01,0,1,2,1,0,4
TINGUIPAYA,"anticoncepcion, prevencion de its y de cancer de cuello uterino",metodos naturales: usuarias nuevas,2015-11-01,0,1,7,3,0,11
TIPUANI,"anticoncepcion, prevencion de its y de cancer de cuello uterino",metodos naturales: usuarias nuevas,2015-11-01,0,0,1,0,0,1
TIQUIPAYA,"anticoncepcion, prevencion de its y de cancer de cuello uterino",metodos naturales: usuarias nuevas,2015-11-01,0,0,3,0,0,3
TIRAQUE (CBBA),"anticoncepcion, prevencion de its y de cancer de cuello uterino",metodos naturales: usuarias nuevas,2015-11-01,0,0,1,0,0,1
TOMAVE,"anticoncepcion, prevencion de its y de cancer de cuello uterino",metodos naturales: usuarias nuevas,2015-11-01,0,0,1,1,0,2
TOMINA,"anticoncepcion, prevencion de its y de cancer de cuello uterino",metodos naturales: usuarias nuevas,2015-11-01,0,1,4,3,0,8
TOTORA(CBBA),"anticoncepcion, prevencion de its y de cancer de cuello uterino",metodos naturales: usuarias nuevas,2015-11-01,0,0,1,0,0,1
TOTORA(ORR),"anticoncepcion, prevencion de its y de cancer de cuello uterino",metodos naturales: usuarias nuevas,2015-11-01,0,0,3,2,0,5
TRINIDAD,"anticoncepcion, prevencion de its y de cancer de cuello uterino",metodos naturales: usuarias nuevas,2015-11-01,1,11,28,42,0,82
TUPIZA,"anticoncepcion, prevencion de its y de cancer de cuello uterino",metodos naturales: usuarias nuevas,2015-11-01,0,0,8,4,0,12
UNCIA,"anticoncepcion, prevencion de its y de cancer de cuello uterino",metodos naturales: usuarias nuevas,2015-11-01,0,3,3,1,0,7
UYUNI,"anticoncepcion, prevencion de its y de cancer de cuello uterino",metodos naturales: usuarias nuevas,2015-11-01,0,2,0,0,0,2
VACAS,"anticoncepcion, prevencion de its y de cancer de cuello uterino",metodos naturales: usuarias nuevas,2015-11-01,0,3,2,0,0,5
VILLA CHARCAS,"anticoncepcion, prevencion de its y de cancer de cuello uterino",metodos naturales: usuarias nuevas,2015-11-01,2,2,0,0,0,4
VILLA MONTES,"anticoncepcion, prevencion de its y de cancer de cuello uterino",metodos naturales: usuarias nuevas,2015-11-01,0,7,11,10,0,28
VILLA NUEVA (LOMA ALTA),"anticoncepcion, prevencion de its y de cancer de cuello uterino",metodos naturales: usuarias nuevas,2015-11-01,0,0,0,2,0,2
VILLA RIVERO,"anticoncepcion, prevencion de its y de cancer de cuello uterino",metodos naturales: usuarias nuevas,2015-11-01,0,2,1,0,0,3
VILLA SERRANO,"anticoncepcion, prevencion de its y de cancer de cuello uterino",metodos naturales: usuarias nuevas,2015-11-01,0,1,0,0,0,1
VILLA TUNARI,"anticoncepcion, prevencion de its y de cancer de cuello uterino",metodos naturales: usuarias nuevas,2015-11-01,0,1,5,2,0,8
VILLA VACA GUZMAN (MUYUPAMPA),"anticoncepcion, prevencion de its y de cancer de cuello uterino",metodos naturales: usuarias nuevas,2015-11-01,0,0,1,0,0,1
VILLAZON,"anticoncepcion, prevencion de its y de cancer de cuello uterino",metodos naturales: usuarias nuevas,2015-11-01,0,4,6,0,0,10
VINTO,"anticoncepcion, prevencion de its y de cancer de cuello uterino",metodos naturales: usuarias nuevas,2015-11-01,1,3,23,4,0,31
VITICHI,"anticoncepcion, prevencion de its y de cancer de cuello uterino",metodos naturales: usuarias nuevas,2015-11-01,0,1,2,0,0,3
YACUIBA,"anticoncepcion, prevencion de its y de cancer de cuello uterino",metodos naturales: usuarias nuevas,2015-11-01,0,0,1,0,0,1
YANACACHI,"anticoncepcion, prevencion de its y de cancer de cuello uterino",metodos naturales: usuarias nuevas,2015-11-01,0,0,2,1,0,3
YAPACANI,"anticoncepcion, prevencion de its y de cancer de cuello uterino",metodos naturales: usuarias nuevas,2015-11-01,0,3,6,1,0,10
YOTALA,"anticoncepcion, prevencion de its y de cancer de cuello uterino",metodos naturales: usuarias nuevas,2015-11-01,0,2,6,2,0,10
ZUDAÑEZ,"anticoncepcion, prevencion de its y de cancer de cuello uterino",metodos naturales: usuarias nuevas,2015-11-01,0,2,4,4,0,10
ACACIO,"anticoncepcion, prevencion de its y de cancer de cuello uterino",metodos naturales: usuarias nuevas,2015-12-01,0,0,2,0,0,2
ACHACACHI,"anticoncepcion, prevencion de its y de cancer de cuello uterino",metodos naturales: usuarias nuevas,2015-12-01,0,0,3,1,0,4
AIQUILE,"anticoncepcion, prevencion de its y de cancer de cuello uterino",metodos naturales: usuarias nuevas,2015-12-01,0,0,1,0,0,1
ALCALA,"anticoncepcion, prevencion de its y de cancer de cuello uterino",metodos naturales: usuarias nuevas,2015-12-01,0,1,0,1,0,2
ANCORAIMES,"anticoncepcion, prevencion de its y de cancer de cuello uterino",metodos naturales: usuarias nuevas,2015-12-01,0,2,4,3,0,9
ANDAMARCA,"anticoncepcion, prevencion de its y de cancer de cuello uterino",metodos naturales: usuarias nuevas,2015-12-01,0,0,2,1,0,3
ANTEQUERA,"anticoncepcion, prevencion de its y de cancer de cuello uterino",metodos naturales: usuarias nuevas,2015-12-01,0,0,1,0,0,1
ANZALDO,"anticoncepcion, prevencion de its y de cancer de cuello uterino",metodos naturales: usuarias nuevas,2015-12-01,0,1,0,0,0,1
APOLO,"anticoncepcion, prevencion de its y de cancer de cuello uterino",metodos naturales: usuarias nuevas,2015-12-01,0,0,1,0,0,1
ARAMPAMPA,"anticoncepcion, prevencion de its y de cancer de cuello uterino",metodos naturales: usuarias nuevas,2015-12-01,0,1,0,0,0,1
ARBIETO,"anticoncepcion, prevencion de its y de cancer de cuello uterino",metodos naturales: usuarias nuevas,2015-12-01,0,4,7,2,0,13
AUCAPATA,"anticoncepcion, prevencion de its y de cancer de cuello uterino",metodos naturales: usuarias nuevas,2015-12-01,0,2,0,0,0,2
AYO AYO,"anticoncepcion, prevencion de its y de cancer de cuello uterino",metodos naturales: usuarias nuevas,2015-12-01,0,1,3,0,0,4
AYOPAYA (V. DE INDEPENDENCIA),"anticoncepcion, prevencion de its y de cancer de cuello uterino",metodos naturales: usuarias nuevas,2015-12-01,0,0,5,1,0,6
AZURDUY,"anticoncepcion, prevencion de its y de cancer de cuello uterino",metodos naturales: usuarias nuevas,2015-12-01,1,1,0,1,0,3
BAURES,"anticoncepcion, prevencion de its y de cancer de cuello uterino",metodos naturales: usuarias nuevas,2015-12-01,0,1,0,0,0,1
BELLA FLOR,"anticoncepcion, prevencion de its y de cancer de cuello uterino",metodos naturales: usuarias nuevas,2015-12-01,0,1,1,0,0,2
BERMEJO,"anticoncepcion, prevencion de its y de cancer de cuello uterino",metodos naturales: usuarias nuevas,2015-12-01,1,1,1,0,0,3
BETANZOS,"anticoncepcion, prevencion de its y de cancer de cuello uterino",metodos naturales: usuarias nuevas,2015-12-01,0,1,4,0,0,5
CAJUATA,"anticoncepcion, prevencion de its y de cancer de cuello uterino",metodos naturales: usuarias nuevas,2015-12-01,0,2,7,2,0,11
CALAMARCA,"anticoncepcion, prevencion de its y de cancer de cuello uterino",metodos naturales: usuarias nuevas,2015-12-01,1,2,8,1,0,12
CAMIRI,"anticoncepcion, prevencion de its y de cancer de cuello uterino",metodos naturales: usuarias nuevas,2015-12-01,0,0,1,0,0,1
CARACOLLO,"anticoncepcion, prevencion de its y de cancer de cuello uterino",metodos naturales: usuarias nuevas,2015-12-01,0,3,14,3,0,20
CARANAVI,"anticoncepcion, prevencion de its y de cancer de cuello uterino",metodos naturales: usuarias nuevas,2015-12-01,0,0,11,4,0,15
CARIPUYO,"anticoncepcion, prevencion de its y de cancer de cuello uterino",metodos naturales: usuarias nuevas,2015-12-01,0,1,4,1,0,6
CHALLAPATA,"anticoncepcion, prevencion de its y de cancer de cuello uterino",metodos naturales: usuarias nuevas,2015-12-01,0,16,34,4,0,54
CHAQUI,"anticoncepcion, prevencion de its y de cancer de cuello uterino",metodos naturales: usuarias nuevas,2015-12-01,0,2,3,0,0,5
CHAYANTA,"anticoncepcion, prevencion de its y de cancer de cuello uterino",metodos naturales: usuarias nuevas,2015-12-01,0,4,9,5,0,18
CHOQUE COTA,"anticoncepcion, prevencion de its y de cancer de cuello uterino",metodos naturales: usuarias nuevas,2015-12-01,0,0,1,0,0,1
CHUA COCANI,"anticoncepcion, prevencion de its y de cancer de cuello uterino",metodos naturales: usuarias nuevas,2015-12-01,0,0,3,1,0,4
CHULUMANI (V. DE LA LIBERTAD),"anticoncepcion, prevencion de its y de cancer de cuello uterino",metodos naturales: usuarias nuevas,2015-12-01,0,8,18,2,0,28
CHUQUIHUTA AYLLU JUCUMANI,"anticoncepcion, prevencion de its y de cancer de cuello uterino",metodos naturales: usuarias nuevas,2015-12-01,0,0,3,0,0,3
CKOCHAS,"anticoncepcion, prevencion de its y de cancer de cuello uterino",metodos naturales: usuarias nuevas,2015-12-01,0,2,12,2,0,16
CLIZA,"anticoncepcion, prevencion de its y de cancer de cuello uterino",metodos naturales: usuarias nuevas,2015-12-01,0,0,2,0,0,2
COBIJA,"anticoncepcion, prevencion de its y de cancer de cuello uterino",metodos naturales: usuarias nuevas,2015-12-01,1,6,16,3,0,26
COCHABAMBA,"anticoncepcion, prevencion de its y de cancer de cuello uterino",metodos naturales: usuarias nuevas,2015-12-01,5,28,78,77,0,188
COLOMI,"anticoncepcion, prevencion de its y de cancer de cuello uterino",metodos naturales: usuarias nuevas,2015-12-01,1,5,10,2,0,18
COLPA BELGICA,"anticoncepcion, prevencion de its y de cancer de cuello uterino",metodos naturales: usuarias nuevas,2015-12-01,0,1,5,0,0,6
COLQUECHACA,"anticoncepcion, prevencion de its y de cancer de cuello uterino",metodos naturales: usuarias nuevas,2015-12-01,0,0,5,2,0,7
COLQUIRI,"anticoncepcion, prevencion de its y de cancer de cuello uterino",metodos naturales: usuarias nuevas,2015-12-01,0,4,6,0,0,10
COMARAPA,"anticoncepcion, prevencion de its y de cancer de cuello uterino",metodos naturales: usuarias nuevas,2015-12-01,0,9,21,3,0,33
CONCEPCION,"anticoncepcion, prevencion de its y de cancer de cuello uterino",metodos naturales: usuarias nuevas,2015-12-01,1,5,2,0,0,8
CORIPATA,"anticoncepcion, prevencion de its y de cancer de cuello uterino",metodos naturales: usuarias nuevas,2015-12-01,0,1,3,0,0,4
COROICO,"anticoncepcion, prevencion de its y de cancer de cuello uterino",metodos naturales: usuarias nuevas,2015-12-01,0,6,21,0,0,27
CORQUE,"anticoncepcion, prevencion de its y de cancer de cuello uterino",metodos naturales: usuarias nuevas,2015-12-01,0,0,4,2,0,6
COTAGAITA,"anticoncepcion, prevencion de its y de cancer de cuello uterino",metodos naturales: usuarias nuevas,2015-12-01,1,0,0,0,0,1
COTOCA,"anticoncepcion, prevencion de its y de cancer de cuello uterino",metodos naturales: usuarias nuevas,2015-12-01,0,1,3,0,0,4
CUCHUMUELA (V. G. VILLARROEL),"anticoncepcion, prevencion de its y de cancer de cuello uterino",metodos naturales: usuarias nuevas,2015-12-01,0,1,0,0,0,1
CULPINA,"anticoncepcion, prevencion de its y de cancer de cuello uterino",metodos naturales: usuarias nuevas,2015-12-01,0,1,8,4,0,13
CURAHUARA DE CARANGAS,"anticoncepcion, prevencion de its y de cancer de cuello uterino",metodos naturales: usuarias nuevas,2015-12-01,0,0,1,0,0,1
EL ALTO,"anticoncepcion, prevencion de its y de cancer de cuello uterino",metodos naturales: usuarias nuevas,2015-12-01,0,17,165,428,3,613
EL CHORO,"anticoncepcion, prevencion de its y de cancer de cuello uterino",metodos naturales: usuarias nuevas,2015-12-01,0,1,2,1,0,4
EL PUENTE(STC),"anticoncepcion, prevencion de its y de cancer de cuello uterino",metodos naturales: usuarias nuevas,2015-12-01,0,0,10,0,0,10
EL TORNO,"anticoncepcion, prevencion de its y de cancer de cuello uterino",metodos naturales: usuarias nuevas,2015-12-01,0,2,1,0,0,3
EL VILLAR,"anticoncepcion, prevencion de its y de cancer de cuello uterino",metodos naturales: usuarias nuevas,2015-12-01,0,1,1,0,0,2
ENTRE RIOS TRJ,"anticoncepcion, prevencion de its y de cancer de cuello uterino",metodos naturales: usuarias nuevas,2015-12-01,0,0,0,1,0,1
ENTRE RIOS CBBA,"anticoncepcion, prevencion de its y de cancer de cuello uterino",metodos naturales: usuarias nuevas,2015-12-01,0,0,3,0,0,3
EUCALIPTUS,"anticoncepcion, prevencion de its y de cancer de cuello uterino",metodos naturales: usuarias nuevas,2015-12-01,0,4,1,0,0,5
FILADELFIA,"anticoncepcion, prevencion de its y de cancer de cuello uterino",metodos naturales: usuarias nuevas,2015-12-01,1,0,1,0,0,2
GUAQUI,"anticoncepcion, prevencion de its y de cancer de cuello uterino",metodos naturales: usuarias nuevas,2015-12-01,0,2,0,0,0,2
GUAYARAMERIN,"anticoncepcion, prevencion de its y de cancer de cuello uterino",metodos naturales: usuarias nuevas,2015-12-01,1,14,32,3,0,50
HUANUNI,"anticoncepcion, prevencion de its y de cancer de cuello uterino",metodos naturales: usuarias nuevas,2015-12-01,0,1,7,0,0,8
HUAYLLAMARCA,"anticoncepcion, prevencion de its y de cancer de cuello uterino",metodos naturales: usuarias nuevas,2015-12-01,0,0,3,0,0,3
INCAHUASI,"anticoncepcion, prevencion de its y de cancer de cuello uterino",metodos naturales: usuarias nuevas,2015-12-01,0,2,8,1,0,11
INQUISIVI,"anticoncepcion, prevencion de its y de cancer de cuello uterino",metodos naturales: usuarias nuevas,2015-12-01,0,2,5,0,0,7
IRUPANA (VILLA DE LANZA),"anticoncepcion, prevencion de its y de cancer de cuello uterino",metodos naturales: usuarias nuevas,2015-12-01,0,0,3,1,0,4
IXIAMAS,"anticoncepcion, prevencion de its y de cancer de cuello uterino",metodos naturales: usuarias nuevas,2015-12-01,1,1,10,3,0,15
JESUS DE MACHACA,"anticoncepcion, prevencion de its y de cancer de cuello uterino",metodos naturales: usuarias nuevas,2015-12-01,0,1,1,0,0,2
LA ASUNTA,"anticoncepcion, prevencion de its y de cancer de cuello uterino",metodos naturales: usuarias nuevas,2015-12-01,0,13,33,5,0,51
LA PAZ,"anticoncepcion, prevencion de its y de cancer de cuello uterino",metodos naturales: usuarias nuevas,2015-12-01,0,16,131,25,1,173
LAGUNILLAS,"anticoncepcion, prevencion de its y de cancer de cuello uterino",metodos naturales: usuarias nuevas,2015-12-01,0,0,2,0,0,2
LAJA,"anticoncepcion, prevencion de its y de cancer de cuello uterino",metodos naturales: usuarias nuevas,2015-12-01,0,0,1,0,0,1
LICOMA PAMPA,"anticoncepcion, prevencion de its y de cancer de cuello uterino",metodos naturales: usuarias nuevas,2015-12-01,0,1,1,1,0,3
LLALLAGUA,"anticoncepcion, prevencion de its y de cancer de cuello uterino",metodos naturales: usuarias nuevas,2015-12-01,0,2,17,0,0,19
MACHACAMARCA,"anticoncepcion, prevencion de its y de cancer de cuello uterino",metodos naturales: usuarias nuevas,2015-12-01,0,0,1,0,0,1
MAGDALENA,"anticoncepcion, prevencion de its y de cancer de cuello uterino",metodos naturales: usuarias nuevas,2015-12-01,1,0,11,0,0,12
MAPIRI,"anticoncepcion, prevencion de its y de cancer de cuello uterino",metodos naturales: usuarias nuevas,2015-12-01,0,0,0,1,0,1
MINEROS,"anticoncepcion, prevencion de its y de cancer de cuello uterino",metodos naturales: usuarias nuevas,2015-12-01,0,2,6,1,1,10
MIZQUE,"anticoncepcion, prevencion de its y de cancer de cuello uterino",metodos naturales: usuarias nuevas,2015-12-01,0,1,2,1,0,4
MOCOMOCO,"anticoncepcion, prevencion de its y de cancer de cuello uterino",metodos naturales: usuarias nuevas,2015-12-01,0,0,2,0,0,2
MOJOCOYA,"anticoncepcion, prevencion de its y de cancer de cuello uterino",metodos naturales: usuarias nuevas,2015-12-01,0,2,2,0,0,4
MONTEAGUDO,"anticoncepcion, prevencion de its y de cancer de cuello uterino",metodos naturales: usuarias nuevas,2015-12-01,0,0,2,0,0,2
MONTERO,"anticoncepcion, prevencion de its y de cancer de cuello uterino",metodos naturales: usuarias nuevas,2015-12-01,0,2,9,2,0,13
MOROCHATA,"anticoncepcion, prevencion de its y de cancer de cuello uterino",metodos naturales: usuarias nuevas,2015-12-01,0,3,10,1,0,14
NUEVO MANOA (NUEVA ESPERANZA),"anticoncepcion, prevencion de its y de cancer de cuello uterino",metodos naturales: usuarias nuevas,2015-12-01,0,0,1,0,0,1
OCURI,"anticoncepcion, prevencion de its y de cancer de cuello uterino",metodos naturales: usuarias nuevas,2015-12-01,0,3,5,0,0,8
OMEREQUE,"anticoncepcion, prevencion de its y de cancer de cuello uterino",metodos naturales: usuarias nuevas,2015-12-01,0,2,1,0,0,3
ORURO,"anticoncepcion, prevencion de its y de cancer de cuello uterino",metodos naturales: usuarias nuevas,2015-12-01,0,13,64,14,0,91
PADILLA,"anticoncepcion, prevencion de its y de cancer de cuello uterino",metodos naturales: usuarias nuevas,2015-12-01,1,6,5,2,0,14
PALCA,"anticoncepcion, prevencion de its y de cancer de cuello uterino",metodos naturales: usuarias nuevas,2015-12-01,0,0,1,1,0,2
PALOS BLANCOS,"anticoncepcion, prevencion de its y de cancer de cuello uterino",metodos naturales: usuarias nuevas,2015-12-01,0,0,0,0,1,1
PAMPA AULLAGAS,"anticoncepcion, prevencion de its y de cancer de cuello uterino",metodos naturales: usuarias nuevas,2015-12-01,0,0,1,0,0,1
PAMPA GRANDE,"anticoncepcion, prevencion de its y de cancer de cuello uterino",metodos naturales: usuarias nuevas,2015-12-01,0,0,3,0,0,3
PATACAMAYA,"anticoncepcion, prevencion de its y de cancer de cuello uterino",metodos naturales: usuarias nuevas,2015-12-01,0,1,0,0,0,1
PAZÑA,"anticoncepcion, prevencion de its y de cancer de cuello uterino",metodos naturales: usuarias nuevas,2015-12-01,0,2,1,0,0,3
POCOATA,"anticoncepcion, prevencion de its y de cancer de cuello uterino",metodos naturales: usuarias nuevas,2015-12-01,0,3,12,7,0,22
POCONA,"anticoncepcion, prevencion de its y de cancer de cuello uterino",metodos naturales: usuarias nuevas,2015-12-01,0,0,1,2,0,3
POJO (CBBA),"anticoncepcion, prevencion de its y de cancer de cuello uterino",metodos naturales: usuarias nuevas,2015-12-01,0,1,0,0,0,1
POOPO,"anticoncepcion, prevencion de its y de cancer de cuello uterino",metodos naturales: usuarias nuevas,2015-12-01,0,0,2,0,0,2
PORCO,"anticoncepcion, prevencion de its y de cancer de cuello uterino",metodos naturales: usuarias nuevas,2015-12-01,0,1,2,0,0,3
POROMA,"anticoncepcion, prevencion de its y de cancer de cuello uterino",metodos naturales: usuarias nuevas,2015-12-01,0,5,1,0,0,6
PORONGO,"anticoncepcion, prevencion de its y de cancer de cuello uterino",metodos naturales: usuarias nuevas,2015-12-01,0,1,4,0,0,5
PORTACHUELO,"anticoncepcion, prevencion de its y de cancer de cuello uterino",metodos naturales: usuarias nuevas,2015-12-01,1,7,3,0,0,11
PORVENIR,"anticoncepcion, prevencion de its y de cancer de cuello uterino",metodos naturales: usuarias nuevas,2015-12-01,0,0,4,0,0,4
POTOSI,"anticoncepcion, prevencion de its y de cancer de cuello uterino",metodos naturales: usuarias nuevas,2015-12-01,0,13,29,80,0,122
PRESTO,"anticoncepcion, prevencion de its y de cancer de cuello uterino",metodos naturales: usuarias nuevas,2015-12-01,0,0,1,1,0,2
PUCARANI,"anticoncepcion, prevencion de its y de cancer de cuello uterino",metodos naturales: usuarias nuevas,2015-12-01,0,3,7,1,0,11
PUERTO ACOSTA,"anticoncepcion, prevencion de its y de cancer de cuello uterino",metodos naturales: usuarias nuevas,2015-12-01,0,1,0,3,0,4
PUERTO CARABUCO,"anticoncepcion, prevencion de its y de cancer de cuello uterino",metodos naturales: usuarias nuevas,2015-12-01,0,1,1,0,0,2
PUERTO GONZALO MORENO,"anticoncepcion, prevencion de its y de cancer de cuello uterino",metodos naturales: usuarias nuevas,2015-12-01,0,4,0,0,0,4
PUERTO PEREZ,"anticoncepcion, prevencion de its y de cancer de cuello uterino",metodos naturales: usuarias nuevas,2015-12-01,0,2,1,0,0,3
PUERTO RICO,"anticoncepcion, prevencion de its y de cancer de cuello uterino",metodos naturales: usuarias nuevas,2015-12-01,1,3,1,0,0,5
PUERTO VILLARROEL,"anticoncepcion, prevencion de its y de cancer de cuello uterino",metodos naturales: usuarias nuevas,2015-12-01,0,1,3,0,0,4
PUNA,"anticoncepcion, prevencion de its y de cancer de cuello uterino",metodos naturales: usuarias nuevas,2015-12-01,0,2,4,1,0,7
PUNATA,"anticoncepcion, prevencion de its y de cancer de cuello uterino",metodos naturales: usuarias nuevas,2015-12-01,0,29,69,19,0,117
QUILLACOLLO,"anticoncepcion, prevencion de its y de cancer de cuello uterino",metodos naturales: usuarias nuevas,2015-12-01,0,3,5,3,0,11
QUIME,"anticoncepcion, prevencion de its y de cancer de cuello uterino",metodos naturales: usuarias nuevas,2015-12-01,0,3,4,0,0,7
REYES,"anticoncepcion, prevencion de its y de cancer de cuello uterino",metodos naturales: usuarias nuevas,2015-12-01,1,25,42,14,0,82
RIBERALTA,"anticoncepcion, prevencion de its y de cancer de cuello uterino",metodos naturales: usuarias nuevas,2015-12-01,5,56,101,19,1,182
RURRENABAQUE,"anticoncepcion, prevencion de its y de cancer de cuello uterino",metodos naturales: usuarias nuevas,2015-12-01,0,6,8,1,0,15
SABAYA,"anticoncepcion, prevencion de its y de cancer de cuello uterino",metodos naturales: usuarias nuevas,2015-12-01,0,1,0,0,0,1
SACABA,"anticoncepcion, prevencion de its y de cancer de cuello uterino",metodos naturales: usuarias nuevas,2015-12-01,0,9,43,17,0,69
SACACA,"anticoncepcion, prevencion de its y de cancer de cuello uterino",metodos naturales: usuarias nuevas,2015-12-01,1,1,5,1,0,8
SALINAS DE GARCI MENDOZA,"anticoncepcion, prevencion de its y de cancer de cuello uterino",metodos naturales: usuarias nuevas,2015-12-01,1,1,2,1,0,5
SAN ANDRES,"anticoncepcion, prevencion de its y de cancer de cuello uterino",metodos naturales: usuarias nuevas,2015-12-01,1,0,0,0,0,1
SAN ANTONIO DE ESMORUCO,"anticoncepcion, prevencion de its y de cancer de cuello uterino",metodos naturales: usuarias nuevas,2015-12-01,0,0,1,0,0,1
SAN BENITO,"anticoncepcion, prevencion de its y de cancer de cuello uterino",metodos naturales: usuarias nuevas,2015-12-01,0,1,2,0,0,3
SAN BORJA,"anticoncepcion, prevencion de its y de cancer de cuello uterino",metodos naturales: usuarias nuevas,2015-12-01,1,13,4,1,0,19
SAN BUENA VENTURA,"anticoncepcion, prevencion de its y de cancer de cuello uterino",metodos naturales: usuarias nuevas,2015-12-01,0,3,6,2,0,11
SAN CARLOS,"anticoncepcion, prevencion de its y de cancer de cuello uterino",metodos naturales: usuarias nuevas,2015-12-01,0,15,19,2,0,36
SAN IGNACIO,"anticoncepcion, prevencion de its y de cancer de cuello uterino",metodos naturales: usuarias nuevas,2015-12-01,1,7,2,5,0,15
SAN JAVIER(BNI),"anticoncepcion, prevencion de its y de cancer de cuello uterino",metodos naturales: usuarias nuevas,2015-12-01,0,0,0,3,0,3
SAN JUAN DE YAPACANI,"anticoncepcion, prevencion de its y de cancer de cuello uterino",metodos naturales: usuarias nuevas,2015-12-01,0,1,3,0,0,4
SAN JULIAN,"anticoncepcion, prevencion de its y de cancer de cuello uterino",metodos naturales: usuarias nuevas,2015-12-01,0,1,0,0,0,1
SAN LORENZO(PND),"anticoncepcion, prevencion de its y de cancer de cuello uterino",metodos naturales: usuarias nuevas,2015-12-01,0,1,0,0,0,1
SAN LUCAS,"anticoncepcion, prevencion de its y de cancer de cuello uterino",metodos naturales: usuarias nuevas,2015-12-01,0,5,8,0,0,13
SAN MIGUEL DE VELASCO,"anticoncepcion, prevencion de its y de cancer de cuello uterino",metodos naturales: usuarias nuevas,2015-12-01,0,0,2,0,0,2
SAN PEDRO,"anticoncepcion, prevencion de its y de cancer de cuello uterino",metodos naturales: usuarias nuevas,2015-12-01,0,1,2,1,0,4
SAN PEDRO DE BUENA VISTA,"anticoncepcion, prevencion de its y de cancer de cuello uterino",metodos naturales: usuarias nuevas,2015-12-01,0,1,7,1,0,9
SAN PEDRO DE TIQUINA,"anticoncepcion, prevencion de its y de cancer de cuello uterino",metodos naturales: usuarias nuevas,2015-12-01,0,1,1,0,0,2
SAN RAFAEL,"anticoncepcion, prevencion de its y de cancer de cuello uterino",metodos naturales: usuarias nuevas,2015-12-01,0,3,3,0,0,6
SANTA ANA,"anticoncepcion, prevencion de its y de cancer de cuello uterino",metodos naturales: usuarias nuevas,2015-12-01,0,8,17,0,0,25
SANTA CRUZ DE LA SIERRA,"anticoncepcion, prevencion de its y de cancer de cuello uterino",metodos naturales: usuarias nuevas,2015-12-01,0,11,23,14,1,49
SANTA ROSA DEL SARA,"anticoncepcion, prevencion de its y de cancer de cuello uterino",metodos naturales: usuarias nuevas,2015-12-01,0,0,8,1,0,9
SANTIAGO DE HUARI,"anticoncepcion, prevencion de its y de cancer de cuello uterino",metodos naturales: usuarias nuevas,2015-12-01,0,0,3,0,0,3
SANTIAGO DE MACHACA,"anticoncepcion, prevencion de its y de cancer de cuello uterino",metodos naturales: usuarias nuevas,2015-12-01,0,1,0,0,0,1
SANTUARIO DE QUILLACAS,"anticoncepcion, prevencion de its y de cancer de cuello uterino",metodos naturales: usuarias nuevas,2015-12-01,0,1,2,0,0,3
SAPAHAQUI,"anticoncepcion, prevencion de its y de cancer de cuello uterino",metodos naturales: usuarias nuevas,2015-12-01,0,6,3,0,0,9
SENA,"anticoncepcion, prevencion de its y de cancer de cuello uterino",metodos naturales: usuarias nuevas,2015-12-01,0,2,0,0,0,2
SHINAOTA,"anticoncepcion, prevencion de its y de cancer de cuello uterino",metodos naturales: usuarias nuevas,2015-12-01,0,2,0,0,0,2
SIPE SIPE,"anticoncepcion, prevencion de its y de cancer de cuello uterino",metodos naturales: usuarias nuevas,2015-12-01,0,6,14,4,0,24
SOPACHUY,"anticoncepcion, prevencion de its y de cancer de cuello uterino",metodos naturales: usuarias nuevas,2015-12-01,0,3,8,3,0,14
SORACACHI,"anticoncepcion, prevencion de its y de cancer de cuello uterino",metodos naturales: usuarias nuevas,2015-12-01,0,0,6,0,0,6
SUCRE,"anticoncepcion, prevencion de its y de cancer de cuello uterino",metodos naturales: usuarias nuevas,2015-12-01,0,49,230,35,1,315
TACOPAYA,"anticoncepcion, prevencion de its y de cancer de cuello uterino",metodos naturales: usuarias nuevas,2015-12-01,0,0,2,0,0,2
TAPACARI,"anticoncepcion, prevencion de its y de cancer de cuello uterino",metodos naturales: usuarias nuevas,2015-12-01,0,0,2,0,0,2
TARABUCO,"anticoncepcion, prevencion de its y de cancer de cuello uterino",metodos naturales: usuarias nuevas,2015-12-01,0,1,1,2,0,4
TARACO,"anticoncepcion, prevencion de its y de cancer de cuello uterino",metodos naturales: usuarias nuevas,2015-12-01,0,2,1,0,0,3
TARATA,"anticoncepcion, prevencion de its y de cancer de cuello uterino",metodos naturales: usuarias nuevas,2015-12-01,1,2,4,1,0,8
TARIJA,"anticoncepcion, prevencion de its y de cancer de cuello uterino",metodos naturales: usuarias nuevas,2015-12-01,0,0,3,3,0,6
TARVITA,"anticoncepcion, prevencion de its y de cancer de cuello uterino",metodos naturales: usuarias nuevas,2015-12-01,1,3,2,1,0,7
TEOPONTE,"anticoncepcion, prevencion de its y de cancer de cuello uterino",metodos naturales: usuarias nuevas,2015-12-01,0,2,4,1,0,7
TIAWANACU,"anticoncepcion, prevencion de its y de cancer de cuello uterino",metodos naturales: usuarias nuevas,2015-12-01,0,3,4,0,0,7
TINGUIPAYA,"anticoncepcion, prevencion de its y de cancer de cuello uterino",metodos naturales: usuarias nuevas,2015-12-01,0,0,1,0,0,1
TIPUANI,"anticoncepcion, prevencion de its y de cancer de cuello uterino",metodos naturales: usuarias nuevas,2015-12-01,0,1,7,1,0,9
TIRAQUE (CBBA),"anticoncepcion, prevencion de its y de cancer de cuello uterino",metodos naturales: usuarias nuevas,2015-12-01,0,0,0,1,0,1
TOMAVE,"anticoncepcion, prevencion de its y de cancer de cuello uterino",metodos naturales: usuarias nuevas,2015-12-01,0,0,1,1,0,2
TOMINA,"anticoncepcion, prevencion de its y de cancer de cuello uterino",metodos naturales: usuarias nuevas,2015-12-01,0,5,4,0,0,9
TORO TORO,"anticoncepcion, prevencion de its y de cancer de cuello uterino",metodos naturales: usuarias nuevas,2015-12-01,0,0,1,0,0,1
TOTORA(CBBA),"anticoncepcion, prevencion de its y de cancer de cuello uterino",metodos naturales: usuarias nuevas,2015-12-01,0,0,1,0,0,1
TOTORA(ORR),"anticoncepcion, prevencion de its y de cancer de cuello uterino",metodos naturales: usuarias nuevas,2015-12-01,0,2,2,0,0,4
TRINIDAD,"anticoncepcion, prevencion de its y de cancer de cuello uterino",metodos naturales: usuarias nuevas,2015-12-01,0,10,18,1,0,29
TUPIZA,"anticoncepcion, prevencion de its y de cancer de cuello uterino",metodos naturales: usuarias nuevas,2015-12-01,0,0,2,0,0,2
UNCIA,"anticoncepcion, prevencion de its y de cancer de cuello uterino",metodos naturales: usuarias nuevas,2015-12-01,0,1,2,0,0,3
VACAS,"anticoncepcion, prevencion de its y de cancer de cuello uterino",metodos naturales: usuarias nuevas,2015-12-01,0,3,4,2,0,9
VILLA CHARCAS,"anticoncepcion, prevencion de its y de cancer de cuello uterino",metodos naturales: usuarias nuevas,2015-12-01,0,6,5,0,0,11
VILLA MONTES,"anticoncepcion, prevencion de its y de cancer de cuello uterino",metodos naturales: usuarias nuevas,2015-12-01,1,8,11,7,0,27
VILLA RIVERO,"anticoncepcion, prevencion de its y de cancer de cuello uterino",metodos naturales: usuarias nuevas,2015-12-01,0,0,1,0,0,1
VILLA SERRANO,"anticoncepcion, prevencion de its y de cancer de cuello uterino",metodos naturales: usuarias nuevas,2015-12-01,0,1,5,3,0,9
VILLA TUNARI,"anticoncepcion, prevencion de its y de cancer de cuello uterino",metodos naturales: usuarias nuevas,2015-12-01,0,0,1,0,0,1
VILLA VACA GUZMAN (MUYUPAMPA),"anticoncepcion, prevencion de its y de cancer de cuello uterino",metodos naturales: usuarias nuevas,2015-12-01,0,0,0,1,0,1
VILLAZON,"anticoncepcion, prevencion de its y de cancer de cuello uterino",metodos naturales: usuarias nuevas,2015-12-01,0,2,2,1,0,5
VINTO,"anticoncepcion, prevencion de its y de cancer de cuello uterino",metodos naturales: usuarias nuevas,2015-12-01,1,7,28,13,0,49
VITICHI,"anticoncepcion, prevencion de its y de cancer de cuello uterino",metodos naturales: usuarias nuevas,2015-12-01,0,1,4,1,0,6
WARNES,"anticoncepcion, prevencion de its y de cancer de cuello uterino",metodos naturales: usuarias nuevas,2015-12-01,0,0,1,0,0,1
YACUIBA,"anticoncepcion, prevencion de its y de cancer de cuello uterino",metodos naturales: usuarias nuevas,2015-12-01,0,3,4,1,0,8
YANACACHI,"anticoncepcion, prevencion de its y de cancer de cuello uterino",metodos naturales: usuarias nuevas,2015-12-01,0,0,1,0,0,1
YAPACANI,"anticoncepcion, prevencion de its y de cancer de cuello uterino",metodos naturales: usuarias nuevas,2015-12-01,1,1,2,0,0,4
YOTALA,"anticoncepcion, prevencion de its y de cancer de cuello uterino",metodos naturales: usuarias nuevas,2015-12-01,0,6,6,0,0,12
ZUDAÑEZ,"anticoncepcion, prevencion de its y de cancer de cuello uterino",metodos naturales: usuarias nuevas,2015-12-01,0,5,4,3,0,12
