municipality,group,variable,month,Número de inyectables trimestrales suministrados,Número de inyectables trimestrales suministrados1,Número de inyectables trimestrales suministrados2,Número de inyectables trimestrales suministrados3,Número de inyectables trimestrales suministrados4,TOTAL
ACACIO,"anticoncepcion, prevencion de its y de cancer de cuello uterino",numero de inyectables trimestrales suministrados,2015-01-01,0,2,8,5,0,15
ACHACACHI,"anticoncepcion, prevencion de its y de cancer de cuello uterino",numero de inyectables trimestrales suministrados,2015-01-01,1,3,50,38,0,92
ACHOCALLA,"anticoncepcion, prevencion de its y de cancer de cuello uterino",numero de inyectables trimestrales suministrados,2015-01-01,0,10,24,7,0,41
AIQUILE,"anticoncepcion, prevencion de its y de cancer de cuello uterino",numero de inyectables trimestrales suministrados,2015-01-01,0,2,35,34,0,71
ALALAY,"anticoncepcion, prevencion de its y de cancer de cuello uterino",numero de inyectables trimestrales suministrados,2015-01-01,0,1,6,2,0,9
ALCALA,"anticoncepcion, prevencion de its y de cancer de cuello uterino",numero de inyectables trimestrales suministrados,2015-01-01,0,3,19,20,0,42
ALTO BENI,"anticoncepcion, prevencion de its y de cancer de cuello uterino",numero de inyectables trimestrales suministrados,2015-01-01,0,8,29,17,0,54
ANCORAIMES,"anticoncepcion, prevencion de its y de cancer de cuello uterino",numero de inyectables trimestrales suministrados,2015-01-01,0,2,13,11,1,27
ANDAMARCA,"anticoncepcion, prevencion de its y de cancer de cuello uterino",numero de inyectables trimestrales suministrados,2015-01-01,0,1,8,6,0,15
ANTEQUERA,"anticoncepcion, prevencion de its y de cancer de cuello uterino",numero de inyectables trimestrales suministrados,2015-01-01,0,1,3,3,0,7
ANZALDO,"anticoncepcion, prevencion de its y de cancer de cuello uterino",numero de inyectables trimestrales suministrados,2015-01-01,0,9,23,12,0,44
APOLO,"anticoncepcion, prevencion de its y de cancer de cuello uterino",numero de inyectables trimestrales suministrados,2015-01-01,0,5,38,17,1,61
ARAMPAMPA,"anticoncepcion, prevencion de its y de cancer de cuello uterino",numero de inyectables trimestrales suministrados,2015-01-01,0,0,7,3,0,10
ARANI,"anticoncepcion, prevencion de its y de cancer de cuello uterino",numero de inyectables trimestrales suministrados,2015-01-01,0,3,13,16,0,32
ARBIETO,"anticoncepcion, prevencion de its y de cancer de cuello uterino",numero de inyectables trimestrales suministrados,2015-01-01,0,6,46,24,0,76
ARQUE,"anticoncepcion, prevencion de its y de cancer de cuello uterino",numero de inyectables trimestrales suministrados,2015-01-01,0,10,36,34,0,80
ASCENCION DE GUARAYOS,"anticoncepcion, prevencion de its y de cancer de cuello uterino",numero de inyectables trimestrales suministrados,2015-01-01,12,11,51,17,0,91
ATOCHA,"anticoncepcion, prevencion de its y de cancer de cuello uterino",numero de inyectables trimestrales suministrados,2015-01-01,0,5,34,10,0,49
AUCAPATA,"anticoncepcion, prevencion de its y de cancer de cuello uterino",numero de inyectables trimestrales suministrados,2015-01-01,0,0,13,3,0,16
AYATA,"anticoncepcion, prevencion de its y de cancer de cuello uterino",numero de inyectables trimestrales suministrados,2015-01-01,0,1,15,19,0,35
AYO AYO,"anticoncepcion, prevencion de its y de cancer de cuello uterino",numero de inyectables trimestrales suministrados,2015-01-01,0,2,10,8,0,20
AYOPAYA (V. DE INDEPENDENCIA),"anticoncepcion, prevencion de its y de cancer de cuello uterino",numero de inyectables trimestrales suministrados,2015-01-01,1,17,78,62,1,159
AZURDUY,"anticoncepcion, prevencion de its y de cancer de cuello uterino",numero de inyectables trimestrales suministrados,2015-01-01,0,10,47,29,0,86
BATALLAS,"anticoncepcion, prevencion de its y de cancer de cuello uterino",numero de inyectables trimestrales suministrados,2015-01-01,0,1,29,24,0,54
BAURES,"anticoncepcion, prevencion de its y de cancer de cuello uterino",numero de inyectables trimestrales suministrados,2015-01-01,0,0,12,2,0,14
BELEN DE ANDAMARCA,"anticoncepcion, prevencion de its y de cancer de cuello uterino",numero de inyectables trimestrales suministrados,2015-01-01,0,0,2,0,0,2
BELEN DE URMIRI,"anticoncepcion, prevencion de its y de cancer de cuello uterino",numero de inyectables trimestrales suministrados,2015-01-01,0,0,3,1,0,4
BELLA FLOR,"anticoncepcion, prevencion de its y de cancer de cuello uterino",numero de inyectables trimestrales suministrados,2015-01-01,0,9,9,2,0,20
BERMEJO,"anticoncepcion, prevencion de its y de cancer de cuello uterino",numero de inyectables trimestrales suministrados,2015-01-01,0,14,56,28,1,99
BETANZOS,"anticoncepcion, prevencion de its y de cancer de cuello uterino",numero de inyectables trimestrales suministrados,2015-01-01,0,2,50,40,0,92
BOLIVAR,"anticoncepcion, prevencion de its y de cancer de cuello uterino",numero de inyectables trimestrales suministrados,2015-01-01,0,0,1,3,0,4
BOLPEBRA,"anticoncepcion, prevencion de its y de cancer de cuello uterino",numero de inyectables trimestrales suministrados,2015-01-01,0,1,2,1,0,4
BOYUIBE,"anticoncepcion, prevencion de its y de cancer de cuello uterino",numero de inyectables trimestrales suministrados,2015-01-01,0,1,8,6,0,15
BUENA VISTA,"anticoncepcion, prevencion de its y de cancer de cuello uterino",numero de inyectables trimestrales suministrados,2015-01-01,0,10,32,17,0,59
CABEZAS,"anticoncepcion, prevencion de its y de cancer de cuello uterino",numero de inyectables trimestrales suministrados,2015-01-01,0,22,97,26,2,147
CAIROMA,"anticoncepcion, prevencion de its y de cancer de cuello uterino",numero de inyectables trimestrales suministrados,2015-01-01,0,1,14,5,0,20
"CAIZA ""D""","anticoncepcion, prevencion de its y de cancer de cuello uterino",numero de inyectables trimestrales suministrados,2015-01-01,0,1,20,7,0,28
CAJUATA,"anticoncepcion, prevencion de its y de cancer de cuello uterino",numero de inyectables trimestrales suministrados,2015-01-01,0,5,33,19,0,57
CALACOTO,"anticoncepcion, prevencion de its y de cancer de cuello uterino",numero de inyectables trimestrales suministrados,2015-01-01,0,0,7,2,0,9
CALAMARCA,"anticoncepcion, prevencion de its y de cancer de cuello uterino",numero de inyectables trimestrales suministrados,2015-01-01,0,7,48,21,0,76
CAMARGO,"anticoncepcion, prevencion de its y de cancer de cuello uterino",numero de inyectables trimestrales suministrados,2015-01-01,0,7,26,26,0,59
CAMATAQUI (C. VILLA ABECIA),"anticoncepcion, prevencion de its y de cancer de cuello uterino",numero de inyectables trimestrales suministrados,2015-01-01,0,0,9,9,0,18
CAMIRI,"anticoncepcion, prevencion de its y de cancer de cuello uterino",numero de inyectables trimestrales suministrados,2015-01-01,0,10,47,21,0,78
CAPINOTA,"anticoncepcion, prevencion de its y de cancer de cuello uterino",numero de inyectables trimestrales suministrados,2015-01-01,1,13,57,27,0,98
CAQUIAVIRI,"anticoncepcion, prevencion de its y de cancer de cuello uterino",numero de inyectables trimestrales suministrados,2015-01-01,0,0,14,5,0,19
CARACOLLO,"anticoncepcion, prevencion de its y de cancer de cuello uterino",numero de inyectables trimestrales suministrados,2015-01-01,0,1,33,22,1,57
CARANAVI,"anticoncepcion, prevencion de its y de cancer de cuello uterino",numero de inyectables trimestrales suministrados,2015-01-01,2,10,73,38,0,123
CARAPARI,"anticoncepcion, prevencion de its y de cancer de cuello uterino",numero de inyectables trimestrales suministrados,2015-01-01,0,12,69,38,0,119
CARIPUYO,"anticoncepcion, prevencion de its y de cancer de cuello uterino",numero de inyectables trimestrales suministrados,2015-01-01,0,0,5,6,0,11
CARMEN RIVERO TORREZ,"anticoncepcion, prevencion de its y de cancer de cuello uterino",numero de inyectables trimestrales suministrados,2015-01-01,0,2,12,3,0,17
CATACORA,"anticoncepcion, prevencion de its y de cancer de cuello uterino",numero de inyectables trimestrales suministrados,2015-01-01,0,0,3,2,0,5
CHACARILLA,"anticoncepcion, prevencion de its y de cancer de cuello uterino",numero de inyectables trimestrales suministrados,2015-01-01,0,0,1,0,0,1
CHALLAPATA,"anticoncepcion, prevencion de its y de cancer de cuello uterino",numero de inyectables trimestrales suministrados,2015-01-01,0,4,34,15,0,53
CHAQUI,"anticoncepcion, prevencion de its y de cancer de cuello uterino",numero de inyectables trimestrales suministrados,2015-01-01,0,3,12,10,0,25
CHARAGUA,"anticoncepcion, prevencion de its y de cancer de cuello uterino",numero de inyectables trimestrales suministrados,2015-01-01,0,6,46,12,0,64
CHARAÑA,"anticoncepcion, prevencion de its y de cancer de cuello uterino",numero de inyectables trimestrales suministrados,2015-01-01,0,0,4,5,0,9
CHAYANTA,"anticoncepcion, prevencion de its y de cancer de cuello uterino",numero de inyectables trimestrales suministrados,2015-01-01,0,2,22,9,0,33
CHIMORE,"anticoncepcion, prevencion de its y de cancer de cuello uterino",numero de inyectables trimestrales suministrados,2015-01-01,0,9,78,29,0,116
CHIPAYA,"anticoncepcion, prevencion de its y de cancer de cuello uterino",numero de inyectables trimestrales suministrados,2015-01-01,2,2,10,6,0,20
CHOQUE COTA,"anticoncepcion, prevencion de its y de cancer de cuello uterino",numero de inyectables trimestrales suministrados,2015-01-01,0,0,1,1,0,2
CHUA COCANI,"anticoncepcion, prevencion de its y de cancer de cuello uterino",numero de inyectables trimestrales suministrados,2015-01-01,0,1,2,5,0,8
CHULUMANI (V. DE LA LIBERTAD),"anticoncepcion, prevencion de its y de cancer de cuello uterino",numero de inyectables trimestrales suministrados,2015-01-01,0,5,44,9,0,58
CHUMA,"anticoncepcion, prevencion de its y de cancer de cuello uterino",numero de inyectables trimestrales suministrados,2015-01-01,0,1,14,21,0,36
CHUQUIHUTA AYLLU JUCUMANI,"anticoncepcion, prevencion de its y de cancer de cuello uterino",numero de inyectables trimestrales suministrados,2015-01-01,0,4,23,3,0,30
CKOCHAS,"anticoncepcion, prevencion de its y de cancer de cuello uterino",numero de inyectables trimestrales suministrados,2015-01-01,0,1,16,22,0,39
CLIZA,"anticoncepcion, prevencion de its y de cancer de cuello uterino",numero de inyectables trimestrales suministrados,2015-01-01,0,9,51,9,0,69
COBIJA,"anticoncepcion, prevencion de its y de cancer de cuello uterino",numero de inyectables trimestrales suministrados,2015-01-01,2,30,93,21,0,146
COCAPATA,"anticoncepcion, prevencion de its y de cancer de cuello uterino",numero de inyectables trimestrales suministrados,2015-01-01,1,5,38,18,0,62
COCHABAMBA,"anticoncepcion, prevencion de its y de cancer de cuello uterino",numero de inyectables trimestrales suministrados,2015-01-01,0,65,436,117,1,619
COIPASA,"anticoncepcion, prevencion de its y de cancer de cuello uterino",numero de inyectables trimestrales suministrados,2015-01-01,0,0,5,2,0,7
COLCAPIRHUA,"anticoncepcion, prevencion de its y de cancer de cuello uterino",numero de inyectables trimestrales suministrados,2015-01-01,0,12,59,9,0,80
"COLCHA ""K""","anticoncepcion, prevencion de its y de cancer de cuello uterino",numero de inyectables trimestrales suministrados,2015-01-01,0,5,51,15,0,71
COLLANA,"anticoncepcion, prevencion de its y de cancer de cuello uterino",numero de inyectables trimestrales suministrados,2015-01-01,0,2,8,3,0,13
COLOMI,"anticoncepcion, prevencion de its y de cancer de cuello uterino",numero de inyectables trimestrales suministrados,2015-01-01,0,10,57,22,0,89
COLPA BELGICA,"anticoncepcion, prevencion de its y de cancer de cuello uterino",numero de inyectables trimestrales suministrados,2015-01-01,0,2,17,4,0,23
COLQUECHACA,"anticoncepcion, prevencion de its y de cancer de cuello uterino",numero de inyectables trimestrales suministrados,2015-01-01,0,5,27,20,0,52
COLQUENCHA,"anticoncepcion, prevencion de its y de cancer de cuello uterino",numero de inyectables trimestrales suministrados,2015-01-01,0,18,25,10,0,53
COLQUIRI,"anticoncepcion, prevencion de its y de cancer de cuello uterino",numero de inyectables trimestrales suministrados,2015-01-01,0,1,30,15,0,46
COMANCHE,"anticoncepcion, prevencion de its y de cancer de cuello uterino",numero de inyectables trimestrales suministrados,2015-01-01,0,0,3,0,0,3
COMARAPA,"anticoncepcion, prevencion de its y de cancer de cuello uterino",numero de inyectables trimestrales suministrados,2015-01-01,2,18,97,24,1,142
COMBAYA,"anticoncepcion, prevencion de its y de cancer de cuello uterino",numero de inyectables trimestrales suministrados,2015-01-01,0,0,7,2,0,9
CONCEPCION,"anticoncepcion, prevencion de its y de cancer de cuello uterino",numero de inyectables trimestrales suministrados,2015-01-01,0,8,41,4,0,53
COPACABANA,"anticoncepcion, prevencion de its y de cancer de cuello uterino",numero de inyectables trimestrales suministrados,2015-01-01,0,0,33,5,0,38
CORIPATA,"anticoncepcion, prevencion de its y de cancer de cuello uterino",numero de inyectables trimestrales suministrados,2015-01-01,0,2,30,11,0,43
CORO CORO,"anticoncepcion, prevencion de its y de cancer de cuello uterino",numero de inyectables trimestrales suministrados,2015-01-01,0,0,16,5,0,21
COROICO,"anticoncepcion, prevencion de its y de cancer de cuello uterino",numero de inyectables trimestrales suministrados,2015-01-01,0,2,6,7,1,16
CORQUE,"anticoncepcion, prevencion de its y de cancer de cuello uterino",numero de inyectables trimestrales suministrados,2015-01-01,0,3,20,6,0,29
COTAGAITA,"anticoncepcion, prevencion de its y de cancer de cuello uterino",numero de inyectables trimestrales suministrados,2015-01-01,0,1,35,23,0,59
COTOCA,"anticoncepcion, prevencion de its y de cancer de cuello uterino",numero de inyectables trimestrales suministrados,2015-01-01,0,24,121,34,0,179
CUATRO CAÑADAS,"anticoncepcion, prevencion de its y de cancer de cuello uterino",numero de inyectables trimestrales suministrados,2015-01-01,1,4,46,15,0,66
CUCHUMUELA (V. G. VILLARROEL),"anticoncepcion, prevencion de its y de cancer de cuello uterino",numero de inyectables trimestrales suministrados,2015-01-01,0,0,5,1,0,6
CUEVO,"anticoncepcion, prevencion de its y de cancer de cuello uterino",numero de inyectables trimestrales suministrados,2015-01-01,0,2,25,10,0,37
CULPINA,"anticoncepcion, prevencion de its y de cancer de cuello uterino",numero de inyectables trimestrales suministrados,2015-01-01,0,6,63,35,0,104
CURAHUARA DE CARANGAS,"anticoncepcion, prevencion de its y de cancer de cuello uterino",numero de inyectables trimestrales suministrados,2015-01-01,0,2,8,5,0,15
CURVA,"anticoncepcion, prevencion de its y de cancer de cuello uterino",numero de inyectables trimestrales suministrados,2015-01-01,0,0,3,2,1,6
DESAGUADERO,"anticoncepcion, prevencion de its y de cancer de cuello uterino",numero de inyectables trimestrales suministrados,2015-01-01,0,0,13,9,0,22
EL ALTO,"anticoncepcion, prevencion de its y de cancer de cuello uterino",numero de inyectables trimestrales suministrados,2015-01-01,1,113,1199,422,1,1736
EL CHORO,"anticoncepcion, prevencion de its y de cancer de cuello uterino",numero de inyectables trimestrales suministrados,2015-01-01,0,1,17,4,0,22
EL PUENTE(STC),"anticoncepcion, prevencion de its y de cancer de cuello uterino",numero de inyectables trimestrales suministrados,2015-01-01,0,7,49,20,0,76
EL PUENTE(TJA),"anticoncepcion, prevencion de its y de cancer de cuello uterino",numero de inyectables trimestrales suministrados,2015-01-01,0,13,71,45,1,130
EL TORNO,"anticoncepcion, prevencion de its y de cancer de cuello uterino",numero de inyectables trimestrales suministrados,2015-01-01,3,26,130,68,1,228
EL VILLAR,"anticoncepcion, prevencion de its y de cancer de cuello uterino",numero de inyectables trimestrales suministrados,2015-01-01,0,4,24,13,0,41
ENTRE RIOS TRJ,"anticoncepcion, prevencion de its y de cancer de cuello uterino",numero de inyectables trimestrales suministrados,2015-01-01,0,23,108,55,0,186
ENTRE RIOS CBBA,"anticoncepcion, prevencion de its y de cancer de cuello uterino",numero de inyectables trimestrales suministrados,2015-01-01,0,13,46,20,0,79
ESCARA,"anticoncepcion, prevencion de its y de cancer de cuello uterino",numero de inyectables trimestrales suministrados,2015-01-01,0,0,1,0,0,1
ESCOMA,"anticoncepcion, prevencion de its y de cancer de cuello uterino",numero de inyectables trimestrales suministrados,2015-01-01,0,0,3,3,0,6
ESMERALDA,"anticoncepcion, prevencion de its y de cancer de cuello uterino",numero de inyectables trimestrales suministrados,2015-01-01,0,0,2,0,0,2
EUCALIPTUS,"anticoncepcion, prevencion de its y de cancer de cuello uterino",numero de inyectables trimestrales suministrados,2015-01-01,0,0,6,4,0,10
EUREKA (SANTOS MERCADO),"anticoncepcion, prevencion de its y de cancer de cuello uterino",numero de inyectables trimestrales suministrados,2015-01-01,0,1,4,0,0,5
EXALTACION,"anticoncepcion, prevencion de its y de cancer de cuello uterino",numero de inyectables trimestrales suministrados,2015-01-01,0,0,3,0,0,3
FERNANDEZ ALONSO,"anticoncepcion, prevencion de its y de cancer de cuello uterino",numero de inyectables trimestrales suministrados,2015-01-01,0,13,48,24,4,89
FILADELFIA,"anticoncepcion, prevencion de its y de cancer de cuello uterino",numero de inyectables trimestrales suministrados,2015-01-01,0,7,21,3,1,32
GENERAL SAAVEDRA,"anticoncepcion, prevencion de its y de cancer de cuello uterino",numero de inyectables trimestrales suministrados,2015-01-01,0,22,46,19,0,87
GRAL. J.J. PEREZ (CHARAZANI),"anticoncepcion, prevencion de its y de cancer de cuello uterino",numero de inyectables trimestrales suministrados,2015-01-01,0,0,12,16,0,28
GUANAY,"anticoncepcion, prevencion de its y de cancer de cuello uterino",numero de inyectables trimestrales suministrados,2015-01-01,0,5,18,5,0,28
GUAQUI,"anticoncepcion, prevencion de its y de cancer de cuello uterino",numero de inyectables trimestrales suministrados,2015-01-01,0,3,20,2,0,25
GUAYARAMERIN,"anticoncepcion, prevencion de its y de cancer de cuello uterino",numero de inyectables trimestrales suministrados,2015-01-01,2,20,75,14,0,111
GUTIERREZ,"anticoncepcion, prevencion de its y de cancer de cuello uterino",numero de inyectables trimestrales suministrados,2015-01-01,0,6,26,14,0,46
HUACARETA,"anticoncepcion, prevencion de its y de cancer de cuello uterino",numero de inyectables trimestrales suministrados,2015-01-01,0,4,29,17,3,53
HUACAYA (VILLA DE HUACAYA),"anticoncepcion, prevencion de its y de cancer de cuello uterino",numero de inyectables trimestrales suministrados,2015-01-01,0,1,20,0,0,21
HUACHACALLA,"anticoncepcion, prevencion de its y de cancer de cuello uterino",numero de inyectables trimestrales suministrados,2015-01-01,0,0,3,2,0,5
HUANUNI,"anticoncepcion, prevencion de its y de cancer de cuello uterino",numero de inyectables trimestrales suministrados,2015-01-01,0,5,21,7,0,33
HUARACAJE,"anticoncepcion, prevencion de its y de cancer de cuello uterino",numero de inyectables trimestrales suministrados,2015-01-01,0,2,8,1,0,11
HUARINA,"anticoncepcion, prevencion de its y de cancer de cuello uterino",numero de inyectables trimestrales suministrados,2015-01-01,0,0,5,1,1,7
HUATAJATA,"anticoncepcion, prevencion de its y de cancer de cuello uterino",numero de inyectables trimestrales suministrados,2015-01-01,0,0,7,1,0,8
HUAYLLAMARCA,"anticoncepcion, prevencion de its y de cancer de cuello uterino",numero de inyectables trimestrales suministrados,2015-01-01,0,1,11,5,0,17
HUMANATA,"anticoncepcion, prevencion de its y de cancer de cuello uterino",numero de inyectables trimestrales suministrados,2015-01-01,0,2,0,7,0,9
ICHOCA,"anticoncepcion, prevencion de its y de cancer de cuello uterino",numero de inyectables trimestrales suministrados,2015-01-01,0,0,6,3,0,9
ICLA,"anticoncepcion, prevencion de its y de cancer de cuello uterino",numero de inyectables trimestrales suministrados,2015-01-01,0,1,11,16,0,28
INCAHUASI,"anticoncepcion, prevencion de its y de cancer de cuello uterino",numero de inyectables trimestrales suministrados,2015-01-01,0,5,59,26,0,90
INGAVI (HUMAITA),"anticoncepcion, prevencion de its y de cancer de cuello uterino",numero de inyectables trimestrales suministrados,2015-01-01,0,1,5,0,0,6
INQUISIVI,"anticoncepcion, prevencion de its y de cancer de cuello uterino",numero de inyectables trimestrales suministrados,2015-01-01,0,2,23,12,1,38
IRUPANA (VILLA DE LANZA),"anticoncepcion, prevencion de its y de cancer de cuello uterino",numero de inyectables trimestrales suministrados,2015-01-01,0,8,62,21,0,91
IXIAMAS,"anticoncepcion, prevencion de its y de cancer de cuello uterino",numero de inyectables trimestrales suministrados,2015-01-01,0,7,18,5,0,30
JESUS DE MACHACA,"anticoncepcion, prevencion de its y de cancer de cuello uterino",numero de inyectables trimestrales suministrados,2015-01-01,0,0,12,9,0,21
LA ASUNTA,"anticoncepcion, prevencion de its y de cancer de cuello uterino",numero de inyectables trimestrales suministrados,2015-01-01,0,7,128,49,1,185
LA GUARDIA,"anticoncepcion, prevencion de its y de cancer de cuello uterino",numero de inyectables trimestrales suministrados,2015-01-01,0,27,109,25,0,161
LA PAZ,"anticoncepcion, prevencion de its y de cancer de cuello uterino",numero de inyectables trimestrales suministrados,2015-01-01,2,53,489,109,0,653
LAGUNILLAS,"anticoncepcion, prevencion de its y de cancer de cuello uterino",numero de inyectables trimestrales suministrados,2015-01-01,1,3,16,5,0,25
LAJA,"anticoncepcion, prevencion de its y de cancer de cuello uterino",numero de inyectables trimestrales suministrados,2015-01-01,0,10,38,20,1,69
LAS CARRERAS,"anticoncepcion, prevencion de its y de cancer de cuello uterino",numero de inyectables trimestrales suministrados,2015-01-01,0,4,13,4,0,21
LICOMA PAMPA,"anticoncepcion, prevencion de its y de cancer de cuello uterino",numero de inyectables trimestrales suministrados,2015-01-01,0,1,7,4,0,12
LLALLAGUA,"anticoncepcion, prevencion de its y de cancer de cuello uterino",numero de inyectables trimestrales suministrados,2015-01-01,0,2,67,13,0,82
LLICA,"anticoncepcion, prevencion de its y de cancer de cuello uterino",numero de inyectables trimestrales suministrados,2015-01-01,0,1,21,3,0,25
LORETO,"anticoncepcion, prevencion de its y de cancer de cuello uterino",numero de inyectables trimestrales suministrados,2015-01-01,0,1,4,3,0,8
LURIBAY,"anticoncepcion, prevencion de its y de cancer de cuello uterino",numero de inyectables trimestrales suministrados,2015-01-01,0,0,21,12,0,33
MACHACAMARCA,"anticoncepcion, prevencion de its y de cancer de cuello uterino",numero de inyectables trimestrales suministrados,2015-01-01,0,0,3,1,0,4
MACHARETI,"anticoncepcion, prevencion de its y de cancer de cuello uterino",numero de inyectables trimestrales suministrados,2015-01-01,0,3,25,11,1,40
MAGDALENA,"anticoncepcion, prevencion de its y de cancer de cuello uterino",numero de inyectables trimestrales suministrados,2015-01-01,0,11,39,9,0,59
MAIRANA,"anticoncepcion, prevencion de its y de cancer de cuello uterino",numero de inyectables trimestrales suministrados,2015-01-01,0,7,23,4,0,34
MALLA,"anticoncepcion, prevencion de its y de cancer de cuello uterino",numero de inyectables trimestrales suministrados,2015-01-01,0,0,4,1,0,5
MAPIRI,"anticoncepcion, prevencion de its y de cancer de cuello uterino",numero de inyectables trimestrales suministrados,2015-01-01,0,8,23,4,0,35
MECAPACA,"anticoncepcion, prevencion de its y de cancer de cuello uterino",numero de inyectables trimestrales suministrados,2015-01-01,0,1,20,16,0,37
MINEROS,"anticoncepcion, prevencion de its y de cancer de cuello uterino",numero de inyectables trimestrales suministrados,2015-01-01,0,2,20,11,0,33
MIZQUE,"anticoncepcion, prevencion de its y de cancer de cuello uterino",numero de inyectables trimestrales suministrados,2015-01-01,1,13,87,38,0,139
MOCOMOCO,"anticoncepcion, prevencion de its y de cancer de cuello uterino",numero de inyectables trimestrales suministrados,2015-01-01,0,4,11,12,0,27
MOJINETE,"anticoncepcion, prevencion de its y de cancer de cuello uterino",numero de inyectables trimestrales suministrados,2015-01-01,0,1,1,0,0,2
MOJOCOYA,"anticoncepcion, prevencion de its y de cancer de cuello uterino",numero de inyectables trimestrales suministrados,2015-01-01,0,0,42,25,0,67
MONTEAGUDO,"anticoncepcion, prevencion de its y de cancer de cuello uterino",numero de inyectables trimestrales suministrados,2015-01-01,1,12,71,45,1,130
MONTERO,"anticoncepcion, prevencion de its y de cancer de cuello uterino",numero de inyectables trimestrales suministrados,2015-01-01,0,48,162,40,0,250
MORO MORO,"anticoncepcion, prevencion de its y de cancer de cuello uterino",numero de inyectables trimestrales suministrados,2015-01-01,1,3,6,8,1,19
MOROCHATA,"anticoncepcion, prevencion de its y de cancer de cuello uterino",numero de inyectables trimestrales suministrados,2015-01-01,0,3,30,30,1,64
NACEBE (SANTA ROSA DEL ABUNA),"anticoncepcion, prevencion de its y de cancer de cuello uterino",numero de inyectables trimestrales suministrados,2015-01-01,1,3,9,0,0,13
NAZACARA DE PACAJES,"anticoncepcion, prevencion de its y de cancer de cuello uterino",numero de inyectables trimestrales suministrados,2015-01-01,0,0,0,1,0,1
NUEVO MANOA (NUEVA ESPERANZA),"anticoncepcion, prevencion de its y de cancer de cuello uterino",numero de inyectables trimestrales suministrados,2015-01-01,0,2,12,0,0,14
OCURI,"anticoncepcion, prevencion de its y de cancer de cuello uterino",numero de inyectables trimestrales suministrados,2015-01-01,0,1,25,18,0,44
OKINAWA,"anticoncepcion, prevencion de its y de cancer de cuello uterino",numero de inyectables trimestrales suministrados,2015-01-01,0,3,30,11,0,44
OMEREQUE,"anticoncepcion, prevencion de its y de cancer de cuello uterino",numero de inyectables trimestrales suministrados,2015-01-01,0,3,29,17,1,50
ORURO,"anticoncepcion, prevencion de its y de cancer de cuello uterino",numero de inyectables trimestrales suministrados,2015-01-01,0,38,490,169,0,697
PADCAYA,"anticoncepcion, prevencion de its y de cancer de cuello uterino",numero de inyectables trimestrales suministrados,2015-01-01,1,30,109,69,0,209
PADILLA,"anticoncepcion, prevencion de its y de cancer de cuello uterino",numero de inyectables trimestrales suministrados,2015-01-01,0,8,63,31,2,104
PAILON,"anticoncepcion, prevencion de its y de cancer de cuello uterino",numero de inyectables trimestrales suministrados,2015-01-01,1,7,32,17,0,57
PALCA,"anticoncepcion, prevencion de its y de cancer de cuello uterino",numero de inyectables trimestrales suministrados,2015-01-01,1,5,24,9,0,39
PALOS BLANCOS,"anticoncepcion, prevencion de its y de cancer de cuello uterino",numero de inyectables trimestrales suministrados,2015-01-01,0,7,69,40,0,116
PAMPA AULLAGAS,"anticoncepcion, prevencion de its y de cancer de cuello uterino",numero de inyectables trimestrales suministrados,2015-01-01,0,0,5,2,0,7
PAMPA GRANDE,"anticoncepcion, prevencion de its y de cancer de cuello uterino",numero de inyectables trimestrales suministrados,2015-01-01,0,8,29,10,4,51
PAPEL PAMPA,"anticoncepcion, prevencion de its y de cancer de cuello uterino",numero de inyectables trimestrales suministrados,2015-01-01,0,3,15,6,0,24
PASORAPA,"anticoncepcion, prevencion de its y de cancer de cuello uterino",numero de inyectables trimestrales suministrados,2015-01-01,0,2,15,10,0,27
PATACAMAYA,"anticoncepcion, prevencion de its y de cancer de cuello uterino",numero de inyectables trimestrales suministrados,2015-01-01,0,1,19,8,0,28
PAZÑA,"anticoncepcion, prevencion de its y de cancer de cuello uterino",numero de inyectables trimestrales suministrados,2015-01-01,0,1,25,7,0,33
PELECHUCO,"anticoncepcion, prevencion de its y de cancer de cuello uterino",numero de inyectables trimestrales suministrados,2015-01-01,0,3,12,13,0,28
POCOATA,"anticoncepcion, prevencion de its y de cancer de cuello uterino",numero de inyectables trimestrales suministrados,2015-01-01,0,1,42,19,0,62
POCONA,"anticoncepcion, prevencion de its y de cancer de cuello uterino",numero de inyectables trimestrales suministrados,2015-01-01,0,10,37,25,0,72
POJO (CBBA),"anticoncepcion, prevencion de its y de cancer de cuello uterino",numero de inyectables trimestrales suministrados,2015-01-01,0,11,50,34,0,95
POOPO,"anticoncepcion, prevencion de its y de cancer de cuello uterino",numero de inyectables trimestrales suministrados,2015-01-01,0,2,8,2,0,12
PORCO,"anticoncepcion, prevencion de its y de cancer de cuello uterino",numero de inyectables trimestrales suministrados,2015-01-01,0,6,35,9,0,50
POROMA,"anticoncepcion, prevencion de its y de cancer de cuello uterino",numero de inyectables trimestrales suministrados,2015-01-01,1,5,39,35,1,81
PORONGO,"anticoncepcion, prevencion de its y de cancer de cuello uterino",numero de inyectables trimestrales suministrados,2015-01-01,0,12,25,10,0,47
PORTACHUELO,"anticoncepcion, prevencion de its y de cancer de cuello uterino",numero de inyectables trimestrales suministrados,2015-01-01,0,9,46,12,0,67
PORVENIR,"anticoncepcion, prevencion de its y de cancer de cuello uterino",numero de inyectables trimestrales suministrados,2015-01-01,0,5,26,5,0,36
POSTRER VALLE,"anticoncepcion, prevencion de its y de cancer de cuello uterino",numero de inyectables trimestrales suministrados,2015-01-01,0,0,7,3,0,10
POTOSI,"anticoncepcion, prevencion de its y de cancer de cuello uterino",numero de inyectables trimestrales suministrados,2015-01-01,0,39,476,155,0,670
PRESTO,"anticoncepcion, prevencion de its y de cancer de cuello uterino",numero de inyectables trimestrales suministrados,2015-01-01,0,7,32,15,0,54
PUCARA,"anticoncepcion, prevencion de its y de cancer de cuello uterino",numero de inyectables trimestrales suministrados,2015-01-01,0,0,12,3,0,15
PUCARANI,"anticoncepcion, prevencion de its y de cancer de cuello uterino",numero de inyectables trimestrales suministrados,2015-01-01,0,7,75,31,1,114
PUERTO ACOSTA,"anticoncepcion, prevencion de its y de cancer de cuello uterino",numero de inyectables trimestrales suministrados,2015-01-01,0,2,7,1,0,10
PUERTO CARABUCO,"anticoncepcion, prevencion de its y de cancer de cuello uterino",numero de inyectables trimestrales suministrados,2015-01-01,0,0,22,10,0,32
PUERTO GONZALO MORENO,"anticoncepcion, prevencion de its y de cancer de cuello uterino",numero de inyectables trimestrales suministrados,2015-01-01,1,7,21,7,0,36
PUERTO PEREZ,"anticoncepcion, prevencion de its y de cancer de cuello uterino",numero de inyectables trimestrales suministrados,2015-01-01,0,0,11,7,0,18
PUERTO QUIJARRO,"anticoncepcion, prevencion de its y de cancer de cuello uterino",numero de inyectables trimestrales suministrados,2015-01-01,0,3,19,6,0,28
PUERTO RICO,"anticoncepcion, prevencion de its y de cancer de cuello uterino",numero de inyectables trimestrales suministrados,2015-01-01,0,18,32,5,0,55
PUERTO SILES,"anticoncepcion, prevencion de its y de cancer de cuello uterino",numero de inyectables trimestrales suministrados,2015-01-01,0,1,0,0,0,1
PUERTO SUAREZ,"anticoncepcion, prevencion de its y de cancer de cuello uterino",numero de inyectables trimestrales suministrados,2015-01-01,0,1,10,0,0,11
PUERTO VILLARROEL,"anticoncepcion, prevencion de its y de cancer de cuello uterino",numero de inyectables trimestrales suministrados,2015-01-01,2,13,78,28,0,121
PUNA,"anticoncepcion, prevencion de its y de cancer de cuello uterino",numero de inyectables trimestrales suministrados,2015-01-01,1,2,30,15,0,48
PUNATA,"anticoncepcion, prevencion de its y de cancer de cuello uterino",numero de inyectables trimestrales suministrados,2015-01-01,0,4,50,22,1,77
QUIABAYA,"anticoncepcion, prevencion de its y de cancer de cuello uterino",numero de inyectables trimestrales suministrados,2015-01-01,0,0,13,6,0,19
QUILLACOLLO,"anticoncepcion, prevencion de its y de cancer de cuello uterino",numero de inyectables trimestrales suministrados,2015-01-01,0,35,189,24,0,248
QUIME,"anticoncepcion, prevencion de its y de cancer de cuello uterino",numero de inyectables trimestrales suministrados,2015-01-01,0,3,37,0,0,40
QUIRUSILLAS,"anticoncepcion, prevencion de its y de cancer de cuello uterino",numero de inyectables trimestrales suministrados,2015-01-01,0,3,6,3,0,12
RAVELO,"anticoncepcion, prevencion de its y de cancer de cuello uterino",numero de inyectables trimestrales suministrados,2015-01-01,0,2,44,39,0,85
REYES,"anticoncepcion, prevencion de its y de cancer de cuello uterino",numero de inyectables trimestrales suministrados,2015-01-01,2,11,24,6,0,43
RIBERALTA,"anticoncepcion, prevencion de its y de cancer de cuello uterino",numero de inyectables trimestrales suministrados,2015-01-01,11,46,147,22,0,226
ROBORE,"anticoncepcion, prevencion de its y de cancer de cuello uterino",numero de inyectables trimestrales suministrados,2015-01-01,1,7,39,6,0,53
RURRENABAQUE,"anticoncepcion, prevencion de its y de cancer de cuello uterino",numero de inyectables trimestrales suministrados,2015-01-01,0,4,34,29,0,67
SABAYA,"anticoncepcion, prevencion de its y de cancer de cuello uterino",numero de inyectables trimestrales suministrados,2015-01-01,0,1,16,5,0,22
SACABA,"anticoncepcion, prevencion de its y de cancer de cuello uterino",numero de inyectables trimestrales suministrados,2015-01-01,0,22,165,38,0,225
SACABAMBA,"anticoncepcion, prevencion de its y de cancer de cuello uterino",numero de inyectables trimestrales suministrados,2015-01-01,0,2,7,10,0,19
SACACA,"anticoncepcion, prevencion de its y de cancer de cuello uterino",numero de inyectables trimestrales suministrados,2015-01-01,0,7,44,32,0,83
SAIPINA,"anticoncepcion, prevencion de its y de cancer de cuello uterino",numero de inyectables trimestrales suministrados,2015-01-01,0,5,18,12,0,35
SALINAS DE GARCI MENDOZA,"anticoncepcion, prevencion de its y de cancer de cuello uterino",numero de inyectables trimestrales suministrados,2015-01-01,0,3,23,9,0,35
SAMAIPATA,"anticoncepcion, prevencion de its y de cancer de cuello uterino",numero de inyectables trimestrales suministrados,2015-01-01,2,5,30,10,0,47
SAN AGUSTIN,"anticoncepcion, prevencion de its y de cancer de cuello uterino",numero de inyectables trimestrales suministrados,2015-01-01,0,0,5,1,0,6
SAN ANDRES,"anticoncepcion, prevencion de its y de cancer de cuello uterino",numero de inyectables trimestrales suministrados,2015-01-01,0,6,16,14,1,37
SAN ANDRES DE MACHACA,"anticoncepcion, prevencion de its y de cancer de cuello uterino",numero de inyectables trimestrales suministrados,2015-01-01,0,0,6,4,0,10
SAN ANTONIO DE ESMORUCO,"anticoncepcion, prevencion de its y de cancer de cuello uterino",numero de inyectables trimestrales suministrados,2015-01-01,0,2,3,1,0,6
SAN ANTONIO DE LOMERIO,"anticoncepcion, prevencion de its y de cancer de cuello uterino",numero de inyectables trimestrales suministrados,2015-01-01,0,5,36,35,1,77
SAN BENITO,"anticoncepcion, prevencion de its y de cancer de cuello uterino",numero de inyectables trimestrales suministrados,2015-01-01,0,2,21,11,0,34
SAN BORJA,"anticoncepcion, prevencion de its y de cancer de cuello uterino",numero de inyectables trimestrales suministrados,2015-01-01,0,21,99,34,0,154
SAN BUENA VENTURA,"anticoncepcion, prevencion de its y de cancer de cuello uterino",numero de inyectables trimestrales suministrados,2015-01-01,0,3,21,9,0,33
SAN CARLOS,"anticoncepcion, prevencion de its y de cancer de cuello uterino",numero de inyectables trimestrales suministrados,2015-01-01,0,9,41,18,0,68
SAN IGNACIO,"anticoncepcion, prevencion de its y de cancer de cuello uterino",numero de inyectables trimestrales suministrados,2015-01-01,0,23,94,26,0,143
SAN IGNACIO DE VELASCO,"anticoncepcion, prevencion de its y de cancer de cuello uterino",numero de inyectables trimestrales suministrados,2015-01-01,1,25,157,46,1,230
SAN JAVIER(BNI),"anticoncepcion, prevencion de its y de cancer de cuello uterino",numero de inyectables trimestrales suministrados,2015-01-01,0,0,7,3,0,10
SAN JAVIER(STC),"anticoncepcion, prevencion de its y de cancer de cuello uterino",numero de inyectables trimestrales suministrados,2015-01-01,0,11,15,10,0,36
SAN JOAQUIN,"anticoncepcion, prevencion de its y de cancer de cuello uterino",numero de inyectables trimestrales suministrados,2015-01-01,0,2,3,0,0,5
SAN JOSE DE CHIQUITOS,"anticoncepcion, prevencion de its y de cancer de cuello uterino",numero de inyectables trimestrales suministrados,2015-01-01,0,2,4,1,0,7
SAN JUAN DE YAPACANI,"anticoncepcion, prevencion de its y de cancer de cuello uterino",numero de inyectables trimestrales suministrados,2015-01-01,0,2,30,12,0,44
SAN JULIAN,"anticoncepcion, prevencion de its y de cancer de cuello uterino",numero de inyectables trimestrales suministrados,2015-01-01,0,20,128,47,0,195
SAN LORENZO(PND),"anticoncepcion, prevencion de its y de cancer de cuello uterino",numero de inyectables trimestrales suministrados,2015-01-01,5,7,20,2,0,34
SAN LORENZO(TJA),"anticoncepcion, prevencion de its y de cancer de cuello uterino",numero de inyectables trimestrales suministrados,2015-01-01,0,10,58,38,0,106
SAN LUCAS,"anticoncepcion, prevencion de its y de cancer de cuello uterino",numero de inyectables trimestrales suministrados,2015-01-01,1,8,64,47,0,120
SAN MATIAS,"anticoncepcion, prevencion de its y de cancer de cuello uterino",numero de inyectables trimestrales suministrados,2015-01-01,0,9,22,7,1,39
SAN MIGUEL DE VELASCO,"anticoncepcion, prevencion de its y de cancer de cuello uterino",numero de inyectables trimestrales suministrados,2015-01-01,3,10,69,31,2,115
SAN PABLO DE LIPEZ,"anticoncepcion, prevencion de its y de cancer de cuello uterino",numero de inyectables trimestrales suministrados,2015-01-01,0,0,6,2,0,8
SAN PEDRO,"anticoncepcion, prevencion de its y de cancer de cuello uterino",numero de inyectables trimestrales suministrados,2015-01-01,0,7,36,18,0,61
SAN PEDRO DE BUENA VISTA,"anticoncepcion, prevencion de its y de cancer de cuello uterino",numero de inyectables trimestrales suministrados,2015-01-01,0,3,46,22,0,71
SAN PEDRO DE CURAHUARA,"anticoncepcion, prevencion de its y de cancer de cuello uterino",numero de inyectables trimestrales suministrados,2015-01-01,0,3,5,8,0,16
SAN PEDRO DE QUEMES,"anticoncepcion, prevencion de its y de cancer de cuello uterino",numero de inyectables trimestrales suministrados,2015-01-01,0,0,1,0,0,1
SAN PEDRO DE TIQUINA,"anticoncepcion, prevencion de its y de cancer de cuello uterino",numero de inyectables trimestrales suministrados,2015-01-01,0,0,7,2,0,9
SAN PEDRO(PND),"anticoncepcion, prevencion de its y de cancer de cuello uterino",numero de inyectables trimestrales suministrados,2015-01-01,0,5,3,0,0,8
SAN RAFAEL,"anticoncepcion, prevencion de its y de cancer de cuello uterino",numero de inyectables trimestrales suministrados,2015-01-01,0,12,43,13,0,68
SAN RAMON BENI,"anticoncepcion, prevencion de its y de cancer de cuello uterino",numero de inyectables trimestrales suministrados,2015-01-01,0,0,9,0,0,9
SAN RAMON SCZ,"anticoncepcion, prevencion de its y de cancer de cuello uterino",numero de inyectables trimestrales suministrados,2015-01-01,0,19,28,7,0,54
SANTA ANA,"anticoncepcion, prevencion de its y de cancer de cuello uterino",numero de inyectables trimestrales suministrados,2015-01-01,1,6,36,8,0,51
SANTA CRUZ DE LA SIERRA,"anticoncepcion, prevencion de its y de cancer de cuello uterino",numero de inyectables trimestrales suministrados,2015-01-01,6,120,494,109,3,732
SANTA ROSA,"anticoncepcion, prevencion de its y de cancer de cuello uterino",numero de inyectables trimestrales suministrados,2015-01-01,0,4,9,4,0,17
SANTA ROSA DEL SARA,"anticoncepcion, prevencion de its y de cancer de cuello uterino",numero de inyectables trimestrales suministrados,2015-01-01,2,10,40,26,0,78
SANTIAGO DE CALLAPA,"anticoncepcion, prevencion de its y de cancer de cuello uterino",numero de inyectables trimestrales suministrados,2015-01-01,0,0,1,1,0,2
SANTIAGO DE HUARI,"anticoncepcion, prevencion de its y de cancer de cuello uterino",numero de inyectables trimestrales suministrados,2015-01-01,0,3,9,12,0,24
SANTIAGO DE HUATA,"anticoncepcion, prevencion de its y de cancer de cuello uterino",numero de inyectables trimestrales suministrados,2015-01-01,0,2,11,5,0,18
SANTIAGO DE MACHACA,"anticoncepcion, prevencion de its y de cancer de cuello uterino",numero de inyectables trimestrales suministrados,2015-01-01,0,1,4,2,0,7
SANTIVAÑES,"anticoncepcion, prevencion de its y de cancer de cuello uterino",numero de inyectables trimestrales suministrados,2015-01-01,3,2,21,4,0,30
SANTUARIO DE QUILLACAS,"anticoncepcion, prevencion de its y de cancer de cuello uterino",numero de inyectables trimestrales suministrados,2015-01-01,0,1,7,1,0,9
SAPAHAQUI,"anticoncepcion, prevencion de its y de cancer de cuello uterino",numero de inyectables trimestrales suministrados,2015-01-01,0,3,20,24,0,47
SENA,"anticoncepcion, prevencion de its y de cancer de cuello uterino",numero de inyectables trimestrales suministrados,2015-01-01,0,4,10,1,0,15
SHINAOTA,"anticoncepcion, prevencion de its y de cancer de cuello uterino",numero de inyectables trimestrales suministrados,2015-01-01,0,4,51,8,0,63
SICA SICA (VILLA AROMA),"anticoncepcion, prevencion de its y de cancer de cuello uterino",numero de inyectables trimestrales suministrados,2015-01-01,0,6,46,35,1,88
SICAYA,"anticoncepcion, prevencion de its y de cancer de cuello uterino",numero de inyectables trimestrales suministrados,2015-01-01,0,2,17,7,0,26
SIPE SIPE,"anticoncepcion, prevencion de its y de cancer de cuello uterino",numero de inyectables trimestrales suministrados,2015-01-01,0,20,178,73,0,271
SOPACHUY,"anticoncepcion, prevencion de its y de cancer de cuello uterino",numero de inyectables trimestrales suministrados,2015-01-01,0,5,31,22,0,58
SORACACHI,"anticoncepcion, prevencion de its y de cancer de cuello uterino",numero de inyectables trimestrales suministrados,2015-01-01,0,6,17,9,0,32
SORATA,"anticoncepcion, prevencion de its y de cancer de cuello uterino",numero de inyectables trimestrales suministrados,2015-01-01,0,2,49,21,0,72
SUCRE,"anticoncepcion, prevencion de its y de cancer de cuello uterino",numero de inyectables trimestrales suministrados,2015-01-01,1,68,517,195,2,783
TACACHI,"anticoncepcion, prevencion de its y de cancer de cuello uterino",numero de inyectables trimestrales suministrados,2015-01-01,0,0,2,3,0,5
TACACOMA,"anticoncepcion, prevencion de its y de cancer de cuello uterino",numero de inyectables trimestrales suministrados,2015-01-01,0,2,29,10,0,41
TACOBAMBA,"anticoncepcion, prevencion de its y de cancer de cuello uterino",numero de inyectables trimestrales suministrados,2015-01-01,0,1,12,11,0,24
TACOPAYA,"anticoncepcion, prevencion de its y de cancer de cuello uterino",numero de inyectables trimestrales suministrados,2015-01-01,2,2,12,7,0,23
TAPACARI,"anticoncepcion, prevencion de its y de cancer de cuello uterino",numero de inyectables trimestrales suministrados,2015-01-01,0,13,63,42,0,118
TARABUCO,"anticoncepcion, prevencion de its y de cancer de cuello uterino",numero de inyectables trimestrales suministrados,2015-01-01,0,5,44,22,1,72
TARACO,"anticoncepcion, prevencion de its y de cancer de cuello uterino",numero de inyectables trimestrales suministrados,2015-01-01,0,3,12,13,1,29
TARATA,"anticoncepcion, prevencion de its y de cancer de cuello uterino",numero de inyectables trimestrales suministrados,2015-01-01,0,6,34,14,0,54
TARIJA,"anticoncepcion, prevencion de its y de cancer de cuello uterino",numero de inyectables trimestrales suministrados,2015-01-01,3,63,282,95,4,447
TARVITA,"anticoncepcion, prevencion de its y de cancer de cuello uterino",numero de inyectables trimestrales suministrados,2015-01-01,0,4,35,28,0,67
TEOPONTE,"anticoncepcion, prevencion de its y de cancer de cuello uterino",numero de inyectables trimestrales suministrados,2015-01-01,0,3,17,8,0,28
TIAWANACU,"anticoncepcion, prevencion de its y de cancer de cuello uterino",numero de inyectables trimestrales suministrados,2015-01-01,0,6,41,19,0,66
TINGUIPAYA,"anticoncepcion, prevencion de its y de cancer de cuello uterino",numero de inyectables trimestrales suministrados,2015-01-01,0,1,14,15,0,30
TIPUANI,"anticoncepcion, prevencion de its y de cancer de cuello uterino",numero de inyectables trimestrales suministrados,2015-01-01,0,6,27,7,0,40
TIQUIPAYA,"anticoncepcion, prevencion de its y de cancer de cuello uterino",numero de inyectables trimestrales suministrados,2015-01-01,1,18,95,25,0,139
TIRAQUE (CBBA),"anticoncepcion, prevencion de its y de cancer de cuello uterino",numero de inyectables trimestrales suministrados,2015-01-01,0,8,56,43,1,108
TITO YUPANQUI (PARQUIPUJIO),"anticoncepcion, prevencion de its y de cancer de cuello uterino",numero de inyectables trimestrales suministrados,2015-01-01,0,0,2,2,0,4
TOCO,"anticoncepcion, prevencion de its y de cancer de cuello uterino",numero de inyectables trimestrales suministrados,2015-01-01,0,9,23,16,0,48
TODOS SANTOS,"anticoncepcion, prevencion de its y de cancer de cuello uterino",numero de inyectables trimestrales suministrados,2015-01-01,0,0,1,2,0,3
TOLATA,"anticoncepcion, prevencion de its y de cancer de cuello uterino",numero de inyectables trimestrales suministrados,2015-01-01,0,2,19,5,0,26
TOLEDO,"anticoncepcion, prevencion de its y de cancer de cuello uterino",numero de inyectables trimestrales suministrados,2015-01-01,0,0,1,2,0,3
TOMAVE,"anticoncepcion, prevencion de its y de cancer de cuello uterino",numero de inyectables trimestrales suministrados,2015-01-01,0,0,26,19,0,45
TOMINA,"anticoncepcion, prevencion de its y de cancer de cuello uterino",numero de inyectables trimestrales suministrados,2015-01-01,0,9,51,30,0,90
TORO TORO,"anticoncepcion, prevencion de its y de cancer de cuello uterino",numero de inyectables trimestrales suministrados,2015-01-01,0,8,31,9,0,48
TOTORA(CBBA),"anticoncepcion, prevencion de its y de cancer de cuello uterino",numero de inyectables trimestrales suministrados,2015-01-01,1,14,68,30,0,113
TOTORA(ORR),"anticoncepcion, prevencion de its y de cancer de cuello uterino",numero de inyectables trimestrales suministrados,2015-01-01,0,0,14,8,1,23
TRIGAL,"anticoncepcion, prevencion de its y de cancer de cuello uterino",numero de inyectables trimestrales suministrados,2015-01-01,0,1,6,2,0,9
TRINIDAD,"anticoncepcion, prevencion de its y de cancer de cuello uterino",numero de inyectables trimestrales suministrados,2015-01-01,2,22,65,17,0,106
TUPIZA,"anticoncepcion, prevencion de its y de cancer de cuello uterino",numero de inyectables trimestrales suministrados,2015-01-01,0,17,136,53,0,206
TURCO,"anticoncepcion, prevencion de its y de cancer de cuello uterino",numero de inyectables trimestrales suministrados,2015-01-01,0,2,13,6,0,21
UMALA,"anticoncepcion, prevencion de its y de cancer de cuello uterino",numero de inyectables trimestrales suministrados,2015-01-01,0,1,8,5,0,14
UNCIA,"anticoncepcion, prevencion de its y de cancer de cuello uterino",numero de inyectables trimestrales suministrados,2015-01-01,0,2,39,24,0,65
URIONDO (A. CONCEPCION),"anticoncepcion, prevencion de its y de cancer de cuello uterino",numero de inyectables trimestrales suministrados,2015-01-01,0,11,63,23,1,98
URUBICHA,"anticoncepcion, prevencion de its y de cancer de cuello uterino",numero de inyectables trimestrales suministrados,2015-01-01,0,1,9,7,0,17
UYUNI,"anticoncepcion, prevencion de its y de cancer de cuello uterino",numero de inyectables trimestrales suministrados,2015-01-01,0,4,35,7,0,46
VACAS,"anticoncepcion, prevencion de its y de cancer de cuello uterino",numero de inyectables trimestrales suministrados,2015-01-01,0,4,32,21,0,57
VALLEGRANDE,"anticoncepcion, prevencion de its y de cancer de cuello uterino",numero de inyectables trimestrales suministrados,2015-01-01,0,22,45,8,0,75
VIACHA,"anticoncepcion, prevencion de its y de cancer de cuello uterino",numero de inyectables trimestrales suministrados,2015-01-01,0,12,133,68,0,213
VILA VILA,"anticoncepcion, prevencion de its y de cancer de cuello uterino",numero de inyectables trimestrales suministrados,2015-01-01,0,0,3,2,0,5
VILLA CHARCAS,"anticoncepcion, prevencion de its y de cancer de cuello uterino",numero de inyectables trimestrales suministrados,2015-01-01,0,9,48,23,0,80
VILLA MONTES,"anticoncepcion, prevencion de its y de cancer de cuello uterino",numero de inyectables trimestrales suministrados,2015-01-01,2,17,110,24,0,153
VILLA NUEVA (LOMA ALTA),"anticoncepcion, prevencion de its y de cancer de cuello uterino",numero de inyectables trimestrales suministrados,2015-01-01,2,0,8,0,1,11
VILLA RIVERO,"anticoncepcion, prevencion de its y de cancer de cuello uterino",numero de inyectables trimestrales suministrados,2015-01-01,0,6,32,18,0,56
VILLA SERRANO,"anticoncepcion, prevencion de its y de cancer de cuello uterino",numero de inyectables trimestrales suministrados,2015-01-01,0,4,36,22,0,62
VILLA TUNARI,"anticoncepcion, prevencion de its y de cancer de cuello uterino",numero de inyectables trimestrales suministrados,2015-01-01,0,40,352,101,1,494
VILLA VACA GUZMAN (MUYUPAMPA),"anticoncepcion, prevencion de its y de cancer de cuello uterino",numero de inyectables trimestrales suministrados,2015-01-01,0,4,39,19,0,62
VILLAZON,"anticoncepcion, prevencion de its y de cancer de cuello uterino",numero de inyectables trimestrales suministrados,2015-01-01,0,12,127,43,0,182
VINTO,"anticoncepcion, prevencion de its y de cancer de cuello uterino",numero de inyectables trimestrales suministrados,2015-01-01,1,12,53,19,0,85
VITICHI,"anticoncepcion, prevencion de its y de cancer de cuello uterino",numero de inyectables trimestrales suministrados,2015-01-01,0,3,13,11,0,27
WALDO BALLIVIAN,"anticoncepcion, prevencion de its y de cancer de cuello uterino",numero de inyectables trimestrales suministrados,2015-01-01,0,0,0,3,0,3
WARNES,"anticoncepcion, prevencion de its y de cancer de cuello uterino",numero de inyectables trimestrales suministrados,2015-01-01,2,37,191,54,2,286
YACO,"anticoncepcion, prevencion de its y de cancer de cuello uterino",numero de inyectables trimestrales suministrados,2015-01-01,0,1,9,8,0,18
YACUIBA,"anticoncepcion, prevencion de its y de cancer de cuello uterino",numero de inyectables trimestrales suministrados,2015-01-01,1,37,192,127,2,359
YAMPARAEZ,"anticoncepcion, prevencion de its y de cancer de cuello uterino",numero de inyectables trimestrales suministrados,2015-01-01,0,1,9,14,0,24
YANACACHI,"anticoncepcion, prevencion de its y de cancer de cuello uterino",numero de inyectables trimestrales suministrados,2015-01-01,0,1,12,7,0,20
YAPACANI,"anticoncepcion, prevencion de its y de cancer de cuello uterino",numero de inyectables trimestrales suministrados,2015-01-01,0,15,72,23,0,110
YOCALLA,"anticoncepcion, prevencion de its y de cancer de cuello uterino",numero de inyectables trimestrales suministrados,2015-01-01,0,3,14,5,0,22
YOTALA,"anticoncepcion, prevencion de its y de cancer de cuello uterino",numero de inyectables trimestrales suministrados,2015-01-01,0,1,5,3,0,9
YUNCHARA,"anticoncepcion, prevencion de its y de cancer de cuello uterino",numero de inyectables trimestrales suministrados,2015-01-01,0,11,50,26,1,88
ZUDAÑEZ,"anticoncepcion, prevencion de its y de cancer de cuello uterino",numero de inyectables trimestrales suministrados,2015-01-01,0,3,34,21,0,58
ACACIO,"anticoncepcion, prevencion de its y de cancer de cuello uterino",numero de inyectables trimestrales suministrados,2015-02-01,0,2,12,8,0,22
ACHACACHI,"anticoncepcion, prevencion de its y de cancer de cuello uterino",numero de inyectables trimestrales suministrados,2015-02-01,0,6,59,37,0,102
ACHOCALLA,"anticoncepcion, prevencion de its y de cancer de cuello uterino",numero de inyectables trimestrales suministrados,2015-02-01,0,4,22,18,0,44
AIQUILE,"anticoncepcion, prevencion de its y de cancer de cuello uterino",numero de inyectables trimestrales suministrados,2015-02-01,0,5,27,20,0,52
ALALAY,"anticoncepcion, prevencion de its y de cancer de cuello uterino",numero de inyectables trimestrales suministrados,2015-02-01,0,2,4,4,0,10
ALCALA,"anticoncepcion, prevencion de its y de cancer de cuello uterino",numero de inyectables trimestrales suministrados,2015-02-01,0,5,16,9,0,30
ALTO BENI,"anticoncepcion, prevencion de its y de cancer de cuello uterino",numero de inyectables trimestrales suministrados,2015-02-01,0,5,22,8,0,35
ANCORAIMES,"anticoncepcion, prevencion de its y de cancer de cuello uterino",numero de inyectables trimestrales suministrados,2015-02-01,0,3,10,6,0,19
ANDAMARCA,"anticoncepcion, prevencion de its y de cancer de cuello uterino",numero de inyectables trimestrales suministrados,2015-02-01,0,1,2,5,0,8
ANTEQUERA,"anticoncepcion, prevencion de its y de cancer de cuello uterino",numero de inyectables trimestrales suministrados,2015-02-01,0,0,4,0,0,4
ANZALDO,"anticoncepcion, prevencion de its y de cancer de cuello uterino",numero de inyectables trimestrales suministrados,2015-02-01,0,0,4,2,0,6
APOLO,"anticoncepcion, prevencion de its y de cancer de cuello uterino",numero de inyectables trimestrales suministrados,2015-02-01,0,0,35,25,1,61
ARAMPAMPA,"anticoncepcion, prevencion de its y de cancer de cuello uterino",numero de inyectables trimestrales suministrados,2015-02-01,0,0,6,6,0,12
ARANI,"anticoncepcion, prevencion de its y de cancer de cuello uterino",numero de inyectables trimestrales suministrados,2015-02-01,0,3,18,0,0,21
ARBIETO,"anticoncepcion, prevencion de its y de cancer de cuello uterino",numero de inyectables trimestrales suministrados,2015-02-01,0,7,47,11,0,65
ARQUE,"anticoncepcion, prevencion de its y de cancer de cuello uterino",numero de inyectables trimestrales suministrados,2015-02-01,0,3,43,32,0,78
ASCENCION DE GUARAYOS,"anticoncepcion, prevencion de its y de cancer de cuello uterino",numero de inyectables trimestrales suministrados,2015-02-01,1,10,45,13,0,69
ATOCHA,"anticoncepcion, prevencion de its y de cancer de cuello uterino",numero de inyectables trimestrales suministrados,2015-02-01,0,1,27,12,0,40
AUCAPATA,"anticoncepcion, prevencion de its y de cancer de cuello uterino",numero de inyectables trimestrales suministrados,2015-02-01,0,2,13,7,0,22
AYATA,"anticoncepcion, prevencion de its y de cancer de cuello uterino",numero de inyectables trimestrales suministrados,2015-02-01,0,0,23,13,0,36
AYO AYO,"anticoncepcion, prevencion de its y de cancer de cuello uterino",numero de inyectables trimestrales suministrados,2015-02-01,0,3,18,10,0,31
AYOPAYA (V. DE INDEPENDENCIA),"anticoncepcion, prevencion de its y de cancer de cuello uterino",numero de inyectables trimestrales suministrados,2015-02-01,0,12,93,76,0,181
AZURDUY,"anticoncepcion, prevencion de its y de cancer de cuello uterino",numero de inyectables trimestrales suministrados,2015-02-01,0,14,55,24,0,93
BATALLAS,"anticoncepcion, prevencion de its y de cancer de cuello uterino",numero de inyectables trimestrales suministrados,2015-02-01,0,2,31,13,0,46
BAURES,"anticoncepcion, prevencion de its y de cancer de cuello uterino",numero de inyectables trimestrales suministrados,2015-02-01,0,1,0,5,0,6
BELEN DE ANDAMARCA,"anticoncepcion, prevencion de its y de cancer de cuello uterino",numero de inyectables trimestrales suministrados,2015-02-01,0,0,1,0,0,1
BELEN DE URMIRI,"anticoncepcion, prevencion de its y de cancer de cuello uterino",numero de inyectables trimestrales suministrados,2015-02-01,0,0,3,2,0,5
BELLA FLOR,"anticoncepcion, prevencion de its y de cancer de cuello uterino",numero de inyectables trimestrales suministrados,2015-02-01,0,4,5,4,0,13
BERMEJO,"anticoncepcion, prevencion de its y de cancer de cuello uterino",numero de inyectables trimestrales suministrados,2015-02-01,1,14,50,14,0,79
BETANZOS,"anticoncepcion, prevencion de its y de cancer de cuello uterino",numero de inyectables trimestrales suministrados,2015-02-01,0,2,37,31,0,70
BOLIVAR,"anticoncepcion, prevencion de its y de cancer de cuello uterino",numero de inyectables trimestrales suministrados,2015-02-01,0,0,14,9,0,23
BOLPEBRA,"anticoncepcion, prevencion de its y de cancer de cuello uterino",numero de inyectables trimestrales suministrados,2015-02-01,0,1,7,4,0,12
BOYUIBE,"anticoncepcion, prevencion de its y de cancer de cuello uterino",numero de inyectables trimestrales suministrados,2015-02-01,0,4,12,2,0,18
BUENA VISTA,"anticoncepcion, prevencion de its y de cancer de cuello uterino",numero de inyectables trimestrales suministrados,2015-02-01,0,8,25,12,0,45
CABEZAS,"anticoncepcion, prevencion de its y de cancer de cuello uterino",numero de inyectables trimestrales suministrados,2015-02-01,2,17,81,27,1,128
CAIROMA,"anticoncepcion, prevencion de its y de cancer de cuello uterino",numero de inyectables trimestrales suministrados,2015-02-01,0,0,25,13,0,38
"CAIZA ""D""","anticoncepcion, prevencion de its y de cancer de cuello uterino",numero de inyectables trimestrales suministrados,2015-02-01,0,1,18,9,0,28
CAJUATA,"anticoncepcion, prevencion de its y de cancer de cuello uterino",numero de inyectables trimestrales suministrados,2015-02-01,0,6,32,8,0,46
CALACOTO,"anticoncepcion, prevencion de its y de cancer de cuello uterino",numero de inyectables trimestrales suministrados,2015-02-01,0,0,3,3,0,6
CALAMARCA,"anticoncepcion, prevencion de its y de cancer de cuello uterino",numero de inyectables trimestrales suministrados,2015-02-01,0,6,39,17,0,62
CAMARGO,"anticoncepcion, prevencion de its y de cancer de cuello uterino",numero de inyectables trimestrales suministrados,2015-02-01,0,1,24,17,1,43
CAMATAQUI (C. VILLA ABECIA),"anticoncepcion, prevencion de its y de cancer de cuello uterino",numero de inyectables trimestrales suministrados,2015-02-01,0,2,9,8,0,19
CAMIRI,"anticoncepcion, prevencion de its y de cancer de cuello uterino",numero de inyectables trimestrales suministrados,2015-02-01,0,7,33,11,0,51
CAPINOTA,"anticoncepcion, prevencion de its y de cancer de cuello uterino",numero de inyectables trimestrales suministrados,2015-02-01,0,3,53,22,3,81
CAQUIAVIRI,"anticoncepcion, prevencion de its y de cancer de cuello uterino",numero de inyectables trimestrales suministrados,2015-02-01,0,3,20,8,0,31
CARACOLLO,"anticoncepcion, prevencion de its y de cancer de cuello uterino",numero de inyectables trimestrales suministrados,2015-02-01,0,2,37,32,0,71
CARANAVI,"anticoncepcion, prevencion de its y de cancer de cuello uterino",numero de inyectables trimestrales suministrados,2015-02-01,0,12,82,39,0,133
CARAPARI,"anticoncepcion, prevencion de its y de cancer de cuello uterino",numero de inyectables trimestrales suministrados,2015-02-01,0,6,53,28,0,87
CARIPUYO,"anticoncepcion, prevencion de its y de cancer de cuello uterino",numero de inyectables trimestrales suministrados,2015-02-01,0,1,6,9,0,16
CARMEN RIVERO TORREZ,"anticoncepcion, prevencion de its y de cancer de cuello uterino",numero de inyectables trimestrales suministrados,2015-02-01,0,1,6,5,0,12
CATACORA,"anticoncepcion, prevencion de its y de cancer de cuello uterino",numero de inyectables trimestrales suministrados,2015-02-01,0,0,5,0,0,5
CHACARILLA,"anticoncepcion, prevencion de its y de cancer de cuello uterino",numero de inyectables trimestrales suministrados,2015-02-01,0,0,8,1,0,9
CHALLAPATA,"anticoncepcion, prevencion de its y de cancer de cuello uterino",numero de inyectables trimestrales suministrados,2015-02-01,0,3,29,11,0,43
CHAQUI,"anticoncepcion, prevencion de its y de cancer de cuello uterino",numero de inyectables trimestrales suministrados,2015-02-01,0,3,16,12,0,31
CHARAGUA,"anticoncepcion, prevencion de its y de cancer de cuello uterino",numero de inyectables trimestrales suministrados,2015-02-01,1,4,33,13,0,51
CHARAÑA,"anticoncepcion, prevencion de its y de cancer de cuello uterino",numero de inyectables trimestrales suministrados,2015-02-01,0,1,4,1,0,6
CHAYANTA,"anticoncepcion, prevencion de its y de cancer de cuello uterino",numero de inyectables trimestrales suministrados,2015-02-01,0,2,36,9,0,47
CHIMORE,"anticoncepcion, prevencion de its y de cancer de cuello uterino",numero de inyectables trimestrales suministrados,2015-02-01,2,4,45,10,0,61
CHIPAYA,"anticoncepcion, prevencion de its y de cancer de cuello uterino",numero de inyectables trimestrales suministrados,2015-02-01,0,11,10,1,0,22
CHOQUE COTA,"anticoncepcion, prevencion de its y de cancer de cuello uterino",numero de inyectables trimestrales suministrados,2015-02-01,0,0,2,0,0,2
CHUA COCANI,"anticoncepcion, prevencion de its y de cancer de cuello uterino",numero de inyectables trimestrales suministrados,2015-02-01,0,0,4,3,0,7
CHULUMANI (V. DE LA LIBERTAD),"anticoncepcion, prevencion de its y de cancer de cuello uterino",numero de inyectables trimestrales suministrados,2015-02-01,0,2,40,13,0,55
CHUMA,"anticoncepcion, prevencion de its y de cancer de cuello uterino",numero de inyectables trimestrales suministrados,2015-02-01,0,2,23,8,0,33
CHUQUIHUTA AYLLU JUCUMANI,"anticoncepcion, prevencion de its y de cancer de cuello uterino",numero de inyectables trimestrales suministrados,2015-02-01,0,1,26,7,0,34
CKOCHAS,"anticoncepcion, prevencion de its y de cancer de cuello uterino",numero de inyectables trimestrales suministrados,2015-02-01,0,0,14,14,0,28
CLIZA,"anticoncepcion, prevencion de its y de cancer de cuello uterino",numero de inyectables trimestrales suministrados,2015-02-01,0,3,39,15,1,58
COBIJA,"anticoncepcion, prevencion de its y de cancer de cuello uterino",numero de inyectables trimestrales suministrados,2015-02-01,2,29,85,12,0,128
COCAPATA,"anticoncepcion, prevencion de its y de cancer de cuello uterino",numero de inyectables trimestrales suministrados,2015-02-01,0,8,41,15,0,64
COCHABAMBA,"anticoncepcion, prevencion de its y de cancer de cuello uterino",numero de inyectables trimestrales suministrados,2015-02-01,1,44,328,89,0,462
COIPASA,"anticoncepcion, prevencion de its y de cancer de cuello uterino",numero de inyectables trimestrales suministrados,2015-02-01,0,0,3,1,0,4
COLCAPIRHUA,"anticoncepcion, prevencion de its y de cancer de cuello uterino",numero de inyectables trimestrales suministrados,2015-02-01,0,5,52,11,0,68
"COLCHA ""K""","anticoncepcion, prevencion de its y de cancer de cuello uterino",numero de inyectables trimestrales suministrados,2015-02-01,0,8,49,18,1,76
COLLANA,"anticoncepcion, prevencion de its y de cancer de cuello uterino",numero de inyectables trimestrales suministrados,2015-02-01,0,1,4,2,0,7
COLOMI,"anticoncepcion, prevencion de its y de cancer de cuello uterino",numero de inyectables trimestrales suministrados,2015-02-01,0,13,61,21,0,95
COLPA BELGICA,"anticoncepcion, prevencion de its y de cancer de cuello uterino",numero de inyectables trimestrales suministrados,2015-02-01,0,4,11,4,0,19
COLQUECHACA,"anticoncepcion, prevencion de its y de cancer de cuello uterino",numero de inyectables trimestrales suministrados,2015-02-01,0,3,16,4,0,23
COLQUENCHA,"anticoncepcion, prevencion de its y de cancer de cuello uterino",numero de inyectables trimestrales suministrados,2015-02-01,0,2,25,13,0,40
COLQUIRI,"anticoncepcion, prevencion de its y de cancer de cuello uterino",numero de inyectables trimestrales suministrados,2015-02-01,0,0,26,15,0,41
COMANCHE,"anticoncepcion, prevencion de its y de cancer de cuello uterino",numero de inyectables trimestrales suministrados,2015-02-01,0,0,4,0,0,4
COMARAPA,"anticoncepcion, prevencion de its y de cancer de cuello uterino",numero de inyectables trimestrales suministrados,2015-02-01,0,12,55,27,1,95
CONCEPCION,"anticoncepcion, prevencion de its y de cancer de cuello uterino",numero de inyectables trimestrales suministrados,2015-02-01,0,8,42,5,0,55
COPACABANA,"anticoncepcion, prevencion de its y de cancer de cuello uterino",numero de inyectables trimestrales suministrados,2015-02-01,1,2,23,19,0,45
CORIPATA,"anticoncepcion, prevencion de its y de cancer de cuello uterino",numero de inyectables trimestrales suministrados,2015-02-01,0,1,42,15,0,58
CORO CORO,"anticoncepcion, prevencion de its y de cancer de cuello uterino",numero de inyectables trimestrales suministrados,2015-02-01,0,3,18,5,0,26
COROICO,"anticoncepcion, prevencion de its y de cancer de cuello uterino",numero de inyectables trimestrales suministrados,2015-02-01,0,0,9,1,0,10
CORQUE,"anticoncepcion, prevencion de its y de cancer de cuello uterino",numero de inyectables trimestrales suministrados,2015-02-01,0,0,8,6,0,14
COTAGAITA,"anticoncepcion, prevencion de its y de cancer de cuello uterino",numero de inyectables trimestrales suministrados,2015-02-01,0,10,53,39,0,102
COTOCA,"anticoncepcion, prevencion de its y de cancer de cuello uterino",numero de inyectables trimestrales suministrados,2015-02-01,0,11,80,20,0,111
CUATRO CAÑADAS,"anticoncepcion, prevencion de its y de cancer de cuello uterino",numero de inyectables trimestrales suministrados,2015-02-01,2,6,22,18,0,48
CUCHUMUELA (V. G. VILLARROEL),"anticoncepcion, prevencion de its y de cancer de cuello uterino",numero de inyectables trimestrales suministrados,2015-02-01,0,2,9,3,0,14
CUEVO,"anticoncepcion, prevencion de its y de cancer de cuello uterino",numero de inyectables trimestrales suministrados,2015-02-01,0,1,18,8,0,27
CULPINA,"anticoncepcion, prevencion de its y de cancer de cuello uterino",numero de inyectables trimestrales suministrados,2015-02-01,1,7,70,36,0,114
CURAHUARA DE CARANGAS,"anticoncepcion, prevencion de its y de cancer de cuello uterino",numero de inyectables trimestrales suministrados,2015-02-01,0,1,9,12,0,22
CURVA,"anticoncepcion, prevencion de its y de cancer de cuello uterino",numero de inyectables trimestrales suministrados,2015-02-01,0,0,5,1,0,6
DESAGUADERO,"anticoncepcion, prevencion de its y de cancer de cuello uterino",numero de inyectables trimestrales suministrados,2015-02-01,0,1,10,1,0,12
EL ALTO,"anticoncepcion, prevencion de its y de cancer de cuello uterino",numero de inyectables trimestrales suministrados,2015-02-01,0,96,1006,287,3,1392
EL CHORO,"anticoncepcion, prevencion de its y de cancer de cuello uterino",numero de inyectables trimestrales suministrados,2015-02-01,0,0,7,5,0,12
EL PUENTE(STC),"anticoncepcion, prevencion de its y de cancer de cuello uterino",numero de inyectables trimestrales suministrados,2015-02-01,1,11,42,7,0,61
EL PUENTE(TJA),"anticoncepcion, prevencion de its y de cancer de cuello uterino",numero de inyectables trimestrales suministrados,2015-02-01,0,5,67,35,1,108
EL TORNO,"anticoncepcion, prevencion de its y de cancer de cuello uterino",numero de inyectables trimestrales suministrados,2015-02-01,3,32,109,42,1,187
EL VILLAR,"anticoncepcion, prevencion de its y de cancer de cuello uterino",numero de inyectables trimestrales suministrados,2015-02-01,0,2,20,16,0,38
ENTRE RIOS TRJ,"anticoncepcion, prevencion de its y de cancer de cuello uterino",numero de inyectables trimestrales suministrados,2015-02-01,0,21,90,61,0,172
ENTRE RIOS CBBA,"anticoncepcion, prevencion de its y de cancer de cuello uterino",numero de inyectables trimestrales suministrados,2015-02-01,0,17,37,18,0,72
ESCOMA,"anticoncepcion, prevencion de its y de cancer de cuello uterino",numero de inyectables trimestrales suministrados,2015-02-01,0,0,2,0,0,2
ESMERALDA,"anticoncepcion, prevencion de its y de cancer de cuello uterino",numero de inyectables trimestrales suministrados,2015-02-01,0,0,2,0,0,2
EUCALIPTUS,"anticoncepcion, prevencion de its y de cancer de cuello uterino",numero de inyectables trimestrales suministrados,2015-02-01,0,0,1,1,0,2
EUREKA (SANTOS MERCADO),"anticoncepcion, prevencion de its y de cancer de cuello uterino",numero de inyectables trimestrales suministrados,2015-02-01,0,1,5,3,0,9
EXALTACION,"anticoncepcion, prevencion de its y de cancer de cuello uterino",numero de inyectables trimestrales suministrados,2015-02-01,0,0,1,0,0,1
FERNANDEZ ALONSO,"anticoncepcion, prevencion de its y de cancer de cuello uterino",numero de inyectables trimestrales suministrados,2015-02-01,0,21,87,60,0,168
FILADELFIA,"anticoncepcion, prevencion de its y de cancer de cuello uterino",numero de inyectables trimestrales suministrados,2015-02-01,0,5,12,3,0,20
GENERAL SAAVEDRA,"anticoncepcion, prevencion de its y de cancer de cuello uterino",numero de inyectables trimestrales suministrados,2015-02-01,1,4,52,18,0,75
GRAL. J.J. PEREZ (CHARAZANI),"anticoncepcion, prevencion de its y de cancer de cuello uterino",numero de inyectables trimestrales suministrados,2015-02-01,0,2,18,5,0,25
GUANAY,"anticoncepcion, prevencion de its y de cancer de cuello uterino",numero de inyectables trimestrales suministrados,2015-02-01,0,2,10,7,0,19
GUAQUI,"anticoncepcion, prevencion de its y de cancer de cuello uterino",numero de inyectables trimestrales suministrados,2015-02-01,0,1,10,10,0,21
GUAYARAMERIN,"anticoncepcion, prevencion de its y de cancer de cuello uterino",numero de inyectables trimestrales suministrados,2015-02-01,5,71,172,44,0,292
GUTIERREZ,"anticoncepcion, prevencion de its y de cancer de cuello uterino",numero de inyectables trimestrales suministrados,2015-02-01,0,3,15,5,0,23
HUACARETA,"anticoncepcion, prevencion de its y de cancer de cuello uterino",numero de inyectables trimestrales suministrados,2015-02-01,0,3,23,11,1,38
HUACAYA (VILLA DE HUACAYA),"anticoncepcion, prevencion de its y de cancer de cuello uterino",numero de inyectables trimestrales suministrados,2015-02-01,0,0,4,3,0,7
HUACHACALLA,"anticoncepcion, prevencion de its y de cancer de cuello uterino",numero de inyectables trimestrales suministrados,2015-02-01,0,0,2,0,0,2
HUANUNI,"anticoncepcion, prevencion de its y de cancer de cuello uterino",numero de inyectables trimestrales suministrados,2015-02-01,0,2,13,2,0,17
HUARACAJE,"anticoncepcion, prevencion de its y de cancer de cuello uterino",numero de inyectables trimestrales suministrados,2015-02-01,0,0,12,4,0,16
HUARINA,"anticoncepcion, prevencion de its y de cancer de cuello uterino",numero de inyectables trimestrales suministrados,2015-02-01,0,0,9,8,0,17
HUATAJATA,"anticoncepcion, prevencion de its y de cancer de cuello uterino",numero de inyectables trimestrales suministrados,2015-02-01,0,1,2,4,0,7
HUAYLLAMARCA,"anticoncepcion, prevencion de its y de cancer de cuello uterino",numero de inyectables trimestrales suministrados,2015-02-01,0,1,9,7,0,17
HUMANATA,"anticoncepcion, prevencion de its y de cancer de cuello uterino",numero de inyectables trimestrales suministrados,2015-02-01,0,0,8,5,0,13
ICHOCA,"anticoncepcion, prevencion de its y de cancer de cuello uterino",numero de inyectables trimestrales suministrados,2015-02-01,0,1,2,5,0,8
ICLA,"anticoncepcion, prevencion de its y de cancer de cuello uterino",numero de inyectables trimestrales suministrados,2015-02-01,0,5,22,22,0,49
INCAHUASI,"anticoncepcion, prevencion de its y de cancer de cuello uterino",numero de inyectables trimestrales suministrados,2015-02-01,0,5,30,21,1,57
INGAVI (HUMAITA),"anticoncepcion, prevencion de its y de cancer de cuello uterino",numero de inyectables trimestrales suministrados,2015-02-01,0,0,6,0,0,6
INQUISIVI,"anticoncepcion, prevencion de its y de cancer de cuello uterino",numero de inyectables trimestrales suministrados,2015-02-01,0,2,15,9,0,26
IRUPANA (VILLA DE LANZA),"anticoncepcion, prevencion de its y de cancer de cuello uterino",numero de inyectables trimestrales suministrados,2015-02-01,0,7,33,11,0,51
IXIAMAS,"anticoncepcion, prevencion de its y de cancer de cuello uterino",numero de inyectables trimestrales suministrados,2015-02-01,0,3,22,4,0,29
JESUS DE MACHACA,"anticoncepcion, prevencion de its y de cancer de cuello uterino",numero de inyectables trimestrales suministrados,2015-02-01,0,0,15,15,0,30
LA ASUNTA,"anticoncepcion, prevencion de its y de cancer de cuello uterino",numero de inyectables trimestrales suministrados,2015-02-01,0,6,109,39,0,154
LA GUARDIA,"anticoncepcion, prevencion de its y de cancer de cuello uterino",numero de inyectables trimestrales suministrados,2015-02-01,0,32,74,36,0,142
LA PAZ,"anticoncepcion, prevencion de its y de cancer de cuello uterino",numero de inyectables trimestrales suministrados,2015-02-01,7,62,457,92,0,618
LA RIVERA,"anticoncepcion, prevencion de its y de cancer de cuello uterino",numero de inyectables trimestrales suministrados,2015-02-01,0,0,1,0,0,1
LAGUNILLAS,"anticoncepcion, prevencion de its y de cancer de cuello uterino",numero de inyectables trimestrales suministrados,2015-02-01,0,1,7,4,0,12
LAJA,"anticoncepcion, prevencion de its y de cancer de cuello uterino",numero de inyectables trimestrales suministrados,2015-02-01,0,2,23,14,0,39
LAS CARRERAS,"anticoncepcion, prevencion de its y de cancer de cuello uterino",numero de inyectables trimestrales suministrados,2015-02-01,0,2,18,9,0,29
LICOMA PAMPA,"anticoncepcion, prevencion de its y de cancer de cuello uterino",numero de inyectables trimestrales suministrados,2015-02-01,0,2,9,6,0,17
LLALLAGUA,"anticoncepcion, prevencion de its y de cancer de cuello uterino",numero de inyectables trimestrales suministrados,2015-02-01,0,3,59,22,1,85
LLICA,"anticoncepcion, prevencion de its y de cancer de cuello uterino",numero de inyectables trimestrales suministrados,2015-02-01,0,3,23,4,0,30
LORETO,"anticoncepcion, prevencion de its y de cancer de cuello uterino",numero de inyectables trimestrales suministrados,2015-02-01,0,6,28,1,0,35
LURIBAY,"anticoncepcion, prevencion de its y de cancer de cuello uterino",numero de inyectables trimestrales suministrados,2015-02-01,0,3,25,23,0,51
MACHACAMARCA,"anticoncepcion, prevencion de its y de cancer de cuello uterino",numero de inyectables trimestrales suministrados,2015-02-01,0,0,5,2,0,7
MACHARETI,"anticoncepcion, prevencion de its y de cancer de cuello uterino",numero de inyectables trimestrales suministrados,2015-02-01,0,9,28,19,0,56
MAGDALENA,"anticoncepcion, prevencion de its y de cancer de cuello uterino",numero de inyectables trimestrales suministrados,2015-02-01,0,7,32,12,0,51
MAIRANA,"anticoncepcion, prevencion de its y de cancer de cuello uterino",numero de inyectables trimestrales suministrados,2015-02-01,0,5,27,8,0,40
MALLA,"anticoncepcion, prevencion de its y de cancer de cuello uterino",numero de inyectables trimestrales suministrados,2015-02-01,0,0,6,2,0,8
MAPIRI,"anticoncepcion, prevencion de its y de cancer de cuello uterino",numero de inyectables trimestrales suministrados,2015-02-01,0,0,10,7,0,17
MECAPACA,"anticoncepcion, prevencion de its y de cancer de cuello uterino",numero de inyectables trimestrales suministrados,2015-02-01,0,4,18,10,0,32
MINEROS,"anticoncepcion, prevencion de its y de cancer de cuello uterino",numero de inyectables trimestrales suministrados,2015-02-01,0,9,28,12,0,49
MIZQUE,"anticoncepcion, prevencion de its y de cancer de cuello uterino",numero de inyectables trimestrales suministrados,2015-02-01,1,12,82,37,0,132
MOCOMOCO,"anticoncepcion, prevencion de its y de cancer de cuello uterino",numero de inyectables trimestrales suministrados,2015-02-01,0,2,21,5,0,28
MOJINETE,"anticoncepcion, prevencion de its y de cancer de cuello uterino",numero de inyectables trimestrales suministrados,2015-02-01,0,0,2,3,0,5
MOJOCOYA,"anticoncepcion, prevencion de its y de cancer de cuello uterino",numero de inyectables trimestrales suministrados,2015-02-01,0,3,21,21,2,47
MONTEAGUDO,"anticoncepcion, prevencion de its y de cancer de cuello uterino",numero de inyectables trimestrales suministrados,2015-02-01,0,11,56,50,1,118
MONTERO,"anticoncepcion, prevencion de its y de cancer de cuello uterino",numero de inyectables trimestrales suministrados,2015-02-01,0,45,150,36,1,232
MORO MORO,"anticoncepcion, prevencion de its y de cancer de cuello uterino",numero de inyectables trimestrales suministrados,2015-02-01,0,3,17,9,0,29
MOROCHATA,"anticoncepcion, prevencion de its y de cancer de cuello uterino",numero de inyectables trimestrales suministrados,2015-02-01,0,3,46,30,1,80
NACEBE (SANTA ROSA DEL ABUNA),"anticoncepcion, prevencion de its y de cancer de cuello uterino",numero de inyectables trimestrales suministrados,2015-02-01,0,7,20,1,0,28
NUEVO MANOA (NUEVA ESPERANZA),"anticoncepcion, prevencion de its y de cancer de cuello uterino",numero de inyectables trimestrales suministrados,2015-02-01,0,1,8,2,0,11
OCURI,"anticoncepcion, prevencion de its y de cancer de cuello uterino",numero de inyectables trimestrales suministrados,2015-02-01,0,1,17,4,0,22
OKINAWA,"anticoncepcion, prevencion de its y de cancer de cuello uterino",numero de inyectables trimestrales suministrados,2015-02-01,0,7,23,17,0,47
OMEREQUE,"anticoncepcion, prevencion de its y de cancer de cuello uterino",numero de inyectables trimestrales suministrados,2015-02-01,0,6,25,25,1,57
ORURO,"anticoncepcion, prevencion de its y de cancer de cuello uterino",numero de inyectables trimestrales suministrados,2015-02-01,1,37,354,108,1,501
PADCAYA,"anticoncepcion, prevencion de its y de cancer de cuello uterino",numero de inyectables trimestrales suministrados,2015-02-01,0,15,96,58,4,173
PADILLA,"anticoncepcion, prevencion de its y de cancer de cuello uterino",numero de inyectables trimestrales suministrados,2015-02-01,0,3,49,20,1,73
PAILON,"anticoncepcion, prevencion de its y de cancer de cuello uterino",numero de inyectables trimestrales suministrados,2015-02-01,1,4,34,5,0,44
PALCA,"anticoncepcion, prevencion de its y de cancer de cuello uterino",numero de inyectables trimestrales suministrados,2015-02-01,1,4,15,5,0,25
PALOS BLANCOS,"anticoncepcion, prevencion de its y de cancer de cuello uterino",numero de inyectables trimestrales suministrados,2015-02-01,1,9,43,33,0,86
PAMPA AULLAGAS,"anticoncepcion, prevencion de its y de cancer de cuello uterino",numero de inyectables trimestrales suministrados,2015-02-01,0,0,1,5,0,6
PAMPA GRANDE,"anticoncepcion, prevencion de its y de cancer de cuello uterino",numero de inyectables trimestrales suministrados,2015-02-01,0,7,22,19,0,48
PAPEL PAMPA,"anticoncepcion, prevencion de its y de cancer de cuello uterino",numero de inyectables trimestrales suministrados,2015-02-01,0,4,15,10,0,29
PASORAPA,"anticoncepcion, prevencion de its y de cancer de cuello uterino",numero de inyectables trimestrales suministrados,2015-02-01,0,0,11,10,1,22
PATACAMAYA,"anticoncepcion, prevencion de its y de cancer de cuello uterino",numero de inyectables trimestrales suministrados,2015-02-01,0,1,20,6,0,27
PAZÑA,"anticoncepcion, prevencion de its y de cancer de cuello uterino",numero de inyectables trimestrales suministrados,2015-02-01,0,1,17,7,0,25
PELECHUCO,"anticoncepcion, prevencion de its y de cancer de cuello uterino",numero de inyectables trimestrales suministrados,2015-02-01,0,4,22,9,0,35
POCOATA,"anticoncepcion, prevencion de its y de cancer de cuello uterino",numero de inyectables trimestrales suministrados,2015-02-01,0,0,27,22,0,49
POCONA,"anticoncepcion, prevencion de its y de cancer de cuello uterino",numero de inyectables trimestrales suministrados,2015-02-01,0,6,49,23,1,79
POJO (CBBA),"anticoncepcion, prevencion de its y de cancer de cuello uterino",numero de inyectables trimestrales suministrados,2015-02-01,2,13,52,28,1,96
POOPO,"anticoncepcion, prevencion de its y de cancer de cuello uterino",numero de inyectables trimestrales suministrados,2015-02-01,0,1,7,7,0,15
PORCO,"anticoncepcion, prevencion de its y de cancer de cuello uterino",numero de inyectables trimestrales suministrados,2015-02-01,0,0,18,4,0,22
POROMA,"anticoncepcion, prevencion de its y de cancer de cuello uterino",numero de inyectables trimestrales suministrados,2015-02-01,1,6,32,30,0,69
PORONGO,"anticoncepcion, prevencion de its y de cancer de cuello uterino",numero de inyectables trimestrales suministrados,2015-02-01,1,4,23,9,1,38
PORTACHUELO,"anticoncepcion, prevencion de its y de cancer de cuello uterino",numero de inyectables trimestrales suministrados,2015-02-01,0,8,25,7,0,40
PORVENIR,"anticoncepcion, prevencion de its y de cancer de cuello uterino",numero de inyectables trimestrales suministrados,2015-02-01,0,5,17,3,0,25
POSTRER VALLE,"anticoncepcion, prevencion de its y de cancer de cuello uterino",numero de inyectables trimestrales suministrados,2015-02-01,0,1,4,2,0,7
POTOSI,"anticoncepcion, prevencion de its y de cancer de cuello uterino",numero de inyectables trimestrales suministrados,2015-02-01,0,38,405,101,1,545
PRESTO,"anticoncepcion, prevencion de its y de cancer de cuello uterino",numero de inyectables trimestrales suministrados,2015-02-01,0,3,27,18,0,48
PUCARA,"anticoncepcion, prevencion de its y de cancer de cuello uterino",numero de inyectables trimestrales suministrados,2015-02-01,0,0,9,9,0,18
PUCARANI,"anticoncepcion, prevencion de its y de cancer de cuello uterino",numero de inyectables trimestrales suministrados,2015-02-01,0,7,76,40,1,124
PUERTO ACOSTA,"anticoncepcion, prevencion de its y de cancer de cuello uterino",numero de inyectables trimestrales suministrados,2015-02-01,0,0,16,8,0,24
PUERTO CARABUCO,"anticoncepcion, prevencion de its y de cancer de cuello uterino",numero de inyectables trimestrales suministrados,2015-02-01,0,0,21,15,0,36
PUERTO GONZALO MORENO,"anticoncepcion, prevencion de its y de cancer de cuello uterino",numero de inyectables trimestrales suministrados,2015-02-01,1,5,19,5,0,30
PUERTO PEREZ,"anticoncepcion, prevencion de its y de cancer de cuello uterino",numero de inyectables trimestrales suministrados,2015-02-01,0,0,5,7,0,12
PUERTO QUIJARRO,"anticoncepcion, prevencion de its y de cancer de cuello uterino",numero de inyectables trimestrales suministrados,2015-02-01,0,0,6,9,0,15
PUERTO RICO,"anticoncepcion, prevencion de its y de cancer de cuello uterino",numero de inyectables trimestrales suministrados,2015-02-01,0,5,22,4,0,31
PUERTO SILES,"anticoncepcion, prevencion de its y de cancer de cuello uterino",numero de inyectables trimestrales suministrados,2015-02-01,0,2,1,0,0,3
PUERTO VILLARROEL,"anticoncepcion, prevencion de its y de cancer de cuello uterino",numero de inyectables trimestrales suministrados,2015-02-01,0,7,103,29,1,140
PUNA,"anticoncepcion, prevencion de its y de cancer de cuello uterino",numero de inyectables trimestrales suministrados,2015-02-01,0,1,40,20,0,61
PUNATA,"anticoncepcion, prevencion de its y de cancer de cuello uterino",numero de inyectables trimestrales suministrados,2015-02-01,0,3,39,10,0,52
QUIABAYA,"anticoncepcion, prevencion de its y de cancer de cuello uterino",numero de inyectables trimestrales suministrados,2015-02-01,0,2,5,11,1,19
QUILLACOLLO,"anticoncepcion, prevencion de its y de cancer de cuello uterino",numero de inyectables trimestrales suministrados,2015-02-01,0,36,156,19,0,211
QUIME,"anticoncepcion, prevencion de its y de cancer de cuello uterino",numero de inyectables trimestrales suministrados,2015-02-01,0,6,22,8,0,36
QUIRUSILLAS,"anticoncepcion, prevencion de its y de cancer de cuello uterino",numero de inyectables trimestrales suministrados,2015-02-01,0,3,9,5,0,17
RAVELO,"anticoncepcion, prevencion de its y de cancer de cuello uterino",numero de inyectables trimestrales suministrados,2015-02-01,0,1,41,34,2,78
REYES,"anticoncepcion, prevencion de its y de cancer de cuello uterino",numero de inyectables trimestrales suministrados,2015-02-01,2,4,28,5,0,39
RIBERALTA,"anticoncepcion, prevencion de its y de cancer de cuello uterino",numero de inyectables trimestrales suministrados,2015-02-01,5,40,141,39,0,225
ROBORE,"anticoncepcion, prevencion de its y de cancer de cuello uterino",numero de inyectables trimestrales suministrados,2015-02-01,0,1,27,15,0,43
RURRENABAQUE,"anticoncepcion, prevencion de its y de cancer de cuello uterino",numero de inyectables trimestrales suministrados,2015-02-01,1,1,26,7,0,35
SABAYA,"anticoncepcion, prevencion de its y de cancer de cuello uterino",numero de inyectables trimestrales suministrados,2015-02-01,0,0,6,2,0,8
SACABA,"anticoncepcion, prevencion de its y de cancer de cuello uterino",numero de inyectables trimestrales suministrados,2015-02-01,1,21,140,44,0,206
SACABAMBA,"anticoncepcion, prevencion de its y de cancer de cuello uterino",numero de inyectables trimestrales suministrados,2015-02-01,0,0,3,2,0,5
SACACA,"anticoncepcion, prevencion de its y de cancer de cuello uterino",numero de inyectables trimestrales suministrados,2015-02-01,0,6,40,21,0,67
SAIPINA,"anticoncepcion, prevencion de its y de cancer de cuello uterino",numero de inyectables trimestrales suministrados,2015-02-01,0,8,19,7,0,34
SALINAS DE GARCI MENDOZA,"anticoncepcion, prevencion de its y de cancer de cuello uterino",numero de inyectables trimestrales suministrados,2015-02-01,0,1,14,8,0,23
SAMAIPATA,"anticoncepcion, prevencion de its y de cancer de cuello uterino",numero de inyectables trimestrales suministrados,2015-02-01,0,6,24,7,0,37
SAN AGUSTIN,"anticoncepcion, prevencion de its y de cancer de cuello uterino",numero de inyectables trimestrales suministrados,2015-02-01,0,1,3,1,0,5
SAN ANDRES,"anticoncepcion, prevencion de its y de cancer de cuello uterino",numero de inyectables trimestrales suministrados,2015-02-01,0,9,34,9,0,52
SAN ANDRES DE MACHACA,"anticoncepcion, prevencion de its y de cancer de cuello uterino",numero de inyectables trimestrales suministrados,2015-02-01,0,0,6,2,0,8
SAN ANTONIO DE ESMORUCO,"anticoncepcion, prevencion de its y de cancer de cuello uterino",numero de inyectables trimestrales suministrados,2015-02-01,0,2,8,0,0,10
SAN ANTONIO DE LOMERIO,"anticoncepcion, prevencion de its y de cancer de cuello uterino",numero de inyectables trimestrales suministrados,2015-02-01,0,4,45,24,2,75
SAN BENITO,"anticoncepcion, prevencion de its y de cancer de cuello uterino",numero de inyectables trimestrales suministrados,2015-02-01,0,3,23,11,0,37
SAN BORJA,"anticoncepcion, prevencion de its y de cancer de cuello uterino",numero de inyectables trimestrales suministrados,2015-02-01,1,9,93,23,0,126
SAN BUENA VENTURA,"anticoncepcion, prevencion de its y de cancer de cuello uterino",numero de inyectables trimestrales suministrados,2015-02-01,0,1,23,7,0,31
SAN CARLOS,"anticoncepcion, prevencion de its y de cancer de cuello uterino",numero de inyectables trimestrales suministrados,2015-02-01,0,3,43,23,0,69
SAN IGNACIO,"anticoncepcion, prevencion de its y de cancer de cuello uterino",numero de inyectables trimestrales suministrados,2015-02-01,1,8,59,15,0,83
SAN IGNACIO DE VELASCO,"anticoncepcion, prevencion de its y de cancer de cuello uterino",numero de inyectables trimestrales suministrados,2015-02-01,1,16,129,34,0,180
SAN JAVIER(BNI),"anticoncepcion, prevencion de its y de cancer de cuello uterino",numero de inyectables trimestrales suministrados,2015-02-01,0,0,10,3,0,13
SAN JAVIER(STC),"anticoncepcion, prevencion de its y de cancer de cuello uterino",numero de inyectables trimestrales suministrados,2015-02-01,0,5,19,2,0,26
SAN JOAQUIN,"anticoncepcion, prevencion de its y de cancer de cuello uterino",numero de inyectables trimestrales suministrados,2015-02-01,0,0,1,0,0,1
SAN JOSE DE CHIQUITOS,"anticoncepcion, prevencion de its y de cancer de cuello uterino",numero de inyectables trimestrales suministrados,2015-02-01,0,6,20,8,0,34
SAN JUAN DE YAPACANI,"anticoncepcion, prevencion de its y de cancer de cuello uterino",numero de inyectables trimestrales suministrados,2015-02-01,0,3,24,13,0,40
SAN JULIAN,"anticoncepcion, prevencion de its y de cancer de cuello uterino",numero de inyectables trimestrales suministrados,2015-02-01,1,21,75,45,0,142
SAN LORENZO(PND),"anticoncepcion, prevencion de its y de cancer de cuello uterino",numero de inyectables trimestrales suministrados,2015-02-01,0,2,10,8,0,20
SAN LORENZO(TJA),"anticoncepcion, prevencion de its y de cancer de cuello uterino",numero de inyectables trimestrales suministrados,2015-02-01,0,18,70,34,0,122
SAN LUCAS,"anticoncepcion, prevencion de its y de cancer de cuello uterino",numero de inyectables trimestrales suministrados,2015-02-01,1,11,69,41,0,122
SAN MATIAS,"anticoncepcion, prevencion de its y de cancer de cuello uterino",numero de inyectables trimestrales suministrados,2015-02-01,0,4,26,11,0,41
SAN MIGUEL DE VELASCO,"anticoncepcion, prevencion de its y de cancer de cuello uterino",numero de inyectables trimestrales suministrados,2015-02-01,0,7,36,20,0,63
SAN PABLO DE LIPEZ,"anticoncepcion, prevencion de its y de cancer de cuello uterino",numero de inyectables trimestrales suministrados,2015-02-01,0,0,3,2,0,5
SAN PEDRO,"anticoncepcion, prevencion de its y de cancer de cuello uterino",numero de inyectables trimestrales suministrados,2015-02-01,0,7,30,18,0,55
SAN PEDRO DE BUENA VISTA,"anticoncepcion, prevencion de its y de cancer de cuello uterino",numero de inyectables trimestrales suministrados,2015-02-01,0,3,17,15,0,35
SAN PEDRO DE CURAHUARA,"anticoncepcion, prevencion de its y de cancer de cuello uterino",numero de inyectables trimestrales suministrados,2015-02-01,0,2,5,6,0,13
SAN PEDRO DE QUEMES,"anticoncepcion, prevencion de its y de cancer de cuello uterino",numero de inyectables trimestrales suministrados,2015-02-01,0,0,2,1,0,3
SAN PEDRO DE TIQUINA,"anticoncepcion, prevencion de its y de cancer de cuello uterino",numero de inyectables trimestrales suministrados,2015-02-01,0,0,12,5,0,17
SAN PEDRO(PND),"anticoncepcion, prevencion de its y de cancer de cuello uterino",numero de inyectables trimestrales suministrados,2015-02-01,0,2,6,1,0,9
SAN RAFAEL,"anticoncepcion, prevencion de its y de cancer de cuello uterino",numero de inyectables trimestrales suministrados,2015-02-01,1,5,32,9,1,48
SAN RAMON BENI,"anticoncepcion, prevencion de its y de cancer de cuello uterino",numero de inyectables trimestrales suministrados,2015-02-01,0,4,7,1,0,12
SANTA ANA,"anticoncepcion, prevencion de its y de cancer de cuello uterino",numero de inyectables trimestrales suministrados,2015-02-01,0,2,21,5,0,28
SANTA CRUZ DE LA SIERRA,"anticoncepcion, prevencion de its y de cancer de cuello uterino",numero de inyectables trimestrales suministrados,2015-02-01,4,92,421,60,1,578
SANTA ROSA,"anticoncepcion, prevencion de its y de cancer de cuello uterino",numero de inyectables trimestrales suministrados,2015-02-01,0,4,20,4,0,28
SANTA ROSA DEL SARA,"anticoncepcion, prevencion de its y de cancer de cuello uterino",numero de inyectables trimestrales suministrados,2015-02-01,0,7,43,27,0,77
SANTIAGO DE CALLAPA,"anticoncepcion, prevencion de its y de cancer de cuello uterino",numero de inyectables trimestrales suministrados,2015-02-01,0,0,1,2,0,3
SANTIAGO DE HUARI,"anticoncepcion, prevencion de its y de cancer de cuello uterino",numero de inyectables trimestrales suministrados,2015-02-01,0,1,18,8,0,27
SANTIAGO DE HUATA,"anticoncepcion, prevencion de its y de cancer de cuello uterino",numero de inyectables trimestrales suministrados,2015-02-01,0,1,4,3,0,8
SANTIAGO DE MACHACA,"anticoncepcion, prevencion de its y de cancer de cuello uterino",numero de inyectables trimestrales suministrados,2015-02-01,0,1,6,7,0,14
SANTIVAÑES,"anticoncepcion, prevencion de its y de cancer de cuello uterino",numero de inyectables trimestrales suministrados,2015-02-01,0,2,26,4,0,32
SANTUARIO DE QUILLACAS,"anticoncepcion, prevencion de its y de cancer de cuello uterino",numero de inyectables trimestrales suministrados,2015-02-01,0,2,6,0,0,8
SAPAHAQUI,"anticoncepcion, prevencion de its y de cancer de cuello uterino",numero de inyectables trimestrales suministrados,2015-02-01,0,1,22,10,0,33
SENA,"anticoncepcion, prevencion de its y de cancer de cuello uterino",numero de inyectables trimestrales suministrados,2015-02-01,0,0,7,0,0,7
SHINAOTA,"anticoncepcion, prevencion de its y de cancer de cuello uterino",numero de inyectables trimestrales suministrados,2015-02-01,0,4,36,14,0,54
SICA SICA (VILLA AROMA),"anticoncepcion, prevencion de its y de cancer de cuello uterino",numero de inyectables trimestrales suministrados,2015-02-01,0,2,43,24,2,71
SICAYA,"anticoncepcion, prevencion de its y de cancer de cuello uterino",numero de inyectables trimestrales suministrados,2015-02-01,0,0,11,6,0,17
SIPE SIPE,"anticoncepcion, prevencion de its y de cancer de cuello uterino",numero de inyectables trimestrales suministrados,2015-02-01,1,18,147,63,1,230
SOPACHUY,"anticoncepcion, prevencion de its y de cancer de cuello uterino",numero de inyectables trimestrales suministrados,2015-02-01,0,5,33,13,0,51
SORACACHI,"anticoncepcion, prevencion de its y de cancer de cuello uterino",numero de inyectables trimestrales suministrados,2015-02-01,0,1,19,14,0,34
SORATA,"anticoncepcion, prevencion de its y de cancer de cuello uterino",numero de inyectables trimestrales suministrados,2015-02-01,1,4,49,19,0,73
SUCRE,"anticoncepcion, prevencion de its y de cancer de cuello uterino",numero de inyectables trimestrales suministrados,2015-02-01,0,84,570,155,4,813
TACACHI,"anticoncepcion, prevencion de its y de cancer de cuello uterino",numero de inyectables trimestrales suministrados,2015-02-01,0,1,1,1,0,3
TACACOMA,"anticoncepcion, prevencion de its y de cancer de cuello uterino",numero de inyectables trimestrales suministrados,2015-02-01,0,4,32,10,0,46
TACOBAMBA,"anticoncepcion, prevencion de its y de cancer de cuello uterino",numero de inyectables trimestrales suministrados,2015-02-01,0,5,21,18,0,44
TACOPAYA,"anticoncepcion, prevencion de its y de cancer de cuello uterino",numero de inyectables trimestrales suministrados,2015-02-01,0,1,14,11,0,26
TAHUA,"anticoncepcion, prevencion de its y de cancer de cuello uterino",numero de inyectables trimestrales suministrados,2015-02-01,0,0,2,0,0,2
TAPACARI,"anticoncepcion, prevencion de its y de cancer de cuello uterino",numero de inyectables trimestrales suministrados,2015-02-01,0,2,43,29,0,74
TARABUCO,"anticoncepcion, prevencion de its y de cancer de cuello uterino",numero de inyectables trimestrales suministrados,2015-02-01,0,3,25,20,1,49
TARACO,"anticoncepcion, prevencion de its y de cancer de cuello uterino",numero de inyectables trimestrales suministrados,2015-02-01,0,4,14,11,0,29
TARATA,"anticoncepcion, prevencion de its y de cancer de cuello uterino",numero de inyectables trimestrales suministrados,2015-02-01,0,5,19,8,0,32
TARIJA,"anticoncepcion, prevencion de its y de cancer de cuello uterino",numero de inyectables trimestrales suministrados,2015-02-01,1,35,213,98,1,348
TARVITA,"anticoncepcion, prevencion de its y de cancer de cuello uterino",numero de inyectables trimestrales suministrados,2015-02-01,0,7,60,25,0,92
TEOPONTE,"anticoncepcion, prevencion de its y de cancer de cuello uterino",numero de inyectables trimestrales suministrados,2015-02-01,0,5,10,1,0,16
TIAWANACU,"anticoncepcion, prevencion de its y de cancer de cuello uterino",numero de inyectables trimestrales suministrados,2015-02-01,0,1,29,19,0,49
TINGUIPAYA,"anticoncepcion, prevencion de its y de cancer de cuello uterino",numero de inyectables trimestrales suministrados,2015-02-01,0,0,33,13,0,46
TIPUANI,"anticoncepcion, prevencion de its y de cancer de cuello uterino",numero de inyectables trimestrales suministrados,2015-02-01,1,4,20,5,0,30
TIQUIPAYA,"anticoncepcion, prevencion de its y de cancer de cuello uterino",numero de inyectables trimestrales suministrados,2015-02-01,0,13,84,20,0,117
TIRAQUE (CBBA),"anticoncepcion, prevencion de its y de cancer de cuello uterino",numero de inyectables trimestrales suministrados,2015-02-01,0,5,72,25,0,102
TITO YUPANQUI (PARQUIPUJIO),"anticoncepcion, prevencion de its y de cancer de cuello uterino",numero de inyectables trimestrales suministrados,2015-02-01,0,1,1,1,0,3
TOCO,"anticoncepcion, prevencion de its y de cancer de cuello uterino",numero de inyectables trimestrales suministrados,2015-02-01,0,3,10,14,0,27
TODOS SANTOS,"anticoncepcion, prevencion de its y de cancer de cuello uterino",numero de inyectables trimestrales suministrados,2015-02-01,0,0,1,0,0,1
TOLATA,"anticoncepcion, prevencion de its y de cancer de cuello uterino",numero de inyectables trimestrales suministrados,2015-02-01,0,0,11,3,0,14
TOLEDO,"anticoncepcion, prevencion de its y de cancer de cuello uterino",numero de inyectables trimestrales suministrados,2015-02-01,0,0,5,3,0,8
TOMAVE,"anticoncepcion, prevencion de its y de cancer de cuello uterino",numero de inyectables trimestrales suministrados,2015-02-01,0,3,19,9,0,31
TOMINA,"anticoncepcion, prevencion de its y de cancer de cuello uterino",numero de inyectables trimestrales suministrados,2015-02-01,0,3,41,37,0,81
TORO TORO,"anticoncepcion, prevencion de its y de cancer de cuello uterino",numero de inyectables trimestrales suministrados,2015-02-01,0,3,25,8,0,36
TOTORA(CBBA),"anticoncepcion, prevencion de its y de cancer de cuello uterino",numero de inyectables trimestrales suministrados,2015-02-01,0,10,59,23,0,92
TOTORA(ORR),"anticoncepcion, prevencion de its y de cancer de cuello uterino",numero de inyectables trimestrales suministrados,2015-02-01,0,3,10,2,0,15
TRIGAL,"anticoncepcion, prevencion de its y de cancer de cuello uterino",numero de inyectables trimestrales suministrados,2015-02-01,0,1,5,3,0,9
TRINIDAD,"anticoncepcion, prevencion de its y de cancer de cuello uterino",numero de inyectables trimestrales suministrados,2015-02-01,6,15,48,14,0,83
TUPIZA,"anticoncepcion, prevencion de its y de cancer de cuello uterino",numero de inyectables trimestrales suministrados,2015-02-01,1,12,120,53,0,186
TURCO,"anticoncepcion, prevencion de its y de cancer de cuello uterino",numero de inyectables trimestrales suministrados,2015-02-01,0,0,8,4,0,12
UMALA,"anticoncepcion, prevencion de its y de cancer de cuello uterino",numero de inyectables trimestrales suministrados,2015-02-01,0,3,11,5,0,19
UNCIA,"anticoncepcion, prevencion de its y de cancer de cuello uterino",numero de inyectables trimestrales suministrados,2015-02-01,0,8,38,20,0,66
URIONDO (A. CONCEPCION),"anticoncepcion, prevencion de its y de cancer de cuello uterino",numero de inyectables trimestrales suministrados,2015-02-01,0,12,61,36,2,111
URUBICHA,"anticoncepcion, prevencion de its y de cancer de cuello uterino",numero de inyectables trimestrales suministrados,2015-02-01,0,1,8,12,0,21
UYUNI,"anticoncepcion, prevencion de its y de cancer de cuello uterino",numero de inyectables trimestrales suministrados,2015-02-01,0,4,41,9,0,54
VACAS,"anticoncepcion, prevencion de its y de cancer de cuello uterino",numero de inyectables trimestrales suministrados,2015-02-01,0,2,16,13,0,31
VALLEGRANDE,"anticoncepcion, prevencion de its y de cancer de cuello uterino",numero de inyectables trimestrales suministrados,2015-02-01,0,7,50,10,0,67
VIACHA,"anticoncepcion, prevencion de its y de cancer de cuello uterino",numero de inyectables trimestrales suministrados,2015-02-01,0,11,134,40,0,185
VILA VILA,"anticoncepcion, prevencion de its y de cancer de cuello uterino",numero de inyectables trimestrales suministrados,2015-02-01,1,1,5,2,0,9
VILLA CHARCAS,"anticoncepcion, prevencion de its y de cancer de cuello uterino",numero de inyectables trimestrales suministrados,2015-02-01,1,5,53,37,1,97
VILLA MONTES,"anticoncepcion, prevencion de its y de cancer de cuello uterino",numero de inyectables trimestrales suministrados,2015-02-01,1,20,59,21,0,101
VILLA NUEVA (LOMA ALTA),"anticoncepcion, prevencion de its y de cancer de cuello uterino",numero de inyectables trimestrales suministrados,2015-02-01,3,1,12,2,0,18
VILLA RIVERO,"anticoncepcion, prevencion de its y de cancer de cuello uterino",numero de inyectables trimestrales suministrados,2015-02-01,0,4,29,17,0,50
VILLA SERRANO,"anticoncepcion, prevencion de its y de cancer de cuello uterino",numero de inyectables trimestrales suministrados,2015-02-01,0,10,31,21,1,63
VILLA TUNARI,"anticoncepcion, prevencion de its y de cancer de cuello uterino",numero de inyectables trimestrales suministrados,2015-02-01,0,31,261,75,0,367
VILLA VACA GUZMAN (MUYUPAMPA),"anticoncepcion, prevencion de its y de cancer de cuello uterino",numero de inyectables trimestrales suministrados,2015-02-01,1,6,38,29,2,76
VILLAZON,"anticoncepcion, prevencion de its y de cancer de cuello uterino",numero de inyectables trimestrales suministrados,2015-02-01,0,17,101,51,0,169
VINTO,"anticoncepcion, prevencion de its y de cancer de cuello uterino",numero de inyectables trimestrales suministrados,2015-02-01,0,2,49,19,0,70
VITICHI,"anticoncepcion, prevencion de its y de cancer de cuello uterino",numero de inyectables trimestrales suministrados,2015-02-01,0,1,18,14,0,33
WALDO BALLIVIAN,"anticoncepcion, prevencion de its y de cancer de cuello uterino",numero de inyectables trimestrales suministrados,2015-02-01,0,1,5,2,0,8
WARNES,"anticoncepcion, prevencion de its y de cancer de cuello uterino",numero de inyectables trimestrales suministrados,2015-02-01,4,34,135,38,0,211
YACO,"anticoncepcion, prevencion de its y de cancer de cuello uterino",numero de inyectables trimestrales suministrados,2015-02-01,0,0,13,6,0,19
YACUIBA,"anticoncepcion, prevencion de its y de cancer de cuello uterino",numero de inyectables trimestrales suministrados,2015-02-01,1,34,187,75,1,298
YAMPARAEZ,"anticoncepcion, prevencion de its y de cancer de cuello uterino",numero de inyectables trimestrales suministrados,2015-02-01,0,5,12,9,0,26
YANACACHI,"anticoncepcion, prevencion de its y de cancer de cuello uterino",numero de inyectables trimestrales suministrados,2015-02-01,0,2,10,5,0,17
YAPACANI,"anticoncepcion, prevencion de its y de cancer de cuello uterino",numero de inyectables trimestrales suministrados,2015-02-01,0,16,50,23,0,89
YOCALLA,"anticoncepcion, prevencion de its y de cancer de cuello uterino",numero de inyectables trimestrales suministrados,2015-02-01,0,0,19,4,0,23
YOTALA,"anticoncepcion, prevencion de its y de cancer de cuello uterino",numero de inyectables trimestrales suministrados,2015-02-01,0,0,8,4,0,12
YUNCHARA,"anticoncepcion, prevencion de its y de cancer de cuello uterino",numero de inyectables trimestrales suministrados,2015-02-01,0,7,41,21,0,69
YUNGUYO DE LITORAL,"anticoncepcion, prevencion de its y de cancer de cuello uterino",numero de inyectables trimestrales suministrados,2015-02-01,0,0,1,0,0,1
ZUDAÑEZ,"anticoncepcion, prevencion de its y de cancer de cuello uterino",numero de inyectables trimestrales suministrados,2015-02-01,0,7,39,21,1,68
ACACIO,"anticoncepcion, prevencion de its y de cancer de cuello uterino",numero de inyectables trimestrales suministrados,2015-03-01,0,0,17,5,0,22
ACHACACHI,"anticoncepcion, prevencion de its y de cancer de cuello uterino",numero de inyectables trimestrales suministrados,2015-03-01,1,7,61,32,1,102
ACHOCALLA,"anticoncepcion, prevencion de its y de cancer de cuello uterino",numero de inyectables trimestrales suministrados,2015-03-01,0,3,47,28,0,78
AIQUILE,"anticoncepcion, prevencion de its y de cancer de cuello uterino",numero de inyectables trimestrales suministrados,2015-03-01,0,3,46,26,0,75
ALALAY,"anticoncepcion, prevencion de its y de cancer de cuello uterino",numero de inyectables trimestrales suministrados,2015-03-01,0,1,3,3,0,7
ALCALA,"anticoncepcion, prevencion de its y de cancer de cuello uterino",numero de inyectables trimestrales suministrados,2015-03-01,0,0,17,14,0,31
ALTO BENI,"anticoncepcion, prevencion de its y de cancer de cuello uterino",numero de inyectables trimestrales suministrados,2015-03-01,0,3,38,23,0,64
ANCORAIMES,"anticoncepcion, prevencion de its y de cancer de cuello uterino",numero de inyectables trimestrales suministrados,2015-03-01,0,3,19,11,1,34
ANDAMARCA,"anticoncepcion, prevencion de its y de cancer de cuello uterino",numero de inyectables trimestrales suministrados,2015-03-01,0,2,7,2,0,11
ANTEQUERA,"anticoncepcion, prevencion de its y de cancer de cuello uterino",numero de inyectables trimestrales suministrados,2015-03-01,0,0,11,5,0,16
ANZALDO,"anticoncepcion, prevencion de its y de cancer de cuello uterino",numero de inyectables trimestrales suministrados,2015-03-01,1,12,9,9,0,31
APOLO,"anticoncepcion, prevencion de its y de cancer de cuello uterino",numero de inyectables trimestrales suministrados,2015-03-01,0,2,40,27,2,71
ARAMPAMPA,"anticoncepcion, prevencion de its y de cancer de cuello uterino",numero de inyectables trimestrales suministrados,2015-03-01,0,2,10,9,0,21
ARANI,"anticoncepcion, prevencion de its y de cancer de cuello uterino",numero de inyectables trimestrales suministrados,2015-03-01,0,0,14,5,0,19
ARBIETO,"anticoncepcion, prevencion de its y de cancer de cuello uterino",numero de inyectables trimestrales suministrados,2015-03-01,0,8,41,19,0,68
ARQUE,"anticoncepcion, prevencion de its y de cancer de cuello uterino",numero de inyectables trimestrales suministrados,2015-03-01,0,5,37,43,0,85
ASCENCION DE GUARAYOS,"anticoncepcion, prevencion de its y de cancer de cuello uterino",numero de inyectables trimestrales suministrados,2015-03-01,0,11,55,12,0,78
ATOCHA,"anticoncepcion, prevencion de its y de cancer de cuello uterino",numero de inyectables trimestrales suministrados,2015-03-01,0,5,74,22,0,101
AUCAPATA,"anticoncepcion, prevencion de its y de cancer de cuello uterino",numero de inyectables trimestrales suministrados,2015-03-01,0,1,22,12,0,35
AYATA,"anticoncepcion, prevencion de its y de cancer de cuello uterino",numero de inyectables trimestrales suministrados,2015-03-01,0,1,13,13,0,27
AYO AYO,"anticoncepcion, prevencion de its y de cancer de cuello uterino",numero de inyectables trimestrales suministrados,2015-03-01,0,1,12,7,1,21
AYOPAYA (V. DE INDEPENDENCIA),"anticoncepcion, prevencion de its y de cancer de cuello uterino",numero de inyectables trimestrales suministrados,2015-03-01,0,9,101,57,0,167
AZURDUY,"anticoncepcion, prevencion de its y de cancer de cuello uterino",numero de inyectables trimestrales suministrados,2015-03-01,0,4,34,26,0,64
BATALLAS,"anticoncepcion, prevencion de its y de cancer de cuello uterino",numero de inyectables trimestrales suministrados,2015-03-01,1,5,42,18,0,66
BAURES,"anticoncepcion, prevencion de its y de cancer de cuello uterino",numero de inyectables trimestrales suministrados,2015-03-01,0,0,6,0,0,6
BELEN DE ANDAMARCA,"anticoncepcion, prevencion de its y de cancer de cuello uterino",numero de inyectables trimestrales suministrados,2015-03-01,0,0,3,3,0,6
BELEN DE URMIRI,"anticoncepcion, prevencion de its y de cancer de cuello uterino",numero de inyectables trimestrales suministrados,2015-03-01,0,0,4,4,0,8
BELLA FLOR,"anticoncepcion, prevencion de its y de cancer de cuello uterino",numero de inyectables trimestrales suministrados,2015-03-01,0,1,14,5,0,20
BERMEJO,"anticoncepcion, prevencion de its y de cancer de cuello uterino",numero de inyectables trimestrales suministrados,2015-03-01,0,19,67,21,0,107
BETANZOS,"anticoncepcion, prevencion de its y de cancer de cuello uterino",numero de inyectables trimestrales suministrados,2015-03-01,0,5,50,57,0,112
BOLIVAR,"anticoncepcion, prevencion de its y de cancer de cuello uterino",numero de inyectables trimestrales suministrados,2015-03-01,0,1,11,8,0,20
BOLPEBRA,"anticoncepcion, prevencion de its y de cancer de cuello uterino",numero de inyectables trimestrales suministrados,2015-03-01,3,4,6,3,0,16
BOYUIBE,"anticoncepcion, prevencion de its y de cancer de cuello uterino",numero de inyectables trimestrales suministrados,2015-03-01,0,0,11,8,0,19
BUENA VISTA,"anticoncepcion, prevencion de its y de cancer de cuello uterino",numero de inyectables trimestrales suministrados,2015-03-01,0,10,35,16,0,61
CABEZAS,"anticoncepcion, prevencion de its y de cancer de cuello uterino",numero de inyectables trimestrales suministrados,2015-03-01,1,16,82,31,0,130
CAIROMA,"anticoncepcion, prevencion de its y de cancer de cuello uterino",numero de inyectables trimestrales suministrados,2015-03-01,0,1,16,5,0,22
"CAIZA ""D""","anticoncepcion, prevencion de its y de cancer de cuello uterino",numero de inyectables trimestrales suministrados,2015-03-01,0,0,30,12,0,42
CAJUATA,"anticoncepcion, prevencion de its y de cancer de cuello uterino",numero de inyectables trimestrales suministrados,2015-03-01,0,2,40,20,0,62
CALACOTO,"anticoncepcion, prevencion de its y de cancer de cuello uterino",numero de inyectables trimestrales suministrados,2015-03-01,0,1,5,4,0,10
CALAMARCA,"anticoncepcion, prevencion de its y de cancer de cuello uterino",numero de inyectables trimestrales suministrados,2015-03-01,0,13,37,20,0,70
CAMARGO,"anticoncepcion, prevencion de its y de cancer de cuello uterino",numero de inyectables trimestrales suministrados,2015-03-01,0,1,29,21,1,52
CAMATAQUI (C. VILLA ABECIA),"anticoncepcion, prevencion de its y de cancer de cuello uterino",numero de inyectables trimestrales suministrados,2015-03-01,0,1,8,12,0,21
CAMIRI,"anticoncepcion, prevencion de its y de cancer de cuello uterino",numero de inyectables trimestrales suministrados,2015-03-01,0,12,36,12,0,60
CAPINOTA,"anticoncepcion, prevencion de its y de cancer de cuello uterino",numero de inyectables trimestrales suministrados,2015-03-01,0,10,40,28,0,78
CAQUIAVIRI,"anticoncepcion, prevencion de its y de cancer de cuello uterino",numero de inyectables trimestrales suministrados,2015-03-01,0,2,12,3,0,17
CARACOLLO,"anticoncepcion, prevencion de its y de cancer de cuello uterino",numero de inyectables trimestrales suministrados,2015-03-01,0,1,31,27,0,59
CARANAVI,"anticoncepcion, prevencion de its y de cancer de cuello uterino",numero de inyectables trimestrales suministrados,2015-03-01,0,14,97,41,0,152
CARANGAS,"anticoncepcion, prevencion de its y de cancer de cuello uterino",numero de inyectables trimestrales suministrados,2015-03-01,0,0,2,0,0,2
CARAPARI,"anticoncepcion, prevencion de its y de cancer de cuello uterino",numero de inyectables trimestrales suministrados,2015-03-01,0,13,56,23,0,92
CARIPUYO,"anticoncepcion, prevencion de its y de cancer de cuello uterino",numero de inyectables trimestrales suministrados,2015-03-01,0,3,13,12,0,28
CARMEN RIVERO TORREZ,"anticoncepcion, prevencion de its y de cancer de cuello uterino",numero de inyectables trimestrales suministrados,2015-03-01,0,7,16,4,0,27
CATACORA,"anticoncepcion, prevencion de its y de cancer de cuello uterino",numero de inyectables trimestrales suministrados,2015-03-01,0,0,4,0,0,4
CHACARILLA,"anticoncepcion, prevencion de its y de cancer de cuello uterino",numero de inyectables trimestrales suministrados,2015-03-01,0,0,1,0,0,1
CHALLAPATA,"anticoncepcion, prevencion de its y de cancer de cuello uterino",numero de inyectables trimestrales suministrados,2015-03-01,0,4,40,18,0,62
CHAQUI,"anticoncepcion, prevencion de its y de cancer de cuello uterino",numero de inyectables trimestrales suministrados,2015-03-01,0,4,34,14,0,52
CHARAGUA,"anticoncepcion, prevencion de its y de cancer de cuello uterino",numero de inyectables trimestrales suministrados,2015-03-01,0,5,48,12,0,65
CHARAÑA,"anticoncepcion, prevencion de its y de cancer de cuello uterino",numero de inyectables trimestrales suministrados,2015-03-01,0,0,5,3,0,8
CHAYANTA,"anticoncepcion, prevencion de its y de cancer de cuello uterino",numero de inyectables trimestrales suministrados,2015-03-01,0,3,39,14,0,56
CHIMORE,"anticoncepcion, prevencion de its y de cancer de cuello uterino",numero de inyectables trimestrales suministrados,2015-03-01,1,11,72,23,0,107
CHIPAYA,"anticoncepcion, prevencion de its y de cancer de cuello uterino",numero de inyectables trimestrales suministrados,2015-03-01,0,5,10,2,0,17
CHOQUE COTA,"anticoncepcion, prevencion de its y de cancer de cuello uterino",numero de inyectables trimestrales suministrados,2015-03-01,0,0,3,3,0,6
CHUA COCANI,"anticoncepcion, prevencion de its y de cancer de cuello uterino",numero de inyectables trimestrales suministrados,2015-03-01,0,0,8,3,1,12
CHULUMANI (V. DE LA LIBERTAD),"anticoncepcion, prevencion de its y de cancer de cuello uterino",numero de inyectables trimestrales suministrados,2015-03-01,0,2,14,7,0,23
CHUMA,"anticoncepcion, prevencion de its y de cancer de cuello uterino",numero de inyectables trimestrales suministrados,2015-03-01,0,3,26,25,0,54
CHUQUIHUTA AYLLU JUCUMANI,"anticoncepcion, prevencion de its y de cancer de cuello uterino",numero de inyectables trimestrales suministrados,2015-03-01,0,0,13,4,0,17
CKOCHAS,"anticoncepcion, prevencion de its y de cancer de cuello uterino",numero de inyectables trimestrales suministrados,2015-03-01,0,2,25,27,0,54
CLIZA,"anticoncepcion, prevencion de its y de cancer de cuello uterino",numero de inyectables trimestrales suministrados,2015-03-01,0,2,22,5,1,30
COBIJA,"anticoncepcion, prevencion de its y de cancer de cuello uterino",numero de inyectables trimestrales suministrados,2015-03-01,5,38,112,15,0,170
COCAPATA,"anticoncepcion, prevencion de its y de cancer de cuello uterino",numero de inyectables trimestrales suministrados,2015-03-01,1,8,31,22,0,62
COCHABAMBA,"anticoncepcion, prevencion de its y de cancer de cuello uterino",numero de inyectables trimestrales suministrados,2015-03-01,1,73,352,93,0,519
COIPASA,"anticoncepcion, prevencion de its y de cancer de cuello uterino",numero de inyectables trimestrales suministrados,2015-03-01,0,0,2,4,0,6
COLCAPIRHUA,"anticoncepcion, prevencion de its y de cancer de cuello uterino",numero de inyectables trimestrales suministrados,2015-03-01,0,6,80,9,0,95
"COLCHA ""K""","anticoncepcion, prevencion de its y de cancer de cuello uterino",numero de inyectables trimestrales suministrados,2015-03-01,0,6,42,19,0,67
COLLANA,"anticoncepcion, prevencion de its y de cancer de cuello uterino",numero de inyectables trimestrales suministrados,2015-03-01,0,0,8,4,0,12
COLOMI,"anticoncepcion, prevencion de its y de cancer de cuello uterino",numero de inyectables trimestrales suministrados,2015-03-01,0,11,78,16,0,105
COLPA BELGICA,"anticoncepcion, prevencion de its y de cancer de cuello uterino",numero de inyectables trimestrales suministrados,2015-03-01,0,2,16,4,0,22
COLQUECHACA,"anticoncepcion, prevencion de its y de cancer de cuello uterino",numero de inyectables trimestrales suministrados,2015-03-01,0,4,27,16,0,47
COLQUENCHA,"anticoncepcion, prevencion de its y de cancer de cuello uterino",numero de inyectables trimestrales suministrados,2015-03-01,0,1,27,19,0,47
COLQUIRI,"anticoncepcion, prevencion de its y de cancer de cuello uterino",numero de inyectables trimestrales suministrados,2015-03-01,0,6,27,14,0,47
COMANCHE,"anticoncepcion, prevencion de its y de cancer de cuello uterino",numero de inyectables trimestrales suministrados,2015-03-01,0,1,2,0,0,3
COMARAPA,"anticoncepcion, prevencion de its y de cancer de cuello uterino",numero de inyectables trimestrales suministrados,2015-03-01,1,15,107,30,0,153
COMBAYA,"anticoncepcion, prevencion de its y de cancer de cuello uterino",numero de inyectables trimestrales suministrados,2015-03-01,0,0,1,5,0,6
CONCEPCION,"anticoncepcion, prevencion de its y de cancer de cuello uterino",numero de inyectables trimestrales suministrados,2015-03-01,0,6,30,15,0,51
COPACABANA,"anticoncepcion, prevencion de its y de cancer de cuello uterino",numero de inyectables trimestrales suministrados,2015-03-01,0,3,31,21,2,57
CORIPATA,"anticoncepcion, prevencion de its y de cancer de cuello uterino",numero de inyectables trimestrales suministrados,2015-03-01,0,0,37,15,0,52
CORO CORO,"anticoncepcion, prevencion de its y de cancer de cuello uterino",numero de inyectables trimestrales suministrados,2015-03-01,0,1,14,11,0,26
COROICO,"anticoncepcion, prevencion de its y de cancer de cuello uterino",numero de inyectables trimestrales suministrados,2015-03-01,0,1,16,6,0,23
CORQUE,"anticoncepcion, prevencion de its y de cancer de cuello uterino",numero de inyectables trimestrales suministrados,2015-03-01,0,2,13,8,0,23
COTAGAITA,"anticoncepcion, prevencion de its y de cancer de cuello uterino",numero de inyectables trimestrales suministrados,2015-03-01,0,8,73,40,1,122
COTOCA,"anticoncepcion, prevencion de its y de cancer de cuello uterino",numero de inyectables trimestrales suministrados,2015-03-01,0,16,73,22,0,111
CUATRO CAÑADAS,"anticoncepcion, prevencion de its y de cancer de cuello uterino",numero de inyectables trimestrales suministrados,2015-03-01,0,6,42,14,0,62
CUCHUMUELA (V. G. VILLARROEL),"anticoncepcion, prevencion de its y de cancer de cuello uterino",numero de inyectables trimestrales suministrados,2015-03-01,0,0,5,3,0,8
CUEVO,"anticoncepcion, prevencion de its y de cancer de cuello uterino",numero de inyectables trimestrales suministrados,2015-03-01,0,4,18,13,1,36
CULPINA,"anticoncepcion, prevencion de its y de cancer de cuello uterino",numero de inyectables trimestrales suministrados,2015-03-01,0,7,67,61,0,135
CURAHUARA DE CARANGAS,"anticoncepcion, prevencion de its y de cancer de cuello uterino",numero de inyectables trimestrales suministrados,2015-03-01,0,2,13,6,0,21
CURVA,"anticoncepcion, prevencion de its y de cancer de cuello uterino",numero de inyectables trimestrales suministrados,2015-03-01,0,1,4,1,0,6
DESAGUADERO,"anticoncepcion, prevencion de its y de cancer de cuello uterino",numero de inyectables trimestrales suministrados,2015-03-01,0,0,10,0,0,10
EL ALTO,"anticoncepcion, prevencion de its y de cancer de cuello uterino",numero de inyectables trimestrales suministrados,2015-03-01,2,102,1062,424,4,1594
EL CHORO,"anticoncepcion, prevencion de its y de cancer de cuello uterino",numero de inyectables trimestrales suministrados,2015-03-01,0,1,11,3,0,15
EL PUENTE(STC),"anticoncepcion, prevencion de its y de cancer de cuello uterino",numero de inyectables trimestrales suministrados,2015-03-01,0,11,36,19,0,66
EL PUENTE(TJA),"anticoncepcion, prevencion de its y de cancer de cuello uterino",numero de inyectables trimestrales suministrados,2015-03-01,0,6,58,33,1,98
EL TORNO,"anticoncepcion, prevencion de its y de cancer de cuello uterino",numero de inyectables trimestrales suministrados,2015-03-01,2,38,126,46,3,215
EL VILLAR,"anticoncepcion, prevencion de its y de cancer de cuello uterino",numero de inyectables trimestrales suministrados,2015-03-01,0,5,15,15,2,37
ENTRE RIOS TRJ,"anticoncepcion, prevencion de its y de cancer de cuello uterino",numero de inyectables trimestrales suministrados,2015-03-01,0,28,86,64,1,179
ENTRE RIOS CBBA,"anticoncepcion, prevencion de its y de cancer de cuello uterino",numero de inyectables trimestrales suministrados,2015-03-01,0,12,70,23,0,105
ESCOMA,"anticoncepcion, prevencion de its y de cancer de cuello uterino",numero de inyectables trimestrales suministrados,2015-03-01,0,1,2,0,0,3
ESMERALDA,"anticoncepcion, prevencion de its y de cancer de cuello uterino",numero de inyectables trimestrales suministrados,2015-03-01,0,0,2,0,0,2
EUCALIPTUS,"anticoncepcion, prevencion de its y de cancer de cuello uterino",numero de inyectables trimestrales suministrados,2015-03-01,0,1,7,3,0,11
EUREKA (SANTOS MERCADO),"anticoncepcion, prevencion de its y de cancer de cuello uterino",numero de inyectables trimestrales suministrados,2015-03-01,0,0,3,1,0,4
EXALTACION,"anticoncepcion, prevencion de its y de cancer de cuello uterino",numero de inyectables trimestrales suministrados,2015-03-01,0,0,5,0,0,5
FERNANDEZ ALONSO,"anticoncepcion, prevencion de its y de cancer de cuello uterino",numero de inyectables trimestrales suministrados,2015-03-01,0,15,82,31,0,128
FILADELFIA,"anticoncepcion, prevencion de its y de cancer de cuello uterino",numero de inyectables trimestrales suministrados,2015-03-01,1,3,23,5,0,32
GENERAL SAAVEDRA,"anticoncepcion, prevencion de its y de cancer de cuello uterino",numero de inyectables trimestrales suministrados,2015-03-01,1,16,47,15,2,81
GRAL. J.J. PEREZ (CHARAZANI),"anticoncepcion, prevencion de its y de cancer de cuello uterino",numero de inyectables trimestrales suministrados,2015-03-01,0,1,14,12,0,27
GUANAY,"anticoncepcion, prevencion de its y de cancer de cuello uterino",numero de inyectables trimestrales suministrados,2015-03-01,0,4,26,6,0,36
GUAQUI,"anticoncepcion, prevencion de its y de cancer de cuello uterino",numero de inyectables trimestrales suministrados,2015-03-01,0,1,14,8,0,23
GUAYARAMERIN,"anticoncepcion, prevencion de its y de cancer de cuello uterino",numero de inyectables trimestrales suministrados,2015-03-01,0,13,32,9,0,54
GUTIERREZ,"anticoncepcion, prevencion de its y de cancer de cuello uterino",numero de inyectables trimestrales suministrados,2015-03-01,0,1,21,10,0,32
HUACARETA,"anticoncepcion, prevencion de its y de cancer de cuello uterino",numero de inyectables trimestrales suministrados,2015-03-01,0,6,28,13,0,47
HUACAYA (VILLA DE HUACAYA),"anticoncepcion, prevencion de its y de cancer de cuello uterino",numero de inyectables trimestrales suministrados,2015-03-01,0,0,16,1,0,17
HUACHACALLA,"anticoncepcion, prevencion de its y de cancer de cuello uterino",numero de inyectables trimestrales suministrados,2015-03-01,0,0,1,1,0,2
HUANUNI,"anticoncepcion, prevencion de its y de cancer de cuello uterino",numero de inyectables trimestrales suministrados,2015-03-01,0,1,28,8,0,37
HUARACAJE,"anticoncepcion, prevencion de its y de cancer de cuello uterino",numero de inyectables trimestrales suministrados,2015-03-01,0,2,7,3,1,13
HUARINA,"anticoncepcion, prevencion de its y de cancer de cuello uterino",numero de inyectables trimestrales suministrados,2015-03-01,0,1,5,5,1,12
HUATAJATA,"anticoncepcion, prevencion de its y de cancer de cuello uterino",numero de inyectables trimestrales suministrados,2015-03-01,0,1,4,3,0,8
HUAYLLAMARCA,"anticoncepcion, prevencion de its y de cancer de cuello uterino",numero de inyectables trimestrales suministrados,2015-03-01,0,3,7,9,0,19
HUMANATA,"anticoncepcion, prevencion de its y de cancer de cuello uterino",numero de inyectables trimestrales suministrados,2015-03-01,0,0,3,5,0,8
ICHOCA,"anticoncepcion, prevencion de its y de cancer de cuello uterino",numero de inyectables trimestrales suministrados,2015-03-01,0,2,4,2,0,8
ICLA,"anticoncepcion, prevencion de its y de cancer de cuello uterino",numero de inyectables trimestrales suministrados,2015-03-01,0,1,17,22,1,41
INCAHUASI,"anticoncepcion, prevencion de its y de cancer de cuello uterino",numero de inyectables trimestrales suministrados,2015-03-01,0,4,48,23,0,75
INGAVI (HUMAITA),"anticoncepcion, prevencion de its y de cancer de cuello uterino",numero de inyectables trimestrales suministrados,2015-03-01,0,1,5,0,0,6
INQUISIVI,"anticoncepcion, prevencion de its y de cancer de cuello uterino",numero de inyectables trimestrales suministrados,2015-03-01,0,2,24,20,0,46
IRUPANA (VILLA DE LANZA),"anticoncepcion, prevencion de its y de cancer de cuello uterino",numero de inyectables trimestrales suministrados,2015-03-01,1,5,48,22,0,76
IXIAMAS,"anticoncepcion, prevencion de its y de cancer de cuello uterino",numero de inyectables trimestrales suministrados,2015-03-01,0,3,25,1,0,29
JESUS DE MACHACA,"anticoncepcion, prevencion de its y de cancer de cuello uterino",numero de inyectables trimestrales suministrados,2015-03-01,0,3,21,7,0,31
LA ASUNTA,"anticoncepcion, prevencion de its y de cancer de cuello uterino",numero de inyectables trimestrales suministrados,2015-03-01,5,15,114,37,0,171
LA GUARDIA,"anticoncepcion, prevencion de its y de cancer de cuello uterino",numero de inyectables trimestrales suministrados,2015-03-01,0,32,151,39,0,222
LA PAZ,"anticoncepcion, prevencion de its y de cancer de cuello uterino",numero de inyectables trimestrales suministrados,2015-03-01,0,60,465,147,1,673
LA RIVERA,"anticoncepcion, prevencion de its y de cancer de cuello uterino",numero de inyectables trimestrales suministrados,2015-03-01,0,0,1,1,0,2
LAGUNILLAS,"anticoncepcion, prevencion de its y de cancer de cuello uterino",numero de inyectables trimestrales suministrados,2015-03-01,0,0,5,2,0,7
LAJA,"anticoncepcion, prevencion de its y de cancer de cuello uterino",numero de inyectables trimestrales suministrados,2015-03-01,0,6,37,13,0,56
LAS CARRERAS,"anticoncepcion, prevencion de its y de cancer de cuello uterino",numero de inyectables trimestrales suministrados,2015-03-01,0,3,18,9,0,30
LICOMA PAMPA,"anticoncepcion, prevencion de its y de cancer de cuello uterino",numero de inyectables trimestrales suministrados,2015-03-01,0,1,8,7,0,16
LLALLAGUA,"anticoncepcion, prevencion de its y de cancer de cuello uterino",numero de inyectables trimestrales suministrados,2015-03-01,0,12,98,22,0,132
LLICA,"anticoncepcion, prevencion de its y de cancer de cuello uterino",numero de inyectables trimestrales suministrados,2015-03-01,0,8,17,10,0,35
LORETO,"anticoncepcion, prevencion de its y de cancer de cuello uterino",numero de inyectables trimestrales suministrados,2015-03-01,0,4,9,0,0,13
LURIBAY,"anticoncepcion, prevencion de its y de cancer de cuello uterino",numero de inyectables trimestrales suministrados,2015-03-01,0,5,15,17,1,38
MACHACAMARCA,"anticoncepcion, prevencion de its y de cancer de cuello uterino",numero de inyectables trimestrales suministrados,2015-03-01,0,0,6,2,0,8
MACHARETI,"anticoncepcion, prevencion de its y de cancer de cuello uterino",numero de inyectables trimestrales suministrados,2015-03-01,0,4,34,12,0,50
MAGDALENA,"anticoncepcion, prevencion de its y de cancer de cuello uterino",numero de inyectables trimestrales suministrados,2015-03-01,0,4,27,7,0,38
MAIRANA,"anticoncepcion, prevencion de its y de cancer de cuello uterino",numero de inyectables trimestrales suministrados,2015-03-01,0,8,38,11,0,57
MALLA,"anticoncepcion, prevencion de its y de cancer de cuello uterino",numero de inyectables trimestrales suministrados,2015-03-01,0,0,9,3,0,12
MAPIRI,"anticoncepcion, prevencion de its y de cancer de cuello uterino",numero de inyectables trimestrales suministrados,2015-03-01,0,1,12,9,0,22
MECAPACA,"anticoncepcion, prevencion de its y de cancer de cuello uterino",numero de inyectables trimestrales suministrados,2015-03-01,0,0,31,19,1,51
MINEROS,"anticoncepcion, prevencion de its y de cancer de cuello uterino",numero de inyectables trimestrales suministrados,2015-03-01,0,13,49,13,1,76
MIZQUE,"anticoncepcion, prevencion de its y de cancer de cuello uterino",numero de inyectables trimestrales suministrados,2015-03-01,0,8,103,36,1,148
MOCOMOCO,"anticoncepcion, prevencion de its y de cancer de cuello uterino",numero de inyectables trimestrales suministrados,2015-03-01,0,2,22,20,0,44
MOJINETE,"anticoncepcion, prevencion de its y de cancer de cuello uterino",numero de inyectables trimestrales suministrados,2015-03-01,0,2,4,2,0,8
MOJOCOYA,"anticoncepcion, prevencion de its y de cancer de cuello uterino",numero de inyectables trimestrales suministrados,2015-03-01,0,7,27,25,1,60
MONTEAGUDO,"anticoncepcion, prevencion de its y de cancer de cuello uterino",numero de inyectables trimestrales suministrados,2015-03-01,1,19,75,40,1,136
MONTERO,"anticoncepcion, prevencion de its y de cancer de cuello uterino",numero de inyectables trimestrales suministrados,2015-03-01,2,39,139,42,0,222
MORO MORO,"anticoncepcion, prevencion de its y de cancer de cuello uterino",numero de inyectables trimestrales suministrados,2015-03-01,1,4,21,0,1,27
MOROCHATA,"anticoncepcion, prevencion de its y de cancer de cuello uterino",numero de inyectables trimestrales suministrados,2015-03-01,0,9,47,37,0,93
NACEBE (SANTA ROSA DEL ABUNA),"anticoncepcion, prevencion de its y de cancer de cuello uterino",numero de inyectables trimestrales suministrados,2015-03-01,1,8,15,6,0,30
NAZACARA DE PACAJES,"anticoncepcion, prevencion de its y de cancer de cuello uterino",numero de inyectables trimestrales suministrados,2015-03-01,0,0,1,1,0,2
NUEVO MANOA (NUEVA ESPERANZA),"anticoncepcion, prevencion de its y de cancer de cuello uterino",numero de inyectables trimestrales suministrados,2015-03-01,0,0,5,1,0,6
OCURI,"anticoncepcion, prevencion de its y de cancer de cuello uterino",numero de inyectables trimestrales suministrados,2015-03-01,0,2,30,19,0,51
OKINAWA,"anticoncepcion, prevencion de its y de cancer de cuello uterino",numero de inyectables trimestrales suministrados,2015-03-01,0,9,39,15,1,64
OMEREQUE,"anticoncepcion, prevencion de its y de cancer de cuello uterino",numero de inyectables trimestrales suministrados,2015-03-01,0,2,23,11,0,36
ORURO,"anticoncepcion, prevencion de its y de cancer de cuello uterino",numero de inyectables trimestrales suministrados,2015-03-01,0,48,507,184,2,741
PADCAYA,"anticoncepcion, prevencion de its y de cancer de cuello uterino",numero de inyectables trimestrales suministrados,2015-03-01,0,24,97,107,2,230
PADILLA,"anticoncepcion, prevencion de its y de cancer de cuello uterino",numero de inyectables trimestrales suministrados,2015-03-01,0,11,62,32,0,105
PAILON,"anticoncepcion, prevencion de its y de cancer de cuello uterino",numero de inyectables trimestrales suministrados,2015-03-01,3,7,37,10,0,57
PALCA,"anticoncepcion, prevencion de its y de cancer de cuello uterino",numero de inyectables trimestrales suministrados,2015-03-01,0,3,30,4,0,37
PALOS BLANCOS,"anticoncepcion, prevencion de its y de cancer de cuello uterino",numero de inyectables trimestrales suministrados,2015-03-01,0,7,66,39,0,112
PAMPA AULLAGAS,"anticoncepcion, prevencion de its y de cancer de cuello uterino",numero de inyectables trimestrales suministrados,2015-03-01,0,0,3,2,0,5
PAMPA GRANDE,"anticoncepcion, prevencion de its y de cancer de cuello uterino",numero de inyectables trimestrales suministrados,2015-03-01,1,5,42,12,0,60
PAPEL PAMPA,"anticoncepcion, prevencion de its y de cancer de cuello uterino",numero de inyectables trimestrales suministrados,2015-03-01,0,0,8,17,0,25
PASORAPA,"anticoncepcion, prevencion de its y de cancer de cuello uterino",numero de inyectables trimestrales suministrados,2015-03-01,0,1,15,10,0,26
PATACAMAYA,"anticoncepcion, prevencion de its y de cancer de cuello uterino",numero de inyectables trimestrales suministrados,2015-03-01,0,1,22,8,0,31
PAZÑA,"anticoncepcion, prevencion de its y de cancer de cuello uterino",numero de inyectables trimestrales suministrados,2015-03-01,0,0,18,11,0,29
PELECHUCO,"anticoncepcion, prevencion de its y de cancer de cuello uterino",numero de inyectables trimestrales suministrados,2015-03-01,0,1,13,9,0,23
POCOATA,"anticoncepcion, prevencion de its y de cancer de cuello uterino",numero de inyectables trimestrales suministrados,2015-03-01,0,4,28,40,0,72
POCONA,"anticoncepcion, prevencion de its y de cancer de cuello uterino",numero de inyectables trimestrales suministrados,2015-03-01,0,8,61,43,2,114
POJO (CBBA),"anticoncepcion, prevencion de its y de cancer de cuello uterino",numero de inyectables trimestrales suministrados,2015-03-01,0,9,56,25,1,91
POOPO,"anticoncepcion, prevencion de its y de cancer de cuello uterino",numero de inyectables trimestrales suministrados,2015-03-01,0,0,9,1,0,10
PORCO,"anticoncepcion, prevencion de its y de cancer de cuello uterino",numero de inyectables trimestrales suministrados,2015-03-01,0,4,16,7,0,27
POROMA,"anticoncepcion, prevencion de its y de cancer de cuello uterino",numero de inyectables trimestrales suministrados,2015-03-01,0,5,66,20,2,93
PORONGO,"anticoncepcion, prevencion de its y de cancer de cuello uterino",numero de inyectables trimestrales suministrados,2015-03-01,0,5,36,6,0,47
PORTACHUELO,"anticoncepcion, prevencion de its y de cancer de cuello uterino",numero de inyectables trimestrales suministrados,2015-03-01,0,7,37,9,0,53
PORVENIR,"anticoncepcion, prevencion de its y de cancer de cuello uterino",numero de inyectables trimestrales suministrados,2015-03-01,0,5,23,5,0,33
POSTRER VALLE,"anticoncepcion, prevencion de its y de cancer de cuello uterino",numero de inyectables trimestrales suministrados,2015-03-01,0,0,9,3,0,12
POTOSI,"anticoncepcion, prevencion de its y de cancer de cuello uterino",numero de inyectables trimestrales suministrados,2015-03-01,1,42,533,128,0,704
PRESTO,"anticoncepcion, prevencion de its y de cancer de cuello uterino",numero de inyectables trimestrales suministrados,2015-03-01,0,5,31,22,0,58
PUCARA,"anticoncepcion, prevencion de its y de cancer de cuello uterino",numero de inyectables trimestrales suministrados,2015-03-01,0,2,4,4,0,10
PUCARANI,"anticoncepcion, prevencion de its y de cancer de cuello uterino",numero de inyectables trimestrales suministrados,2015-03-01,0,10,82,42,1,135
PUERTO ACOSTA,"anticoncepcion, prevencion de its y de cancer de cuello uterino",numero de inyectables trimestrales suministrados,2015-03-01,0,2,7,3,0,12
PUERTO CARABUCO,"anticoncepcion, prevencion de its y de cancer de cuello uterino",numero de inyectables trimestrales suministrados,2015-03-01,0,1,16,17,0,34
PUERTO GONZALO MORENO,"anticoncepcion, prevencion de its y de cancer de cuello uterino",numero de inyectables trimestrales suministrados,2015-03-01,2,7,19,8,1,37
PUERTO PEREZ,"anticoncepcion, prevencion de its y de cancer de cuello uterino",numero de inyectables trimestrales suministrados,2015-03-01,0,0,11,3,0,14
PUERTO QUIJARRO,"anticoncepcion, prevencion de its y de cancer de cuello uterino",numero de inyectables trimestrales suministrados,2015-03-01,0,8,22,6,0,36
PUERTO RICO,"anticoncepcion, prevencion de its y de cancer de cuello uterino",numero de inyectables trimestrales suministrados,2015-03-01,0,11,31,17,0,59
PUERTO SILES,"anticoncepcion, prevencion de its y de cancer de cuello uterino",numero de inyectables trimestrales suministrados,2015-03-01,1,0,2,0,0,3
PUERTO SUAREZ,"anticoncepcion, prevencion de its y de cancer de cuello uterino",numero de inyectables trimestrales suministrados,2015-03-01,0,0,17,1,0,18
PUERTO VILLARROEL,"anticoncepcion, prevencion de its y de cancer de cuello uterino",numero de inyectables trimestrales suministrados,2015-03-01,0,24,87,46,1,158
PUNA,"anticoncepcion, prevencion de its y de cancer de cuello uterino",numero de inyectables trimestrales suministrados,2015-03-01,0,4,46,20,1,71
PUNATA,"anticoncepcion, prevencion de its y de cancer de cuello uterino",numero de inyectables trimestrales suministrados,2015-03-01,0,5,57,20,1,83
QUIABAYA,"anticoncepcion, prevencion de its y de cancer de cuello uterino",numero de inyectables trimestrales suministrados,2015-03-01,0,2,11,4,0,17
QUILLACOLLO,"anticoncepcion, prevencion de its y de cancer de cuello uterino",numero de inyectables trimestrales suministrados,2015-03-01,0,22,222,51,0,295
QUIME,"anticoncepcion, prevencion de its y de cancer de cuello uterino",numero de inyectables trimestrales suministrados,2015-03-01,0,5,27,17,1,50
QUIRUSILLAS,"anticoncepcion, prevencion de its y de cancer de cuello uterino",numero de inyectables trimestrales suministrados,2015-03-01,0,2,11,5,1,19
RAVELO,"anticoncepcion, prevencion de its y de cancer de cuello uterino",numero de inyectables trimestrales suministrados,2015-03-01,0,9,56,45,1,111
REYES,"anticoncepcion, prevencion de its y de cancer de cuello uterino",numero de inyectables trimestrales suministrados,2015-03-01,0,3,18,2,0,23
RIBERALTA,"anticoncepcion, prevencion de its y de cancer de cuello uterino",numero de inyectables trimestrales suministrados,2015-03-01,2,45,198,45,0,290
ROBORE,"anticoncepcion, prevencion de its y de cancer de cuello uterino",numero de inyectables trimestrales suministrados,2015-03-01,0,6,46,9,0,61
RURRENABAQUE,"anticoncepcion, prevencion de its y de cancer de cuello uterino",numero de inyectables trimestrales suministrados,2015-03-01,0,6,56,17,0,79
SABAYA,"anticoncepcion, prevencion de its y de cancer de cuello uterino",numero de inyectables trimestrales suministrados,2015-03-01,0,0,2,4,0,6
SACABA,"anticoncepcion, prevencion de its y de cancer de cuello uterino",numero de inyectables trimestrales suministrados,2015-03-01,0,35,208,57,0,300
SACABAMBA,"anticoncepcion, prevencion de its y de cancer de cuello uterino",numero de inyectables trimestrales suministrados,2015-03-01,0,2,0,6,0,8
SACACA,"anticoncepcion, prevencion de its y de cancer de cuello uterino",numero de inyectables trimestrales suministrados,2015-03-01,0,6,53,22,0,81
SAIPINA,"anticoncepcion, prevencion de its y de cancer de cuello uterino",numero de inyectables trimestrales suministrados,2015-03-01,0,5,23,5,0,33
SALINAS DE GARCI MENDOZA,"anticoncepcion, prevencion de its y de cancer de cuello uterino",numero de inyectables trimestrales suministrados,2015-03-01,0,6,29,8,0,43
SAMAIPATA,"anticoncepcion, prevencion de its y de cancer de cuello uterino",numero de inyectables trimestrales suministrados,2015-03-01,0,8,39,8,0,55
SAN AGUSTIN,"anticoncepcion, prevencion de its y de cancer de cuello uterino",numero de inyectables trimestrales suministrados,2015-03-01,0,0,9,3,0,12
SAN ANDRES,"anticoncepcion, prevencion de its y de cancer de cuello uterino",numero de inyectables trimestrales suministrados,2015-03-01,0,9,34,19,0,62
SAN ANDRES DE MACHACA,"anticoncepcion, prevencion de its y de cancer de cuello uterino",numero de inyectables trimestrales suministrados,2015-03-01,0,0,2,1,0,3
SAN ANTONIO DE ESMORUCO,"anticoncepcion, prevencion de its y de cancer de cuello uterino",numero de inyectables trimestrales suministrados,2015-03-01,0,0,8,0,0,8
SAN ANTONIO DE LOMERIO,"anticoncepcion, prevencion de its y de cancer de cuello uterino",numero de inyectables trimestrales suministrados,2015-03-01,1,10,34,24,0,69
SAN BENITO,"anticoncepcion, prevencion de its y de cancer de cuello uterino",numero de inyectables trimestrales suministrados,2015-03-01,0,3,40,18,0,61
SAN BORJA,"anticoncepcion, prevencion de its y de cancer de cuello uterino",numero de inyectables trimestrales suministrados,2015-03-01,0,22,97,38,3,160
SAN BUENA VENTURA,"anticoncepcion, prevencion de its y de cancer de cuello uterino",numero de inyectables trimestrales suministrados,2015-03-01,0,4,21,9,0,34
SAN CARLOS,"anticoncepcion, prevencion de its y de cancer de cuello uterino",numero de inyectables trimestrales suministrados,2015-03-01,0,13,27,16,0,56
SAN IGNACIO,"anticoncepcion, prevencion de its y de cancer de cuello uterino",numero de inyectables trimestrales suministrados,2015-03-01,2,19,79,34,1,135
SAN IGNACIO DE VELASCO,"anticoncepcion, prevencion de its y de cancer de cuello uterino",numero de inyectables trimestrales suministrados,2015-03-01,0,28,141,50,1,220
SAN JAVIER(BNI),"anticoncepcion, prevencion de its y de cancer de cuello uterino",numero de inyectables trimestrales suministrados,2015-03-01,2,2,5,0,0,9
SAN JAVIER(STC),"anticoncepcion, prevencion de its y de cancer de cuello uterino",numero de inyectables trimestrales suministrados,2015-03-01,0,6,21,9,0,36
SAN JOSE DE CHIQUITOS,"anticoncepcion, prevencion de its y de cancer de cuello uterino",numero de inyectables trimestrales suministrados,2015-03-01,0,6,33,16,0,55
SAN JUAN DE YAPACANI,"anticoncepcion, prevencion de its y de cancer de cuello uterino",numero de inyectables trimestrales suministrados,2015-03-01,0,3,26,13,0,42
SAN JULIAN,"anticoncepcion, prevencion de its y de cancer de cuello uterino",numero de inyectables trimestrales suministrados,2015-03-01,1,18,101,46,0,166
SAN LORENZO(PND),"anticoncepcion, prevencion de its y de cancer de cuello uterino",numero de inyectables trimestrales suministrados,2015-03-01,0,1,7,2,0,10
SAN LORENZO(TJA),"anticoncepcion, prevencion de its y de cancer de cuello uterino",numero de inyectables trimestrales suministrados,2015-03-01,0,16,98,58,2,174
SAN LUCAS,"anticoncepcion, prevencion de its y de cancer de cuello uterino",numero de inyectables trimestrales suministrados,2015-03-01,0,8,72,40,1,121
SAN MATIAS,"anticoncepcion, prevencion de its y de cancer de cuello uterino",numero de inyectables trimestrales suministrados,2015-03-01,0,0,24,6,1,31
SAN MIGUEL DE VELASCO,"anticoncepcion, prevencion de its y de cancer de cuello uterino",numero de inyectables trimestrales suministrados,2015-03-01,0,20,67,29,2,118
SAN PABLO DE LIPEZ,"anticoncepcion, prevencion de its y de cancer de cuello uterino",numero de inyectables trimestrales suministrados,2015-03-01,0,0,4,0,0,4
SAN PEDRO,"anticoncepcion, prevencion de its y de cancer de cuello uterino",numero de inyectables trimestrales suministrados,2015-03-01,0,10,34,8,0,52
SAN PEDRO DE BUENA VISTA,"anticoncepcion, prevencion de its y de cancer de cuello uterino",numero de inyectables trimestrales suministrados,2015-03-01,0,5,42,22,0,69
SAN PEDRO DE CURAHUARA,"anticoncepcion, prevencion de its y de cancer de cuello uterino",numero de inyectables trimestrales suministrados,2015-03-01,0,0,11,6,0,17
SAN PEDRO DE QUEMES,"anticoncepcion, prevencion de its y de cancer de cuello uterino",numero de inyectables trimestrales suministrados,2015-03-01,0,2,2,1,0,5
SAN PEDRO DE TIQUINA,"anticoncepcion, prevencion de its y de cancer de cuello uterino",numero de inyectables trimestrales suministrados,2015-03-01,0,1,7,4,0,12
SAN PEDRO(PND),"anticoncepcion, prevencion de its y de cancer de cuello uterino",numero de inyectables trimestrales suministrados,2015-03-01,0,1,7,2,0,10
SAN RAFAEL,"anticoncepcion, prevencion de its y de cancer de cuello uterino",numero de inyectables trimestrales suministrados,2015-03-01,0,14,32,16,1,63
SAN RAMON BENI,"anticoncepcion, prevencion de its y de cancer de cuello uterino",numero de inyectables trimestrales suministrados,2015-03-01,0,2,10,6,0,18
SANTA ANA,"anticoncepcion, prevencion de its y de cancer de cuello uterino",numero de inyectables trimestrales suministrados,2015-03-01,1,8,23,3,0,35
SANTA CRUZ DE LA SIERRA,"anticoncepcion, prevencion de its y de cancer de cuello uterino",numero de inyectables trimestrales suministrados,2015-03-01,7,151,903,164,0,1225
SANTA ROSA,"anticoncepcion, prevencion de its y de cancer de cuello uterino",numero de inyectables trimestrales suministrados,2015-03-01,0,3,2,3,0,8
SANTA ROSA DEL SARA,"anticoncepcion, prevencion de its y de cancer de cuello uterino",numero de inyectables trimestrales suministrados,2015-03-01,0,8,47,17,0,72
SANTIAGO DE CALLAPA,"anticoncepcion, prevencion de its y de cancer de cuello uterino",numero de inyectables trimestrales suministrados,2015-03-01,0,1,2,0,0,3
SANTIAGO DE HUARI,"anticoncepcion, prevencion de its y de cancer de cuello uterino",numero de inyectables trimestrales suministrados,2015-03-01,0,7,17,6,0,30
SANTIAGO DE HUATA,"anticoncepcion, prevencion de its y de cancer de cuello uterino",numero de inyectables trimestrales suministrados,2015-03-01,0,1,10,6,0,17
SANTIAGO DE MACHACA,"anticoncepcion, prevencion de its y de cancer de cuello uterino",numero de inyectables trimestrales suministrados,2015-03-01,0,1,5,7,0,13
SANTIVAÑES,"anticoncepcion, prevencion de its y de cancer de cuello uterino",numero de inyectables trimestrales suministrados,2015-03-01,0,6,21,12,0,39
SANTUARIO DE QUILLACAS,"anticoncepcion, prevencion de its y de cancer de cuello uterino",numero de inyectables trimestrales suministrados,2015-03-01,0,0,4,3,0,7
SAPAHAQUI,"anticoncepcion, prevencion de its y de cancer de cuello uterino",numero de inyectables trimestrales suministrados,2015-03-01,0,1,25,14,0,40
SENA,"anticoncepcion, prevencion de its y de cancer de cuello uterino",numero de inyectables trimestrales suministrados,2015-03-01,0,2,14,2,0,18
SHINAOTA,"anticoncepcion, prevencion de its y de cancer de cuello uterino",numero de inyectables trimestrales suministrados,2015-03-01,0,5,42,12,0,59
SICA SICA (VILLA AROMA),"anticoncepcion, prevencion de its y de cancer de cuello uterino",numero de inyectables trimestrales suministrados,2015-03-01,0,1,36,27,0,64
SICAYA,"anticoncepcion, prevencion de its y de cancer de cuello uterino",numero de inyectables trimestrales suministrados,2015-03-01,0,2,14,9,0,25
SIPE SIPE,"anticoncepcion, prevencion de its y de cancer de cuello uterino",numero de inyectables trimestrales suministrados,2015-03-01,0,14,212,53,0,279
SOPACHUY,"anticoncepcion, prevencion de its y de cancer de cuello uterino",numero de inyectables trimestrales suministrados,2015-03-01,0,1,25,16,0,42
SORACACHI,"anticoncepcion, prevencion de its y de cancer de cuello uterino",numero de inyectables trimestrales suministrados,2015-03-01,0,3,19,6,0,28
SORATA,"anticoncepcion, prevencion de its y de cancer de cuello uterino",numero de inyectables trimestrales suministrados,2015-03-01,0,5,36,29,0,70
SUCRE,"anticoncepcion, prevencion de its y de cancer de cuello uterino",numero de inyectables trimestrales suministrados,2015-03-01,1,104,724,208,4,1041
TACACHI,"anticoncepcion, prevencion de its y de cancer de cuello uterino",numero de inyectables trimestrales suministrados,2015-03-01,0,0,1,0,0,1
TACACOMA,"anticoncepcion, prevencion de its y de cancer de cuello uterino",numero de inyectables trimestrales suministrados,2015-03-01,0,1,34,9,0,44
TACOBAMBA,"anticoncepcion, prevencion de its y de cancer de cuello uterino",numero de inyectables trimestrales suministrados,2015-03-01,0,2,41,25,0,68
TACOPAYA,"anticoncepcion, prevencion de its y de cancer de cuello uterino",numero de inyectables trimestrales suministrados,2015-03-01,0,2,11,19,0,32
TAPACARI,"anticoncepcion, prevencion de its y de cancer de cuello uterino",numero de inyectables trimestrales suministrados,2015-03-01,0,6,66,38,0,110
TARABUCO,"anticoncepcion, prevencion de its y de cancer de cuello uterino",numero de inyectables trimestrales suministrados,2015-03-01,0,5,42,27,0,74
TARACO,"anticoncepcion, prevencion de its y de cancer de cuello uterino",numero de inyectables trimestrales suministrados,2015-03-01,0,2,15,13,1,31
TARATA,"anticoncepcion, prevencion de its y de cancer de cuello uterino",numero de inyectables trimestrales suministrados,2015-03-01,1,5,22,15,0,43
TARIJA,"anticoncepcion, prevencion de its y de cancer de cuello uterino",numero de inyectables trimestrales suministrados,2015-03-01,1,71,261,112,2,447
TARVITA,"anticoncepcion, prevencion de its y de cancer de cuello uterino",numero de inyectables trimestrales suministrados,2015-03-01,0,7,36,25,0,68
TEOPONTE,"anticoncepcion, prevencion de its y de cancer de cuello uterino",numero de inyectables trimestrales suministrados,2015-03-01,1,2,24,10,0,37
TIAWANACU,"anticoncepcion, prevencion de its y de cancer de cuello uterino",numero de inyectables trimestrales suministrados,2015-03-01,0,0,22,17,0,39
TINGUIPAYA,"anticoncepcion, prevencion de its y de cancer de cuello uterino",numero de inyectables trimestrales suministrados,2015-03-01,0,4,26,19,2,51
TIPUANI,"anticoncepcion, prevencion de its y de cancer de cuello uterino",numero de inyectables trimestrales suministrados,2015-03-01,0,1,32,5,0,38
TIQUIPAYA,"anticoncepcion, prevencion de its y de cancer de cuello uterino",numero de inyectables trimestrales suministrados,2015-03-01,0,21,108,28,0,157
TIRAQUE (CBBA),"anticoncepcion, prevencion de its y de cancer de cuello uterino",numero de inyectables trimestrales suministrados,2015-03-01,0,5,57,32,0,94
TOCO,"anticoncepcion, prevencion de its y de cancer de cuello uterino",numero de inyectables trimestrales suministrados,2015-03-01,0,5,14,9,0,28
TODOS SANTOS,"anticoncepcion, prevencion de its y de cancer de cuello uterino",numero de inyectables trimestrales suministrados,2015-03-01,0,0,1,0,0,1
TOLATA,"anticoncepcion, prevencion de its y de cancer de cuello uterino",numero de inyectables trimestrales suministrados,2015-03-01,0,0,24,4,0,28
TOLEDO,"anticoncepcion, prevencion de its y de cancer de cuello uterino",numero de inyectables trimestrales suministrados,2015-03-01,0,0,2,3,0,5
TOMAVE,"anticoncepcion, prevencion de its y de cancer de cuello uterino",numero de inyectables trimestrales suministrados,2015-03-01,0,4,36,12,0,52
TOMINA,"anticoncepcion, prevencion de its y de cancer de cuello uterino",numero de inyectables trimestrales suministrados,2015-03-01,0,14,63,37,0,114
TORO TORO,"anticoncepcion, prevencion de its y de cancer de cuello uterino",numero de inyectables trimestrales suministrados,2015-03-01,0,2,15,10,0,27
TOTORA(CBBA),"anticoncepcion, prevencion de its y de cancer de cuello uterino",numero de inyectables trimestrales suministrados,2015-03-01,6,28,81,25,0,140
TOTORA(ORR),"anticoncepcion, prevencion de its y de cancer de cuello uterino",numero de inyectables trimestrales suministrados,2015-03-01,0,0,10,7,0,17
TRIGAL,"anticoncepcion, prevencion de its y de cancer de cuello uterino",numero de inyectables trimestrales suministrados,2015-03-01,0,1,7,3,0,11
TRINIDAD,"anticoncepcion, prevencion de its y de cancer de cuello uterino",numero de inyectables trimestrales suministrados,2015-03-01,3,19,75,15,0,112
TUPIZA,"anticoncepcion, prevencion de its y de cancer de cuello uterino",numero de inyectables trimestrales suministrados,2015-03-01,0,24,188,62,0,274
TURCO,"anticoncepcion, prevencion de its y de cancer de cuello uterino",numero de inyectables trimestrales suministrados,2015-03-01,0,3,6,12,0,21
UMALA,"anticoncepcion, prevencion de its y de cancer de cuello uterino",numero de inyectables trimestrales suministrados,2015-03-01,0,3,5,5,0,13
UNCIA,"anticoncepcion, prevencion de its y de cancer de cuello uterino",numero de inyectables trimestrales suministrados,2015-03-01,0,4,59,25,0,88
URIONDO (A. CONCEPCION),"anticoncepcion, prevencion de its y de cancer de cuello uterino",numero de inyectables trimestrales suministrados,2015-03-01,1,17,62,36,2,118
URUBICHA,"anticoncepcion, prevencion de its y de cancer de cuello uterino",numero de inyectables trimestrales suministrados,2015-03-01,0,0,16,7,0,23
UYUNI,"anticoncepcion, prevencion de its y de cancer de cuello uterino",numero de inyectables trimestrales suministrados,2015-03-01,0,7,36,9,0,52
VACAS,"anticoncepcion, prevencion de its y de cancer de cuello uterino",numero de inyectables trimestrales suministrados,2015-03-01,0,0,6,1,0,7
VALLEGRANDE,"anticoncepcion, prevencion de its y de cancer de cuello uterino",numero de inyectables trimestrales suministrados,2015-03-01,0,14,49,5,0,68
VIACHA,"anticoncepcion, prevencion de its y de cancer de cuello uterino",numero de inyectables trimestrales suministrados,2015-03-01,0,21,163,61,2,247
VILA VILA,"anticoncepcion, prevencion de its y de cancer de cuello uterino",numero de inyectables trimestrales suministrados,2015-03-01,0,2,9,3,0,14
VILLA CHARCAS,"anticoncepcion, prevencion de its y de cancer de cuello uterino",numero de inyectables trimestrales suministrados,2015-03-01,0,5,54,41,0,100
VILLA MONTES,"anticoncepcion, prevencion de its y de cancer de cuello uterino",numero de inyectables trimestrales suministrados,2015-03-01,1,11,70,17,0,99
VILLA NUEVA (LOMA ALTA),"anticoncepcion, prevencion de its y de cancer de cuello uterino",numero de inyectables trimestrales suministrados,2015-03-01,2,1,6,0,0,9
VILLA RIVERO,"anticoncepcion, prevencion de its y de cancer de cuello uterino",numero de inyectables trimestrales suministrados,2015-03-01,0,5,23,14,0,42
VILLA SERRANO,"anticoncepcion, prevencion de its y de cancer de cuello uterino",numero de inyectables trimestrales suministrados,2015-03-01,0,5,37,32,3,77
VILLA TUNARI,"anticoncepcion, prevencion de its y de cancer de cuello uterino",numero de inyectables trimestrales suministrados,2015-03-01,0,37,255,73,3,368
VILLA VACA GUZMAN (MUYUPAMPA),"anticoncepcion, prevencion de its y de cancer de cuello uterino",numero de inyectables trimestrales suministrados,2015-03-01,0,4,41,24,1,70
VILLAZON,"anticoncepcion, prevencion de its y de cancer de cuello uterino",numero de inyectables trimestrales suministrados,2015-03-01,0,23,117,51,0,191
VINTO,"anticoncepcion, prevencion de its y de cancer de cuello uterino",numero de inyectables trimestrales suministrados,2015-03-01,0,2,33,11,0,46
VITICHI,"anticoncepcion, prevencion de its y de cancer de cuello uterino",numero de inyectables trimestrales suministrados,2015-03-01,0,2,13,9,0,24
WALDO BALLIVIAN,"anticoncepcion, prevencion de its y de cancer de cuello uterino",numero de inyectables trimestrales suministrados,2015-03-01,0,1,5,4,0,10
WARNES,"anticoncepcion, prevencion de its y de cancer de cuello uterino",numero de inyectables trimestrales suministrados,2015-03-01,1,54,183,56,2,296
YACO,"anticoncepcion, prevencion de its y de cancer de cuello uterino",numero de inyectables trimestrales suministrados,2015-03-01,0,4,22,8,0,34
YACUIBA,"anticoncepcion, prevencion de its y de cancer de cuello uterino",numero de inyectables trimestrales suministrados,2015-03-01,2,37,215,106,4,364
YAMPARAEZ,"anticoncepcion, prevencion de its y de cancer de cuello uterino",numero de inyectables trimestrales suministrados,2015-03-01,0,0,14,10,0,24
YANACACHI,"anticoncepcion, prevencion de its y de cancer de cuello uterino",numero de inyectables trimestrales suministrados,2015-03-01,0,1,18,3,0,22
YAPACANI,"anticoncepcion, prevencion de its y de cancer de cuello uterino",numero de inyectables trimestrales suministrados,2015-03-01,0,7,95,22,0,124
YOCALLA,"anticoncepcion, prevencion de its y de cancer de cuello uterino",numero de inyectables trimestrales suministrados,2015-03-01,0,3,15,7,0,25
YOTALA,"anticoncepcion, prevencion de its y de cancer de cuello uterino",numero de inyectables trimestrales suministrados,2015-03-01,0,3,17,8,0,28
YUNCHARA,"anticoncepcion, prevencion de its y de cancer de cuello uterino",numero de inyectables trimestrales suministrados,2015-03-01,0,7,43,24,0,74
ZUDAÑEZ,"anticoncepcion, prevencion de its y de cancer de cuello uterino",numero de inyectables trimestrales suministrados,2015-03-01,0,5,37,21,0,63
ACACIO,"anticoncepcion, prevencion de its y de cancer de cuello uterino",numero de inyectables trimestrales suministrados,2015-04-01,0,2,8,4,0,14
ACHACACHI,"anticoncepcion, prevencion de its y de cancer de cuello uterino",numero de inyectables trimestrales suministrados,2015-04-01,1,5,57,34,1,98
ACHOCALLA,"anticoncepcion, prevencion de its y de cancer de cuello uterino",numero de inyectables trimestrales suministrados,2015-04-01,0,4,43,10,0,57
AIQUILE,"anticoncepcion, prevencion de its y de cancer de cuello uterino",numero de inyectables trimestrales suministrados,2015-04-01,0,3,27,30,0,60
ALALAY,"anticoncepcion, prevencion de its y de cancer de cuello uterino",numero de inyectables trimestrales suministrados,2015-04-01,0,0,9,2,0,11
ALCALA,"anticoncepcion, prevencion de its y de cancer de cuello uterino",numero de inyectables trimestrales suministrados,2015-04-01,0,5,16,17,1,39
ALTO BENI,"anticoncepcion, prevencion de its y de cancer de cuello uterino",numero de inyectables trimestrales suministrados,2015-04-01,0,8,34,20,0,62
ANCORAIMES,"anticoncepcion, prevencion de its y de cancer de cuello uterino",numero de inyectables trimestrales suministrados,2015-04-01,0,2,8,14,0,24
ANDAMARCA,"anticoncepcion, prevencion de its y de cancer de cuello uterino",numero de inyectables trimestrales suministrados,2015-04-01,0,0,7,7,0,14
ANTEQUERA,"anticoncepcion, prevencion de its y de cancer de cuello uterino",numero de inyectables trimestrales suministrados,2015-04-01,0,0,4,3,0,7
ANZALDO,"anticoncepcion, prevencion de its y de cancer de cuello uterino",numero de inyectables trimestrales suministrados,2015-04-01,0,6,22,12,0,40
APOLO,"anticoncepcion, prevencion de its y de cancer de cuello uterino",numero de inyectables trimestrales suministrados,2015-04-01,0,6,40,36,1,83
ARAMPAMPA,"anticoncepcion, prevencion de its y de cancer de cuello uterino",numero de inyectables trimestrales suministrados,2015-04-01,0,3,10,1,0,14
ARANI,"anticoncepcion, prevencion de its y de cancer de cuello uterino",numero de inyectables trimestrales suministrados,2015-04-01,0,2,12,15,0,29
ARBIETO,"anticoncepcion, prevencion de its y de cancer de cuello uterino",numero de inyectables trimestrales suministrados,2015-04-01,0,1,43,19,0,63
ARQUE,"anticoncepcion, prevencion de its y de cancer de cuello uterino",numero de inyectables trimestrales suministrados,2015-04-01,0,7,40,33,0,80
ASCENCION DE GUARAYOS,"anticoncepcion, prevencion de its y de cancer de cuello uterino",numero de inyectables trimestrales suministrados,2015-04-01,0,10,41,14,0,65
ATOCHA,"anticoncepcion, prevencion de its y de cancer de cuello uterino",numero de inyectables trimestrales suministrados,2015-04-01,0,3,32,14,0,49
AUCAPATA,"anticoncepcion, prevencion de its y de cancer de cuello uterino",numero de inyectables trimestrales suministrados,2015-04-01,0,1,18,7,0,26
AYATA,"anticoncepcion, prevencion de its y de cancer de cuello uterino",numero de inyectables trimestrales suministrados,2015-04-01,0,1,15,19,0,35
AYO AYO,"anticoncepcion, prevencion de its y de cancer de cuello uterino",numero de inyectables trimestrales suministrados,2015-04-01,0,2,14,7,0,23
AYOPAYA (V. DE INDEPENDENCIA),"anticoncepcion, prevencion de its y de cancer de cuello uterino",numero de inyectables trimestrales suministrados,2015-04-01,0,16,69,75,0,160
AZURDUY,"anticoncepcion, prevencion de its y de cancer de cuello uterino",numero de inyectables trimestrales suministrados,2015-04-01,0,13,44,29,1,87
BATALLAS,"anticoncepcion, prevencion de its y de cancer de cuello uterino",numero de inyectables trimestrales suministrados,2015-04-01,0,3,26,18,0,47
BAURES,"anticoncepcion, prevencion de its y de cancer de cuello uterino",numero de inyectables trimestrales suministrados,2015-04-01,0,1,7,3,0,11
BELEN DE ANDAMARCA,"anticoncepcion, prevencion de its y de cancer de cuello uterino",numero de inyectables trimestrales suministrados,2015-04-01,0,0,3,2,0,5
BELEN DE URMIRI,"anticoncepcion, prevencion de its y de cancer de cuello uterino",numero de inyectables trimestrales suministrados,2015-04-01,0,0,4,3,0,7
BELLA FLOR,"anticoncepcion, prevencion de its y de cancer de cuello uterino",numero de inyectables trimestrales suministrados,2015-04-01,0,5,11,0,1,17
BERMEJO,"anticoncepcion, prevencion de its y de cancer de cuello uterino",numero de inyectables trimestrales suministrados,2015-04-01,1,18,99,39,1,158
BETANZOS,"anticoncepcion, prevencion de its y de cancer de cuello uterino",numero de inyectables trimestrales suministrados,2015-04-01,0,5,65,37,0,107
BOLIVAR,"anticoncepcion, prevencion de its y de cancer de cuello uterino",numero de inyectables trimestrales suministrados,2015-04-01,0,1,3,5,0,9
BOLPEBRA,"anticoncepcion, prevencion de its y de cancer de cuello uterino",numero de inyectables trimestrales suministrados,2015-04-01,0,1,3,1,0,5
BOYUIBE,"anticoncepcion, prevencion de its y de cancer de cuello uterino",numero de inyectables trimestrales suministrados,2015-04-01,0,1,10,2,0,13
BUENA VISTA,"anticoncepcion, prevencion de its y de cancer de cuello uterino",numero de inyectables trimestrales suministrados,2015-04-01,0,10,29,13,0,52
CABEZAS,"anticoncepcion, prevencion de its y de cancer de cuello uterino",numero de inyectables trimestrales suministrados,2015-04-01,0,13,83,21,0,117
CAIROMA,"anticoncepcion, prevencion de its y de cancer de cuello uterino",numero de inyectables trimestrales suministrados,2015-04-01,0,2,20,6,0,28
"CAIZA ""D""","anticoncepcion, prevencion de its y de cancer de cuello uterino",numero de inyectables trimestrales suministrados,2015-04-01,0,1,17,13,0,31
CAJUATA,"anticoncepcion, prevencion de its y de cancer de cuello uterino",numero de inyectables trimestrales suministrados,2015-04-01,0,4,37,16,2,59
CALACOTO,"anticoncepcion, prevencion de its y de cancer de cuello uterino",numero de inyectables trimestrales suministrados,2015-04-01,0,0,2,6,0,8
CALAMARCA,"anticoncepcion, prevencion de its y de cancer de cuello uterino",numero de inyectables trimestrales suministrados,2015-04-01,0,4,48,22,0,74
CAMARGO,"anticoncepcion, prevencion de its y de cancer de cuello uterino",numero de inyectables trimestrales suministrados,2015-04-01,0,6,25,20,0,51
CAMATAQUI (C. VILLA ABECIA),"anticoncepcion, prevencion de its y de cancer de cuello uterino",numero de inyectables trimestrales suministrados,2015-04-01,0,2,13,10,0,25
CAMIRI,"anticoncepcion, prevencion de its y de cancer de cuello uterino",numero de inyectables trimestrales suministrados,2015-04-01,0,6,34,11,0,51
CAPINOTA,"anticoncepcion, prevencion de its y de cancer de cuello uterino",numero de inyectables trimestrales suministrados,2015-04-01,0,13,47,26,0,86
CAQUIAVIRI,"anticoncepcion, prevencion de its y de cancer de cuello uterino",numero de inyectables trimestrales suministrados,2015-04-01,0,3,12,8,0,23
CARACOLLO,"anticoncepcion, prevencion de its y de cancer de cuello uterino",numero de inyectables trimestrales suministrados,2015-04-01,0,4,26,21,1,52
CARANAVI,"anticoncepcion, prevencion de its y de cancer de cuello uterino",numero de inyectables trimestrales suministrados,2015-04-01,1,10,75,38,0,124
CARANGAS,"anticoncepcion, prevencion de its y de cancer de cuello uterino",numero de inyectables trimestrales suministrados,2015-04-01,0,0,1,0,0,1
CARAPARI,"anticoncepcion, prevencion de its y de cancer de cuello uterino",numero de inyectables trimestrales suministrados,2015-04-01,0,5,64,32,0,101
CARIPUYO,"anticoncepcion, prevencion de its y de cancer de cuello uterino",numero de inyectables trimestrales suministrados,2015-04-01,0,1,7,3,0,11
CARMEN RIVERO TORREZ,"anticoncepcion, prevencion de its y de cancer de cuello uterino",numero de inyectables trimestrales suministrados,2015-04-01,0,4,14,2,0,20
CATACORA,"anticoncepcion, prevencion de its y de cancer de cuello uterino",numero de inyectables trimestrales suministrados,2015-04-01,0,1,4,4,0,9
CHALLAPATA,"anticoncepcion, prevencion de its y de cancer de cuello uterino",numero de inyectables trimestrales suministrados,2015-04-01,0,9,34,12,0,55
CHAQUI,"anticoncepcion, prevencion de its y de cancer de cuello uterino",numero de inyectables trimestrales suministrados,2015-04-01,0,1,19,6,0,26
CHARAGUA,"anticoncepcion, prevencion de its y de cancer de cuello uterino",numero de inyectables trimestrales suministrados,2015-04-01,0,5,49,20,0,74
CHARAÑA,"anticoncepcion, prevencion de its y de cancer de cuello uterino",numero de inyectables trimestrales suministrados,2015-04-01,0,0,6,2,0,8
CHAYANTA,"anticoncepcion, prevencion de its y de cancer de cuello uterino",numero de inyectables trimestrales suministrados,2015-04-01,0,2,21,22,0,45
CHIMORE,"anticoncepcion, prevencion de its y de cancer de cuello uterino",numero de inyectables trimestrales suministrados,2015-04-01,0,5,69,17,0,91
CHIPAYA,"anticoncepcion, prevencion de its y de cancer de cuello uterino",numero de inyectables trimestrales suministrados,2015-04-01,2,1,9,4,0,16
CHOQUE COTA,"anticoncepcion, prevencion de its y de cancer de cuello uterino",numero de inyectables trimestrales suministrados,2015-04-01,0,0,0,1,0,1
CHUA COCANI,"anticoncepcion, prevencion de its y de cancer de cuello uterino",numero de inyectables trimestrales suministrados,2015-04-01,0,0,5,2,0,7
CHULUMANI (V. DE LA LIBERTAD),"anticoncepcion, prevencion de its y de cancer de cuello uterino",numero de inyectables trimestrales suministrados,2015-04-01,0,6,37,14,1,58
CHUMA,"anticoncepcion, prevencion de its y de cancer de cuello uterino",numero de inyectables trimestrales suministrados,2015-04-01,0,2,28,26,0,56
CHUQUIHUTA AYLLU JUCUMANI,"anticoncepcion, prevencion de its y de cancer de cuello uterino",numero de inyectables trimestrales suministrados,2015-04-01,0,3,14,4,0,21
CKOCHAS,"anticoncepcion, prevencion de its y de cancer de cuello uterino",numero de inyectables trimestrales suministrados,2015-04-01,0,2,29,24,0,55
CLIZA,"anticoncepcion, prevencion de its y de cancer de cuello uterino",numero de inyectables trimestrales suministrados,2015-04-01,0,2,31,6,0,39
COBIJA,"anticoncepcion, prevencion de its y de cancer de cuello uterino",numero de inyectables trimestrales suministrados,2015-04-01,1,36,114,28,0,179
COCAPATA,"anticoncepcion, prevencion de its y de cancer de cuello uterino",numero de inyectables trimestrales suministrados,2015-04-01,0,5,48,19,0,72
COCHABAMBA,"anticoncepcion, prevencion de its y de cancer de cuello uterino",numero de inyectables trimestrales suministrados,2015-04-01,0,58,360,95,0,513
COIPASA,"anticoncepcion, prevencion de its y de cancer de cuello uterino",numero de inyectables trimestrales suministrados,2015-04-01,0,0,5,3,0,8
COLCAPIRHUA,"anticoncepcion, prevencion de its y de cancer de cuello uterino",numero de inyectables trimestrales suministrados,2015-04-01,8,3,48,12,0,71
"COLCHA ""K""","anticoncepcion, prevencion de its y de cancer de cuello uterino",numero de inyectables trimestrales suministrados,2015-04-01,0,6,47,17,0,70
COLLANA,"anticoncepcion, prevencion de its y de cancer de cuello uterino",numero de inyectables trimestrales suministrados,2015-04-01,0,2,10,3,0,15
COLOMI,"anticoncepcion, prevencion de its y de cancer de cuello uterino",numero de inyectables trimestrales suministrados,2015-04-01,2,11,58,23,0,94
COLPA BELGICA,"anticoncepcion, prevencion de its y de cancer de cuello uterino",numero de inyectables trimestrales suministrados,2015-04-01,0,5,21,6,0,32
COLQUECHACA,"anticoncepcion, prevencion de its y de cancer de cuello uterino",numero de inyectables trimestrales suministrados,2015-04-01,0,3,58,32,0,93
COLQUENCHA,"anticoncepcion, prevencion de its y de cancer de cuello uterino",numero de inyectables trimestrales suministrados,2015-04-01,0,3,28,18,0,49
COLQUIRI,"anticoncepcion, prevencion de its y de cancer de cuello uterino",numero de inyectables trimestrales suministrados,2015-04-01,0,3,37,22,0,62
COMANCHE,"anticoncepcion, prevencion de its y de cancer de cuello uterino",numero de inyectables trimestrales suministrados,2015-04-01,0,0,1,0,0,1
COMARAPA,"anticoncepcion, prevencion de its y de cancer de cuello uterino",numero de inyectables trimestrales suministrados,2015-04-01,2,19,86,29,1,137
COMBAYA,"anticoncepcion, prevencion de its y de cancer de cuello uterino",numero de inyectables trimestrales suministrados,2015-04-01,0,0,3,1,0,4
CONCEPCION,"anticoncepcion, prevencion de its y de cancer de cuello uterino",numero de inyectables trimestrales suministrados,2015-04-01,0,4,38,9,0,51
COPACABANA,"anticoncepcion, prevencion de its y de cancer de cuello uterino",numero de inyectables trimestrales suministrados,2015-04-01,0,0,22,14,0,36
CORIPATA,"anticoncepcion, prevencion de its y de cancer de cuello uterino",numero de inyectables trimestrales suministrados,2015-04-01,0,0,40,16,0,56
CORO CORO,"anticoncepcion, prevencion de its y de cancer de cuello uterino",numero de inyectables trimestrales suministrados,2015-04-01,0,0,11,6,0,17
COROICO,"anticoncepcion, prevencion de its y de cancer de cuello uterino",numero de inyectables trimestrales suministrados,2015-04-01,0,3,17,5,0,25
CORQUE,"anticoncepcion, prevencion de its y de cancer de cuello uterino",numero de inyectables trimestrales suministrados,2015-04-01,0,5,22,11,0,38
COTAGAITA,"anticoncepcion, prevencion de its y de cancer de cuello uterino",numero de inyectables trimestrales suministrados,2015-04-01,0,5,60,39,1,105
COTOCA,"anticoncepcion, prevencion de its y de cancer de cuello uterino",numero de inyectables trimestrales suministrados,2015-04-01,0,22,108,18,0,148
CUATRO CAÑADAS,"anticoncepcion, prevencion de its y de cancer de cuello uterino",numero de inyectables trimestrales suministrados,2015-04-01,0,2,44,9,1,56
CUCHUMUELA (V. G. VILLARROEL),"anticoncepcion, prevencion de its y de cancer de cuello uterino",numero de inyectables trimestrales suministrados,2015-04-01,0,0,6,2,0,8
CUEVO,"anticoncepcion, prevencion de its y de cancer de cuello uterino",numero de inyectables trimestrales suministrados,2015-04-01,1,2,25,5,0,33
CULPINA,"anticoncepcion, prevencion de its y de cancer de cuello uterino",numero de inyectables trimestrales suministrados,2015-04-01,0,14,64,37,0,115
CURAHUARA DE CARANGAS,"anticoncepcion, prevencion de its y de cancer de cuello uterino",numero de inyectables trimestrales suministrados,2015-04-01,0,2,4,10,0,16
CURVA,"anticoncepcion, prevencion de its y de cancer de cuello uterino",numero de inyectables trimestrales suministrados,2015-04-01,0,0,5,4,0,9
DESAGUADERO,"anticoncepcion, prevencion de its y de cancer de cuello uterino",numero de inyectables trimestrales suministrados,2015-04-01,0,0,9,9,0,18
EL ALTO,"anticoncepcion, prevencion de its y de cancer de cuello uterino",numero de inyectables trimestrales suministrados,2015-04-01,1,118,1134,362,1,1616
EL CHORO,"anticoncepcion, prevencion de its y de cancer de cuello uterino",numero de inyectables trimestrales suministrados,2015-04-01,0,0,12,3,0,15
EL PUENTE(STC),"anticoncepcion, prevencion de its y de cancer de cuello uterino",numero de inyectables trimestrales suministrados,2015-04-01,0,12,41,24,0,77
EL PUENTE(TJA),"anticoncepcion, prevencion de its y de cancer de cuello uterino",numero de inyectables trimestrales suministrados,2015-04-01,0,13,72,39,0,124
EL TORNO,"anticoncepcion, prevencion de its y de cancer de cuello uterino",numero de inyectables trimestrales suministrados,2015-04-01,10,29,98,55,3,195
EL VILLAR,"anticoncepcion, prevencion de its y de cancer de cuello uterino",numero de inyectables trimestrales suministrados,2015-04-01,0,4,23,15,0,42
ENTRE RIOS TRJ,"anticoncepcion, prevencion de its y de cancer de cuello uterino",numero de inyectables trimestrales suministrados,2015-04-01,0,25,115,45,1,186
ENTRE RIOS CBBA,"anticoncepcion, prevencion de its y de cancer de cuello uterino",numero de inyectables trimestrales suministrados,2015-04-01,0,12,52,17,0,81
ESCOMA,"anticoncepcion, prevencion de its y de cancer de cuello uterino",numero de inyectables trimestrales suministrados,2015-04-01,0,1,4,1,0,6
ESMERALDA,"anticoncepcion, prevencion de its y de cancer de cuello uterino",numero de inyectables trimestrales suministrados,2015-04-01,0,0,1,0,0,1
EUCALIPTUS,"anticoncepcion, prevencion de its y de cancer de cuello uterino",numero de inyectables trimestrales suministrados,2015-04-01,0,0,7,5,0,12
EUREKA (SANTOS MERCADO),"anticoncepcion, prevencion de its y de cancer de cuello uterino",numero de inyectables trimestrales suministrados,2015-04-01,0,0,6,3,0,9
EXALTACION,"anticoncepcion, prevencion de its y de cancer de cuello uterino",numero de inyectables trimestrales suministrados,2015-04-01,0,0,3,0,0,3
FERNANDEZ ALONSO,"anticoncepcion, prevencion de its y de cancer de cuello uterino",numero de inyectables trimestrales suministrados,2015-04-01,0,4,42,21,1,68
FILADELFIA,"anticoncepcion, prevencion de its y de cancer de cuello uterino",numero de inyectables trimestrales suministrados,2015-04-01,1,14,9,4,0,28
GENERAL SAAVEDRA,"anticoncepcion, prevencion de its y de cancer de cuello uterino",numero de inyectables trimestrales suministrados,2015-04-01,1,14,41,17,0,73
GRAL. J.J. PEREZ (CHARAZANI),"anticoncepcion, prevencion de its y de cancer de cuello uterino",numero de inyectables trimestrales suministrados,2015-04-01,0,3,23,13,0,39
GUANAY,"anticoncepcion, prevencion de its y de cancer de cuello uterino",numero de inyectables trimestrales suministrados,2015-04-01,0,1,20,5,1,27
GUAQUI,"anticoncepcion, prevencion de its y de cancer de cuello uterino",numero de inyectables trimestrales suministrados,2015-04-01,0,4,21,7,0,32
GUAYARAMERIN,"anticoncepcion, prevencion de its y de cancer de cuello uterino",numero de inyectables trimestrales suministrados,2015-04-01,0,24,45,8,0,77
GUTIERREZ,"anticoncepcion, prevencion de its y de cancer de cuello uterino",numero de inyectables trimestrales suministrados,2015-04-01,0,3,16,7,0,26
HUACARETA,"anticoncepcion, prevencion de its y de cancer de cuello uterino",numero de inyectables trimestrales suministrados,2015-04-01,0,6,24,16,0,46
HUACAYA (VILLA DE HUACAYA),"anticoncepcion, prevencion de its y de cancer de cuello uterino",numero de inyectables trimestrales suministrados,2015-04-01,0,0,17,1,0,18
HUACHACALLA,"anticoncepcion, prevencion de its y de cancer de cuello uterino",numero de inyectables trimestrales suministrados,2015-04-01,0,0,2,3,0,5
HUANUNI,"anticoncepcion, prevencion de its y de cancer de cuello uterino",numero de inyectables trimestrales suministrados,2015-04-01,0,0,17,6,0,23
HUARACAJE,"anticoncepcion, prevencion de its y de cancer de cuello uterino",numero de inyectables trimestrales suministrados,2015-04-01,0,1,5,3,0,9
HUARINA,"anticoncepcion, prevencion de its y de cancer de cuello uterino",numero de inyectables trimestrales suministrados,2015-04-01,0,1,6,1,0,8
HUATAJATA,"anticoncepcion, prevencion de its y de cancer de cuello uterino",numero de inyectables trimestrales suministrados,2015-04-01,0,0,7,3,0,10
HUAYLLAMARCA,"anticoncepcion, prevencion de its y de cancer de cuello uterino",numero de inyectables trimestrales suministrados,2015-04-01,0,5,5,6,0,16
HUMANATA,"anticoncepcion, prevencion de its y de cancer de cuello uterino",numero de inyectables trimestrales suministrados,2015-04-01,0,3,6,2,0,11
ICHOCA,"anticoncepcion, prevencion de its y de cancer de cuello uterino",numero de inyectables trimestrales suministrados,2015-04-01,0,1,6,2,0,9
ICLA,"anticoncepcion, prevencion de its y de cancer de cuello uterino",numero de inyectables trimestrales suministrados,2015-04-01,0,1,15,13,0,29
INCAHUASI,"anticoncepcion, prevencion de its y de cancer de cuello uterino",numero de inyectables trimestrales suministrados,2015-04-01,0,5,34,17,0,56
INGAVI (HUMAITA),"anticoncepcion, prevencion de its y de cancer de cuello uterino",numero de inyectables trimestrales suministrados,2015-04-01,0,3,7,1,0,11
INQUISIVI,"anticoncepcion, prevencion de its y de cancer de cuello uterino",numero de inyectables trimestrales suministrados,2015-04-01,0,0,19,15,0,34
IRUPANA (VILLA DE LANZA),"anticoncepcion, prevencion de its y de cancer de cuello uterino",numero de inyectables trimestrales suministrados,2015-04-01,0,6,50,16,0,72
IXIAMAS,"anticoncepcion, prevencion de its y de cancer de cuello uterino",numero de inyectables trimestrales suministrados,2015-04-01,0,6,32,5,0,43
JESUS DE MACHACA,"anticoncepcion, prevencion de its y de cancer de cuello uterino",numero de inyectables trimestrales suministrados,2015-04-01,0,0,6,5,0,11
LA ASUNTA,"anticoncepcion, prevencion de its y de cancer de cuello uterino",numero de inyectables trimestrales suministrados,2015-04-01,0,11,130,49,0,190
LA GUARDIA,"anticoncepcion, prevencion de its y de cancer de cuello uterino",numero de inyectables trimestrales suministrados,2015-04-01,0,35,112,31,0,178
LA PAZ,"anticoncepcion, prevencion de its y de cancer de cuello uterino",numero de inyectables trimestrales suministrados,2015-04-01,1,57,431,119,4,612
LAGUNILLAS,"anticoncepcion, prevencion de its y de cancer de cuello uterino",numero de inyectables trimestrales suministrados,2015-04-01,0,2,6,0,0,8
LAJA,"anticoncepcion, prevencion de its y de cancer de cuello uterino",numero de inyectables trimestrales suministrados,2015-04-01,0,8,53,22,2,85
LAS CARRERAS,"anticoncepcion, prevencion de its y de cancer de cuello uterino",numero de inyectables trimestrales suministrados,2015-04-01,0,2,11,5,0,18
LICOMA PAMPA,"anticoncepcion, prevencion de its y de cancer de cuello uterino",numero de inyectables trimestrales suministrados,2015-04-01,0,2,10,5,0,17
LLALLAGUA,"anticoncepcion, prevencion de its y de cancer de cuello uterino",numero de inyectables trimestrales suministrados,2015-04-01,0,3,74,16,0,93
LLICA,"anticoncepcion, prevencion de its y de cancer de cuello uterino",numero de inyectables trimestrales suministrados,2015-04-01,0,3,19,9,0,31
LORETO,"anticoncepcion, prevencion de its y de cancer de cuello uterino",numero de inyectables trimestrales suministrados,2015-04-01,0,4,5,3,0,12
LURIBAY,"anticoncepcion, prevencion de its y de cancer de cuello uterino",numero de inyectables trimestrales suministrados,2015-04-01,0,1,22,24,0,47
MACHACAMARCA,"anticoncepcion, prevencion de its y de cancer de cuello uterino",numero de inyectables trimestrales suministrados,2015-04-01,0,0,3,1,0,4
MACHARETI,"anticoncepcion, prevencion de its y de cancer de cuello uterino",numero de inyectables trimestrales suministrados,2015-04-01,0,5,28,9,0,42
MAGDALENA,"anticoncepcion, prevencion de its y de cancer de cuello uterino",numero de inyectables trimestrales suministrados,2015-04-01,0,1,13,5,0,19
MAIRANA,"anticoncepcion, prevencion de its y de cancer de cuello uterino",numero de inyectables trimestrales suministrados,2015-04-01,0,9,29,5,0,43
MALLA,"anticoncepcion, prevencion de its y de cancer de cuello uterino",numero de inyectables trimestrales suministrados,2015-04-01,0,0,6,1,0,7
MAPIRI,"anticoncepcion, prevencion de its y de cancer de cuello uterino",numero de inyectables trimestrales suministrados,2015-04-01,0,3,20,4,0,27
MECAPACA,"anticoncepcion, prevencion de its y de cancer de cuello uterino",numero de inyectables trimestrales suministrados,2015-04-01,0,0,17,12,0,29
MINEROS,"anticoncepcion, prevencion de its y de cancer de cuello uterino",numero de inyectables trimestrales suministrados,2015-04-01,1,17,57,12,0,87
MIZQUE,"anticoncepcion, prevencion de its y de cancer de cuello uterino",numero de inyectables trimestrales suministrados,2015-04-01,0,13,86,32,0,131
MOCOMOCO,"anticoncepcion, prevencion de its y de cancer de cuello uterino",numero de inyectables trimestrales suministrados,2015-04-01,0,1,19,15,0,35
MOJINETE,"anticoncepcion, prevencion de its y de cancer de cuello uterino",numero de inyectables trimestrales suministrados,2015-04-01,0,0,6,2,0,8
MOJOCOYA,"anticoncepcion, prevencion de its y de cancer de cuello uterino",numero de inyectables trimestrales suministrados,2015-04-01,0,1,39,27,0,67
MONTEAGUDO,"anticoncepcion, prevencion de its y de cancer de cuello uterino",numero de inyectables trimestrales suministrados,2015-04-01,0,17,75,40,0,132
MONTERO,"anticoncepcion, prevencion de its y de cancer de cuello uterino",numero de inyectables trimestrales suministrados,2015-04-01,0,34,172,40,0,246
MORO MORO,"anticoncepcion, prevencion de its y de cancer de cuello uterino",numero de inyectables trimestrales suministrados,2015-04-01,0,6,11,7,1,25
MOROCHATA,"anticoncepcion, prevencion de its y de cancer de cuello uterino",numero de inyectables trimestrales suministrados,2015-04-01,0,4,39,32,1,76
NACEBE (SANTA ROSA DEL ABUNA),"anticoncepcion, prevencion de its y de cancer de cuello uterino",numero de inyectables trimestrales suministrados,2015-04-01,0,15,7,1,0,23
NAZACARA DE PACAJES,"anticoncepcion, prevencion de its y de cancer de cuello uterino",numero de inyectables trimestrales suministrados,2015-04-01,0,0,1,1,0,2
NUEVO MANOA (NUEVA ESPERANZA),"anticoncepcion, prevencion de its y de cancer de cuello uterino",numero de inyectables trimestrales suministrados,2015-04-01,0,1,0,0,0,1
OCURI,"anticoncepcion, prevencion de its y de cancer de cuello uterino",numero de inyectables trimestrales suministrados,2015-04-01,0,1,45,19,0,65
OKINAWA,"anticoncepcion, prevencion de its y de cancer de cuello uterino",numero de inyectables trimestrales suministrados,2015-04-01,0,7,31,5,0,43
OMEREQUE,"anticoncepcion, prevencion de its y de cancer de cuello uterino",numero de inyectables trimestrales suministrados,2015-04-01,0,1,25,17,0,43
ORURO,"anticoncepcion, prevencion de its y de cancer de cuello uterino",numero de inyectables trimestrales suministrados,2015-04-01,0,27,426,162,1,616
PADCAYA,"anticoncepcion, prevencion de its y de cancer de cuello uterino",numero de inyectables trimestrales suministrados,2015-04-01,2,22,105,72,0,201
PADILLA,"anticoncepcion, prevencion de its y de cancer de cuello uterino",numero de inyectables trimestrales suministrados,2015-04-01,0,8,62,35,1,106
PAILON,"anticoncepcion, prevencion de its y de cancer de cuello uterino",numero de inyectables trimestrales suministrados,2015-04-01,2,14,38,4,0,58
PALCA,"anticoncepcion, prevencion de its y de cancer de cuello uterino",numero de inyectables trimestrales suministrados,2015-04-01,1,7,41,10,1,60
PALOS BLANCOS,"anticoncepcion, prevencion de its y de cancer de cuello uterino",numero de inyectables trimestrales suministrados,2015-04-01,2,8,57,41,1,109
PAMPA AULLAGAS,"anticoncepcion, prevencion de its y de cancer de cuello uterino",numero de inyectables trimestrales suministrados,2015-04-01,0,0,5,1,0,6
PAMPA GRANDE,"anticoncepcion, prevencion de its y de cancer de cuello uterino",numero de inyectables trimestrales suministrados,2015-04-01,0,4,24,10,1,39
PAPEL PAMPA,"anticoncepcion, prevencion de its y de cancer de cuello uterino",numero de inyectables trimestrales suministrados,2015-04-01,0,3,17,6,0,26
PASORAPA,"anticoncepcion, prevencion de its y de cancer de cuello uterino",numero de inyectables trimestrales suministrados,2015-04-01,0,3,14,13,0,30
PATACAMAYA,"anticoncepcion, prevencion de its y de cancer de cuello uterino",numero de inyectables trimestrales suministrados,2015-04-01,0,0,14,0,0,14
PAZÑA,"anticoncepcion, prevencion de its y de cancer de cuello uterino",numero de inyectables trimestrales suministrados,2015-04-01,0,3,13,11,0,27
PELECHUCO,"anticoncepcion, prevencion de its y de cancer de cuello uterino",numero de inyectables trimestrales suministrados,2015-04-01,0,2,13,9,0,24
POCOATA,"anticoncepcion, prevencion de its y de cancer de cuello uterino",numero de inyectables trimestrales suministrados,2015-04-01,0,2,47,19,0,68
POCONA,"anticoncepcion, prevencion de its y de cancer de cuello uterino",numero de inyectables trimestrales suministrados,2015-04-01,0,2,56,41,0,99
POJO (CBBA),"anticoncepcion, prevencion de its y de cancer de cuello uterino",numero de inyectables trimestrales suministrados,2015-04-01,0,7,64,41,0,112
POOPO,"anticoncepcion, prevencion de its y de cancer de cuello uterino",numero de inyectables trimestrales suministrados,2015-04-01,0,2,12,0,0,14
PORCO,"anticoncepcion, prevencion de its y de cancer de cuello uterino",numero de inyectables trimestrales suministrados,2015-04-01,0,4,19,6,0,29
POROMA,"anticoncepcion, prevencion de its y de cancer de cuello uterino",numero de inyectables trimestrales suministrados,2015-04-01,0,7,46,26,0,79
PORONGO,"anticoncepcion, prevencion de its y de cancer de cuello uterino",numero de inyectables trimestrales suministrados,2015-04-01,0,1,11,10,0,22
PORTACHUELO,"anticoncepcion, prevencion de its y de cancer de cuello uterino",numero de inyectables trimestrales suministrados,2015-04-01,0,8,39,1,0,48
PORVENIR,"anticoncepcion, prevencion de its y de cancer de cuello uterino",numero de inyectables trimestrales suministrados,2015-04-01,0,4,17,2,0,23
POSTRER VALLE,"anticoncepcion, prevencion de its y de cancer de cuello uterino",numero de inyectables trimestrales suministrados,2015-04-01,0,1,5,2,0,8
POTOSI,"anticoncepcion, prevencion de its y de cancer de cuello uterino",numero de inyectables trimestrales suministrados,2015-04-01,2,53,472,169,0,696
PRESTO,"anticoncepcion, prevencion de its y de cancer de cuello uterino",numero de inyectables trimestrales suministrados,2015-04-01,0,8,33,13,0,54
PUCARA,"anticoncepcion, prevencion de its y de cancer de cuello uterino",numero de inyectables trimestrales suministrados,2015-04-01,0,1,7,3,0,11
PUCARANI,"anticoncepcion, prevencion de its y de cancer de cuello uterino",numero de inyectables trimestrales suministrados,2015-04-01,0,7,52,23,0,82
PUERTO ACOSTA,"anticoncepcion, prevencion de its y de cancer de cuello uterino",numero de inyectables trimestrales suministrados,2015-04-01,1,2,6,4,0,13
PUERTO CARABUCO,"anticoncepcion, prevencion de its y de cancer de cuello uterino",numero de inyectables trimestrales suministrados,2015-04-01,0,0,21,14,0,35
PUERTO GONZALO MORENO,"anticoncepcion, prevencion de its y de cancer de cuello uterino",numero de inyectables trimestrales suministrados,2015-04-01,1,5,26,6,0,38
PUERTO PEREZ,"anticoncepcion, prevencion de its y de cancer de cuello uterino",numero de inyectables trimestrales suministrados,2015-04-01,0,1,11,5,0,17
PUERTO QUIJARRO,"anticoncepcion, prevencion de its y de cancer de cuello uterino",numero de inyectables trimestrales suministrados,2015-04-01,0,4,20,7,0,31
PUERTO RICO,"anticoncepcion, prevencion de its y de cancer de cuello uterino",numero de inyectables trimestrales suministrados,2015-04-01,0,9,30,4,0,43
PUERTO SILES,"anticoncepcion, prevencion de its y de cancer de cuello uterino",numero de inyectables trimestrales suministrados,2015-04-01,0,0,2,0,0,2
PUERTO SUAREZ,"anticoncepcion, prevencion de its y de cancer de cuello uterino",numero de inyectables trimestrales suministrados,2015-04-01,1,6,5,0,0,12
PUERTO VILLARROEL,"anticoncepcion, prevencion de its y de cancer de cuello uterino",numero de inyectables trimestrales suministrados,2015-04-01,0,15,77,14,0,106
PUNA,"anticoncepcion, prevencion de its y de cancer de cuello uterino",numero de inyectables trimestrales suministrados,2015-04-01,0,2,27,20,0,49
PUNATA,"anticoncepcion, prevencion de its y de cancer de cuello uterino",numero de inyectables trimestrales suministrados,2015-04-01,0,5,39,12,0,56
QUIABAYA,"anticoncepcion, prevencion de its y de cancer de cuello uterino",numero de inyectables trimestrales suministrados,2015-04-01,0,0,8,7,0,15
QUILLACOLLO,"anticoncepcion, prevencion de its y de cancer de cuello uterino",numero de inyectables trimestrales suministrados,2015-04-01,0,32,200,22,0,254
QUIME,"anticoncepcion, prevencion de its y de cancer de cuello uterino",numero de inyectables trimestrales suministrados,2015-04-01,0,2,26,15,0,43
QUIRUSILLAS,"anticoncepcion, prevencion de its y de cancer de cuello uterino",numero de inyectables trimestrales suministrados,2015-04-01,0,2,5,3,0,10
RAVELO,"anticoncepcion, prevencion de its y de cancer de cuello uterino",numero de inyectables trimestrales suministrados,2015-04-01,0,5,42,47,0,94
REYES,"anticoncepcion, prevencion de its y de cancer de cuello uterino",numero de inyectables trimestrales suministrados,2015-04-01,0,16,39,13,0,68
RIBERALTA,"anticoncepcion, prevencion de its y de cancer de cuello uterino",numero de inyectables trimestrales suministrados,2015-04-01,1,45,172,27,0,245
ROBORE,"anticoncepcion, prevencion de its y de cancer de cuello uterino",numero de inyectables trimestrales suministrados,2015-04-01,0,8,33,5,0,46
RURRENABAQUE,"anticoncepcion, prevencion de its y de cancer de cuello uterino",numero de inyectables trimestrales suministrados,2015-04-01,1,4,49,16,0,70
SABAYA,"anticoncepcion, prevencion de its y de cancer de cuello uterino",numero de inyectables trimestrales suministrados,2015-04-01,0,2,9,8,0,19
SACABA,"anticoncepcion, prevencion de its y de cancer de cuello uterino",numero de inyectables trimestrales suministrados,2015-04-01,1,27,145,69,0,242
SACABAMBA,"anticoncepcion, prevencion de its y de cancer de cuello uterino",numero de inyectables trimestrales suministrados,2015-04-01,0,0,0,5,0,5
SACACA,"anticoncepcion, prevencion de its y de cancer de cuello uterino",numero de inyectables trimestrales suministrados,2015-04-01,0,7,46,26,1,80
SAIPINA,"anticoncepcion, prevencion de its y de cancer de cuello uterino",numero de inyectables trimestrales suministrados,2015-04-01,1,6,18,8,0,33
SALINAS DE GARCI MENDOZA,"anticoncepcion, prevencion de its y de cancer de cuello uterino",numero de inyectables trimestrales suministrados,2015-04-01,0,4,22,9,0,35
SAMAIPATA,"anticoncepcion, prevencion de its y de cancer de cuello uterino",numero de inyectables trimestrales suministrados,2015-04-01,0,7,29,8,0,44
SAN AGUSTIN,"anticoncepcion, prevencion de its y de cancer de cuello uterino",numero de inyectables trimestrales suministrados,2015-04-01,0,0,10,1,0,11
SAN ANDRES,"anticoncepcion, prevencion de its y de cancer de cuello uterino",numero de inyectables trimestrales suministrados,2015-04-01,0,9,20,15,1,45
SAN ANDRES DE MACHACA,"anticoncepcion, prevencion de its y de cancer de cuello uterino",numero de inyectables trimestrales suministrados,2015-04-01,0,0,6,4,0,10
SAN ANTONIO DE ESMORUCO,"anticoncepcion, prevencion de its y de cancer de cuello uterino",numero de inyectables trimestrales suministrados,2015-04-01,0,0,2,2,0,4
SAN ANTONIO DE LOMERIO,"anticoncepcion, prevencion de its y de cancer de cuello uterino",numero de inyectables trimestrales suministrados,2015-04-01,0,4,37,32,0,73
SAN BENITO,"anticoncepcion, prevencion de its y de cancer de cuello uterino",numero de inyectables trimestrales suministrados,2015-04-01,1,6,17,0,0,24
SAN BORJA,"anticoncepcion, prevencion de its y de cancer de cuello uterino",numero de inyectables trimestrales suministrados,2015-04-01,1,17,86,33,2,139
SAN BUENA VENTURA,"anticoncepcion, prevencion de its y de cancer de cuello uterino",numero de inyectables trimestrales suministrados,2015-04-01,0,3,16,3,0,22
SAN CARLOS,"anticoncepcion, prevencion de its y de cancer de cuello uterino",numero de inyectables trimestrales suministrados,2015-04-01,0,9,34,12,0,55
SAN IGNACIO,"anticoncepcion, prevencion de its y de cancer de cuello uterino",numero de inyectables trimestrales suministrados,2015-04-01,5,31,83,45,0,164
SAN IGNACIO DE VELASCO,"anticoncepcion, prevencion de its y de cancer de cuello uterino",numero de inyectables trimestrales suministrados,2015-04-01,0,23,146,52,0,221
SAN JAVIER(BNI),"anticoncepcion, prevencion de its y de cancer de cuello uterino",numero de inyectables trimestrales suministrados,2015-04-01,0,0,9,0,0,9
SAN JAVIER(STC),"anticoncepcion, prevencion de its y de cancer de cuello uterino",numero de inyectables trimestrales suministrados,2015-04-01,0,7,17,7,0,31
SAN JOSE DE CHIQUITOS,"anticoncepcion, prevencion de its y de cancer de cuello uterino",numero de inyectables trimestrales suministrados,2015-04-01,0,6,32,13,0,51
SAN JUAN DE YAPACANI,"anticoncepcion, prevencion de its y de cancer de cuello uterino",numero de inyectables trimestrales suministrados,2015-04-01,0,0,24,9,0,33
SAN JULIAN,"anticoncepcion, prevencion de its y de cancer de cuello uterino",numero de inyectables trimestrales suministrados,2015-04-01,1,17,88,44,0,150
SAN LORENZO(PND),"anticoncepcion, prevencion de its y de cancer de cuello uterino",numero de inyectables trimestrales suministrados,2015-04-01,0,1,5,1,0,7
SAN LORENZO(TJA),"anticoncepcion, prevencion de its y de cancer de cuello uterino",numero de inyectables trimestrales suministrados,2015-04-01,2,12,84,39,1,138
SAN LUCAS,"anticoncepcion, prevencion de its y de cancer de cuello uterino",numero de inyectables trimestrales suministrados,2015-04-01,0,4,62,40,0,106
SAN MATIAS,"anticoncepcion, prevencion de its y de cancer de cuello uterino",numero de inyectables trimestrales suministrados,2015-04-01,0,3,29,15,0,47
SAN MIGUEL DE VELASCO,"anticoncepcion, prevencion de its y de cancer de cuello uterino",numero de inyectables trimestrales suministrados,2015-04-01,2,13,84,30,1,130
SAN PABLO DE LIPEZ,"anticoncepcion, prevencion de its y de cancer de cuello uterino",numero de inyectables trimestrales suministrados,2015-04-01,0,1,2,2,0,5
SAN PEDRO,"anticoncepcion, prevencion de its y de cancer de cuello uterino",numero de inyectables trimestrales suministrados,2015-04-01,0,11,35,20,0,66
SAN PEDRO DE BUENA VISTA,"anticoncepcion, prevencion de its y de cancer de cuello uterino",numero de inyectables trimestrales suministrados,2015-04-01,3,18,37,13,0,71
SAN PEDRO DE CURAHUARA,"anticoncepcion, prevencion de its y de cancer de cuello uterino",numero de inyectables trimestrales suministrados,2015-04-01,0,3,5,10,0,18
SAN PEDRO DE QUEMES,"anticoncepcion, prevencion de its y de cancer de cuello uterino",numero de inyectables trimestrales suministrados,2015-04-01,0,0,1,0,0,1
SAN PEDRO DE TIQUINA,"anticoncepcion, prevencion de its y de cancer de cuello uterino",numero de inyectables trimestrales suministrados,2015-04-01,0,0,7,2,0,9
SAN PEDRO(PND),"anticoncepcion, prevencion de its y de cancer de cuello uterino",numero de inyectables trimestrales suministrados,2015-04-01,0,1,4,0,0,5
SAN RAFAEL,"anticoncepcion, prevencion de its y de cancer de cuello uterino",numero de inyectables trimestrales suministrados,2015-04-01,0,11,39,17,0,67
SAN RAMON BENI,"anticoncepcion, prevencion de its y de cancer de cuello uterino",numero de inyectables trimestrales suministrados,2015-04-01,0,0,7,1,0,8
SANTA ANA,"anticoncepcion, prevencion de its y de cancer de cuello uterino",numero de inyectables trimestrales suministrados,2015-04-01,1,2,17,2,0,22
SANTA CRUZ DE LA SIERRA,"anticoncepcion, prevencion de its y de cancer de cuello uterino",numero de inyectables trimestrales suministrados,2015-04-01,0,124,534,129,0,787
SANTA ROSA,"anticoncepcion, prevencion de its y de cancer de cuello uterino",numero de inyectables trimestrales suministrados,2015-04-01,0,2,11,8,1,22
SANTA ROSA DEL SARA,"anticoncepcion, prevencion de its y de cancer de cuello uterino",numero de inyectables trimestrales suministrados,2015-04-01,2,14,54,19,1,90
SANTIAGO DE CALLAPA,"anticoncepcion, prevencion de its y de cancer de cuello uterino",numero de inyectables trimestrales suministrados,2015-04-01,0,0,0,3,0,3
SANTIAGO DE HUARI,"anticoncepcion, prevencion de its y de cancer de cuello uterino",numero de inyectables trimestrales suministrados,2015-04-01,0,3,5,5,0,13
SANTIAGO DE HUATA,"anticoncepcion, prevencion de its y de cancer de cuello uterino",numero de inyectables trimestrales suministrados,2015-04-01,0,2,12,6,0,20
SANTIAGO DE MACHACA,"anticoncepcion, prevencion de its y de cancer de cuello uterino",numero de inyectables trimestrales suministrados,2015-04-01,0,1,5,2,0,8
SANTIVAÑES,"anticoncepcion, prevencion de its y de cancer de cuello uterino",numero de inyectables trimestrales suministrados,2015-04-01,0,3,22,4,0,29
SANTUARIO DE QUILLACAS,"anticoncepcion, prevencion de its y de cancer de cuello uterino",numero de inyectables trimestrales suministrados,2015-04-01,0,0,3,3,0,6
SAPAHAQUI,"anticoncepcion, prevencion de its y de cancer de cuello uterino",numero de inyectables trimestrales suministrados,2015-04-01,0,1,23,15,0,39
SENA,"anticoncepcion, prevencion de its y de cancer de cuello uterino",numero de inyectables trimestrales suministrados,2015-04-01,0,2,14,5,0,21
SHINAOTA,"anticoncepcion, prevencion de its y de cancer de cuello uterino",numero de inyectables trimestrales suministrados,2015-04-01,0,2,53,9,0,64
SICA SICA (VILLA AROMA),"anticoncepcion, prevencion de its y de cancer de cuello uterino",numero de inyectables trimestrales suministrados,2015-04-01,0,5,47,25,1,78
SICAYA,"anticoncepcion, prevencion de its y de cancer de cuello uterino",numero de inyectables trimestrales suministrados,2015-04-01,0,3,10,7,0,20
SIPE SIPE,"anticoncepcion, prevencion de its y de cancer de cuello uterino",numero de inyectables trimestrales suministrados,2015-04-01,0,14,162,74,0,250
SOPACHUY,"anticoncepcion, prevencion de its y de cancer de cuello uterino",numero de inyectables trimestrales suministrados,2015-04-01,0,4,22,19,0,45
SORACACHI,"anticoncepcion, prevencion de its y de cancer de cuello uterino",numero de inyectables trimestrales suministrados,2015-04-01,0,2,18,13,0,33
SORATA,"anticoncepcion, prevencion de its y de cancer de cuello uterino",numero de inyectables trimestrales suministrados,2015-04-01,0,6,40,26,0,72
SUCRE,"anticoncepcion, prevencion de its y de cancer de cuello uterino",numero de inyectables trimestrales suministrados,2015-04-01,1,89,557,177,0,824
TACACHI,"anticoncepcion, prevencion de its y de cancer de cuello uterino",numero de inyectables trimestrales suministrados,2015-04-01,0,0,3,1,0,4
TACACOMA,"anticoncepcion, prevencion de its y de cancer de cuello uterino",numero de inyectables trimestrales suministrados,2015-04-01,0,0,18,8,0,26
TACOBAMBA,"anticoncepcion, prevencion de its y de cancer de cuello uterino",numero de inyectables trimestrales suministrados,2015-04-01,0,0,16,10,0,26
TACOPAYA,"anticoncepcion, prevencion de its y de cancer de cuello uterino",numero de inyectables trimestrales suministrados,2015-04-01,0,1,9,5,0,15
TAHUA,"anticoncepcion, prevencion de its y de cancer de cuello uterino",numero de inyectables trimestrales suministrados,2015-04-01,0,0,0,1,0,1
TAPACARI,"anticoncepcion, prevencion de its y de cancer de cuello uterino",numero de inyectables trimestrales suministrados,2015-04-01,0,3,66,48,0,117
TARABUCO,"anticoncepcion, prevencion de its y de cancer de cuello uterino",numero de inyectables trimestrales suministrados,2015-04-01,0,6,38,27,0,71
TARACO,"anticoncepcion, prevencion de its y de cancer de cuello uterino",numero de inyectables trimestrales suministrados,2015-04-01,0,3,13,7,1,24
TARATA,"anticoncepcion, prevencion de its y de cancer de cuello uterino",numero de inyectables trimestrales suministrados,2015-04-01,0,8,28,15,0,51
TARIJA,"anticoncepcion, prevencion de its y de cancer de cuello uterino",numero de inyectables trimestrales suministrados,2015-04-01,2,70,280,95,0,447
TARVITA,"anticoncepcion, prevencion de its y de cancer de cuello uterino",numero de inyectables trimestrales suministrados,2015-04-01,0,6,19,18,0,43
TEOPONTE,"anticoncepcion, prevencion de its y de cancer de cuello uterino",numero de inyectables trimestrales suministrados,2015-04-01,0,7,17,12,0,36
TIAWANACU,"anticoncepcion, prevencion de its y de cancer de cuello uterino",numero de inyectables trimestrales suministrados,2015-04-01,0,3,32,22,0,57
TINGUIPAYA,"anticoncepcion, prevencion de its y de cancer de cuello uterino",numero de inyectables trimestrales suministrados,2015-04-01,0,4,20,13,0,37
TIPUANI,"anticoncepcion, prevencion de its y de cancer de cuello uterino",numero de inyectables trimestrales suministrados,2015-04-01,0,6,29,5,0,40
TIQUIPAYA,"anticoncepcion, prevencion de its y de cancer de cuello uterino",numero de inyectables trimestrales suministrados,2015-04-01,0,12,95,34,0,141
TIRAQUE (CBBA),"anticoncepcion, prevencion de its y de cancer de cuello uterino",numero de inyectables trimestrales suministrados,2015-04-01,0,10,49,38,0,97
TITO YUPANQUI (PARQUIPUJIO),"anticoncepcion, prevencion de its y de cancer de cuello uterino",numero de inyectables trimestrales suministrados,2015-04-01,0,0,2,1,0,3
TOCO,"anticoncepcion, prevencion de its y de cancer de cuello uterino",numero de inyectables trimestrales suministrados,2015-04-01,0,1,5,2,0,8
TODOS SANTOS,"anticoncepcion, prevencion de its y de cancer de cuello uterino",numero de inyectables trimestrales suministrados,2015-04-01,0,0,1,0,0,1
TOLATA,"anticoncepcion, prevencion de its y de cancer de cuello uterino",numero de inyectables trimestrales suministrados,2015-04-01,0,0,15,7,0,22
TOLEDO,"anticoncepcion, prevencion de its y de cancer de cuello uterino",numero de inyectables trimestrales suministrados,2015-04-01,0,0,6,1,0,7
TOMAVE,"anticoncepcion, prevencion de its y de cancer de cuello uterino",numero de inyectables trimestrales suministrados,2015-04-01,0,3,32,15,0,50
TOMINA,"anticoncepcion, prevencion de its y de cancer de cuello uterino",numero de inyectables trimestrales suministrados,2015-04-01,1,5,38,35,0,79
TORO TORO,"anticoncepcion, prevencion de its y de cancer de cuello uterino",numero de inyectables trimestrales suministrados,2015-04-01,0,7,23,9,0,39
TOTORA(CBBA),"anticoncepcion, prevencion de its y de cancer de cuello uterino",numero de inyectables trimestrales suministrados,2015-04-01,0,14,61,26,1,102
TOTORA(ORR),"anticoncepcion, prevencion de its y de cancer de cuello uterino",numero de inyectables trimestrales suministrados,2015-04-01,0,0,16,6,1,23
TRIGAL,"anticoncepcion, prevencion de its y de cancer de cuello uterino",numero de inyectables trimestrales suministrados,2015-04-01,0,1,10,2,0,13
TRINIDAD,"anticoncepcion, prevencion de its y de cancer de cuello uterino",numero de inyectables trimestrales suministrados,2015-04-01,3,74,200,15,0,292
TUPIZA,"anticoncepcion, prevencion de its y de cancer de cuello uterino",numero de inyectables trimestrales suministrados,2015-04-01,0,12,152,39,0,203
TURCO,"anticoncepcion, prevencion de its y de cancer de cuello uterino",numero de inyectables trimestrales suministrados,2015-04-01,0,0,9,4,0,13
UMALA,"anticoncepcion, prevencion de its y de cancer de cuello uterino",numero de inyectables trimestrales suministrados,2015-04-01,0,2,7,4,0,13
UNCIA,"anticoncepcion, prevencion de its y de cancer de cuello uterino",numero de inyectables trimestrales suministrados,2015-04-01,0,4,23,14,1,42
URIONDO (A. CONCEPCION),"anticoncepcion, prevencion de its y de cancer de cuello uterino",numero de inyectables trimestrales suministrados,2015-04-01,0,9,68,44,0,121
URUBICHA,"anticoncepcion, prevencion de its y de cancer de cuello uterino",numero de inyectables trimestrales suministrados,2015-04-01,1,1,7,7,0,16
UYUNI,"anticoncepcion, prevencion de its y de cancer de cuello uterino",numero de inyectables trimestrales suministrados,2015-04-01,0,8,41,11,0,60
VACAS,"anticoncepcion, prevencion de its y de cancer de cuello uterino",numero de inyectables trimestrales suministrados,2015-04-01,0,2,26,18,0,46
VALLEGRANDE,"anticoncepcion, prevencion de its y de cancer de cuello uterino",numero de inyectables trimestrales suministrados,2015-04-01,0,17,47,8,0,72
VIACHA,"anticoncepcion, prevencion de its y de cancer de cuello uterino",numero de inyectables trimestrales suministrados,2015-04-01,0,14,157,81,0,252
VILA VILA,"anticoncepcion, prevencion de its y de cancer de cuello uterino",numero de inyectables trimestrales suministrados,2015-04-01,0,0,6,2,0,8
VILLA CHARCAS,"anticoncepcion, prevencion de its y de cancer de cuello uterino",numero de inyectables trimestrales suministrados,2015-04-01,1,13,44,33,1,92
VILLA MONTES,"anticoncepcion, prevencion de its y de cancer de cuello uterino",numero de inyectables trimestrales suministrados,2015-04-01,0,13,78,22,1,114
VILLA NUEVA (LOMA ALTA),"anticoncepcion, prevencion de its y de cancer de cuello uterino",numero de inyectables trimestrales suministrados,2015-04-01,1,2,9,2,1,15
VILLA RIVERO,"anticoncepcion, prevencion de its y de cancer de cuello uterino",numero de inyectables trimestrales suministrados,2015-04-01,0,3,35,16,0,54
VILLA SERRANO,"anticoncepcion, prevencion de its y de cancer de cuello uterino",numero de inyectables trimestrales suministrados,2015-04-01,0,4,32,38,1,75
VILLA TUNARI,"anticoncepcion, prevencion de its y de cancer de cuello uterino",numero de inyectables trimestrales suministrados,2015-04-01,0,51,309,107,0,467
VILLA VACA GUZMAN (MUYUPAMPA),"anticoncepcion, prevencion de its y de cancer de cuello uterino",numero de inyectables trimestrales suministrados,2015-04-01,0,1,41,18,0,60
VILLAZON,"anticoncepcion, prevencion de its y de cancer de cuello uterino",numero de inyectables trimestrales suministrados,2015-04-01,0,15,111,53,0,179
VINTO,"anticoncepcion, prevencion de its y de cancer de cuello uterino",numero de inyectables trimestrales suministrados,2015-04-01,0,11,59,45,0,115
VITICHI,"anticoncepcion, prevencion de its y de cancer de cuello uterino",numero de inyectables trimestrales suministrados,2015-04-01,0,1,11,13,0,25
WALDO BALLIVIAN,"anticoncepcion, prevencion de its y de cancer de cuello uterino",numero de inyectables trimestrales suministrados,2015-04-01,0,0,2,2,0,4
WARNES,"anticoncepcion, prevencion de its y de cancer de cuello uterino",numero de inyectables trimestrales suministrados,2015-04-01,1,39,149,41,0,230
YACO,"anticoncepcion, prevencion de its y de cancer de cuello uterino",numero de inyectables trimestrales suministrados,2015-04-01,0,0,8,9,0,17
YACUIBA,"anticoncepcion, prevencion de its y de cancer de cuello uterino",numero de inyectables trimestrales suministrados,2015-04-01,2,32,192,110,2,338
YAMPARAEZ,"anticoncepcion, prevencion de its y de cancer de cuello uterino",numero de inyectables trimestrales suministrados,2015-04-01,0,1,4,8,0,13
YANACACHI,"anticoncepcion, prevencion de its y de cancer de cuello uterino",numero de inyectables trimestrales suministrados,2015-04-01,0,0,18,11,0,29
YAPACANI,"anticoncepcion, prevencion de its y de cancer de cuello uterino",numero de inyectables trimestrales suministrados,2015-04-01,0,8,74,32,1,115
YOCALLA,"anticoncepcion, prevencion de its y de cancer de cuello uterino",numero de inyectables trimestrales suministrados,2015-04-01,0,2,21,7,0,30
YOTALA,"anticoncepcion, prevencion de its y de cancer de cuello uterino",numero de inyectables trimestrales suministrados,2015-04-01,0,0,10,4,0,14
YUNCHARA,"anticoncepcion, prevencion de its y de cancer de cuello uterino",numero de inyectables trimestrales suministrados,2015-04-01,1,13,39,20,0,73
ZUDAÑEZ,"anticoncepcion, prevencion de its y de cancer de cuello uterino",numero de inyectables trimestrales suministrados,2015-04-01,0,0,38,23,1,62
ACACIO,"anticoncepcion, prevencion de its y de cancer de cuello uterino",numero de inyectables trimestrales suministrados,2015-05-01,0,4,14,7,0,25
ACHACACHI,"anticoncepcion, prevencion de its y de cancer de cuello uterino",numero de inyectables trimestrales suministrados,2015-05-01,0,5,56,36,1,98
ACHOCALLA,"anticoncepcion, prevencion de its y de cancer de cuello uterino",numero de inyectables trimestrales suministrados,2015-05-01,0,5,36,17,0,58
AIQUILE,"anticoncepcion, prevencion de its y de cancer de cuello uterino",numero de inyectables trimestrales suministrados,2015-05-01,0,4,35,19,0,58
ALALAY,"anticoncepcion, prevencion de its y de cancer de cuello uterino",numero de inyectables trimestrales suministrados,2015-05-01,0,0,6,3,0,9
ALCALA,"anticoncepcion, prevencion de its y de cancer de cuello uterino",numero de inyectables trimestrales suministrados,2015-05-01,0,3,12,12,0,27
ALTO BENI,"anticoncepcion, prevencion de its y de cancer de cuello uterino",numero de inyectables trimestrales suministrados,2015-05-01,0,4,21,12,0,37
ANCORAIMES,"anticoncepcion, prevencion de its y de cancer de cuello uterino",numero de inyectables trimestrales suministrados,2015-05-01,0,2,10,6,0,18
ANDAMARCA,"anticoncepcion, prevencion de its y de cancer de cuello uterino",numero de inyectables trimestrales suministrados,2015-05-01,0,0,7,6,0,13
ANTEQUERA,"anticoncepcion, prevencion de its y de cancer de cuello uterino",numero de inyectables trimestrales suministrados,2015-05-01,0,0,4,1,0,5
ANZALDO,"anticoncepcion, prevencion de its y de cancer de cuello uterino",numero de inyectables trimestrales suministrados,2015-05-01,0,1,5,4,0,10
APOLO,"anticoncepcion, prevencion de its y de cancer de cuello uterino",numero de inyectables trimestrales suministrados,2015-05-01,0,1,14,9,0,24
ARAMPAMPA,"anticoncepcion, prevencion de its y de cancer de cuello uterino",numero de inyectables trimestrales suministrados,2015-05-01,0,1,6,5,0,12
ARANI,"anticoncepcion, prevencion de its y de cancer de cuello uterino",numero de inyectables trimestrales suministrados,2015-05-01,0,0,19,5,0,24
ARBIETO,"anticoncepcion, prevencion de its y de cancer de cuello uterino",numero de inyectables trimestrales suministrados,2015-05-01,0,6,41,21,0,68
ARQUE,"anticoncepcion, prevencion de its y de cancer de cuello uterino",numero de inyectables trimestrales suministrados,2015-05-01,0,4,42,35,0,81
ASCENCION DE GUARAYOS,"anticoncepcion, prevencion de its y de cancer de cuello uterino",numero de inyectables trimestrales suministrados,2015-05-01,0,11,40,22,0,73
ATOCHA,"anticoncepcion, prevencion de its y de cancer de cuello uterino",numero de inyectables trimestrales suministrados,2015-05-01,0,1,30,19,0,50
AUCAPATA,"anticoncepcion, prevencion de its y de cancer de cuello uterino",numero de inyectables trimestrales suministrados,2015-05-01,1,1,11,7,0,20
AYATA,"anticoncepcion, prevencion de its y de cancer de cuello uterino",numero de inyectables trimestrales suministrados,2015-05-01,0,0,27,20,0,47
AYO AYO,"anticoncepcion, prevencion de its y de cancer de cuello uterino",numero de inyectables trimestrales suministrados,2015-05-01,0,3,11,11,0,25
AYOPAYA (V. DE INDEPENDENCIA),"anticoncepcion, prevencion de its y de cancer de cuello uterino",numero de inyectables trimestrales suministrados,2015-05-01,0,8,96,69,0,173
AZURDUY,"anticoncepcion, prevencion de its y de cancer de cuello uterino",numero de inyectables trimestrales suministrados,2015-05-01,0,7,53,30,0,90
BATALLAS,"anticoncepcion, prevencion de its y de cancer de cuello uterino",numero de inyectables trimestrales suministrados,2015-05-01,0,4,27,16,1,48
BAURES,"anticoncepcion, prevencion de its y de cancer de cuello uterino",numero de inyectables trimestrales suministrados,2015-05-01,0,3,7,0,0,10
BELEN DE URMIRI,"anticoncepcion, prevencion de its y de cancer de cuello uterino",numero de inyectables trimestrales suministrados,2015-05-01,0,0,5,2,0,7
BELLA FLOR,"anticoncepcion, prevencion de its y de cancer de cuello uterino",numero de inyectables trimestrales suministrados,2015-05-01,0,4,5,3,0,12
BERMEJO,"anticoncepcion, prevencion de its y de cancer de cuello uterino",numero de inyectables trimestrales suministrados,2015-05-01,0,15,65,29,1,110
BETANZOS,"anticoncepcion, prevencion de its y de cancer de cuello uterino",numero de inyectables trimestrales suministrados,2015-05-01,0,3,51,33,0,87
BOLIVAR,"anticoncepcion, prevencion de its y de cancer de cuello uterino",numero de inyectables trimestrales suministrados,2015-05-01,0,1,15,7,0,23
BOLPEBRA,"anticoncepcion, prevencion de its y de cancer de cuello uterino",numero de inyectables trimestrales suministrados,2015-05-01,0,0,8,0,0,8
BOYUIBE,"anticoncepcion, prevencion de its y de cancer de cuello uterino",numero de inyectables trimestrales suministrados,2015-05-01,0,0,10,6,0,16
BUENA VISTA,"anticoncepcion, prevencion de its y de cancer de cuello uterino",numero de inyectables trimestrales suministrados,2015-05-01,0,8,36,10,0,54
CABEZAS,"anticoncepcion, prevencion de its y de cancer de cuello uterino",numero de inyectables trimestrales suministrados,2015-05-01,0,18,71,28,1,118
CAIROMA,"anticoncepcion, prevencion de its y de cancer de cuello uterino",numero de inyectables trimestrales suministrados,2015-05-01,0,3,30,16,0,49
"CAIZA ""D""","anticoncepcion, prevencion de its y de cancer de cuello uterino",numero de inyectables trimestrales suministrados,2015-05-01,0,2,13,3,0,18
CAJUATA,"anticoncepcion, prevencion de its y de cancer de cuello uterino",numero de inyectables trimestrales suministrados,2015-05-01,0,3,38,11,0,52
CALACOTO,"anticoncepcion, prevencion de its y de cancer de cuello uterino",numero de inyectables trimestrales suministrados,2015-05-01,0,2,3,5,1,11
CALAMARCA,"anticoncepcion, prevencion de its y de cancer de cuello uterino",numero de inyectables trimestrales suministrados,2015-05-01,0,4,36,15,0,55
CAMARGO,"anticoncepcion, prevencion de its y de cancer de cuello uterino",numero de inyectables trimestrales suministrados,2015-05-01,0,1,22,18,0,41
CAMATAQUI (C. VILLA ABECIA),"anticoncepcion, prevencion de its y de cancer de cuello uterino",numero de inyectables trimestrales suministrados,2015-05-01,0,2,9,7,0,18
CAMIRI,"anticoncepcion, prevencion de its y de cancer de cuello uterino",numero de inyectables trimestrales suministrados,2015-05-01,0,4,45,15,0,64
CAPINOTA,"anticoncepcion, prevencion de its y de cancer de cuello uterino",numero de inyectables trimestrales suministrados,2015-05-01,0,7,53,23,0,83
CAQUIAVIRI,"anticoncepcion, prevencion de its y de cancer de cuello uterino",numero de inyectables trimestrales suministrados,2015-05-01,0,4,13,10,0,27
CARACOLLO,"anticoncepcion, prevencion de its y de cancer de cuello uterino",numero de inyectables trimestrales suministrados,2015-05-01,0,1,44,21,0,66
CARANAVI,"anticoncepcion, prevencion de its y de cancer de cuello uterino",numero de inyectables trimestrales suministrados,2015-05-01,0,10,86,51,0,147
CARANGAS,"anticoncepcion, prevencion de its y de cancer de cuello uterino",numero de inyectables trimestrales suministrados,2015-05-01,0,1,0,1,0,2
CARAPARI,"anticoncepcion, prevencion de its y de cancer de cuello uterino",numero de inyectables trimestrales suministrados,2015-05-01,0,6,54,28,0,88
CARIPUYO,"anticoncepcion, prevencion de its y de cancer de cuello uterino",numero de inyectables trimestrales suministrados,2015-05-01,0,4,8,10,0,22
CARMEN RIVERO TORREZ,"anticoncepcion, prevencion de its y de cancer de cuello uterino",numero de inyectables trimestrales suministrados,2015-05-01,0,0,11,6,0,17
CATACORA,"anticoncepcion, prevencion de its y de cancer de cuello uterino",numero de inyectables trimestrales suministrados,2015-05-01,0,1,1,5,0,7
CHACARILLA,"anticoncepcion, prevencion de its y de cancer de cuello uterino",numero de inyectables trimestrales suministrados,2015-05-01,0,2,6,1,0,9
CHALLAPATA,"anticoncepcion, prevencion de its y de cancer de cuello uterino",numero de inyectables trimestrales suministrados,2015-05-01,1,5,31,15,0,52
CHAQUI,"anticoncepcion, prevencion de its y de cancer de cuello uterino",numero de inyectables trimestrales suministrados,2015-05-01,0,1,18,9,0,28
CHARAGUA,"anticoncepcion, prevencion de its y de cancer de cuello uterino",numero de inyectables trimestrales suministrados,2015-05-01,0,6,42,22,0,70
CHAYANTA,"anticoncepcion, prevencion de its y de cancer de cuello uterino",numero de inyectables trimestrales suministrados,2015-05-01,0,23,25,7,0,55
CHIMORE,"anticoncepcion, prevencion de its y de cancer de cuello uterino",numero de inyectables trimestrales suministrados,2015-05-01,0,6,50,9,0,65
CHIPAYA,"anticoncepcion, prevencion de its y de cancer de cuello uterino",numero de inyectables trimestrales suministrados,2015-05-01,0,4,9,0,0,13
CHOQUE COTA,"anticoncepcion, prevencion de its y de cancer de cuello uterino",numero de inyectables trimestrales suministrados,2015-05-01,0,0,2,1,0,3
CHUA COCANI,"anticoncepcion, prevencion de its y de cancer de cuello uterino",numero de inyectables trimestrales suministrados,2015-05-01,0,0,2,5,0,7
CHULUMANI (V. DE LA LIBERTAD),"anticoncepcion, prevencion de its y de cancer de cuello uterino",numero de inyectables trimestrales suministrados,2015-05-01,0,1,26,9,0,36
CHUMA,"anticoncepcion, prevencion de its y de cancer de cuello uterino",numero de inyectables trimestrales suministrados,2015-05-01,0,1,26,15,0,42
CHUQUIHUTA AYLLU JUCUMANI,"anticoncepcion, prevencion de its y de cancer de cuello uterino",numero de inyectables trimestrales suministrados,2015-05-01,0,3,16,4,0,23
CKOCHAS,"anticoncepcion, prevencion de its y de cancer de cuello uterino",numero de inyectables trimestrales suministrados,2015-05-01,0,2,21,19,0,42
CLIZA,"anticoncepcion, prevencion de its y de cancer de cuello uterino",numero de inyectables trimestrales suministrados,2015-05-01,0,2,26,3,2,33
COBIJA,"anticoncepcion, prevencion de its y de cancer de cuello uterino",numero de inyectables trimestrales suministrados,2015-05-01,2,37,102,10,0,151
COCAPATA,"anticoncepcion, prevencion de its y de cancer de cuello uterino",numero de inyectables trimestrales suministrados,2015-05-01,0,8,39,30,1,78
COCHABAMBA,"anticoncepcion, prevencion de its y de cancer de cuello uterino",numero de inyectables trimestrales suministrados,2015-05-01,1,90,318,66,0,475
COLCAPIRHUA,"anticoncepcion, prevencion de its y de cancer de cuello uterino",numero de inyectables trimestrales suministrados,2015-05-01,0,5,64,3,0,72
"COLCHA ""K""","anticoncepcion, prevencion de its y de cancer de cuello uterino",numero de inyectables trimestrales suministrados,2015-05-01,0,11,50,16,0,77
COLLANA,"anticoncepcion, prevencion de its y de cancer de cuello uterino",numero de inyectables trimestrales suministrados,2015-05-01,0,2,1,2,0,5
COLOMI,"anticoncepcion, prevencion de its y de cancer de cuello uterino",numero de inyectables trimestrales suministrados,2015-05-01,0,6,69,11,0,86
COLPA BELGICA,"anticoncepcion, prevencion de its y de cancer de cuello uterino",numero de inyectables trimestrales suministrados,2015-05-01,0,2,12,0,1,15
COLQUECHACA,"anticoncepcion, prevencion de its y de cancer de cuello uterino",numero de inyectables trimestrales suministrados,2015-05-01,0,2,40,22,0,64
COLQUENCHA,"anticoncepcion, prevencion de its y de cancer de cuello uterino",numero de inyectables trimestrales suministrados,2015-05-01,0,3,21,12,0,36
COLQUIRI,"anticoncepcion, prevencion de its y de cancer de cuello uterino",numero de inyectables trimestrales suministrados,2015-05-01,0,2,22,12,0,36
COMANCHE,"anticoncepcion, prevencion de its y de cancer de cuello uterino",numero de inyectables trimestrales suministrados,2015-05-01,0,1,4,1,0,6
COMARAPA,"anticoncepcion, prevencion de its y de cancer de cuello uterino",numero de inyectables trimestrales suministrados,2015-05-01,0,6,52,28,0,86
COMBAYA,"anticoncepcion, prevencion de its y de cancer de cuello uterino",numero de inyectables trimestrales suministrados,2015-05-01,0,1,2,0,0,3
CONCEPCION,"anticoncepcion, prevencion de its y de cancer de cuello uterino",numero de inyectables trimestrales suministrados,2015-05-01,0,5,23,3,0,31
COPACABANA,"anticoncepcion, prevencion de its y de cancer de cuello uterino",numero de inyectables trimestrales suministrados,2015-05-01,1,1,18,23,0,43
CORIPATA,"anticoncepcion, prevencion de its y de cancer de cuello uterino",numero de inyectables trimestrales suministrados,2015-05-01,0,3,41,9,0,53
CORO CORO,"anticoncepcion, prevencion de its y de cancer de cuello uterino",numero de inyectables trimestrales suministrados,2015-05-01,0,0,16,4,0,20
COROICO,"anticoncepcion, prevencion de its y de cancer de cuello uterino",numero de inyectables trimestrales suministrados,2015-05-01,0,1,9,2,0,12
CORQUE,"anticoncepcion, prevencion de its y de cancer de cuello uterino",numero de inyectables trimestrales suministrados,2015-05-01,0,2,8,4,0,14
COTAGAITA,"anticoncepcion, prevencion de its y de cancer de cuello uterino",numero de inyectables trimestrales suministrados,2015-05-01,0,6,63,39,0,108
COTOCA,"anticoncepcion, prevencion de its y de cancer de cuello uterino",numero de inyectables trimestrales suministrados,2015-05-01,0,20,86,32,0,138
CUATRO CAÑADAS,"anticoncepcion, prevencion de its y de cancer de cuello uterino",numero de inyectables trimestrales suministrados,2015-05-01,1,15,28,17,1,62
CUCHUMUELA (V. G. VILLARROEL),"anticoncepcion, prevencion de its y de cancer de cuello uterino",numero de inyectables trimestrales suministrados,2015-05-01,0,2,8,3,0,13
CUEVO,"anticoncepcion, prevencion de its y de cancer de cuello uterino",numero de inyectables trimestrales suministrados,2015-05-01,0,4,20,13,0,37
CULPINA,"anticoncepcion, prevencion de its y de cancer de cuello uterino",numero de inyectables trimestrales suministrados,2015-05-01,0,13,70,44,0,127
CURAHUARA DE CARANGAS,"anticoncepcion, prevencion de its y de cancer de cuello uterino",numero de inyectables trimestrales suministrados,2015-05-01,0,1,8,4,0,13
CURVA,"anticoncepcion, prevencion de its y de cancer de cuello uterino",numero de inyectables trimestrales suministrados,2015-05-01,0,0,6,1,0,7
DESAGUADERO,"anticoncepcion, prevencion de its y de cancer de cuello uterino",numero de inyectables trimestrales suministrados,2015-05-01,0,1,16,1,0,18
EL ALTO,"anticoncepcion, prevencion de its y de cancer de cuello uterino",numero de inyectables trimestrales suministrados,2015-05-01,1,89,978,332,0,1400
EL CHORO,"anticoncepcion, prevencion de its y de cancer de cuello uterino",numero de inyectables trimestrales suministrados,2015-05-01,0,1,3,2,0,6
EL PUENTE(STC),"anticoncepcion, prevencion de its y de cancer de cuello uterino",numero de inyectables trimestrales suministrados,2015-05-01,0,10,45,19,0,74
EL PUENTE(TJA),"anticoncepcion, prevencion de its y de cancer de cuello uterino",numero de inyectables trimestrales suministrados,2015-05-01,0,7,67,41,0,115
EL TORNO,"anticoncepcion, prevencion de its y de cancer de cuello uterino",numero de inyectables trimestrales suministrados,2015-05-01,8,24,105,42,1,180
EL VILLAR,"anticoncepcion, prevencion de its y de cancer de cuello uterino",numero de inyectables trimestrales suministrados,2015-05-01,0,5,18,16,0,39
ENTRE RIOS TRJ,"anticoncepcion, prevencion de its y de cancer de cuello uterino",numero de inyectables trimestrales suministrados,2015-05-01,0,22,103,55,0,180
ENTRE RIOS CBBA,"anticoncepcion, prevencion de its y de cancer de cuello uterino",numero de inyectables trimestrales suministrados,2015-05-01,1,20,62,30,1,114
ESCOMA,"anticoncepcion, prevencion de its y de cancer de cuello uterino",numero de inyectables trimestrales suministrados,2015-05-01,0,0,1,1,0,2
ESMERALDA,"anticoncepcion, prevencion de its y de cancer de cuello uterino",numero de inyectables trimestrales suministrados,2015-05-01,0,0,2,0,0,2
EUCALIPTUS,"anticoncepcion, prevencion de its y de cancer de cuello uterino",numero de inyectables trimestrales suministrados,2015-05-01,0,1,4,3,0,8
EUREKA (SANTOS MERCADO),"anticoncepcion, prevencion de its y de cancer de cuello uterino",numero de inyectables trimestrales suministrados,2015-05-01,0,0,3,1,0,4
EXALTACION,"anticoncepcion, prevencion de its y de cancer de cuello uterino",numero de inyectables trimestrales suministrados,2015-05-01,0,0,2,1,0,3
FERNANDEZ ALONSO,"anticoncepcion, prevencion de its y de cancer de cuello uterino",numero de inyectables trimestrales suministrados,2015-05-01,0,13,27,23,1,64
FILADELFIA,"anticoncepcion, prevencion de its y de cancer de cuello uterino",numero de inyectables trimestrales suministrados,2015-05-01,1,4,15,4,0,24
GENERAL SAAVEDRA,"anticoncepcion, prevencion de its y de cancer de cuello uterino",numero de inyectables trimestrales suministrados,2015-05-01,0,4,32,14,1,51
GRAL. J.J. PEREZ (CHARAZANI),"anticoncepcion, prevencion de its y de cancer de cuello uterino",numero de inyectables trimestrales suministrados,2015-05-01,0,3,19,6,0,28
GUANAY,"anticoncepcion, prevencion de its y de cancer de cuello uterino",numero de inyectables trimestrales suministrados,2015-05-01,0,1,11,4,0,16
GUAQUI,"anticoncepcion, prevencion de its y de cancer de cuello uterino",numero de inyectables trimestrales suministrados,2015-05-01,0,2,14,10,0,26
GUAYARAMERIN,"anticoncepcion, prevencion de its y de cancer de cuello uterino",numero de inyectables trimestrales suministrados,2015-05-01,0,8,28,8,0,44
GUTIERREZ,"anticoncepcion, prevencion de its y de cancer de cuello uterino",numero de inyectables trimestrales suministrados,2015-05-01,0,1,16,10,0,27
HUACARETA,"anticoncepcion, prevencion de its y de cancer de cuello uterino",numero de inyectables trimestrales suministrados,2015-05-01,0,4,31,14,0,49
HUACAYA (VILLA DE HUACAYA),"anticoncepcion, prevencion de its y de cancer de cuello uterino",numero de inyectables trimestrales suministrados,2015-05-01,0,0,10,4,0,14
HUACHACALLA,"anticoncepcion, prevencion de its y de cancer de cuello uterino",numero de inyectables trimestrales suministrados,2015-05-01,0,0,2,1,0,3
HUANUNI,"anticoncepcion, prevencion de its y de cancer de cuello uterino",numero de inyectables trimestrales suministrados,2015-05-01,0,1,17,8,0,26
HUARACAJE,"anticoncepcion, prevencion de its y de cancer de cuello uterino",numero de inyectables trimestrales suministrados,2015-05-01,0,1,7,1,0,9
HUARINA,"anticoncepcion, prevencion de its y de cancer de cuello uterino",numero de inyectables trimestrales suministrados,2015-05-01,0,0,8,8,0,16
HUATAJATA,"anticoncepcion, prevencion de its y de cancer de cuello uterino",numero de inyectables trimestrales suministrados,2015-05-01,0,0,1,3,0,4
HUAYLLAMARCA,"anticoncepcion, prevencion de its y de cancer de cuello uterino",numero de inyectables trimestrales suministrados,2015-05-01,0,2,5,9,0,16
HUMANATA,"anticoncepcion, prevencion de its y de cancer de cuello uterino",numero de inyectables trimestrales suministrados,2015-05-01,0,1,8,3,0,12
ICHOCA,"anticoncepcion, prevencion de its y de cancer de cuello uterino",numero de inyectables trimestrales suministrados,2015-05-01,0,0,5,5,0,10
ICLA,"anticoncepcion, prevencion de its y de cancer de cuello uterino",numero de inyectables trimestrales suministrados,2015-05-01,0,3,15,21,0,39
INCAHUASI,"anticoncepcion, prevencion de its y de cancer de cuello uterino",numero de inyectables trimestrales suministrados,2015-05-01,0,3,39,21,1,64
INGAVI (HUMAITA),"anticoncepcion, prevencion de its y de cancer de cuello uterino",numero de inyectables trimestrales suministrados,2015-05-01,0,5,8,1,0,14
INQUISIVI,"anticoncepcion, prevencion de its y de cancer de cuello uterino",numero de inyectables trimestrales suministrados,2015-05-01,0,0,15,14,0,29
IRUPANA (VILLA DE LANZA),"anticoncepcion, prevencion de its y de cancer de cuello uterino",numero de inyectables trimestrales suministrados,2015-05-01,0,3,54,15,1,73
IXIAMAS,"anticoncepcion, prevencion de its y de cancer de cuello uterino",numero de inyectables trimestrales suministrados,2015-05-01,0,6,25,7,0,38
JESUS DE MACHACA,"anticoncepcion, prevencion de its y de cancer de cuello uterino",numero de inyectables trimestrales suministrados,2015-05-01,0,0,16,7,0,23
LA ASUNTA,"anticoncepcion, prevencion de its y de cancer de cuello uterino",numero de inyectables trimestrales suministrados,2015-05-01,0,12,117,45,0,174
LA GUARDIA,"anticoncepcion, prevencion de its y de cancer de cuello uterino",numero de inyectables trimestrales suministrados,2015-05-01,1,21,102,30,1,155
LA PAZ,"anticoncepcion, prevencion de its y de cancer de cuello uterino",numero de inyectables trimestrales suministrados,2015-05-01,1,48,453,112,0,614
LAGUNILLAS,"anticoncepcion, prevencion de its y de cancer de cuello uterino",numero de inyectables trimestrales suministrados,2015-05-01,0,0,2,1,0,3
LAJA,"anticoncepcion, prevencion de its y de cancer de cuello uterino",numero de inyectables trimestrales suministrados,2015-05-01,1,2,22,13,0,38
LAS CARRERAS,"anticoncepcion, prevencion de its y de cancer de cuello uterino",numero de inyectables trimestrales suministrados,2015-05-01,0,4,16,12,0,32
LICOMA PAMPA,"anticoncepcion, prevencion de its y de cancer de cuello uterino",numero de inyectables trimestrales suministrados,2015-05-01,0,1,7,8,0,16
LLALLAGUA,"anticoncepcion, prevencion de its y de cancer de cuello uterino",numero de inyectables trimestrales suministrados,2015-05-01,0,1,62,24,0,87
LLICA,"anticoncepcion, prevencion de its y de cancer de cuello uterino",numero de inyectables trimestrales suministrados,2015-05-01,0,3,12,2,0,17
LORETO,"anticoncepcion, prevencion de its y de cancer de cuello uterino",numero de inyectables trimestrales suministrados,2015-05-01,0,1,6,3,0,10
LURIBAY,"anticoncepcion, prevencion de its y de cancer de cuello uterino",numero de inyectables trimestrales suministrados,2015-05-01,0,1,24,23,1,49
MACHACAMARCA,"anticoncepcion, prevencion de its y de cancer de cuello uterino",numero de inyectables trimestrales suministrados,2015-05-01,0,0,4,1,0,5
MACHARETI,"anticoncepcion, prevencion de its y de cancer de cuello uterino",numero de inyectables trimestrales suministrados,2015-05-01,0,10,28,21,0,59
MAGDALENA,"anticoncepcion, prevencion de its y de cancer de cuello uterino",numero de inyectables trimestrales suministrados,2015-05-01,0,4,26,9,0,39
MAIRANA,"anticoncepcion, prevencion de its y de cancer de cuello uterino",numero de inyectables trimestrales suministrados,2015-05-01,0,7,26,27,0,60
MALLA,"anticoncepcion, prevencion de its y de cancer de cuello uterino",numero de inyectables trimestrales suministrados,2015-05-01,0,0,3,3,0,6
MAPIRI,"anticoncepcion, prevencion de its y de cancer de cuello uterino",numero de inyectables trimestrales suministrados,2015-05-01,0,2,12,8,0,22
MECAPACA,"anticoncepcion, prevencion de its y de cancer de cuello uterino",numero de inyectables trimestrales suministrados,2015-05-01,0,2,27,15,0,44
MINEROS,"anticoncepcion, prevencion de its y de cancer de cuello uterino",numero de inyectables trimestrales suministrados,2015-05-01,1,12,44,15,0,72
MIZQUE,"anticoncepcion, prevencion de its y de cancer de cuello uterino",numero de inyectables trimestrales suministrados,2015-05-01,0,17,81,37,0,135
MOCOMOCO,"anticoncepcion, prevencion de its y de cancer de cuello uterino",numero de inyectables trimestrales suministrados,2015-05-01,0,0,25,9,0,34
MOJINETE,"anticoncepcion, prevencion de its y de cancer de cuello uterino",numero de inyectables trimestrales suministrados,2015-05-01,0,0,0,1,0,1
MOJOCOYA,"anticoncepcion, prevencion de its y de cancer de cuello uterino",numero de inyectables trimestrales suministrados,2015-05-01,0,7,28,19,1,55
MONTEAGUDO,"anticoncepcion, prevencion de its y de cancer de cuello uterino",numero de inyectables trimestrales suministrados,2015-05-01,0,10,57,43,2,112
MONTERO,"anticoncepcion, prevencion de its y de cancer de cuello uterino",numero de inyectables trimestrales suministrados,2015-05-01,4,72,140,42,0,258
MORO MORO,"anticoncepcion, prevencion de its y de cancer de cuello uterino",numero de inyectables trimestrales suministrados,2015-05-01,1,1,16,11,1,30
MOROCHATA,"anticoncepcion, prevencion de its y de cancer de cuello uterino",numero de inyectables trimestrales suministrados,2015-05-01,0,1,42,32,1,76
NACEBE (SANTA ROSA DEL ABUNA),"anticoncepcion, prevencion de its y de cancer de cuello uterino",numero de inyectables trimestrales suministrados,2015-05-01,0,1,8,4,0,13
NAZACARA DE PACAJES,"anticoncepcion, prevencion de its y de cancer de cuello uterino",numero de inyectables trimestrales suministrados,2015-05-01,0,1,0,0,0,1
NUEVO MANOA (NUEVA ESPERANZA),"anticoncepcion, prevencion de its y de cancer de cuello uterino",numero de inyectables trimestrales suministrados,2015-05-01,0,0,1,0,0,1
OCURI,"anticoncepcion, prevencion de its y de cancer de cuello uterino",numero de inyectables trimestrales suministrados,2015-05-01,0,3,35,10,0,48
OKINAWA,"anticoncepcion, prevencion de its y de cancer de cuello uterino",numero de inyectables trimestrales suministrados,2015-05-01,1,12,24,5,0,42
OMEREQUE,"anticoncepcion, prevencion de its y de cancer de cuello uterino",numero de inyectables trimestrales suministrados,2015-05-01,0,3,19,7,0,29
ORURO,"anticoncepcion, prevencion de its y de cancer de cuello uterino",numero de inyectables trimestrales suministrados,2015-05-01,0,40,397,118,1,556
PADCAYA,"anticoncepcion, prevencion de its y de cancer de cuello uterino",numero de inyectables trimestrales suministrados,2015-05-01,1,19,95,60,3,178
PADILLA,"anticoncepcion, prevencion de its y de cancer de cuello uterino",numero de inyectables trimestrales suministrados,2015-05-01,0,4,53,22,0,79
PAILON,"anticoncepcion, prevencion de its y de cancer de cuello uterino",numero de inyectables trimestrales suministrados,2015-05-01,0,10,33,5,0,48
PALCA,"anticoncepcion, prevencion de its y de cancer de cuello uterino",numero de inyectables trimestrales suministrados,2015-05-01,1,5,26,11,0,43
PALOS BLANCOS,"anticoncepcion, prevencion de its y de cancer de cuello uterino",numero de inyectables trimestrales suministrados,2015-05-01,1,8,61,30,1,101
PAMPA AULLAGAS,"anticoncepcion, prevencion de its y de cancer de cuello uterino",numero de inyectables trimestrales suministrados,2015-05-01,0,0,4,5,0,9
PAMPA GRANDE,"anticoncepcion, prevencion de its y de cancer de cuello uterino",numero de inyectables trimestrales suministrados,2015-05-01,0,5,30,12,0,47
PAPEL PAMPA,"anticoncepcion, prevencion de its y de cancer de cuello uterino",numero de inyectables trimestrales suministrados,2015-05-01,0,6,13,15,0,34
PASORAPA,"anticoncepcion, prevencion de its y de cancer de cuello uterino",numero de inyectables trimestrales suministrados,2015-05-01,0,2,13,14,1,30
PATACAMAYA,"anticoncepcion, prevencion de its y de cancer de cuello uterino",numero de inyectables trimestrales suministrados,2015-05-01,0,3,17,8,0,28
PAZÑA,"anticoncepcion, prevencion de its y de cancer de cuello uterino",numero de inyectables trimestrales suministrados,2015-05-01,0,0,18,12,0,30
PELECHUCO,"anticoncepcion, prevencion de its y de cancer de cuello uterino",numero de inyectables trimestrales suministrados,2015-05-01,0,2,13,10,0,25
POCOATA,"anticoncepcion, prevencion de its y de cancer de cuello uterino",numero de inyectables trimestrales suministrados,2015-05-01,0,1,37,35,0,73
POCONA,"anticoncepcion, prevencion de its y de cancer de cuello uterino",numero de inyectables trimestrales suministrados,2015-05-01,0,9,53,27,1,90
POJO (CBBA),"anticoncepcion, prevencion de its y de cancer de cuello uterino",numero de inyectables trimestrales suministrados,2015-05-01,0,8,44,13,0,65
PORCO,"anticoncepcion, prevencion de its y de cancer de cuello uterino",numero de inyectables trimestrales suministrados,2015-05-01,0,1,21,5,0,27
POROMA,"anticoncepcion, prevencion de its y de cancer de cuello uterino",numero de inyectables trimestrales suministrados,2015-05-01,0,2,57,28,0,87
PORONGO,"anticoncepcion, prevencion de its y de cancer de cuello uterino",numero de inyectables trimestrales suministrados,2015-05-01,0,2,19,0,0,21
PORTACHUELO,"anticoncepcion, prevencion de its y de cancer de cuello uterino",numero de inyectables trimestrales suministrados,2015-05-01,0,7,27,13,1,48
PORVENIR,"anticoncepcion, prevencion de its y de cancer de cuello uterino",numero de inyectables trimestrales suministrados,2015-05-01,0,2,17,2,0,21
POSTRER VALLE,"anticoncepcion, prevencion de its y de cancer de cuello uterino",numero de inyectables trimestrales suministrados,2015-05-01,0,2,6,2,0,10
POTOSI,"anticoncepcion, prevencion de its y de cancer de cuello uterino",numero de inyectables trimestrales suministrados,2015-05-01,0,64,383,142,0,589
PRESTO,"anticoncepcion, prevencion de its y de cancer de cuello uterino",numero de inyectables trimestrales suministrados,2015-05-01,0,3,26,18,1,48
PUCARA,"anticoncepcion, prevencion de its y de cancer de cuello uterino",numero de inyectables trimestrales suministrados,2015-05-01,0,1,14,7,0,22
PUCARANI,"anticoncepcion, prevencion de its y de cancer de cuello uterino",numero de inyectables trimestrales suministrados,2015-05-01,0,10,91,41,1,143
PUERTO ACOSTA,"anticoncepcion, prevencion de its y de cancer de cuello uterino",numero de inyectables trimestrales suministrados,2015-05-01,0,0,14,8,0,22
PUERTO CARABUCO,"anticoncepcion, prevencion de its y de cancer de cuello uterino",numero de inyectables trimestrales suministrados,2015-05-01,0,1,22,14,0,37
PUERTO GONZALO MORENO,"anticoncepcion, prevencion de its y de cancer de cuello uterino",numero de inyectables trimestrales suministrados,2015-05-01,0,5,26,7,0,38
PUERTO PEREZ,"anticoncepcion, prevencion de its y de cancer de cuello uterino",numero de inyectables trimestrales suministrados,2015-05-01,0,0,7,7,0,14
PUERTO QUIJARRO,"anticoncepcion, prevencion de its y de cancer de cuello uterino",numero de inyectables trimestrales suministrados,2015-05-01,0,3,13,6,0,22
PUERTO RICO,"anticoncepcion, prevencion de its y de cancer de cuello uterino",numero de inyectables trimestrales suministrados,2015-05-01,0,10,16,4,0,30
PUERTO SILES,"anticoncepcion, prevencion de its y de cancer de cuello uterino",numero de inyectables trimestrales suministrados,2015-05-01,0,0,1,0,0,1
PUERTO VILLARROEL,"anticoncepcion, prevencion de its y de cancer de cuello uterino",numero de inyectables trimestrales suministrados,2015-05-01,0,11,77,21,2,111
PUNA,"anticoncepcion, prevencion de its y de cancer de cuello uterino",numero de inyectables trimestrales suministrados,2015-05-01,0,2,32,21,0,55
PUNATA,"anticoncepcion, prevencion de its y de cancer de cuello uterino",numero de inyectables trimestrales suministrados,2015-05-01,0,4,49,16,0,69
QUIABAYA,"anticoncepcion, prevencion de its y de cancer de cuello uterino",numero de inyectables trimestrales suministrados,2015-05-01,0,1,7,10,0,18
QUILLACOLLO,"anticoncepcion, prevencion de its y de cancer de cuello uterino",numero de inyectables trimestrales suministrados,2015-05-01,2,22,135,40,0,199
QUIME,"anticoncepcion, prevencion de its y de cancer de cuello uterino",numero de inyectables trimestrales suministrados,2015-05-01,0,7,32,8,0,47
QUIRUSILLAS,"anticoncepcion, prevencion de its y de cancer de cuello uterino",numero de inyectables trimestrales suministrados,2015-05-01,0,3,5,5,0,13
RAVELO,"anticoncepcion, prevencion de its y de cancer de cuello uterino",numero de inyectables trimestrales suministrados,2015-05-01,1,5,49,35,0,90
REYES,"anticoncepcion, prevencion de its y de cancer de cuello uterino",numero de inyectables trimestrales suministrados,2015-05-01,0,5,26,5,0,36
RIBERALTA,"anticoncepcion, prevencion de its y de cancer de cuello uterino",numero de inyectables trimestrales suministrados,2015-05-01,1,40,191,30,0,262
ROBORE,"anticoncepcion, prevencion de its y de cancer de cuello uterino",numero de inyectables trimestrales suministrados,2015-05-01,0,3,56,4,0,63
RURRENABAQUE,"anticoncepcion, prevencion de its y de cancer de cuello uterino",numero de inyectables trimestrales suministrados,2015-05-01,1,4,32,8,0,45
SABAYA,"anticoncepcion, prevencion de its y de cancer de cuello uterino",numero de inyectables trimestrales suministrados,2015-05-01,0,0,8,1,0,9
SACABA,"anticoncepcion, prevencion de its y de cancer de cuello uterino",numero de inyectables trimestrales suministrados,2015-05-01,0,22,145,34,0,201
SACABAMBA,"anticoncepcion, prevencion de its y de cancer de cuello uterino",numero de inyectables trimestrales suministrados,2015-05-01,0,0,4,7,0,11
SACACA,"anticoncepcion, prevencion de its y de cancer de cuello uterino",numero de inyectables trimestrales suministrados,2015-05-01,0,5,47,21,0,73
SAIPINA,"anticoncepcion, prevencion de its y de cancer de cuello uterino",numero de inyectables trimestrales suministrados,2015-05-01,0,8,14,6,0,28
SALINAS DE GARCI MENDOZA,"anticoncepcion, prevencion de its y de cancer de cuello uterino",numero de inyectables trimestrales suministrados,2015-05-01,0,6,20,9,1,36
SAMAIPATA,"anticoncepcion, prevencion de its y de cancer de cuello uterino",numero de inyectables trimestrales suministrados,2015-05-01,0,5,20,7,0,32
SAN AGUSTIN,"anticoncepcion, prevencion de its y de cancer de cuello uterino",numero de inyectables trimestrales suministrados,2015-05-01,0,0,11,1,0,12
SAN ANDRES,"anticoncepcion, prevencion de its y de cancer de cuello uterino",numero de inyectables trimestrales suministrados,2015-05-01,0,2,24,7,0,33
SAN ANDRES DE MACHACA,"anticoncepcion, prevencion de its y de cancer de cuello uterino",numero de inyectables trimestrales suministrados,2015-05-01,0,0,3,1,0,4
SAN ANTONIO DE ESMORUCO,"anticoncepcion, prevencion de its y de cancer de cuello uterino",numero de inyectables trimestrales suministrados,2015-05-01,0,0,5,1,0,6
SAN ANTONIO DE LOMERIO,"anticoncepcion, prevencion de its y de cancer de cuello uterino",numero de inyectables trimestrales suministrados,2015-05-01,1,2,42,24,0,69
SAN BENITO,"anticoncepcion, prevencion de its y de cancer de cuello uterino",numero de inyectables trimestrales suministrados,2015-05-01,0,1,18,8,0,27
SAN BORJA,"anticoncepcion, prevencion de its y de cancer de cuello uterino",numero de inyectables trimestrales suministrados,2015-05-01,1,11,106,43,2,163
SAN BUENA VENTURA,"anticoncepcion, prevencion de its y de cancer de cuello uterino",numero de inyectables trimestrales suministrados,2015-05-01,1,2,34,8,0,45
SAN CARLOS,"anticoncepcion, prevencion de its y de cancer de cuello uterino",numero de inyectables trimestrales suministrados,2015-05-01,0,6,32,10,0,48
SAN IGNACIO,"anticoncepcion, prevencion de its y de cancer de cuello uterino",numero de inyectables trimestrales suministrados,2015-05-01,1,11,82,25,0,119
SAN IGNACIO DE VELASCO,"anticoncepcion, prevencion de its y de cancer de cuello uterino",numero de inyectables trimestrales suministrados,2015-05-01,2,23,150,48,0,223
SAN JAVIER(BNI),"anticoncepcion, prevencion de its y de cancer de cuello uterino",numero de inyectables trimestrales suministrados,2015-05-01,1,34,20,4,0,59
SAN JAVIER(STC),"anticoncepcion, prevencion de its y de cancer de cuello uterino",numero de inyectables trimestrales suministrados,2015-05-01,0,8,27,6,0,41
SAN JOAQUIN,"anticoncepcion, prevencion de its y de cancer de cuello uterino",numero de inyectables trimestrales suministrados,2015-05-01,0,4,1,0,0,5
SAN JOSE DE CHIQUITOS,"anticoncepcion, prevencion de its y de cancer de cuello uterino",numero de inyectables trimestrales suministrados,2015-05-01,1,9,35,1,1,47
SAN JUAN DE YAPACANI,"anticoncepcion, prevencion de its y de cancer de cuello uterino",numero de inyectables trimestrales suministrados,2015-05-01,0,4,22,17,0,43
SAN JULIAN,"anticoncepcion, prevencion de its y de cancer de cuello uterino",numero de inyectables trimestrales suministrados,2015-05-01,0,19,65,30,0,114
SAN LORENZO(PND),"anticoncepcion, prevencion de its y de cancer de cuello uterino",numero de inyectables trimestrales suministrados,2015-05-01,0,1,8,2,0,11
SAN LORENZO(TJA),"anticoncepcion, prevencion de its y de cancer de cuello uterino",numero de inyectables trimestrales suministrados,2015-05-01,0,16,84,36,1,137
SAN LUCAS,"anticoncepcion, prevencion de its y de cancer de cuello uterino",numero de inyectables trimestrales suministrados,2015-05-01,0,10,70,63,0,143
SAN MATIAS,"anticoncepcion, prevencion de its y de cancer de cuello uterino",numero de inyectables trimestrales suministrados,2015-05-01,0,5,19,10,0,34
SAN MIGUEL DE VELASCO,"anticoncepcion, prevencion de its y de cancer de cuello uterino",numero de inyectables trimestrales suministrados,2015-05-01,0,2,42,23,0,67
SAN PABLO DE LIPEZ,"anticoncepcion, prevencion de its y de cancer de cuello uterino",numero de inyectables trimestrales suministrados,2015-05-01,0,0,5,2,0,7
SAN PEDRO,"anticoncepcion, prevencion de its y de cancer de cuello uterino",numero de inyectables trimestrales suministrados,2015-05-01,0,9,37,20,1,67
SAN PEDRO DE BUENA VISTA,"anticoncepcion, prevencion de its y de cancer de cuello uterino",numero de inyectables trimestrales suministrados,2015-05-01,0,3,32,23,0,58
SAN PEDRO DE CURAHUARA,"anticoncepcion, prevencion de its y de cancer de cuello uterino",numero de inyectables trimestrales suministrados,2015-05-01,0,0,7,4,0,11
SAN PEDRO DE QUEMES,"anticoncepcion, prevencion de its y de cancer de cuello uterino",numero de inyectables trimestrales suministrados,2015-05-01,0,0,3,3,0,6
SAN PEDRO DE TIQUINA,"anticoncepcion, prevencion de its y de cancer de cuello uterino",numero de inyectables trimestrales suministrados,2015-05-01,0,1,10,8,0,19
SAN PEDRO(PND),"anticoncepcion, prevencion de its y de cancer de cuello uterino",numero de inyectables trimestrales suministrados,2015-05-01,0,0,4,0,0,4
SAN RAFAEL,"anticoncepcion, prevencion de its y de cancer de cuello uterino",numero de inyectables trimestrales suministrados,2015-05-01,0,11,29,11,1,52
SAN RAMON BENI,"anticoncepcion, prevencion de its y de cancer de cuello uterino",numero de inyectables trimestrales suministrados,2015-05-01,0,5,10,0,0,15
SANTA ANA,"anticoncepcion, prevencion de its y de cancer de cuello uterino",numero de inyectables trimestrales suministrados,2015-05-01,2,4,24,4,0,34
SANTA CRUZ DE LA SIERRA,"anticoncepcion, prevencion de its y de cancer de cuello uterino",numero de inyectables trimestrales suministrados,2015-05-01,6,120,437,86,0,649
SANTA ROSA,"anticoncepcion, prevencion de its y de cancer de cuello uterino",numero de inyectables trimestrales suministrados,2015-05-01,0,2,13,1,0,16
SANTA ROSA DEL SARA,"anticoncepcion, prevencion de its y de cancer de cuello uterino",numero de inyectables trimestrales suministrados,2015-05-01,0,12,65,22,0,99
SANTIAGO DE CALLAPA,"anticoncepcion, prevencion de its y de cancer de cuello uterino",numero de inyectables trimestrales suministrados,2015-05-01,0,1,2,1,0,4
SANTIAGO DE HUARI,"anticoncepcion, prevencion de its y de cancer de cuello uterino",numero de inyectables trimestrales suministrados,2015-05-01,0,1,8,4,0,13
SANTIAGO DE HUATA,"anticoncepcion, prevencion de its y de cancer de cuello uterino",numero de inyectables trimestrales suministrados,2015-05-01,0,2,8,5,1,16
SANTIAGO DE MACHACA,"anticoncepcion, prevencion de its y de cancer de cuello uterino",numero de inyectables trimestrales suministrados,2015-05-01,0,2,6,5,0,13
SANTIVAÑES,"anticoncepcion, prevencion de its y de cancer de cuello uterino",numero de inyectables trimestrales suministrados,2015-05-01,0,4,26,5,0,35
SANTUARIO DE QUILLACAS,"anticoncepcion, prevencion de its y de cancer de cuello uterino",numero de inyectables trimestrales suministrados,2015-05-01,0,3,5,1,0,9
SAPAHAQUI,"anticoncepcion, prevencion de its y de cancer de cuello uterino",numero de inyectables trimestrales suministrados,2015-05-01,0,2,22,12,0,36
SENA,"anticoncepcion, prevencion de its y de cancer de cuello uterino",numero de inyectables trimestrales suministrados,2015-05-01,0,8,17,2,0,27
SHINAOTA,"anticoncepcion, prevencion de its y de cancer de cuello uterino",numero de inyectables trimestrales suministrados,2015-05-01,0,9,32,22,0,63
SICA SICA (VILLA AROMA),"anticoncepcion, prevencion de its y de cancer de cuello uterino",numero de inyectables trimestrales suministrados,2015-05-01,0,2,35,26,1,64
SICAYA,"anticoncepcion, prevencion de its y de cancer de cuello uterino",numero de inyectables trimestrales suministrados,2015-05-01,0,0,4,2,0,6
SIPE SIPE,"anticoncepcion, prevencion de its y de cancer de cuello uterino",numero de inyectables trimestrales suministrados,2015-05-01,0,9,106,37,0,152
SOPACHUY,"anticoncepcion, prevencion de its y de cancer de cuello uterino",numero de inyectables trimestrales suministrados,2015-05-01,0,0,25,18,1,44
SORACACHI,"anticoncepcion, prevencion de its y de cancer de cuello uterino",numero de inyectables trimestrales suministrados,2015-05-01,0,1,21,7,0,29
SORATA,"anticoncepcion, prevencion de its y de cancer de cuello uterino",numero de inyectables trimestrales suministrados,2015-05-01,0,4,44,11,0,59
SUCRE,"anticoncepcion, prevencion de its y de cancer de cuello uterino",numero de inyectables trimestrales suministrados,2015-05-01,0,81,469,176,7,733
TACACHI,"anticoncepcion, prevencion de its y de cancer de cuello uterino",numero de inyectables trimestrales suministrados,2015-05-01,0,1,0,2,0,3
TACACOMA,"anticoncepcion, prevencion de its y de cancer de cuello uterino",numero de inyectables trimestrales suministrados,2015-05-01,0,6,37,14,0,57
TACOBAMBA,"anticoncepcion, prevencion de its y de cancer de cuello uterino",numero de inyectables trimestrales suministrados,2015-05-01,0,1,1,4,0,6
TACOPAYA,"anticoncepcion, prevencion de its y de cancer de cuello uterino",numero de inyectables trimestrales suministrados,2015-05-01,0,1,13,9,0,23
TAHUA,"anticoncepcion, prevencion de its y de cancer de cuello uterino",numero de inyectables trimestrales suministrados,2015-05-01,0,0,6,4,0,10
TAPACARI,"anticoncepcion, prevencion de its y de cancer de cuello uterino",numero de inyectables trimestrales suministrados,2015-05-01,0,6,56,33,0,95
TARABUCO,"anticoncepcion, prevencion de its y de cancer de cuello uterino",numero de inyectables trimestrales suministrados,2015-05-01,0,2,41,20,1,64
TARACO,"anticoncepcion, prevencion de its y de cancer de cuello uterino",numero de inyectables trimestrales suministrados,2015-05-01,0,6,11,13,0,30
TARATA,"anticoncepcion, prevencion de its y de cancer de cuello uterino",numero de inyectables trimestrales suministrados,2015-05-01,0,0,5,3,0,8
TARIJA,"anticoncepcion, prevencion de its y de cancer de cuello uterino",numero de inyectables trimestrales suministrados,2015-05-01,2,52,231,101,1,387
TARVITA,"anticoncepcion, prevencion de its y de cancer de cuello uterino",numero de inyectables trimestrales suministrados,2015-05-01,0,3,44,15,1,63
TEOPONTE,"anticoncepcion, prevencion de its y de cancer de cuello uterino",numero de inyectables trimestrales suministrados,2015-05-01,0,4,15,9,0,28
TIAWANACU,"anticoncepcion, prevencion de its y de cancer de cuello uterino",numero de inyectables trimestrales suministrados,2015-05-01,0,0,27,18,0,45
TINGUIPAYA,"anticoncepcion, prevencion de its y de cancer de cuello uterino",numero de inyectables trimestrales suministrados,2015-05-01,0,0,15,12,0,27
TIPUANI,"anticoncepcion, prevencion de its y de cancer de cuello uterino",numero de inyectables trimestrales suministrados,2015-05-01,0,3,15,7,0,25
TIQUIPAYA,"anticoncepcion, prevencion de its y de cancer de cuello uterino",numero de inyectables trimestrales suministrados,2015-05-01,0,20,116,21,0,157
TIRAQUE (CBBA),"anticoncepcion, prevencion de its y de cancer de cuello uterino",numero de inyectables trimestrales suministrados,2015-05-01,0,2,39,22,0,63
TITO YUPANQUI (PARQUIPUJIO),"anticoncepcion, prevencion de its y de cancer de cuello uterino",numero de inyectables trimestrales suministrados,2015-05-01,0,1,1,1,0,3
TOCO,"anticoncepcion, prevencion de its y de cancer de cuello uterino",numero de inyectables trimestrales suministrados,2015-05-01,1,3,6,7,0,17
TODOS SANTOS,"anticoncepcion, prevencion de its y de cancer de cuello uterino",numero de inyectables trimestrales suministrados,2015-05-01,0,1,0,0,0,1
TOLATA,"anticoncepcion, prevencion de its y de cancer de cuello uterino",numero de inyectables trimestrales suministrados,2015-05-01,0,0,5,0,0,5
TOLEDO,"anticoncepcion, prevencion de its y de cancer de cuello uterino",numero de inyectables trimestrales suministrados,2015-05-01,0,1,3,2,0,6
TOMAVE,"anticoncepcion, prevencion de its y de cancer de cuello uterino",numero de inyectables trimestrales suministrados,2015-05-01,0,0,8,9,0,17
TOMINA,"anticoncepcion, prevencion de its y de cancer de cuello uterino",numero de inyectables trimestrales suministrados,2015-05-01,0,6,43,36,1,86
TORO TORO,"anticoncepcion, prevencion de its y de cancer de cuello uterino",numero de inyectables trimestrales suministrados,2015-05-01,0,2,29,11,0,42
TOTORA(CBBA),"anticoncepcion, prevencion de its y de cancer de cuello uterino",numero de inyectables trimestrales suministrados,2015-05-01,0,18,66,31,0,115
TOTORA(ORR),"anticoncepcion, prevencion de its y de cancer de cuello uterino",numero de inyectables trimestrales suministrados,2015-05-01,0,2,12,2,0,16
TRIGAL,"anticoncepcion, prevencion de its y de cancer de cuello uterino",numero de inyectables trimestrales suministrados,2015-05-01,0,0,4,3,0,7
TRINIDAD,"anticoncepcion, prevencion de its y de cancer de cuello uterino",numero de inyectables trimestrales suministrados,2015-05-01,0,9,65,6,0,80
TUPIZA,"anticoncepcion, prevencion de its y de cancer de cuello uterino",numero de inyectables trimestrales suministrados,2015-05-01,0,11,122,51,0,184
TURCO,"anticoncepcion, prevencion de its y de cancer de cuello uterino",numero de inyectables trimestrales suministrados,2015-05-01,0,1,7,4,0,12
UMALA,"anticoncepcion, prevencion de its y de cancer de cuello uterino",numero de inyectables trimestrales suministrados,2015-05-01,0,4,14,7,0,25
UNCIA,"anticoncepcion, prevencion de its y de cancer de cuello uterino",numero de inyectables trimestrales suministrados,2015-05-01,0,0,48,20,0,68
URIONDO (A. CONCEPCION),"anticoncepcion, prevencion de its y de cancer de cuello uterino",numero de inyectables trimestrales suministrados,2015-05-01,0,8,69,29,1,107
URUBICHA,"anticoncepcion, prevencion de its y de cancer de cuello uterino",numero de inyectables trimestrales suministrados,2015-05-01,0,0,6,9,1,16
UYUNI,"anticoncepcion, prevencion de its y de cancer de cuello uterino",numero de inyectables trimestrales suministrados,2015-05-01,0,4,42,15,0,61
VACAS,"anticoncepcion, prevencion de its y de cancer de cuello uterino",numero de inyectables trimestrales suministrados,2015-05-01,0,4,25,20,0,49
VALLEGRANDE,"anticoncepcion, prevencion de its y de cancer de cuello uterino",numero de inyectables trimestrales suministrados,2015-05-01,1,12,38,7,0,58
VIACHA,"anticoncepcion, prevencion de its y de cancer de cuello uterino",numero de inyectables trimestrales suministrados,2015-05-01,1,15,180,60,0,256
VILA VILA,"anticoncepcion, prevencion de its y de cancer de cuello uterino",numero de inyectables trimestrales suministrados,2015-05-01,0,1,5,2,0,8
VILLA CHARCAS,"anticoncepcion, prevencion de its y de cancer de cuello uterino",numero de inyectables trimestrales suministrados,2015-05-01,0,14,46,30,1,91
VILLA MONTES,"anticoncepcion, prevencion de its y de cancer de cuello uterino",numero de inyectables trimestrales suministrados,2015-05-01,1,22,90,34,0,147
VILLA NUEVA (LOMA ALTA),"anticoncepcion, prevencion de its y de cancer de cuello uterino",numero de inyectables trimestrales suministrados,2015-05-01,2,2,10,1,0,15
VILLA RIVERO,"anticoncepcion, prevencion de its y de cancer de cuello uterino",numero de inyectables trimestrales suministrados,2015-05-01,0,6,41,16,0,63
VILLA SERRANO,"anticoncepcion, prevencion de its y de cancer de cuello uterino",numero de inyectables trimestrales suministrados,2015-05-01,1,10,31,26,0,68
VILLA TUNARI,"anticoncepcion, prevencion de its y de cancer de cuello uterino",numero de inyectables trimestrales suministrados,2015-05-01,0,42,284,90,0,416
VILLA VACA GUZMAN (MUYUPAMPA),"anticoncepcion, prevencion de its y de cancer de cuello uterino",numero de inyectables trimestrales suministrados,2015-05-01,0,8,39,18,1,66
VILLAZON,"anticoncepcion, prevencion de its y de cancer de cuello uterino",numero de inyectables trimestrales suministrados,2015-05-01,0,17,113,51,0,181
VINTO,"anticoncepcion, prevencion de its y de cancer de cuello uterino",numero de inyectables trimestrales suministrados,2015-05-01,0,5,55,25,0,85
VITICHI,"anticoncepcion, prevencion de its y de cancer de cuello uterino",numero de inyectables trimestrales suministrados,2015-05-01,0,2,13,12,0,27
WALDO BALLIVIAN,"anticoncepcion, prevencion de its y de cancer de cuello uterino",numero de inyectables trimestrales suministrados,2015-05-01,0,0,6,3,0,9
WARNES,"anticoncepcion, prevencion de its y de cancer de cuello uterino",numero de inyectables trimestrales suministrados,2015-05-01,3,36,114,27,1,181
YACO,"anticoncepcion, prevencion de its y de cancer de cuello uterino",numero de inyectables trimestrales suministrados,2015-05-01,0,2,11,7,0,20
YACUIBA,"anticoncepcion, prevencion de its y de cancer de cuello uterino",numero de inyectables trimestrales suministrados,2015-05-01,1,38,181,110,2,332
YAMPARAEZ,"anticoncepcion, prevencion de its y de cancer de cuello uterino",numero de inyectables trimestrales suministrados,2015-05-01,0,1,8,9,0,18
YANACACHI,"anticoncepcion, prevencion de its y de cancer de cuello uterino",numero de inyectables trimestrales suministrados,2015-05-01,0,0,12,3,0,15
YAPACANI,"anticoncepcion, prevencion de its y de cancer de cuello uterino",numero de inyectables trimestrales suministrados,2015-05-01,0,18,67,25,1,111
YOCALLA,"anticoncepcion, prevencion de its y de cancer de cuello uterino",numero de inyectables trimestrales suministrados,2015-05-01,0,3,19,5,0,27
YOTALA,"anticoncepcion, prevencion de its y de cancer de cuello uterino",numero de inyectables trimestrales suministrados,2015-05-01,0,0,5,5,0,10
YUNCHARA,"anticoncepcion, prevencion de its y de cancer de cuello uterino",numero de inyectables trimestrales suministrados,2015-05-01,0,5,43,30,0,78
ZUDAÑEZ,"anticoncepcion, prevencion de its y de cancer de cuello uterino",numero de inyectables trimestrales suministrados,2015-05-01,0,5,31,18,0,54
ACACIO,"anticoncepcion, prevencion de its y de cancer de cuello uterino",numero de inyectables trimestrales suministrados,2015-06-01,0,4,10,3,1,18
ACHACACHI,"anticoncepcion, prevencion de its y de cancer de cuello uterino",numero de inyectables trimestrales suministrados,2015-06-01,1,9,64,33,0,107
ACHOCALLA,"anticoncepcion, prevencion de its y de cancer de cuello uterino",numero de inyectables trimestrales suministrados,2015-06-01,0,2,56,17,0,75
AIQUILE,"anticoncepcion, prevencion de its y de cancer de cuello uterino",numero de inyectables trimestrales suministrados,2015-06-01,0,6,36,37,0,79
ALALAY,"anticoncepcion, prevencion de its y de cancer de cuello uterino",numero de inyectables trimestrales suministrados,2015-06-01,0,0,1,4,0,5
ALCALA,"anticoncepcion, prevencion de its y de cancer de cuello uterino",numero de inyectables trimestrales suministrados,2015-06-01,0,1,15,11,0,27
ALTO BENI,"anticoncepcion, prevencion de its y de cancer de cuello uterino",numero de inyectables trimestrales suministrados,2015-06-01,0,0,39,19,0,58
ANCORAIMES,"anticoncepcion, prevencion de its y de cancer de cuello uterino",numero de inyectables trimestrales suministrados,2015-06-01,0,2,14,12,0,28
ANDAMARCA,"anticoncepcion, prevencion de its y de cancer de cuello uterino",numero de inyectables trimestrales suministrados,2015-06-01,0,2,4,2,0,8
ANTEQUERA,"anticoncepcion, prevencion de its y de cancer de cuello uterino",numero de inyectables trimestrales suministrados,2015-06-01,0,0,3,4,0,7
ANZALDO,"anticoncepcion, prevencion de its y de cancer de cuello uterino",numero de inyectables trimestrales suministrados,2015-06-01,0,2,12,14,0,28
APOLO,"anticoncepcion, prevencion de its y de cancer de cuello uterino",numero de inyectables trimestrales suministrados,2015-06-01,0,5,43,27,2,77
ARAMPAMPA,"anticoncepcion, prevencion de its y de cancer de cuello uterino",numero de inyectables trimestrales suministrados,2015-06-01,0,0,11,4,0,15
ARANI,"anticoncepcion, prevencion de its y de cancer de cuello uterino",numero de inyectables trimestrales suministrados,2015-06-01,0,1,16,3,0,20
ARBIETO,"anticoncepcion, prevencion de its y de cancer de cuello uterino",numero de inyectables trimestrales suministrados,2015-06-01,0,6,51,14,0,71
ARQUE,"anticoncepcion, prevencion de its y de cancer de cuello uterino",numero de inyectables trimestrales suministrados,2015-06-01,1,4,27,32,0,64
ASCENCION DE GUARAYOS,"anticoncepcion, prevencion de its y de cancer de cuello uterino",numero de inyectables trimestrales suministrados,2015-06-01,1,7,45,13,0,66
ATOCHA,"anticoncepcion, prevencion de its y de cancer de cuello uterino",numero de inyectables trimestrales suministrados,2015-06-01,0,2,58,15,0,75
AUCAPATA,"anticoncepcion, prevencion de its y de cancer de cuello uterino",numero de inyectables trimestrales suministrados,2015-06-01,0,2,17,11,0,30
AYATA,"anticoncepcion, prevencion de its y de cancer de cuello uterino",numero de inyectables trimestrales suministrados,2015-06-01,0,2,19,19,0,40
AYO AYO,"anticoncepcion, prevencion de its y de cancer de cuello uterino",numero de inyectables trimestrales suministrados,2015-06-01,0,0,17,5,0,22
AYOPAYA (V. DE INDEPENDENCIA),"anticoncepcion, prevencion de its y de cancer de cuello uterino",numero de inyectables trimestrales suministrados,2015-06-01,0,9,95,60,0,164
AZURDUY,"anticoncepcion, prevencion de its y de cancer de cuello uterino",numero de inyectables trimestrales suministrados,2015-06-01,0,4,34,18,0,56
BATALLAS,"anticoncepcion, prevencion de its y de cancer de cuello uterino",numero de inyectables trimestrales suministrados,2015-06-01,1,4,33,17,0,55
BAURES,"anticoncepcion, prevencion de its y de cancer de cuello uterino",numero de inyectables trimestrales suministrados,2015-06-01,0,3,11,0,0,14
BELEN DE ANDAMARCA,"anticoncepcion, prevencion de its y de cancer de cuello uterino",numero de inyectables trimestrales suministrados,2015-06-01,0,1,4,3,0,8
BELEN DE URMIRI,"anticoncepcion, prevencion de its y de cancer de cuello uterino",numero de inyectables trimestrales suministrados,2015-06-01,0,0,0,2,0,2
BELLA FLOR,"anticoncepcion, prevencion de its y de cancer de cuello uterino",numero de inyectables trimestrales suministrados,2015-06-01,0,0,11,4,0,15
BERMEJO,"anticoncepcion, prevencion de its y de cancer de cuello uterino",numero de inyectables trimestrales suministrados,2015-06-01,0,20,69,26,2,117
BETANZOS,"anticoncepcion, prevencion de its y de cancer de cuello uterino",numero de inyectables trimestrales suministrados,2015-06-01,1,3,42,57,0,103
BOLIVAR,"anticoncepcion, prevencion de its y de cancer de cuello uterino",numero de inyectables trimestrales suministrados,2015-06-01,0,0,11,7,0,18
BOLPEBRA,"anticoncepcion, prevencion de its y de cancer de cuello uterino",numero de inyectables trimestrales suministrados,2015-06-01,0,1,1,2,0,4
BOYUIBE,"anticoncepcion, prevencion de its y de cancer de cuello uterino",numero de inyectables trimestrales suministrados,2015-06-01,0,0,15,11,0,26
BUENA VISTA,"anticoncepcion, prevencion de its y de cancer de cuello uterino",numero de inyectables trimestrales suministrados,2015-06-01,2,9,25,8,0,44
CABEZAS,"anticoncepcion, prevencion de its y de cancer de cuello uterino",numero de inyectables trimestrales suministrados,2015-06-01,4,23,88,35,0,150
CAIROMA,"anticoncepcion, prevencion de its y de cancer de cuello uterino",numero de inyectables trimestrales suministrados,2015-06-01,0,3,18,4,0,25
"CAIZA ""D""","anticoncepcion, prevencion de its y de cancer de cuello uterino",numero de inyectables trimestrales suministrados,2015-06-01,0,0,28,15,0,43
CAJUATA,"anticoncepcion, prevencion de its y de cancer de cuello uterino",numero de inyectables trimestrales suministrados,2015-06-01,0,1,32,18,0,51
CALACOTO,"anticoncepcion, prevencion de its y de cancer de cuello uterino",numero de inyectables trimestrales suministrados,2015-06-01,0,0,5,4,0,9
CALAMARCA,"anticoncepcion, prevencion de its y de cancer de cuello uterino",numero de inyectables trimestrales suministrados,2015-06-01,1,19,26,14,0,60
CAMARGO,"anticoncepcion, prevencion de its y de cancer de cuello uterino",numero de inyectables trimestrales suministrados,2015-06-01,0,1,28,17,1,47
CAMATAQUI (C. VILLA ABECIA),"anticoncepcion, prevencion de its y de cancer de cuello uterino",numero de inyectables trimestrales suministrados,2015-06-01,0,1,7,14,0,22
CAMIRI,"anticoncepcion, prevencion de its y de cancer de cuello uterino",numero de inyectables trimestrales suministrados,2015-06-01,0,4,43,13,1,61
CAPINOTA,"anticoncepcion, prevencion de its y de cancer de cuello uterino",numero de inyectables trimestrales suministrados,2015-06-01,1,13,48,25,0,87
CAQUIAVIRI,"anticoncepcion, prevencion de its y de cancer de cuello uterino",numero de inyectables trimestrales suministrados,2015-06-01,0,1,8,3,0,12
CARACOLLO,"anticoncepcion, prevencion de its y de cancer de cuello uterino",numero de inyectables trimestrales suministrados,2015-06-01,0,1,33,23,0,57
CARANAVI,"anticoncepcion, prevencion de its y de cancer de cuello uterino",numero de inyectables trimestrales suministrados,2015-06-01,0,12,94,36,0,142
CARANGAS,"anticoncepcion, prevencion de its y de cancer de cuello uterino",numero de inyectables trimestrales suministrados,2015-06-01,0,0,2,0,0,2
CARAPARI,"anticoncepcion, prevencion de its y de cancer de cuello uterino",numero de inyectables trimestrales suministrados,2015-06-01,1,10,50,22,0,83
CARIPUYO,"anticoncepcion, prevencion de its y de cancer de cuello uterino",numero de inyectables trimestrales suministrados,2015-06-01,0,1,17,10,0,28
CARMEN RIVERO TORREZ,"anticoncepcion, prevencion de its y de cancer de cuello uterino",numero de inyectables trimestrales suministrados,2015-06-01,0,3,10,5,0,18
CATACORA,"anticoncepcion, prevencion de its y de cancer de cuello uterino",numero de inyectables trimestrales suministrados,2015-06-01,0,2,1,1,0,4
CHACARILLA,"anticoncepcion, prevencion de its y de cancer de cuello uterino",numero de inyectables trimestrales suministrados,2015-06-01,0,0,2,1,0,3
CHALLAPATA,"anticoncepcion, prevencion de its y de cancer de cuello uterino",numero de inyectables trimestrales suministrados,2015-06-01,0,11,40,23,0,74
CHAQUI,"anticoncepcion, prevencion de its y de cancer de cuello uterino",numero de inyectables trimestrales suministrados,2015-06-01,0,3,21,12,0,36
CHARAGUA,"anticoncepcion, prevencion de its y de cancer de cuello uterino",numero de inyectables trimestrales suministrados,2015-06-01,0,4,45,12,0,61
CHARAÑA,"anticoncepcion, prevencion de its y de cancer de cuello uterino",numero de inyectables trimestrales suministrados,2015-06-01,0,0,4,3,0,7
CHAYANTA,"anticoncepcion, prevencion de its y de cancer de cuello uterino",numero de inyectables trimestrales suministrados,2015-06-01,0,3,39,29,1,72
CHIMORE,"anticoncepcion, prevencion de its y de cancer de cuello uterino",numero de inyectables trimestrales suministrados,2015-06-01,0,6,77,17,0,100
CHIPAYA,"anticoncepcion, prevencion de its y de cancer de cuello uterino",numero de inyectables trimestrales suministrados,2015-06-01,0,4,9,3,0,16
CHOQUE COTA,"anticoncepcion, prevencion de its y de cancer de cuello uterino",numero de inyectables trimestrales suministrados,2015-06-01,0,0,3,3,0,6
CHUA COCANI,"anticoncepcion, prevencion de its y de cancer de cuello uterino",numero de inyectables trimestrales suministrados,2015-06-01,0,1,6,2,0,9
CHULUMANI (V. DE LA LIBERTAD),"anticoncepcion, prevencion de its y de cancer de cuello uterino",numero de inyectables trimestrales suministrados,2015-06-01,1,5,33,11,0,50
CHUMA,"anticoncepcion, prevencion de its y de cancer de cuello uterino",numero de inyectables trimestrales suministrados,2015-06-01,0,5,27,30,0,62
CHUQUIHUTA AYLLU JUCUMANI,"anticoncepcion, prevencion de its y de cancer de cuello uterino",numero de inyectables trimestrales suministrados,2015-06-01,0,1,10,6,0,17
CKOCHAS,"anticoncepcion, prevencion de its y de cancer de cuello uterino",numero de inyectables trimestrales suministrados,2015-06-01,0,3,31,31,0,65
CLIZA,"anticoncepcion, prevencion de its y de cancer de cuello uterino",numero de inyectables trimestrales suministrados,2015-06-01,0,4,46,19,1,70
COBIJA,"anticoncepcion, prevencion de its y de cancer de cuello uterino",numero de inyectables trimestrales suministrados,2015-06-01,0,41,141,30,0,212
COCAPATA,"anticoncepcion, prevencion de its y de cancer de cuello uterino",numero de inyectables trimestrales suministrados,2015-06-01,0,7,45,32,0,84
COCHABAMBA,"anticoncepcion, prevencion de its y de cancer de cuello uterino",numero de inyectables trimestrales suministrados,2015-06-01,2,72,418,90,0,582
COIPASA,"anticoncepcion, prevencion de its y de cancer de cuello uterino",numero de inyectables trimestrales suministrados,2015-06-01,0,0,9,3,0,12
COLCAPIRHUA,"anticoncepcion, prevencion de its y de cancer de cuello uterino",numero de inyectables trimestrales suministrados,2015-06-01,0,5,66,13,0,84
"COLCHA ""K""","anticoncepcion, prevencion de its y de cancer de cuello uterino",numero de inyectables trimestrales suministrados,2015-06-01,0,9,41,17,0,67
COLLANA,"anticoncepcion, prevencion de its y de cancer de cuello uterino",numero de inyectables trimestrales suministrados,2015-06-01,0,0,10,4,0,14
COLOMI,"anticoncepcion, prevencion de its y de cancer de cuello uterino",numero de inyectables trimestrales suministrados,2015-06-01,0,7,65,16,0,88
COLPA BELGICA,"anticoncepcion, prevencion de its y de cancer de cuello uterino",numero de inyectables trimestrales suministrados,2015-06-01,0,3,11,4,0,18
COLQUECHACA,"anticoncepcion, prevencion de its y de cancer de cuello uterino",numero de inyectables trimestrales suministrados,2015-06-01,0,2,40,27,0,69
COLQUENCHA,"anticoncepcion, prevencion de its y de cancer de cuello uterino",numero de inyectables trimestrales suministrados,2015-06-01,0,2,24,18,0,44
COLQUIRI,"anticoncepcion, prevencion de its y de cancer de cuello uterino",numero de inyectables trimestrales suministrados,2015-06-01,0,7,30,14,0,51
COMANCHE,"anticoncepcion, prevencion de its y de cancer de cuello uterino",numero de inyectables trimestrales suministrados,2015-06-01,0,1,3,0,0,4
COMARAPA,"anticoncepcion, prevencion de its y de cancer de cuello uterino",numero de inyectables trimestrales suministrados,2015-06-01,1,14,109,33,0,157
COMBAYA,"anticoncepcion, prevencion de its y de cancer de cuello uterino",numero de inyectables trimestrales suministrados,2015-06-01,0,0,1,3,0,4
CONCEPCION,"anticoncepcion, prevencion de its y de cancer de cuello uterino",numero de inyectables trimestrales suministrados,2015-06-01,1,9,30,9,0,49
COPACABANA,"anticoncepcion, prevencion de its y de cancer de cuello uterino",numero de inyectables trimestrales suministrados,2015-06-01,0,0,36,19,0,55
CORIPATA,"anticoncepcion, prevencion de its y de cancer de cuello uterino",numero de inyectables trimestrales suministrados,2015-06-01,0,2,30,17,0,49
CORO CORO,"anticoncepcion, prevencion de its y de cancer de cuello uterino",numero de inyectables trimestrales suministrados,2015-06-01,0,2,12,10,0,24
COROICO,"anticoncepcion, prevencion de its y de cancer de cuello uterino",numero de inyectables trimestrales suministrados,2015-06-01,0,1,21,5,1,28
CORQUE,"anticoncepcion, prevencion de its y de cancer de cuello uterino",numero de inyectables trimestrales suministrados,2015-06-01,0,2,14,6,0,22
COTAGAITA,"anticoncepcion, prevencion de its y de cancer de cuello uterino",numero de inyectables trimestrales suministrados,2015-06-01,0,7,73,41,1,122
COTOCA,"anticoncepcion, prevencion de its y de cancer de cuello uterino",numero de inyectables trimestrales suministrados,2015-06-01,1,20,113,23,0,157
CUATRO CAÑADAS,"anticoncepcion, prevencion de its y de cancer de cuello uterino",numero de inyectables trimestrales suministrados,2015-06-01,0,9,42,17,5,73
CUCHUMUELA (V. G. VILLARROEL),"anticoncepcion, prevencion de its y de cancer de cuello uterino",numero de inyectables trimestrales suministrados,2015-06-01,0,0,6,3,0,9
CUEVO,"anticoncepcion, prevencion de its y de cancer de cuello uterino",numero de inyectables trimestrales suministrados,2015-06-01,0,5,24,8,1,38
CULPINA,"anticoncepcion, prevencion de its y de cancer de cuello uterino",numero de inyectables trimestrales suministrados,2015-06-01,0,9,63,43,0,115
CURAHUARA DE CARANGAS,"anticoncepcion, prevencion de its y de cancer de cuello uterino",numero de inyectables trimestrales suministrados,2015-06-01,0,2,13,2,0,17
CURVA,"anticoncepcion, prevencion de its y de cancer de cuello uterino",numero de inyectables trimestrales suministrados,2015-06-01,0,0,1,3,0,4
DESAGUADERO,"anticoncepcion, prevencion de its y de cancer de cuello uterino",numero de inyectables trimestrales suministrados,2015-06-01,0,0,12,3,0,15
EL ALTO,"anticoncepcion, prevencion de its y de cancer de cuello uterino",numero de inyectables trimestrales suministrados,2015-06-01,2,100,1099,433,1,1635
EL CHORO,"anticoncepcion, prevencion de its y de cancer de cuello uterino",numero de inyectables trimestrales suministrados,2015-06-01,0,0,6,3,0,9
EL PUENTE(STC),"anticoncepcion, prevencion de its y de cancer de cuello uterino",numero de inyectables trimestrales suministrados,2015-06-01,0,9,39,21,0,69
EL PUENTE(TJA),"anticoncepcion, prevencion de its y de cancer de cuello uterino",numero de inyectables trimestrales suministrados,2015-06-01,0,6,69,40,1,116
EL TORNO,"anticoncepcion, prevencion de its y de cancer de cuello uterino",numero de inyectables trimestrales suministrados,2015-06-01,5,34,123,50,3,215
EL VILLAR,"anticoncepcion, prevencion de its y de cancer de cuello uterino",numero de inyectables trimestrales suministrados,2015-06-01,0,6,15,18,0,39
ENTRE RIOS TRJ,"anticoncepcion, prevencion de its y de cancer de cuello uterino",numero de inyectables trimestrales suministrados,2015-06-01,2,30,112,52,1,197
ENTRE RIOS CBBA,"anticoncepcion, prevencion de its y de cancer de cuello uterino",numero de inyectables trimestrales suministrados,2015-06-01,1,10,59,27,0,97
ESCOMA,"anticoncepcion, prevencion de its y de cancer de cuello uterino",numero de inyectables trimestrales suministrados,2015-06-01,0,0,5,1,0,6
ESMERALDA,"anticoncepcion, prevencion de its y de cancer de cuello uterino",numero de inyectables trimestrales suministrados,2015-06-01,0,0,1,0,0,1
EUCALIPTUS,"anticoncepcion, prevencion de its y de cancer de cuello uterino",numero de inyectables trimestrales suministrados,2015-06-01,0,1,6,4,0,11
EUREKA (SANTOS MERCADO),"anticoncepcion, prevencion de its y de cancer de cuello uterino",numero de inyectables trimestrales suministrados,2015-06-01,0,6,10,2,0,18
EXALTACION,"anticoncepcion, prevencion de its y de cancer de cuello uterino",numero de inyectables trimestrales suministrados,2015-06-01,0,0,3,0,0,3
FERNANDEZ ALONSO,"anticoncepcion, prevencion de its y de cancer de cuello uterino",numero de inyectables trimestrales suministrados,2015-06-01,0,9,46,15,0,70
FILADELFIA,"anticoncepcion, prevencion de its y de cancer de cuello uterino",numero de inyectables trimestrales suministrados,2015-06-01,1,3,10,3,0,17
GENERAL SAAVEDRA,"anticoncepcion, prevencion de its y de cancer de cuello uterino",numero de inyectables trimestrales suministrados,2015-06-01,1,9,46,19,0,75
GRAL. J.J. PEREZ (CHARAZANI),"anticoncepcion, prevencion de its y de cancer de cuello uterino",numero de inyectables trimestrales suministrados,2015-06-01,0,0,23,9,0,32
GUANAY,"anticoncepcion, prevencion de its y de cancer de cuello uterino",numero de inyectables trimestrales suministrados,2015-06-01,1,4,19,5,0,29
GUAQUI,"anticoncepcion, prevencion de its y de cancer de cuello uterino",numero de inyectables trimestrales suministrados,2015-06-01,0,2,9,9,1,21
GUAYARAMERIN,"anticoncepcion, prevencion de its y de cancer de cuello uterino",numero de inyectables trimestrales suministrados,2015-06-01,1,3,20,2,0,26
GUTIERREZ,"anticoncepcion, prevencion de its y de cancer de cuello uterino",numero de inyectables trimestrales suministrados,2015-06-01,0,2,23,6,0,31
HUACARETA,"anticoncepcion, prevencion de its y de cancer de cuello uterino",numero de inyectables trimestrales suministrados,2015-06-01,0,4,29,19,0,52
HUACAYA (VILLA DE HUACAYA),"anticoncepcion, prevencion de its y de cancer de cuello uterino",numero de inyectables trimestrales suministrados,2015-06-01,0,0,16,2,0,18
HUACHACALLA,"anticoncepcion, prevencion de its y de cancer de cuello uterino",numero de inyectables trimestrales suministrados,2015-06-01,0,0,2,1,0,3
HUANUNI,"anticoncepcion, prevencion de its y de cancer de cuello uterino",numero de inyectables trimestrales suministrados,2015-06-01,0,1,32,10,0,43
HUARACAJE,"anticoncepcion, prevencion de its y de cancer de cuello uterino",numero de inyectables trimestrales suministrados,2015-06-01,0,2,7,2,0,11
HUARINA,"anticoncepcion, prevencion de its y de cancer de cuello uterino",numero de inyectables trimestrales suministrados,2015-06-01,0,2,7,3,0,12
HUATAJATA,"anticoncepcion, prevencion de its y de cancer de cuello uterino",numero de inyectables trimestrales suministrados,2015-06-01,0,1,3,4,0,8
HUAYLLAMARCA,"anticoncepcion, prevencion de its y de cancer de cuello uterino",numero de inyectables trimestrales suministrados,2015-06-01,0,3,8,10,0,21
HUMANATA,"anticoncepcion, prevencion de its y de cancer de cuello uterino",numero de inyectables trimestrales suministrados,2015-06-01,0,0,4,5,0,9
ICHOCA,"anticoncepcion, prevencion de its y de cancer de cuello uterino",numero de inyectables trimestrales suministrados,2015-06-01,0,1,6,3,0,10
ICLA,"anticoncepcion, prevencion de its y de cancer de cuello uterino",numero de inyectables trimestrales suministrados,2015-06-01,0,1,12,22,0,35
INCAHUASI,"anticoncepcion, prevencion de its y de cancer de cuello uterino",numero de inyectables trimestrales suministrados,2015-06-01,0,5,26,25,2,58
INGAVI (HUMAITA),"anticoncepcion, prevencion de its y de cancer de cuello uterino",numero de inyectables trimestrales suministrados,2015-06-01,0,1,3,0,0,4
INQUISIVI,"anticoncepcion, prevencion de its y de cancer de cuello uterino",numero de inyectables trimestrales suministrados,2015-06-01,0,0,27,16,0,43
IRUPANA (VILLA DE LANZA),"anticoncepcion, prevencion de its y de cancer de cuello uterino",numero de inyectables trimestrales suministrados,2015-06-01,0,5,41,36,0,82
IXIAMAS,"anticoncepcion, prevencion de its y de cancer de cuello uterino",numero de inyectables trimestrales suministrados,2015-06-01,1,2,28,9,0,40
JESUS DE MACHACA,"anticoncepcion, prevencion de its y de cancer de cuello uterino",numero de inyectables trimestrales suministrados,2015-06-01,0,1,12,6,0,19
LA ASUNTA,"anticoncepcion, prevencion de its y de cancer de cuello uterino",numero de inyectables trimestrales suministrados,2015-06-01,0,12,141,39,0,192
LA GUARDIA,"anticoncepcion, prevencion de its y de cancer de cuello uterino",numero de inyectables trimestrales suministrados,2015-06-01,1,27,136,55,0,219
LA PAZ,"anticoncepcion, prevencion de its y de cancer de cuello uterino",numero de inyectables trimestrales suministrados,2015-06-01,0,42,439,141,2,624
LA RIVERA,"anticoncepcion, prevencion de its y de cancer de cuello uterino",numero de inyectables trimestrales suministrados,2015-06-01,0,0,1,0,0,1
LAGUNILLAS,"anticoncepcion, prevencion de its y de cancer de cuello uterino",numero de inyectables trimestrales suministrados,2015-06-01,1,1,10,7,0,19
LAJA,"anticoncepcion, prevencion de its y de cancer de cuello uterino",numero de inyectables trimestrales suministrados,2015-06-01,0,5,33,11,0,49
LAS CARRERAS,"anticoncepcion, prevencion de its y de cancer de cuello uterino",numero de inyectables trimestrales suministrados,2015-06-01,0,1,18,9,0,28
LICOMA PAMPA,"anticoncepcion, prevencion de its y de cancer de cuello uterino",numero de inyectables trimestrales suministrados,2015-06-01,1,2,11,5,0,19
LLALLAGUA,"anticoncepcion, prevencion de its y de cancer de cuello uterino",numero de inyectables trimestrales suministrados,2015-06-01,0,9,86,26,0,121
LLICA,"anticoncepcion, prevencion de its y de cancer de cuello uterino",numero de inyectables trimestrales suministrados,2015-06-01,0,7,12,10,0,29
LORETO,"anticoncepcion, prevencion de its y de cancer de cuello uterino",numero de inyectables trimestrales suministrados,2015-06-01,0,1,11,2,1,15
LURIBAY,"anticoncepcion, prevencion de its y de cancer de cuello uterino",numero de inyectables trimestrales suministrados,2015-06-01,0,2,20,18,2,42
MACHACAMARCA,"anticoncepcion, prevencion de its y de cancer de cuello uterino",numero de inyectables trimestrales suministrados,2015-06-01,0,0,7,2,0,9
MACHARETI,"anticoncepcion, prevencion de its y de cancer de cuello uterino",numero de inyectables trimestrales suministrados,2015-06-01,0,4,28,9,0,41
MAGDALENA,"anticoncepcion, prevencion de its y de cancer de cuello uterino",numero de inyectables trimestrales suministrados,2015-06-01,0,4,26,2,0,32
MAIRANA,"anticoncepcion, prevencion de its y de cancer de cuello uterino",numero de inyectables trimestrales suministrados,2015-06-01,0,14,32,14,0,60
MALLA,"anticoncepcion, prevencion de its y de cancer de cuello uterino",numero de inyectables trimestrales suministrados,2015-06-01,0,0,7,4,0,11
MAPIRI,"anticoncepcion, prevencion de its y de cancer de cuello uterino",numero de inyectables trimestrales suministrados,2015-06-01,0,1,22,8,0,31
MECAPACA,"anticoncepcion, prevencion de its y de cancer de cuello uterino",numero de inyectables trimestrales suministrados,2015-06-01,0,0,30,20,0,50
MINEROS,"anticoncepcion, prevencion de its y de cancer de cuello uterino",numero de inyectables trimestrales suministrados,2015-06-01,0,18,52,20,1,91
MIZQUE,"anticoncepcion, prevencion de its y de cancer de cuello uterino",numero de inyectables trimestrales suministrados,2015-06-01,2,12,86,40,0,140
MOCOMOCO,"anticoncepcion, prevencion de its y de cancer de cuello uterino",numero de inyectables trimestrales suministrados,2015-06-01,0,0,24,22,0,46
MOJINETE,"anticoncepcion, prevencion de its y de cancer de cuello uterino",numero de inyectables trimestrales suministrados,2015-06-01,0,0,0,2,0,2
MOJOCOYA,"anticoncepcion, prevencion de its y de cancer de cuello uterino",numero de inyectables trimestrales suministrados,2015-06-01,0,5,21,23,0,49
MONTEAGUDO,"anticoncepcion, prevencion de its y de cancer de cuello uterino",numero de inyectables trimestrales suministrados,2015-06-01,2,21,54,32,3,112
MONTERO,"anticoncepcion, prevencion de its y de cancer de cuello uterino",numero de inyectables trimestrales suministrados,2015-06-01,0,49,181,41,0,271
MORO MORO,"anticoncepcion, prevencion de its y de cancer de cuello uterino",numero de inyectables trimestrales suministrados,2015-06-01,0,2,18,12,0,32
MOROCHATA,"anticoncepcion, prevencion de its y de cancer de cuello uterino",numero de inyectables trimestrales suministrados,2015-06-01,1,3,40,25,0,69
NACEBE (SANTA ROSA DEL ABUNA),"anticoncepcion, prevencion de its y de cancer de cuello uterino",numero de inyectables trimestrales suministrados,2015-06-01,0,0,3,2,0,5
NAZACARA DE PACAJES,"anticoncepcion, prevencion de its y de cancer de cuello uterino",numero de inyectables trimestrales suministrados,2015-06-01,0,1,2,0,0,3
NUEVO MANOA (NUEVA ESPERANZA),"anticoncepcion, prevencion de its y de cancer de cuello uterino",numero de inyectables trimestrales suministrados,2015-06-01,0,0,3,1,0,4
OCURI,"anticoncepcion, prevencion de its y de cancer de cuello uterino",numero de inyectables trimestrales suministrados,2015-06-01,0,2,27,27,0,56
OKINAWA,"anticoncepcion, prevencion de its y de cancer de cuello uterino",numero de inyectables trimestrales suministrados,2015-06-01,0,2,9,10,0,21
OMEREQUE,"anticoncepcion, prevencion de its y de cancer de cuello uterino",numero de inyectables trimestrales suministrados,2015-06-01,0,1,22,7,0,30
ORURO,"anticoncepcion, prevencion de its y de cancer de cuello uterino",numero de inyectables trimestrales suministrados,2015-06-01,0,47,487,199,2,735
PADCAYA,"anticoncepcion, prevencion de its y de cancer de cuello uterino",numero de inyectables trimestrales suministrados,2015-06-01,0,23,109,80,0,212
PADILLA,"anticoncepcion, prevencion de its y de cancer de cuello uterino",numero de inyectables trimestrales suministrados,2015-06-01,0,8,64,32,0,104
PAILON,"anticoncepcion, prevencion de its y de cancer de cuello uterino",numero de inyectables trimestrales suministrados,2015-06-01,0,13,37,10,0,60
PALCA,"anticoncepcion, prevencion de its y de cancer de cuello uterino",numero de inyectables trimestrales suministrados,2015-06-01,0,2,45,12,0,59
PALOS BLANCOS,"anticoncepcion, prevencion de its y de cancer de cuello uterino",numero de inyectables trimestrales suministrados,2015-06-01,0,6,68,38,0,112
PAMPA AULLAGAS,"anticoncepcion, prevencion de its y de cancer de cuello uterino",numero de inyectables trimestrales suministrados,2015-06-01,0,0,2,4,0,6
PAMPA GRANDE,"anticoncepcion, prevencion de its y de cancer de cuello uterino",numero de inyectables trimestrales suministrados,2015-06-01,0,8,35,13,1,57
PAPEL PAMPA,"anticoncepcion, prevencion de its y de cancer de cuello uterino",numero de inyectables trimestrales suministrados,2015-06-01,0,2,15,11,0,28
PASORAPA,"anticoncepcion, prevencion de its y de cancer de cuello uterino",numero de inyectables trimestrales suministrados,2015-06-01,0,0,18,10,4,32
PATACAMAYA,"anticoncepcion, prevencion de its y de cancer de cuello uterino",numero de inyectables trimestrales suministrados,2015-06-01,0,0,25,4,0,29
PAZÑA,"anticoncepcion, prevencion de its y de cancer de cuello uterino",numero de inyectables trimestrales suministrados,2015-06-01,0,0,12,8,0,20
PELECHUCO,"anticoncepcion, prevencion de its y de cancer de cuello uterino",numero de inyectables trimestrales suministrados,2015-06-01,0,0,18,15,0,33
POCOATA,"anticoncepcion, prevencion de its y de cancer de cuello uterino",numero de inyectables trimestrales suministrados,2015-06-01,0,4,33,26,1,64
POCONA,"anticoncepcion, prevencion de its y de cancer de cuello uterino",numero de inyectables trimestrales suministrados,2015-06-01,0,11,72,47,2,132
POJO (CBBA),"anticoncepcion, prevencion de its y de cancer de cuello uterino",numero de inyectables trimestrales suministrados,2015-06-01,0,11,62,27,1,101
PORCO,"anticoncepcion, prevencion de its y de cancer de cuello uterino",numero de inyectables trimestrales suministrados,2015-06-01,0,0,8,3,0,11
POROMA,"anticoncepcion, prevencion de its y de cancer de cuello uterino",numero de inyectables trimestrales suministrados,2015-06-01,0,6,46,23,1,76
PORONGO,"anticoncepcion, prevencion de its y de cancer de cuello uterino",numero de inyectables trimestrales suministrados,2015-06-01,0,0,12,2,0,14
PORTACHUELO,"anticoncepcion, prevencion de its y de cancer de cuello uterino",numero de inyectables trimestrales suministrados,2015-06-01,0,7,35,17,0,59
PORVENIR,"anticoncepcion, prevencion de its y de cancer de cuello uterino",numero de inyectables trimestrales suministrados,2015-06-01,0,6,13,1,0,20
POSTRER VALLE,"anticoncepcion, prevencion de its y de cancer de cuello uterino",numero de inyectables trimestrales suministrados,2015-06-01,0,0,7,1,0,8
POTOSI,"anticoncepcion, prevencion de its y de cancer de cuello uterino",numero de inyectables trimestrales suministrados,2015-06-01,1,52,441,139,1,634
PRESTO,"anticoncepcion, prevencion de its y de cancer de cuello uterino",numero de inyectables trimestrales suministrados,2015-06-01,0,2,33,19,0,54
PUCARA,"anticoncepcion, prevencion de its y de cancer de cuello uterino",numero de inyectables trimestrales suministrados,2015-06-01,0,1,7,3,0,11
PUCARANI,"anticoncepcion, prevencion de its y de cancer de cuello uterino",numero de inyectables trimestrales suministrados,2015-06-01,0,9,61,39,0,109
PUERTO ACOSTA,"anticoncepcion, prevencion de its y de cancer de cuello uterino",numero de inyectables trimestrales suministrados,2015-06-01,0,1,6,2,0,9
PUERTO CARABUCO,"anticoncepcion, prevencion de its y de cancer de cuello uterino",numero de inyectables trimestrales suministrados,2015-06-01,0,0,21,14,1,36
PUERTO GONZALO MORENO,"anticoncepcion, prevencion de its y de cancer de cuello uterino",numero de inyectables trimestrales suministrados,2015-06-01,1,12,19,8,0,40
PUERTO PEREZ,"anticoncepcion, prevencion de its y de cancer de cuello uterino",numero de inyectables trimestrales suministrados,2015-06-01,0,0,5,5,0,10
PUERTO QUIJARRO,"anticoncepcion, prevencion de its y de cancer de cuello uterino",numero de inyectables trimestrales suministrados,2015-06-01,0,4,22,2,0,28
PUERTO RICO,"anticoncepcion, prevencion de its y de cancer de cuello uterino",numero de inyectables trimestrales suministrados,2015-06-01,0,11,27,14,0,52
PUERTO SILES,"anticoncepcion, prevencion de its y de cancer de cuello uterino",numero de inyectables trimestrales suministrados,2015-06-01,0,0,2,0,0,2
PUERTO SUAREZ,"anticoncepcion, prevencion de its y de cancer de cuello uterino",numero de inyectables trimestrales suministrados,2015-06-01,0,1,9,0,0,10
PUERTO VILLARROEL,"anticoncepcion, prevencion de its y de cancer de cuello uterino",numero de inyectables trimestrales suministrados,2015-06-01,2,15,83,39,0,139
PUNA,"anticoncepcion, prevencion de its y de cancer de cuello uterino",numero de inyectables trimestrales suministrados,2015-06-01,0,5,38,26,0,69
PUNATA,"anticoncepcion, prevencion de its y de cancer de cuello uterino",numero de inyectables trimestrales suministrados,2015-06-01,0,7,54,16,1,78
QUIABAYA,"anticoncepcion, prevencion de its y de cancer de cuello uterino",numero de inyectables trimestrales suministrados,2015-06-01,0,2,8,2,0,12
QUILLACOLLO,"anticoncepcion, prevencion de its y de cancer de cuello uterino",numero de inyectables trimestrales suministrados,2015-06-01,0,16,161,28,0,205
QUIME,"anticoncepcion, prevencion de its y de cancer de cuello uterino",numero de inyectables trimestrales suministrados,2015-06-01,0,4,29,12,0,45
QUIRUSILLAS,"anticoncepcion, prevencion de its y de cancer de cuello uterino",numero de inyectables trimestrales suministrados,2015-06-01,0,4,5,7,1,17
RAVELO,"anticoncepcion, prevencion de its y de cancer de cuello uterino",numero de inyectables trimestrales suministrados,2015-06-01,0,3,41,49,1,94
REYES,"anticoncepcion, prevencion de its y de cancer de cuello uterino",numero de inyectables trimestrales suministrados,2015-06-01,0,4,35,7,0,46
RIBERALTA,"anticoncepcion, prevencion de its y de cancer de cuello uterino",numero de inyectables trimestrales suministrados,2015-06-01,14,36,142,29,0,221
ROBORE,"anticoncepcion, prevencion de its y de cancer de cuello uterino",numero de inyectables trimestrales suministrados,2015-06-01,0,6,44,5,0,55
RURRENABAQUE,"anticoncepcion, prevencion de its y de cancer de cuello uterino",numero de inyectables trimestrales suministrados,2015-06-01,0,9,55,10,0,74
SABAYA,"anticoncepcion, prevencion de its y de cancer de cuello uterino",numero de inyectables trimestrales suministrados,2015-06-01,0,0,3,2,0,5
SACABA,"anticoncepcion, prevencion de its y de cancer de cuello uterino",numero de inyectables trimestrales suministrados,2015-06-01,0,27,161,50,0,238
SACABAMBA,"anticoncepcion, prevencion de its y de cancer de cuello uterino",numero de inyectables trimestrales suministrados,2015-06-01,0,4,2,6,0,12
SACACA,"anticoncepcion, prevencion de its y de cancer de cuello uterino",numero de inyectables trimestrales suministrados,2015-06-01,0,5,47,18,0,70
SAIPINA,"anticoncepcion, prevencion de its y de cancer de cuello uterino",numero de inyectables trimestrales suministrados,2015-06-01,1,6,19,6,1,33
SALINAS DE GARCI MENDOZA,"anticoncepcion, prevencion de its y de cancer de cuello uterino",numero de inyectables trimestrales suministrados,2015-06-01,0,7,27,11,0,45
SAMAIPATA,"anticoncepcion, prevencion de its y de cancer de cuello uterino",numero de inyectables trimestrales suministrados,2015-06-01,1,2,27,9,0,39
SAN AGUSTIN,"anticoncepcion, prevencion de its y de cancer de cuello uterino",numero de inyectables trimestrales suministrados,2015-06-01,0,0,10,2,0,12
SAN ANDRES,"anticoncepcion, prevencion de its y de cancer de cuello uterino",numero de inyectables trimestrales suministrados,2015-06-01,4,9,32,9,0,54
SAN ANDRES DE MACHACA,"anticoncepcion, prevencion de its y de cancer de cuello uterino",numero de inyectables trimestrales suministrados,2015-06-01,0,0,3,2,0,5
SAN ANTONIO DE ESMORUCO,"anticoncepcion, prevencion de its y de cancer de cuello uterino",numero de inyectables trimestrales suministrados,2015-06-01,0,0,7,0,0,7
SAN ANTONIO DE LOMERIO,"anticoncepcion, prevencion de its y de cancer de cuello uterino",numero de inyectables trimestrales suministrados,2015-06-01,0,12,40,26,0,78
SAN BENITO,"anticoncepcion, prevencion de its y de cancer de cuello uterino",numero de inyectables trimestrales suministrados,2015-06-01,0,2,33,16,0,51
SAN BORJA,"anticoncepcion, prevencion de its y de cancer de cuello uterino",numero de inyectables trimestrales suministrados,2015-06-01,0,32,114,33,0,179
SAN BUENA VENTURA,"anticoncepcion, prevencion de its y de cancer de cuello uterino",numero de inyectables trimestrales suministrados,2015-06-01,0,1,21,4,0,26
SAN CARLOS,"anticoncepcion, prevencion de its y de cancer de cuello uterino",numero de inyectables trimestrales suministrados,2015-06-01,1,11,33,19,0,64
SAN IGNACIO,"anticoncepcion, prevencion de its y de cancer de cuello uterino",numero de inyectables trimestrales suministrados,2015-06-01,0,9,89,42,0,140
SAN IGNACIO DE VELASCO,"anticoncepcion, prevencion de its y de cancer de cuello uterino",numero de inyectables trimestrales suministrados,2015-06-01,0,14,122,37,1,174
SAN JAVIER(BNI),"anticoncepcion, prevencion de its y de cancer de cuello uterino",numero de inyectables trimestrales suministrados,2015-06-01,0,3,3,4,0,10
SAN JAVIER(STC),"anticoncepcion, prevencion de its y de cancer de cuello uterino",numero de inyectables trimestrales suministrados,2015-06-01,0,8,30,10,0,48
SAN JOAQUIN,"anticoncepcion, prevencion de its y de cancer de cuello uterino",numero de inyectables trimestrales suministrados,2015-06-01,0,0,1,0,0,1
SAN JOSE DE CHIQUITOS,"anticoncepcion, prevencion de its y de cancer de cuello uterino",numero de inyectables trimestrales suministrados,2015-06-01,0,6,42,15,1,64
SAN JUAN DE YAPACANI,"anticoncepcion, prevencion de its y de cancer de cuello uterino",numero de inyectables trimestrales suministrados,2015-06-01,0,5,30,12,0,47
SAN JULIAN,"anticoncepcion, prevencion de its y de cancer de cuello uterino",numero de inyectables trimestrales suministrados,2015-06-01,0,15,82,37,1,135
SAN LORENZO(PND),"anticoncepcion, prevencion de its y de cancer de cuello uterino",numero de inyectables trimestrales suministrados,2015-06-01,0,2,25,4,0,31
SAN LORENZO(TJA),"anticoncepcion, prevencion de its y de cancer de cuello uterino",numero de inyectables trimestrales suministrados,2015-06-01,1,20,85,53,2,161
SAN LUCAS,"anticoncepcion, prevencion de its y de cancer de cuello uterino",numero de inyectables trimestrales suministrados,2015-06-01,0,5,68,35,0,108
SAN MATIAS,"anticoncepcion, prevencion de its y de cancer de cuello uterino",numero de inyectables trimestrales suministrados,2015-06-01,0,4,21,7,0,32
SAN MIGUEL DE VELASCO,"anticoncepcion, prevencion de its y de cancer de cuello uterino",numero de inyectables trimestrales suministrados,2015-06-01,1,19,68,26,2,116
SAN PABLO DE LIPEZ,"anticoncepcion, prevencion de its y de cancer de cuello uterino",numero de inyectables trimestrales suministrados,2015-06-01,0,0,3,3,0,6
SAN PEDRO,"anticoncepcion, prevencion de its y de cancer de cuello uterino",numero de inyectables trimestrales suministrados,2015-06-01,0,2,41,12,0,55
SAN PEDRO DE BUENA VISTA,"anticoncepcion, prevencion de its y de cancer de cuello uterino",numero de inyectables trimestrales suministrados,2015-06-01,0,5,41,28,0,74
SAN PEDRO DE CURAHUARA,"anticoncepcion, prevencion de its y de cancer de cuello uterino",numero de inyectables trimestrales suministrados,2015-06-01,0,0,9,8,0,17
SAN PEDRO DE QUEMES,"anticoncepcion, prevencion de its y de cancer de cuello uterino",numero de inyectables trimestrales suministrados,2015-06-01,0,2,4,0,0,6
SAN PEDRO DE TIQUINA,"anticoncepcion, prevencion de its y de cancer de cuello uterino",numero de inyectables trimestrales suministrados,2015-06-01,0,0,11,3,0,14
SAN PEDRO(PND),"anticoncepcion, prevencion de its y de cancer de cuello uterino",numero de inyectables trimestrales suministrados,2015-06-01,0,3,0,1,0,4
SAN RAFAEL,"anticoncepcion, prevencion de its y de cancer de cuello uterino",numero de inyectables trimestrales suministrados,2015-06-01,0,8,32,19,1,60
SAN RAMON BENI,"anticoncepcion, prevencion de its y de cancer de cuello uterino",numero de inyectables trimestrales suministrados,2015-06-01,0,2,5,2,0,9
SAN RAMON SCZ,"anticoncepcion, prevencion de its y de cancer de cuello uterino",numero de inyectables trimestrales suministrados,2015-06-01,0,28,12,10,0,50
SANTA ANA,"anticoncepcion, prevencion de its y de cancer de cuello uterino",numero de inyectables trimestrales suministrados,2015-06-01,1,5,24,2,1,33
SANTA CRUZ DE LA SIERRA,"anticoncepcion, prevencion de its y de cancer de cuello uterino",numero de inyectables trimestrales suministrados,2015-06-01,8,126,593,120,1,848
SANTA ROSA,"anticoncepcion, prevencion de its y de cancer de cuello uterino",numero de inyectables trimestrales suministrados,2015-06-01,0,3,13,0,0,16
SANTA ROSA DEL SARA,"anticoncepcion, prevencion de its y de cancer de cuello uterino",numero de inyectables trimestrales suministrados,2015-06-01,0,17,44,22,0,83
SANTIAGO DE CALLAPA,"anticoncepcion, prevencion de its y de cancer de cuello uterino",numero de inyectables trimestrales suministrados,2015-06-01,0,1,1,1,0,3
SANTIAGO DE HUARI,"anticoncepcion, prevencion de its y de cancer de cuello uterino",numero de inyectables trimestrales suministrados,2015-06-01,0,1,3,4,0,8
SANTIAGO DE HUATA,"anticoncepcion, prevencion de its y de cancer de cuello uterino",numero de inyectables trimestrales suministrados,2015-06-01,0,1,7,5,0,13
SANTIAGO DE MACHACA,"anticoncepcion, prevencion de its y de cancer de cuello uterino",numero de inyectables trimestrales suministrados,2015-06-01,0,1,6,7,0,14
SANTIVAÑES,"anticoncepcion, prevencion de its y de cancer de cuello uterino",numero de inyectables trimestrales suministrados,2015-06-01,0,2,19,7,0,28
SANTUARIO DE QUILLACAS,"anticoncepcion, prevencion de its y de cancer de cuello uterino",numero de inyectables trimestrales suministrados,2015-06-01,0,0,16,2,0,18
SAPAHAQUI,"anticoncepcion, prevencion de its y de cancer de cuello uterino",numero de inyectables trimestrales suministrados,2015-06-01,0,0,30,18,0,48
SENA,"anticoncepcion, prevencion de its y de cancer de cuello uterino",numero de inyectables trimestrales suministrados,2015-06-01,0,3,21,0,0,24
SHINAOTA,"anticoncepcion, prevencion de its y de cancer de cuello uterino",numero de inyectables trimestrales suministrados,2015-06-01,0,9,25,12,0,46
SICA SICA (VILLA AROMA),"anticoncepcion, prevencion de its y de cancer de cuello uterino",numero de inyectables trimestrales suministrados,2015-06-01,0,4,41,24,0,69
SICAYA,"anticoncepcion, prevencion de its y de cancer de cuello uterino",numero de inyectables trimestrales suministrados,2015-06-01,0,2,18,7,0,27
SIPE SIPE,"anticoncepcion, prevencion de its y de cancer de cuello uterino",numero de inyectables trimestrales suministrados,2015-06-01,1,18,175,63,1,258
SOPACHUY,"anticoncepcion, prevencion de its y de cancer de cuello uterino",numero de inyectables trimestrales suministrados,2015-06-01,0,0,26,16,2,44
SORACACHI,"anticoncepcion, prevencion de its y de cancer de cuello uterino",numero de inyectables trimestrales suministrados,2015-06-01,0,7,21,7,0,35
SORATA,"anticoncepcion, prevencion de its y de cancer de cuello uterino",numero de inyectables trimestrales suministrados,2015-06-01,0,5,36,30,0,71
SUCRE,"anticoncepcion, prevencion de its y de cancer de cuello uterino",numero de inyectables trimestrales suministrados,2015-06-01,1,73,598,178,2,852
TACACHI,"anticoncepcion, prevencion de its y de cancer de cuello uterino",numero de inyectables trimestrales suministrados,2015-06-01,0,1,0,0,0,1
TACACOMA,"anticoncepcion, prevencion de its y de cancer de cuello uterino",numero de inyectables trimestrales suministrados,2015-06-01,0,3,31,12,0,46
TACOBAMBA,"anticoncepcion, prevencion de its y de cancer de cuello uterino",numero de inyectables trimestrales suministrados,2015-06-01,0,0,27,16,0,43
TACOPAYA,"anticoncepcion, prevencion de its y de cancer de cuello uterino",numero de inyectables trimestrales suministrados,2015-06-01,0,1,12,20,0,33
TAHUA,"anticoncepcion, prevencion de its y de cancer de cuello uterino",numero de inyectables trimestrales suministrados,2015-06-01,0,1,3,1,0,5
TAPACARI,"anticoncepcion, prevencion de its y de cancer de cuello uterino",numero de inyectables trimestrales suministrados,2015-06-01,0,8,59,48,0,115
TARABUCO,"anticoncepcion, prevencion de its y de cancer de cuello uterino",numero de inyectables trimestrales suministrados,2015-06-01,0,6,46,26,0,78
TARACO,"anticoncepcion, prevencion de its y de cancer de cuello uterino",numero de inyectables trimestrales suministrados,2015-06-01,0,2,19,10,0,31
TARATA,"anticoncepcion, prevencion de its y de cancer de cuello uterino",numero de inyectables trimestrales suministrados,2015-06-01,0,2,24,13,0,39
TARIJA,"anticoncepcion, prevencion de its y de cancer de cuello uterino",numero de inyectables trimestrales suministrados,2015-06-01,0,48,317,81,3,449
TARVITA,"anticoncepcion, prevencion de its y de cancer de cuello uterino",numero de inyectables trimestrales suministrados,2015-06-01,1,7,27,23,0,58
TEOPONTE,"anticoncepcion, prevencion de its y de cancer de cuello uterino",numero de inyectables trimestrales suministrados,2015-06-01,0,3,28,10,0,41
TIAWANACU,"anticoncepcion, prevencion de its y de cancer de cuello uterino",numero de inyectables trimestrales suministrados,2015-06-01,0,0,27,14,1,42
TINGUIPAYA,"anticoncepcion, prevencion de its y de cancer de cuello uterino",numero de inyectables trimestrales suministrados,2015-06-01,0,3,22,18,1,44
TIPUANI,"anticoncepcion, prevencion de its y de cancer de cuello uterino",numero de inyectables trimestrales suministrados,2015-06-01,0,4,15,8,0,27
TIQUIPAYA,"anticoncepcion, prevencion de its y de cancer de cuello uterino",numero de inyectables trimestrales suministrados,2015-06-01,1,19,92,13,0,125
TIRAQUE (CBBA),"anticoncepcion, prevencion de its y de cancer de cuello uterino",numero de inyectables trimestrales suministrados,2015-06-01,0,1,9,12,0,22
TITO YUPANQUI (PARQUIPUJIO),"anticoncepcion, prevencion de its y de cancer de cuello uterino",numero de inyectables trimestrales suministrados,2015-06-01,0,0,0,1,0,1
TOCO,"anticoncepcion, prevencion de its y de cancer de cuello uterino",numero de inyectables trimestrales suministrados,2015-06-01,0,3,17,11,0,31
TODOS SANTOS,"anticoncepcion, prevencion de its y de cancer de cuello uterino",numero de inyectables trimestrales suministrados,2015-06-01,0,0,1,0,0,1
TOLATA,"anticoncepcion, prevencion de its y de cancer de cuello uterino",numero de inyectables trimestrales suministrados,2015-06-01,0,0,25,3,1,29
TOLEDO,"anticoncepcion, prevencion de its y de cancer de cuello uterino",numero de inyectables trimestrales suministrados,2015-06-01,0,1,10,3,0,14
TOMAVE,"anticoncepcion, prevencion de its y de cancer de cuello uterino",numero de inyectables trimestrales suministrados,2015-06-01,0,3,22,7,0,32
TOMINA,"anticoncepcion, prevencion de its y de cancer de cuello uterino",numero de inyectables trimestrales suministrados,2015-06-01,1,6,54,39,1,101
TORO TORO,"anticoncepcion, prevencion de its y de cancer de cuello uterino",numero de inyectables trimestrales suministrados,2015-06-01,0,4,17,10,0,31
TOTORA(CBBA),"anticoncepcion, prevencion de its y de cancer de cuello uterino",numero de inyectables trimestrales suministrados,2015-06-01,0,18,91,34,0,143
TOTORA(ORR),"anticoncepcion, prevencion de its y de cancer de cuello uterino",numero de inyectables trimestrales suministrados,2015-06-01,0,1,11,7,0,19
TRIGAL,"anticoncepcion, prevencion de its y de cancer de cuello uterino",numero de inyectables trimestrales suministrados,2015-06-01,0,0,6,1,0,7
TRINIDAD,"anticoncepcion, prevencion de its y de cancer de cuello uterino",numero de inyectables trimestrales suministrados,2015-06-01,0,13,48,10,0,71
TUPIZA,"anticoncepcion, prevencion de its y de cancer de cuello uterino",numero de inyectables trimestrales suministrados,2015-06-01,0,15,153,48,0,216
TURCO,"anticoncepcion, prevencion de its y de cancer de cuello uterino",numero de inyectables trimestrales suministrados,2015-06-01,0,2,4,9,0,15
UMALA,"anticoncepcion, prevencion de its y de cancer de cuello uterino",numero de inyectables trimestrales suministrados,2015-06-01,0,1,12,8,0,21
UNCIA,"anticoncepcion, prevencion de its y de cancer de cuello uterino",numero de inyectables trimestrales suministrados,2015-06-01,0,2,51,11,1,65
URIONDO (A. CONCEPCION),"anticoncepcion, prevencion de its y de cancer de cuello uterino",numero de inyectables trimestrales suministrados,2015-06-01,2,11,51,35,1,100
URUBICHA,"anticoncepcion, prevencion de its y de cancer de cuello uterino",numero de inyectables trimestrales suministrados,2015-06-01,1,1,11,6,0,19
UYUNI,"anticoncepcion, prevencion de its y de cancer de cuello uterino",numero de inyectables trimestrales suministrados,2015-06-01,0,5,31,11,0,47
VACAS,"anticoncepcion, prevencion de its y de cancer de cuello uterino",numero de inyectables trimestrales suministrados,2015-06-01,0,1,17,8,0,26
VALLEGRANDE,"anticoncepcion, prevencion de its y de cancer de cuello uterino",numero de inyectables trimestrales suministrados,2015-06-01,0,12,48,11,0,71
VIACHA,"anticoncepcion, prevencion de its y de cancer de cuello uterino",numero de inyectables trimestrales suministrados,2015-06-01,1,12,129,53,0,195
VILA VILA,"anticoncepcion, prevencion de its y de cancer de cuello uterino",numero de inyectables trimestrales suministrados,2015-06-01,0,3,4,4,0,11
VILLA CHARCAS,"anticoncepcion, prevencion de its y de cancer de cuello uterino",numero de inyectables trimestrales suministrados,2015-06-01,0,12,50,35,0,97
VILLA MONTES,"anticoncepcion, prevencion de its y de cancer de cuello uterino",numero de inyectables trimestrales suministrados,2015-06-01,0,14,82,35,1,132
VILLA NUEVA (LOMA ALTA),"anticoncepcion, prevencion de its y de cancer de cuello uterino",numero de inyectables trimestrales suministrados,2015-06-01,0,1,4,0,0,5
VILLA RIVERO,"anticoncepcion, prevencion de its y de cancer de cuello uterino",numero de inyectables trimestrales suministrados,2015-06-01,0,7,28,15,0,50
VILLA SERRANO,"anticoncepcion, prevencion de its y de cancer de cuello uterino",numero de inyectables trimestrales suministrados,2015-06-01,0,12,20,21,1,54
VILLA TUNARI,"anticoncepcion, prevencion de its y de cancer de cuello uterino",numero de inyectables trimestrales suministrados,2015-06-01,2,42,272,67,0,383
VILLA VACA GUZMAN (MUYUPAMPA),"anticoncepcion, prevencion de its y de cancer de cuello uterino",numero de inyectables trimestrales suministrados,2015-06-01,0,2,46,27,0,75
VILLAZON,"anticoncepcion, prevencion de its y de cancer de cuello uterino",numero de inyectables trimestrales suministrados,2015-06-01,1,22,97,39,1,160
VINTO,"anticoncepcion, prevencion de its y de cancer de cuello uterino",numero de inyectables trimestrales suministrados,2015-06-01,0,3,82,20,0,105
VITICHI,"anticoncepcion, prevencion de its y de cancer de cuello uterino",numero de inyectables trimestrales suministrados,2015-06-01,0,0,15,13,0,28
WALDO BALLIVIAN,"anticoncepcion, prevencion de its y de cancer de cuello uterino",numero de inyectables trimestrales suministrados,2015-06-01,0,0,5,2,0,7
WARNES,"anticoncepcion, prevencion de its y de cancer de cuello uterino",numero de inyectables trimestrales suministrados,2015-06-01,2,58,180,65,0,305
YACO,"anticoncepcion, prevencion de its y de cancer de cuello uterino",numero de inyectables trimestrales suministrados,2015-06-01,0,1,16,10,0,27
YACUIBA,"anticoncepcion, prevencion de its y de cancer de cuello uterino",numero de inyectables trimestrales suministrados,2015-06-01,2,42,202,100,3,349
YAMPARAEZ,"anticoncepcion, prevencion de its y de cancer de cuello uterino",numero de inyectables trimestrales suministrados,2015-06-01,0,0,11,3,1,15
YANACACHI,"anticoncepcion, prevencion de its y de cancer de cuello uterino",numero de inyectables trimestrales suministrados,2015-06-01,0,1,11,6,0,18
YAPACANI,"anticoncepcion, prevencion de its y de cancer de cuello uterino",numero de inyectables trimestrales suministrados,2015-06-01,0,9,86,28,0,123
YOCALLA,"anticoncepcion, prevencion de its y de cancer de cuello uterino",numero de inyectables trimestrales suministrados,2015-06-01,0,1,7,8,1,17
YOTALA,"anticoncepcion, prevencion de its y de cancer de cuello uterino",numero de inyectables trimestrales suministrados,2015-06-01,0,1,0,6,0,7
YUNCHARA,"anticoncepcion, prevencion de its y de cancer de cuello uterino",numero de inyectables trimestrales suministrados,2015-06-01,0,9,45,21,0,75
ZUDAÑEZ,"anticoncepcion, prevencion de its y de cancer de cuello uterino",numero de inyectables trimestrales suministrados,2015-06-01,0,1,34,22,1,58
ACACIO,"anticoncepcion, prevencion de its y de cancer de cuello uterino",numero de inyectables trimestrales suministrados,2015-07-01,0,2,9,6,0,17
ACHACACHI,"anticoncepcion, prevencion de its y de cancer de cuello uterino",numero de inyectables trimestrales suministrados,2015-07-01,1,4,63,36,0,104
ACHOCALLA,"anticoncepcion, prevencion de its y de cancer de cuello uterino",numero de inyectables trimestrales suministrados,2015-07-01,0,4,41,13,0,58
AIQUILE,"anticoncepcion, prevencion de its y de cancer de cuello uterino",numero de inyectables trimestrales suministrados,2015-07-01,0,1,34,27,1,63
ALALAY,"anticoncepcion, prevencion de its y de cancer de cuello uterino",numero de inyectables trimestrales suministrados,2015-07-01,0,1,8,1,0,10
ALCALA,"anticoncepcion, prevencion de its y de cancer de cuello uterino",numero de inyectables trimestrales suministrados,2015-07-01,0,7,21,17,1,46
ALTO BENI,"anticoncepcion, prevencion de its y de cancer de cuello uterino",numero de inyectables trimestrales suministrados,2015-07-01,1,5,37,16,0,59
ANCORAIMES,"anticoncepcion, prevencion de its y de cancer de cuello uterino",numero de inyectables trimestrales suministrados,2015-07-01,0,1,13,16,0,30
ANDAMARCA,"anticoncepcion, prevencion de its y de cancer de cuello uterino",numero de inyectables trimestrales suministrados,2015-07-01,0,0,7,1,0,8
ANTEQUERA,"anticoncepcion, prevencion de its y de cancer de cuello uterino",numero de inyectables trimestrales suministrados,2015-07-01,0,0,2,1,0,3
ANZALDO,"anticoncepcion, prevencion de its y de cancer de cuello uterino",numero de inyectables trimestrales suministrados,2015-07-01,0,7,18,14,0,39
APOLO,"anticoncepcion, prevencion de its y de cancer de cuello uterino",numero de inyectables trimestrales suministrados,2015-07-01,0,6,38,23,1,68
ARAMPAMPA,"anticoncepcion, prevencion de its y de cancer de cuello uterino",numero de inyectables trimestrales suministrados,2015-07-01,0,1,14,3,0,18
ARANI,"anticoncepcion, prevencion de its y de cancer de cuello uterino",numero de inyectables trimestrales suministrados,2015-07-01,0,3,14,10,0,27
ARBIETO,"anticoncepcion, prevencion de its y de cancer de cuello uterino",numero de inyectables trimestrales suministrados,2015-07-01,0,9,53,25,0,87
ARQUE,"anticoncepcion, prevencion de its y de cancer de cuello uterino",numero de inyectables trimestrales suministrados,2015-07-01,0,8,40,37,0,85
ASCENCION DE GUARAYOS,"anticoncepcion, prevencion de its y de cancer de cuello uterino",numero de inyectables trimestrales suministrados,2015-07-01,0,9,33,13,2,57
ATOCHA,"anticoncepcion, prevencion de its y de cancer de cuello uterino",numero de inyectables trimestrales suministrados,2015-07-01,0,0,33,15,0,48
AUCAPATA,"anticoncepcion, prevencion de its y de cancer de cuello uterino",numero de inyectables trimestrales suministrados,2015-07-01,0,3,9,6,0,18
AYATA,"anticoncepcion, prevencion de its y de cancer de cuello uterino",numero de inyectables trimestrales suministrados,2015-07-01,0,1,18,14,0,33
AYO AYO,"anticoncepcion, prevencion de its y de cancer de cuello uterino",numero de inyectables trimestrales suministrados,2015-07-01,0,1,13,14,0,28
AYOPAYA (V. DE INDEPENDENCIA),"anticoncepcion, prevencion de its y de cancer de cuello uterino",numero de inyectables trimestrales suministrados,2015-07-01,0,11,77,65,0,153
AZURDUY,"anticoncepcion, prevencion de its y de cancer de cuello uterino",numero de inyectables trimestrales suministrados,2015-07-01,0,5,47,32,1,85
BATALLAS,"anticoncepcion, prevencion de its y de cancer de cuello uterino",numero de inyectables trimestrales suministrados,2015-07-01,0,5,33,22,0,60
BAURES,"anticoncepcion, prevencion de its y de cancer de cuello uterino",numero de inyectables trimestrales suministrados,2015-07-01,0,4,10,3,0,17
BELEN DE ANDAMARCA,"anticoncepcion, prevencion de its y de cancer de cuello uterino",numero de inyectables trimestrales suministrados,2015-07-01,0,0,1,1,0,2
BELLA FLOR,"anticoncepcion, prevencion de its y de cancer de cuello uterino",numero de inyectables trimestrales suministrados,2015-07-01,0,3,8,2,0,13
BERMEJO,"anticoncepcion, prevencion de its y de cancer de cuello uterino",numero de inyectables trimestrales suministrados,2015-07-01,1,23,92,39,1,156
BETANZOS,"anticoncepcion, prevencion de its y de cancer de cuello uterino",numero de inyectables trimestrales suministrados,2015-07-01,0,6,52,39,0,97
BOLIVAR,"anticoncepcion, prevencion de its y de cancer de cuello uterino",numero de inyectables trimestrales suministrados,2015-07-01,0,1,5,3,0,9
BOLPEBRA,"anticoncepcion, prevencion de its y de cancer de cuello uterino",numero de inyectables trimestrales suministrados,2015-07-01,2,1,4,1,0,8
BOYUIBE,"anticoncepcion, prevencion de its y de cancer de cuello uterino",numero de inyectables trimestrales suministrados,2015-07-01,0,4,9,6,0,19
BUENA VISTA,"anticoncepcion, prevencion de its y de cancer de cuello uterino",numero de inyectables trimestrales suministrados,2015-07-01,0,8,44,17,0,69
CABEZAS,"anticoncepcion, prevencion de its y de cancer de cuello uterino",numero de inyectables trimestrales suministrados,2015-07-01,1,28,108,27,0,164
CAIROMA,"anticoncepcion, prevencion de its y de cancer de cuello uterino",numero de inyectables trimestrales suministrados,2015-07-01,0,5,26,10,0,41
"CAIZA ""D""","anticoncepcion, prevencion de its y de cancer de cuello uterino",numero de inyectables trimestrales suministrados,2015-07-01,0,0,16,14,0,30
CAJUATA,"anticoncepcion, prevencion de its y de cancer de cuello uterino",numero de inyectables trimestrales suministrados,2015-07-01,0,5,32,17,0,54
CALACOTO,"anticoncepcion, prevencion de its y de cancer de cuello uterino",numero de inyectables trimestrales suministrados,2015-07-01,0,1,4,5,0,10
CALAMARCA,"anticoncepcion, prevencion de its y de cancer de cuello uterino",numero de inyectables trimestrales suministrados,2015-07-01,0,9,53,22,2,86
CAMARGO,"anticoncepcion, prevencion de its y de cancer de cuello uterino",numero de inyectables trimestrales suministrados,2015-07-01,0,4,16,16,0,36
CAMATAQUI (C. VILLA ABECIA),"anticoncepcion, prevencion de its y de cancer de cuello uterino",numero de inyectables trimestrales suministrados,2015-07-01,0,2,15,5,0,22
CAMIRI,"anticoncepcion, prevencion de its y de cancer de cuello uterino",numero de inyectables trimestrales suministrados,2015-07-01,1,7,33,8,0,49
CAPINOTA,"anticoncepcion, prevencion de its y de cancer de cuello uterino",numero de inyectables trimestrales suministrados,2015-07-01,1,11,54,25,0,91
CAQUIAVIRI,"anticoncepcion, prevencion de its y de cancer de cuello uterino",numero de inyectables trimestrales suministrados,2015-07-01,0,3,14,7,0,24
CARACOLLO,"anticoncepcion, prevencion de its y de cancer de cuello uterino",numero de inyectables trimestrales suministrados,2015-07-01,0,3,29,21,0,53
CARANAVI,"anticoncepcion, prevencion de its y de cancer de cuello uterino",numero de inyectables trimestrales suministrados,2015-07-01,1,17,99,40,0,157
CARAPARI,"anticoncepcion, prevencion de its y de cancer de cuello uterino",numero de inyectables trimestrales suministrados,2015-07-01,0,7,59,33,1,100
CARIPUYO,"anticoncepcion, prevencion de its y de cancer de cuello uterino",numero de inyectables trimestrales suministrados,2015-07-01,0,2,3,4,0,9
CARMEN RIVERO TORREZ,"anticoncepcion, prevencion de its y de cancer de cuello uterino",numero de inyectables trimestrales suministrados,2015-07-01,0,5,10,4,0,19
CATACORA,"anticoncepcion, prevencion de its y de cancer de cuello uterino",numero de inyectables trimestrales suministrados,2015-07-01,0,0,4,3,0,7
CHACARILLA,"anticoncepcion, prevencion de its y de cancer de cuello uterino",numero de inyectables trimestrales suministrados,2015-07-01,0,0,3,0,0,3
CHALLAPATA,"anticoncepcion, prevencion de its y de cancer de cuello uterino",numero de inyectables trimestrales suministrados,2015-07-01,0,4,45,16,0,65
CHAQUI,"anticoncepcion, prevencion de its y de cancer de cuello uterino",numero de inyectables trimestrales suministrados,2015-07-01,0,1,14,13,0,28
CHARAGUA,"anticoncepcion, prevencion de its y de cancer de cuello uterino",numero de inyectables trimestrales suministrados,2015-07-01,0,3,49,20,0,72
CHARAÑA,"anticoncepcion, prevencion de its y de cancer de cuello uterino",numero de inyectables trimestrales suministrados,2015-07-01,0,0,4,2,0,6
CHAYANTA,"anticoncepcion, prevencion de its y de cancer de cuello uterino",numero de inyectables trimestrales suministrados,2015-07-01,0,1,12,15,0,28
CHIMORE,"anticoncepcion, prevencion de its y de cancer de cuello uterino",numero de inyectables trimestrales suministrados,2015-07-01,0,13,69,24,0,106
CHIPAYA,"anticoncepcion, prevencion de its y de cancer de cuello uterino",numero de inyectables trimestrales suministrados,2015-07-01,2,6,4,7,0,19
CHOQUE COTA,"anticoncepcion, prevencion de its y de cancer de cuello uterino",numero de inyectables trimestrales suministrados,2015-07-01,0,0,0,2,0,2
CHUA COCANI,"anticoncepcion, prevencion de its y de cancer de cuello uterino",numero de inyectables trimestrales suministrados,2015-07-01,0,0,3,4,0,7
CHULUMANI (V. DE LA LIBERTAD),"anticoncepcion, prevencion de its y de cancer de cuello uterino",numero de inyectables trimestrales suministrados,2015-07-01,0,4,33,14,1,52
CHUMA,"anticoncepcion, prevencion de its y de cancer de cuello uterino",numero de inyectables trimestrales suministrados,2015-07-01,0,3,28,24,0,55
CHUQUIHUTA AYLLU JUCUMANI,"anticoncepcion, prevencion de its y de cancer de cuello uterino",numero de inyectables trimestrales suministrados,2015-07-01,0,2,11,6,0,19
CKOCHAS,"anticoncepcion, prevencion de its y de cancer de cuello uterino",numero de inyectables trimestrales suministrados,2015-07-01,0,1,28,23,0,52
CLIZA,"anticoncepcion, prevencion de its y de cancer de cuello uterino",numero de inyectables trimestrales suministrados,2015-07-01,0,4,49,11,0,64
COBIJA,"anticoncepcion, prevencion de its y de cancer de cuello uterino",numero de inyectables trimestrales suministrados,2015-07-01,1,36,133,15,0,185
COCAPATA,"anticoncepcion, prevencion de its y de cancer de cuello uterino",numero de inyectables trimestrales suministrados,2015-07-01,0,3,38,24,0,65
COCHABAMBA,"anticoncepcion, prevencion de its y de cancer de cuello uterino",numero de inyectables trimestrales suministrados,2015-07-01,5,68,401,92,0,566
COLCAPIRHUA,"anticoncepcion, prevencion de its y de cancer de cuello uterino",numero de inyectables trimestrales suministrados,2015-07-01,0,3,66,7,0,76
"COLCHA ""K""","anticoncepcion, prevencion de its y de cancer de cuello uterino",numero de inyectables trimestrales suministrados,2015-07-01,0,6,42,14,0,62
COLLANA,"anticoncepcion, prevencion de its y de cancer de cuello uterino",numero de inyectables trimestrales suministrados,2015-07-01,0,1,4,4,0,9
COLOMI,"anticoncepcion, prevencion de its y de cancer de cuello uterino",numero de inyectables trimestrales suministrados,2015-07-01,0,7,52,25,0,84
COLPA BELGICA,"anticoncepcion, prevencion de its y de cancer de cuello uterino",numero de inyectables trimestrales suministrados,2015-07-01,0,6,22,4,0,32
COLQUECHACA,"anticoncepcion, prevencion de its y de cancer de cuello uterino",numero de inyectables trimestrales suministrados,2015-07-01,0,9,39,23,0,71
COLQUENCHA,"anticoncepcion, prevencion de its y de cancer de cuello uterino",numero de inyectables trimestrales suministrados,2015-07-01,0,2,24,21,0,47
COLQUIRI,"anticoncepcion, prevencion de its y de cancer de cuello uterino",numero de inyectables trimestrales suministrados,2015-07-01,0,3,31,19,0,53
COMANCHE,"anticoncepcion, prevencion de its y de cancer de cuello uterino",numero de inyectables trimestrales suministrados,2015-07-01,0,0,1,0,0,1
COMARAPA,"anticoncepcion, prevencion de its y de cancer de cuello uterino",numero de inyectables trimestrales suministrados,2015-07-01,0,16,82,35,1,134
COMBAYA,"anticoncepcion, prevencion de its y de cancer de cuello uterino",numero de inyectables trimestrales suministrados,2015-07-01,0,0,1,1,0,2
CONCEPCION,"anticoncepcion, prevencion de its y de cancer de cuello uterino",numero de inyectables trimestrales suministrados,2015-07-01,0,8,41,11,0,60
COPACABANA,"anticoncepcion, prevencion de its y de cancer de cuello uterino",numero de inyectables trimestrales suministrados,2015-07-01,0,1,21,19,0,41
CORIPATA,"anticoncepcion, prevencion de its y de cancer de cuello uterino",numero de inyectables trimestrales suministrados,2015-07-01,0,1,33,17,0,51
CORO CORO,"anticoncepcion, prevencion de its y de cancer de cuello uterino",numero de inyectables trimestrales suministrados,2015-07-01,0,1,12,6,0,19
COROICO,"anticoncepcion, prevencion de its y de cancer de cuello uterino",numero de inyectables trimestrales suministrados,2015-07-01,0,2,12,4,0,18
CORQUE,"anticoncepcion, prevencion de its y de cancer de cuello uterino",numero de inyectables trimestrales suministrados,2015-07-01,0,0,3,4,0,7
COTAGAITA,"anticoncepcion, prevencion de its y de cancer de cuello uterino",numero de inyectables trimestrales suministrados,2015-07-01,0,4,71,43,1,119
COTOCA,"anticoncepcion, prevencion de its y de cancer de cuello uterino",numero de inyectables trimestrales suministrados,2015-07-01,0,17,103,25,0,145
CUATRO CAÑADAS,"anticoncepcion, prevencion de its y de cancer de cuello uterino",numero de inyectables trimestrales suministrados,2015-07-01,0,10,32,14,0,56
CUCHUMUELA (V. G. VILLARROEL),"anticoncepcion, prevencion de its y de cancer de cuello uterino",numero de inyectables trimestrales suministrados,2015-07-01,0,0,7,1,0,8
CUEVO,"anticoncepcion, prevencion de its y de cancer de cuello uterino",numero de inyectables trimestrales suministrados,2015-07-01,0,3,23,6,0,32
CULPINA,"anticoncepcion, prevencion de its y de cancer de cuello uterino",numero de inyectables trimestrales suministrados,2015-07-01,2,4,70,35,1,112
CURAHUARA DE CARANGAS,"anticoncepcion, prevencion de its y de cancer de cuello uterino",numero de inyectables trimestrales suministrados,2015-07-01,0,3,7,3,5,18
CURVA,"anticoncepcion, prevencion de its y de cancer de cuello uterino",numero de inyectables trimestrales suministrados,2015-07-01,0,1,5,3,0,9
DESAGUADERO,"anticoncepcion, prevencion de its y de cancer de cuello uterino",numero de inyectables trimestrales suministrados,2015-07-01,0,0,12,7,0,19
EL ALTO,"anticoncepcion, prevencion de its y de cancer de cuello uterino",numero de inyectables trimestrales suministrados,2015-07-01,3,103,1051,427,1,1585
EL CHORO,"anticoncepcion, prevencion de its y de cancer de cuello uterino",numero de inyectables trimestrales suministrados,2015-07-01,0,0,17,1,0,18
EL PUENTE(STC),"anticoncepcion, prevencion de its y de cancer de cuello uterino",numero de inyectables trimestrales suministrados,2015-07-01,0,13,57,16,2,88
EL PUENTE(TJA),"anticoncepcion, prevencion de its y de cancer de cuello uterino",numero de inyectables trimestrales suministrados,2015-07-01,0,7,71,43,1,122
EL TORNO,"anticoncepcion, prevencion de its y de cancer de cuello uterino",numero de inyectables trimestrales suministrados,2015-07-01,5,32,79,45,2,163
EL VILLAR,"anticoncepcion, prevencion de its y de cancer de cuello uterino",numero de inyectables trimestrales suministrados,2015-07-01,0,5,27,9,0,41
ENTRE RIOS TRJ,"anticoncepcion, prevencion de its y de cancer de cuello uterino",numero de inyectables trimestrales suministrados,2015-07-01,1,20,104,44,0,169
ENTRE RIOS CBBA,"anticoncepcion, prevencion de its y de cancer de cuello uterino",numero de inyectables trimestrales suministrados,2015-07-01,0,10,54,13,0,77
ESCOMA,"anticoncepcion, prevencion de its y de cancer de cuello uterino",numero de inyectables trimestrales suministrados,2015-07-01,0,0,4,1,0,5
EUCALIPTUS,"anticoncepcion, prevencion de its y de cancer de cuello uterino",numero de inyectables trimestrales suministrados,2015-07-01,0,0,3,1,0,4
EUREKA (SANTOS MERCADO),"anticoncepcion, prevencion de its y de cancer de cuello uterino",numero de inyectables trimestrales suministrados,2015-07-01,0,0,3,1,0,4
FERNANDEZ ALONSO,"anticoncepcion, prevencion de its y de cancer de cuello uterino",numero de inyectables trimestrales suministrados,2015-07-01,1,4,38,17,1,61
FILADELFIA,"anticoncepcion, prevencion de its y de cancer de cuello uterino",numero de inyectables trimestrales suministrados,2015-07-01,0,6,20,6,0,32
GENERAL SAAVEDRA,"anticoncepcion, prevencion de its y de cancer de cuello uterino",numero de inyectables trimestrales suministrados,2015-07-01,1,11,39,19,0,70
GRAL. J.J. PEREZ (CHARAZANI),"anticoncepcion, prevencion de its y de cancer de cuello uterino",numero de inyectables trimestrales suministrados,2015-07-01,0,2,17,13,0,32
GUANAY,"anticoncepcion, prevencion de its y de cancer de cuello uterino",numero de inyectables trimestrales suministrados,2015-07-01,0,2,17,5,0,24
GUAQUI,"anticoncepcion, prevencion de its y de cancer de cuello uterino",numero de inyectables trimestrales suministrados,2015-07-01,0,2,18,6,0,26
GUAYARAMERIN,"anticoncepcion, prevencion de its y de cancer de cuello uterino",numero de inyectables trimestrales suministrados,2015-07-01,0,3,11,3,1,18
GUTIERREZ,"anticoncepcion, prevencion de its y de cancer de cuello uterino",numero de inyectables trimestrales suministrados,2015-07-01,0,4,8,6,0,18
HUACARETA,"anticoncepcion, prevencion de its y de cancer de cuello uterino",numero de inyectables trimestrales suministrados,2015-07-01,0,0,28,13,0,41
HUACAYA (VILLA DE HUACAYA),"anticoncepcion, prevencion de its y de cancer de cuello uterino",numero de inyectables trimestrales suministrados,2015-07-01,0,1,24,1,0,26
HUACHACALLA,"anticoncepcion, prevencion de its y de cancer de cuello uterino",numero de inyectables trimestrales suministrados,2015-07-01,0,0,1,2,0,3
HUANUNI,"anticoncepcion, prevencion de its y de cancer de cuello uterino",numero de inyectables trimestrales suministrados,2015-07-01,0,0,19,11,0,30
HUARACAJE,"anticoncepcion, prevencion de its y de cancer de cuello uterino",numero de inyectables trimestrales suministrados,2015-07-01,0,4,6,6,0,16
HUARINA,"anticoncepcion, prevencion de its y de cancer de cuello uterino",numero de inyectables trimestrales suministrados,2015-07-01,0,1,7,3,0,11
HUATAJATA,"anticoncepcion, prevencion de its y de cancer de cuello uterino",numero de inyectables trimestrales suministrados,2015-07-01,0,0,7,4,0,11
HUAYLLAMARCA,"anticoncepcion, prevencion de its y de cancer de cuello uterino",numero de inyectables trimestrales suministrados,2015-07-01,0,2,9,1,0,12
HUMANATA,"anticoncepcion, prevencion de its y de cancer de cuello uterino",numero de inyectables trimestrales suministrados,2015-07-01,0,0,9,4,0,13
ICHOCA,"anticoncepcion, prevencion de its y de cancer de cuello uterino",numero de inyectables trimestrales suministrados,2015-07-01,0,1,5,1,0,7
ICLA,"anticoncepcion, prevencion de its y de cancer de cuello uterino",numero de inyectables trimestrales suministrados,2015-07-01,0,2,13,12,0,27
INCAHUASI,"anticoncepcion, prevencion de its y de cancer de cuello uterino",numero de inyectables trimestrales suministrados,2015-07-01,0,12,35,13,0,60
INGAVI (HUMAITA),"anticoncepcion, prevencion de its y de cancer de cuello uterino",numero de inyectables trimestrales suministrados,2015-07-01,0,0,3,0,0,3
INQUISIVI,"anticoncepcion, prevencion de its y de cancer de cuello uterino",numero de inyectables trimestrales suministrados,2015-07-01,0,3,18,13,0,34
IRUPANA (VILLA DE LANZA),"anticoncepcion, prevencion de its y de cancer de cuello uterino",numero de inyectables trimestrales suministrados,2015-07-01,0,8,49,19,0,76
IXIAMAS,"anticoncepcion, prevencion de its y de cancer de cuello uterino",numero de inyectables trimestrales suministrados,2015-07-01,0,10,32,3,0,45
JESUS DE MACHACA,"anticoncepcion, prevencion de its y de cancer de cuello uterino",numero de inyectables trimestrales suministrados,2015-07-01,0,0,11,9,0,20
LA ASUNTA,"anticoncepcion, prevencion de its y de cancer de cuello uterino",numero de inyectables trimestrales suministrados,2015-07-01,1,10,129,40,0,180
LA GUARDIA,"anticoncepcion, prevencion de its y de cancer de cuello uterino",numero de inyectables trimestrales suministrados,2015-07-01,4,28,121,29,0,182
LA PAZ,"anticoncepcion, prevencion de its y de cancer de cuello uterino",numero de inyectables trimestrales suministrados,2015-07-01,0,50,451,140,1,642
LAGUNILLAS,"anticoncepcion, prevencion de its y de cancer de cuello uterino",numero de inyectables trimestrales suministrados,2015-07-01,0,1,8,6,0,15
LAJA,"anticoncepcion, prevencion de its y de cancer de cuello uterino",numero de inyectables trimestrales suministrados,2015-07-01,0,8,57,25,1,91
LAS CARRERAS,"anticoncepcion, prevencion de its y de cancer de cuello uterino",numero de inyectables trimestrales suministrados,2015-07-01,0,2,12,2,0,16
LICOMA PAMPA,"anticoncepcion, prevencion de its y de cancer de cuello uterino",numero de inyectables trimestrales suministrados,2015-07-01,0,1,7,3,0,11
LLALLAGUA,"anticoncepcion, prevencion de its y de cancer de cuello uterino",numero de inyectables trimestrales suministrados,2015-07-01,0,6,67,13,0,86
LLICA,"anticoncepcion, prevencion de its y de cancer de cuello uterino",numero de inyectables trimestrales suministrados,2015-07-01,0,7,18,7,0,32
LORETO,"anticoncepcion, prevencion de its y de cancer de cuello uterino",numero de inyectables trimestrales suministrados,2015-07-01,0,2,8,6,0,16
LURIBAY,"anticoncepcion, prevencion de its y de cancer de cuello uterino",numero de inyectables trimestrales suministrados,2015-07-01,0,2,22,15,1,40
MACHACAMARCA,"anticoncepcion, prevencion de its y de cancer de cuello uterino",numero de inyectables trimestrales suministrados,2015-07-01,0,0,4,1,0,5
MACHARETI,"anticoncepcion, prevencion de its y de cancer de cuello uterino",numero de inyectables trimestrales suministrados,2015-07-01,1,2,37,14,0,54
MAGDALENA,"anticoncepcion, prevencion de its y de cancer de cuello uterino",numero de inyectables trimestrales suministrados,2015-07-01,0,9,22,4,0,35
MAIRANA,"anticoncepcion, prevencion de its y de cancer de cuello uterino",numero de inyectables trimestrales suministrados,2015-07-01,1,5,20,7,0,33
MALLA,"anticoncepcion, prevencion de its y de cancer de cuello uterino",numero de inyectables trimestrales suministrados,2015-07-01,0,1,3,5,0,9
MAPIRI,"anticoncepcion, prevencion de its y de cancer de cuello uterino",numero de inyectables trimestrales suministrados,2015-07-01,0,1,18,7,1,27
MECAPACA,"anticoncepcion, prevencion de its y de cancer de cuello uterino",numero de inyectables trimestrales suministrados,2015-07-01,0,0,16,14,0,30
MINEROS,"anticoncepcion, prevencion de its y de cancer de cuello uterino",numero de inyectables trimestrales suministrados,2015-07-01,0,13,68,15,1,97
MIZQUE,"anticoncepcion, prevencion de its y de cancer de cuello uterino",numero de inyectables trimestrales suministrados,2015-07-01,0,20,92,52,0,164
MOCOMOCO,"anticoncepcion, prevencion de its y de cancer de cuello uterino",numero de inyectables trimestrales suministrados,2015-07-01,0,4,22,10,0,36
MOJINETE,"anticoncepcion, prevencion de its y de cancer de cuello uterino",numero de inyectables trimestrales suministrados,2015-07-01,0,0,1,1,0,2
MOJOCOYA,"anticoncepcion, prevencion de its y de cancer de cuello uterino",numero de inyectables trimestrales suministrados,2015-07-01,0,1,12,16,0,29
MONTEAGUDO,"anticoncepcion, prevencion de its y de cancer de cuello uterino",numero de inyectables trimestrales suministrados,2015-07-01,0,21,94,48,1,164
MONTERO,"anticoncepcion, prevencion de its y de cancer de cuello uterino",numero de inyectables trimestrales suministrados,2015-07-01,1,41,192,40,0,274
MORO MORO,"anticoncepcion, prevencion de its y de cancer de cuello uterino",numero de inyectables trimestrales suministrados,2015-07-01,1,6,10,9,1,27
MOROCHATA,"anticoncepcion, prevencion de its y de cancer de cuello uterino",numero de inyectables trimestrales suministrados,2015-07-01,0,5,43,40,0,88
NACEBE (SANTA ROSA DEL ABUNA),"anticoncepcion, prevencion de its y de cancer de cuello uterino",numero de inyectables trimestrales suministrados,2015-07-01,0,0,3,1,0,4
NAZACARA DE PACAJES,"anticoncepcion, prevencion de its y de cancer de cuello uterino",numero de inyectables trimestrales suministrados,2015-07-01,0,0,0,1,0,1
NUEVO MANOA (NUEVA ESPERANZA),"anticoncepcion, prevencion de its y de cancer de cuello uterino",numero de inyectables trimestrales suministrados,2015-07-01,0,1,4,1,0,6
OCURI,"anticoncepcion, prevencion de its y de cancer de cuello uterino",numero de inyectables trimestrales suministrados,2015-07-01,0,3,29,17,0,49
OKINAWA,"anticoncepcion, prevencion de its y de cancer de cuello uterino",numero de inyectables trimestrales suministrados,2015-07-01,0,6,23,2,1,32
OMEREQUE,"anticoncepcion, prevencion de its y de cancer de cuello uterino",numero de inyectables trimestrales suministrados,2015-07-01,0,1,33,16,0,50
ORURO,"anticoncepcion, prevencion de its y de cancer de cuello uterino",numero de inyectables trimestrales suministrados,2015-07-01,1,35,478,192,2,708
PADCAYA,"anticoncepcion, prevencion de its y de cancer de cuello uterino",numero de inyectables trimestrales suministrados,2015-07-01,1,20,105,64,2,192
PADILLA,"anticoncepcion, prevencion de its y de cancer de cuello uterino",numero de inyectables trimestrales suministrados,2015-07-01,1,13,58,36,0,108
PAILON,"anticoncepcion, prevencion de its y de cancer de cuello uterino",numero de inyectables trimestrales suministrados,2015-07-01,0,8,28,9,0,45
PALCA,"anticoncepcion, prevencion de its y de cancer de cuello uterino",numero de inyectables trimestrales suministrados,2015-07-01,0,5,41,13,0,59
PALOS BLANCOS,"anticoncepcion, prevencion de its y de cancer de cuello uterino",numero de inyectables trimestrales suministrados,2015-07-01,0,5,72,33,0,110
PAMPA AULLAGAS,"anticoncepcion, prevencion de its y de cancer de cuello uterino",numero de inyectables trimestrales suministrados,2015-07-01,0,0,6,1,0,7
PAMPA GRANDE,"anticoncepcion, prevencion de its y de cancer de cuello uterino",numero de inyectables trimestrales suministrados,2015-07-01,0,3,36,10,2,51
PAPEL PAMPA,"anticoncepcion, prevencion de its y de cancer de cuello uterino",numero de inyectables trimestrales suministrados,2015-07-01,0,2,8,12,0,22
PASORAPA,"anticoncepcion, prevencion de its y de cancer de cuello uterino",numero de inyectables trimestrales suministrados,2015-07-01,0,4,12,12,1,29
PATACAMAYA,"anticoncepcion, prevencion de its y de cancer de cuello uterino",numero de inyectables trimestrales suministrados,2015-07-01,0,0,10,2,0,12
PAZÑA,"anticoncepcion, prevencion de its y de cancer de cuello uterino",numero de inyectables trimestrales suministrados,2015-07-01,0,0,16,7,0,23
PELECHUCO,"anticoncepcion, prevencion de its y de cancer de cuello uterino",numero de inyectables trimestrales suministrados,2015-07-01,0,2,10,5,0,17
POCOATA,"anticoncepcion, prevencion de its y de cancer de cuello uterino",numero de inyectables trimestrales suministrados,2015-07-01,0,1,42,22,0,65
POCONA,"anticoncepcion, prevencion de its y de cancer de cuello uterino",numero de inyectables trimestrales suministrados,2015-07-01,0,7,57,44,2,110
POJO (CBBA),"anticoncepcion, prevencion de its y de cancer de cuello uterino",numero de inyectables trimestrales suministrados,2015-07-01,0,7,60,32,1,100
POOPO,"anticoncepcion, prevencion de its y de cancer de cuello uterino",numero de inyectables trimestrales suministrados,2015-07-01,0,0,7,3,0,10
PORCO,"anticoncepcion, prevencion de its y de cancer de cuello uterino",numero de inyectables trimestrales suministrados,2015-07-01,0,1,10,3,0,14
POROMA,"anticoncepcion, prevencion de its y de cancer de cuello uterino",numero de inyectables trimestrales suministrados,2015-07-01,2,6,49,31,0,88
PORONGO,"anticoncepcion, prevencion de its y de cancer de cuello uterino",numero de inyectables trimestrales suministrados,2015-07-01,0,4,26,12,0,42
PORTACHUELO,"anticoncepcion, prevencion de its y de cancer de cuello uterino",numero de inyectables trimestrales suministrados,2015-07-01,0,13,34,12,0,59
PORVENIR,"anticoncepcion, prevencion de its y de cancer de cuello uterino",numero de inyectables trimestrales suministrados,2015-07-01,0,2,20,4,0,26
POSTRER VALLE,"anticoncepcion, prevencion de its y de cancer de cuello uterino",numero de inyectables trimestrales suministrados,2015-07-01,0,2,6,1,0,9
POTOSI,"anticoncepcion, prevencion de its y de cancer de cuello uterino",numero de inyectables trimestrales suministrados,2015-07-01,2,17,204,99,0,322
PRESTO,"anticoncepcion, prevencion de its y de cancer de cuello uterino",numero de inyectables trimestrales suministrados,2015-07-01,0,4,34,14,0,52
PUCARA,"anticoncepcion, prevencion de its y de cancer de cuello uterino",numero de inyectables trimestrales suministrados,2015-07-01,0,1,12,1,0,14
PUCARANI,"anticoncepcion, prevencion de its y de cancer de cuello uterino",numero de inyectables trimestrales suministrados,2015-07-01,1,10,64,32,0,107
PUERTO ACOSTA,"anticoncepcion, prevencion de its y de cancer de cuello uterino",numero de inyectables trimestrales suministrados,2015-07-01,0,1,9,3,0,13
PUERTO CARABUCO,"anticoncepcion, prevencion de its y de cancer de cuello uterino",numero de inyectables trimestrales suministrados,2015-07-01,0,0,14,11,0,25
PUERTO GONZALO MORENO,"anticoncepcion, prevencion de its y de cancer de cuello uterino",numero de inyectables trimestrales suministrados,2015-07-01,1,14,30,13,0,58
PUERTO PEREZ,"anticoncepcion, prevencion de its y de cancer de cuello uterino",numero de inyectables trimestrales suministrados,2015-07-01,0,0,14,7,0,21
PUERTO QUIJARRO,"anticoncepcion, prevencion de its y de cancer de cuello uterino",numero de inyectables trimestrales suministrados,2015-07-01,0,5,23,3,0,31
PUERTO RICO,"anticoncepcion, prevencion de its y de cancer de cuello uterino",numero de inyectables trimestrales suministrados,2015-07-01,0,1,3,0,0,4
PUERTO SILES,"anticoncepcion, prevencion de its y de cancer de cuello uterino",numero de inyectables trimestrales suministrados,2015-07-01,0,0,1,0,0,1
PUERTO SUAREZ,"anticoncepcion, prevencion de its y de cancer de cuello uterino",numero de inyectables trimestrales suministrados,2015-07-01,0,0,4,1,0,5
PUERTO VILLARROEL,"anticoncepcion, prevencion de its y de cancer de cuello uterino",numero de inyectables trimestrales suministrados,2015-07-01,0,17,93,33,0,143
PUNA,"anticoncepcion, prevencion de its y de cancer de cuello uterino",numero de inyectables trimestrales suministrados,2015-07-01,0,1,14,15,0,30
PUNATA,"anticoncepcion, prevencion de its y de cancer de cuello uterino",numero de inyectables trimestrales suministrados,2015-07-01,0,8,58,21,0,87
QUIABAYA,"anticoncepcion, prevencion de its y de cancer de cuello uterino",numero de inyectables trimestrales suministrados,2015-07-01,0,0,9,5,0,14
QUILLACOLLO,"anticoncepcion, prevencion de its y de cancer de cuello uterino",numero de inyectables trimestrales suministrados,2015-07-01,0,18,170,32,0,220
QUIME,"anticoncepcion, prevencion de its y de cancer de cuello uterino",numero de inyectables trimestrales suministrados,2015-07-01,0,2,32,12,0,46
QUIRUSILLAS,"anticoncepcion, prevencion de its y de cancer de cuello uterino",numero de inyectables trimestrales suministrados,2015-07-01,0,1,0,0,0,1
RAVELO,"anticoncepcion, prevencion de its y de cancer de cuello uterino",numero de inyectables trimestrales suministrados,2015-07-01,0,4,43,33,0,80
REYES,"anticoncepcion, prevencion de its y de cancer de cuello uterino",numero de inyectables trimestrales suministrados,2015-07-01,0,9,22,11,0,42
RIBERALTA,"anticoncepcion, prevencion de its y de cancer de cuello uterino",numero de inyectables trimestrales suministrados,2015-07-01,3,27,108,20,0,158
ROBORE,"anticoncepcion, prevencion de its y de cancer de cuello uterino",numero de inyectables trimestrales suministrados,2015-07-01,1,4,21,1,0,27
RURRENABAQUE,"anticoncepcion, prevencion de its y de cancer de cuello uterino",numero de inyectables trimestrales suministrados,2015-07-01,2,3,47,18,0,70
SABAYA,"anticoncepcion, prevencion de its y de cancer de cuello uterino",numero de inyectables trimestrales suministrados,2015-07-01,0,2,12,7,0,21
SACABA,"anticoncepcion, prevencion de its y de cancer de cuello uterino",numero de inyectables trimestrales suministrados,2015-07-01,0,22,181,57,0,260
SACABAMBA,"anticoncepcion, prevencion de its y de cancer de cuello uterino",numero de inyectables trimestrales suministrados,2015-07-01,0,0,9,7,0,16
SACACA,"anticoncepcion, prevencion de its y de cancer de cuello uterino",numero de inyectables trimestrales suministrados,2015-07-01,0,5,60,25,0,90
SAIPINA,"anticoncepcion, prevencion de its y de cancer de cuello uterino",numero de inyectables trimestrales suministrados,2015-07-01,0,3,20,7,0,30
SALINAS DE GARCI MENDOZA,"anticoncepcion, prevencion de its y de cancer de cuello uterino",numero de inyectables trimestrales suministrados,2015-07-01,0,4,18,9,0,31
SAMAIPATA,"anticoncepcion, prevencion de its y de cancer de cuello uterino",numero de inyectables trimestrales suministrados,2015-07-01,0,8,35,6,0,49
SAN AGUSTIN,"anticoncepcion, prevencion de its y de cancer de cuello uterino",numero de inyectables trimestrales suministrados,2015-07-01,0,3,1,3,0,7
SAN ANDRES,"anticoncepcion, prevencion de its y de cancer de cuello uterino",numero de inyectables trimestrales suministrados,2015-07-01,1,7,33,13,0,54
SAN ANDRES DE MACHACA,"anticoncepcion, prevencion de its y de cancer de cuello uterino",numero de inyectables trimestrales suministrados,2015-07-01,0,0,5,3,0,8
SAN ANTONIO DE ESMORUCO,"anticoncepcion, prevencion de its y de cancer de cuello uterino",numero de inyectables trimestrales suministrados,2015-07-01,0,0,7,1,0,8
SAN ANTONIO DE LOMERIO,"anticoncepcion, prevencion de its y de cancer de cuello uterino",numero de inyectables trimestrales suministrados,2015-07-01,0,7,34,34,0,75
SAN BENITO,"anticoncepcion, prevencion de its y de cancer de cuello uterino",numero de inyectables trimestrales suministrados,2015-07-01,0,3,32,14,0,49
SAN BORJA,"anticoncepcion, prevencion de its y de cancer de cuello uterino",numero de inyectables trimestrales suministrados,2015-07-01,9,47,67,27,0,150
SAN BUENA VENTURA,"anticoncepcion, prevencion de its y de cancer de cuello uterino",numero de inyectables trimestrales suministrados,2015-07-01,0,2,22,9,0,33
SAN CARLOS,"anticoncepcion, prevencion de its y de cancer de cuello uterino",numero de inyectables trimestrales suministrados,2015-07-01,0,6,36,14,0,56
SAN IGNACIO,"anticoncepcion, prevencion de its y de cancer de cuello uterino",numero de inyectables trimestrales suministrados,2015-07-01,0,22,67,26,0,115
SAN IGNACIO DE VELASCO,"anticoncepcion, prevencion de its y de cancer de cuello uterino",numero de inyectables trimestrales suministrados,2015-07-01,0,19,136,55,0,210
SAN JAVIER(BNI),"anticoncepcion, prevencion de its y de cancer de cuello uterino",numero de inyectables trimestrales suministrados,2015-07-01,0,4,17,1,0,22
SAN JAVIER(STC),"anticoncepcion, prevencion de its y de cancer de cuello uterino",numero de inyectables trimestrales suministrados,2015-07-01,0,11,38,7,0,56
SAN JOAQUIN,"anticoncepcion, prevencion de its y de cancer de cuello uterino",numero de inyectables trimestrales suministrados,2015-07-01,0,1,3,0,0,4
SAN JOSE DE CHIQUITOS,"anticoncepcion, prevencion de its y de cancer de cuello uterino",numero de inyectables trimestrales suministrados,2015-07-01,1,0,15,6,0,22
SAN JUAN DE YAPACANI,"anticoncepcion, prevencion de its y de cancer de cuello uterino",numero de inyectables trimestrales suministrados,2015-07-01,0,3,20,5,0,28
SAN JULIAN,"anticoncepcion, prevencion de its y de cancer de cuello uterino",numero de inyectables trimestrales suministrados,2015-07-01,0,15,100,42,1,158
SAN LORENZO(PND),"anticoncepcion, prevencion de its y de cancer de cuello uterino",numero de inyectables trimestrales suministrados,2015-07-01,0,1,6,7,0,14
SAN LORENZO(TJA),"anticoncepcion, prevencion de its y de cancer de cuello uterino",numero de inyectables trimestrales suministrados,2015-07-01,1,11,95,51,2,160
SAN LUCAS,"anticoncepcion, prevencion de its y de cancer de cuello uterino",numero de inyectables trimestrales suministrados,2015-07-01,0,11,44,44,0,99
SAN MATIAS,"anticoncepcion, prevencion de its y de cancer de cuello uterino",numero de inyectables trimestrales suministrados,2015-07-01,0,6,35,15,0,56
SAN MIGUEL DE VELASCO,"anticoncepcion, prevencion de its y de cancer de cuello uterino",numero de inyectables trimestrales suministrados,2015-07-01,1,18,72,40,1,132
SAN PABLO DE LIPEZ,"anticoncepcion, prevencion de its y de cancer de cuello uterino",numero de inyectables trimestrales suministrados,2015-07-01,0,1,3,1,0,5
SAN PEDRO,"anticoncepcion, prevencion de its y de cancer de cuello uterino",numero de inyectables trimestrales suministrados,2015-07-01,0,9,45,21,0,75
SAN PEDRO DE BUENA VISTA,"anticoncepcion, prevencion de its y de cancer de cuello uterino",numero de inyectables trimestrales suministrados,2015-07-01,0,7,45,21,0,73
SAN PEDRO DE CURAHUARA,"anticoncepcion, prevencion de its y de cancer de cuello uterino",numero de inyectables trimestrales suministrados,2015-07-01,0,1,9,6,0,16
SAN PEDRO DE TIQUINA,"anticoncepcion, prevencion de its y de cancer de cuello uterino",numero de inyectables trimestrales suministrados,2015-07-01,0,0,6,1,0,7
SAN PEDRO(PND),"anticoncepcion, prevencion de its y de cancer de cuello uterino",numero de inyectables trimestrales suministrados,2015-07-01,0,1,3,0,0,4
SAN RAFAEL,"anticoncepcion, prevencion de its y de cancer de cuello uterino",numero de inyectables trimestrales suministrados,2015-07-01,0,12,35,13,0,60
SAN RAMON BENI,"anticoncepcion, prevencion de its y de cancer de cuello uterino",numero de inyectables trimestrales suministrados,2015-07-01,0,3,8,3,0,14
SAN RAMON SCZ,"anticoncepcion, prevencion de its y de cancer de cuello uterino",numero de inyectables trimestrales suministrados,2015-07-01,0,22,38,0,0,60
SANTA ANA,"anticoncepcion, prevencion de its y de cancer de cuello uterino",numero de inyectables trimestrales suministrados,2015-07-01,0,6,26,2,0,34
SANTA CRUZ DE LA SIERRA,"anticoncepcion, prevencion de its y de cancer de cuello uterino",numero de inyectables trimestrales suministrados,2015-07-01,2,129,534,121,0,786
SANTA ROSA DEL SARA,"anticoncepcion, prevencion de its y de cancer de cuello uterino",numero de inyectables trimestrales suministrados,2015-07-01,1,6,47,17,1,72
SANTIAGO DE CALLAPA,"anticoncepcion, prevencion de its y de cancer de cuello uterino",numero de inyectables trimestrales suministrados,2015-07-01,0,0,1,3,0,4
SANTIAGO DE HUARI,"anticoncepcion, prevencion de its y de cancer de cuello uterino",numero de inyectables trimestrales suministrados,2015-07-01,0,1,8,4,0,13
SANTIAGO DE HUATA,"anticoncepcion, prevencion de its y de cancer de cuello uterino",numero de inyectables trimestrales suministrados,2015-07-01,0,2,12,6,0,20
SANTIAGO DE MACHACA,"anticoncepcion, prevencion de its y de cancer de cuello uterino",numero de inyectables trimestrales suministrados,2015-07-01,0,1,9,3,0,13
SANTIVAÑES,"anticoncepcion, prevencion de its y de cancer de cuello uterino",numero de inyectables trimestrales suministrados,2015-07-01,0,3,22,8,0,33
SANTUARIO DE QUILLACAS,"anticoncepcion, prevencion de its y de cancer de cuello uterino",numero de inyectables trimestrales suministrados,2015-07-01,0,0,13,5,0,18
SAPAHAQUI,"anticoncepcion, prevencion de its y de cancer de cuello uterino",numero de inyectables trimestrales suministrados,2015-07-01,0,2,18,14,0,34
SENA,"anticoncepcion, prevencion de its y de cancer de cuello uterino",numero de inyectables trimestrales suministrados,2015-07-01,0,7,20,6,0,33
SHINAOTA,"anticoncepcion, prevencion de its y de cancer de cuello uterino",numero de inyectables trimestrales suministrados,2015-07-01,0,5,47,10,0,62
SICA SICA (VILLA AROMA),"anticoncepcion, prevencion de its y de cancer de cuello uterino",numero de inyectables trimestrales suministrados,2015-07-01,0,4,47,36,1,88
SICAYA,"anticoncepcion, prevencion de its y de cancer de cuello uterino",numero de inyectables trimestrales suministrados,2015-07-01,0,2,8,11,0,21
SIPE SIPE,"anticoncepcion, prevencion de its y de cancer de cuello uterino",numero de inyectables trimestrales suministrados,2015-07-01,1,23,177,79,0,280
SOPACHUY,"anticoncepcion, prevencion de its y de cancer de cuello uterino",numero de inyectables trimestrales suministrados,2015-07-01,0,5,28,22,0,55
SORACACHI,"anticoncepcion, prevencion de its y de cancer de cuello uterino",numero de inyectables trimestrales suministrados,2015-07-01,0,1,16,9,0,26
SORATA,"anticoncepcion, prevencion de its y de cancer de cuello uterino",numero de inyectables trimestrales suministrados,2015-07-01,0,0,31,19,0,50
SUCRE,"anticoncepcion, prevencion de its y de cancer de cuello uterino",numero de inyectables trimestrales suministrados,2015-07-01,1,104,454,175,1,735
TACACHI,"anticoncepcion, prevencion de its y de cancer de cuello uterino",numero de inyectables trimestrales suministrados,2015-07-01,0,0,6,0,0,6
TACACOMA,"anticoncepcion, prevencion de its y de cancer de cuello uterino",numero de inyectables trimestrales suministrados,2015-07-01,0,4,24,9,0,37
TACOBAMBA,"anticoncepcion, prevencion de its y de cancer de cuello uterino",numero de inyectables trimestrales suministrados,2015-07-01,0,4,16,14,0,34
TACOPAYA,"anticoncepcion, prevencion de its y de cancer de cuello uterino",numero de inyectables trimestrales suministrados,2015-07-01,0,2,10,6,0,18
TAHUA,"anticoncepcion, prevencion de its y de cancer de cuello uterino",numero de inyectables trimestrales suministrados,2015-07-01,0,0,1,1,0,2
TAPACARI,"anticoncepcion, prevencion de its y de cancer de cuello uterino",numero de inyectables trimestrales suministrados,2015-07-01,0,5,62,39,0,106
TARABUCO,"anticoncepcion, prevencion de its y de cancer de cuello uterino",numero de inyectables trimestrales suministrados,2015-07-01,0,7,44,27,1,79
TARACO,"anticoncepcion, prevencion de its y de cancer de cuello uterino",numero de inyectables trimestrales suministrados,2015-07-01,0,2,13,9,0,24
TARATA,"anticoncepcion, prevencion de its y de cancer de cuello uterino",numero de inyectables trimestrales suministrados,2015-07-01,0,3,6,2,0,11
TARIJA,"anticoncepcion, prevencion de its y de cancer de cuello uterino",numero de inyectables trimestrales suministrados,2015-07-01,1,45,241,106,5,398
TARVITA,"anticoncepcion, prevencion de its y de cancer de cuello uterino",numero de inyectables trimestrales suministrados,2015-07-01,0,5,27,23,0,55
TEOPONTE,"anticoncepcion, prevencion de its y de cancer de cuello uterino",numero de inyectables trimestrales suministrados,2015-07-01,0,5,25,5,0,35
TIAWANACU,"anticoncepcion, prevencion de its y de cancer de cuello uterino",numero de inyectables trimestrales suministrados,2015-07-01,0,7,27,21,0,55
TINGUIPAYA,"anticoncepcion, prevencion de its y de cancer de cuello uterino",numero de inyectables trimestrales suministrados,2015-07-01,0,2,30,17,0,49
TIPUANI,"anticoncepcion, prevencion de its y de cancer de cuello uterino",numero de inyectables trimestrales suministrados,2015-07-01,0,3,21,15,0,39
TIQUIPAYA,"anticoncepcion, prevencion de its y de cancer de cuello uterino",numero de inyectables trimestrales suministrados,2015-07-01,0,15,118,35,0,168
TIRAQUE (CBBA),"anticoncepcion, prevencion de its y de cancer de cuello uterino",numero de inyectables trimestrales suministrados,2015-07-01,0,7,55,38,0,100
TITO YUPANQUI (PARQUIPUJIO),"anticoncepcion, prevencion de its y de cancer de cuello uterino",numero de inyectables trimestrales suministrados,2015-07-01,0,0,1,0,0,1
TOCO,"anticoncepcion, prevencion de its y de cancer de cuello uterino",numero de inyectables trimestrales suministrados,2015-07-01,0,4,18,12,0,34
TODOS SANTOS,"anticoncepcion, prevencion de its y de cancer de cuello uterino",numero de inyectables trimestrales suministrados,2015-07-01,0,0,2,0,0,2
TOLATA,"anticoncepcion, prevencion de its y de cancer de cuello uterino",numero de inyectables trimestrales suministrados,2015-07-01,0,1,18,10,0,29
TOLEDO,"anticoncepcion, prevencion de its y de cancer de cuello uterino",numero de inyectables trimestrales suministrados,2015-07-01,0,0,4,2,0,6
TOMAVE,"anticoncepcion, prevencion de its y de cancer de cuello uterino",numero de inyectables trimestrales suministrados,2015-07-01,0,1,22,21,0,44
TOMINA,"anticoncepcion, prevencion de its y de cancer de cuello uterino",numero de inyectables trimestrales suministrados,2015-07-01,0,6,47,37,1,91
TORO TORO,"anticoncepcion, prevencion de its y de cancer de cuello uterino",numero de inyectables trimestrales suministrados,2015-07-01,0,9,37,9,0,55
TOTORA(CBBA),"anticoncepcion, prevencion de its y de cancer de cuello uterino",numero de inyectables trimestrales suministrados,2015-07-01,4,26,63,12,0,105
TOTORA(ORR),"anticoncepcion, prevencion de its y de cancer de cuello uterino",numero de inyectables trimestrales suministrados,2015-07-01,0,1,21,7,1,30
TRIGAL,"anticoncepcion, prevencion de its y de cancer de cuello uterino",numero de inyectables trimestrales suministrados,2015-07-01,0,2,9,1,0,12
TRINIDAD,"anticoncepcion, prevencion de its y de cancer de cuello uterino",numero de inyectables trimestrales suministrados,2015-07-01,0,16,86,11,0,113
TUPIZA,"anticoncepcion, prevencion de its y de cancer de cuello uterino",numero de inyectables trimestrales suministrados,2015-07-01,0,6,101,40,0,147
TURCO,"anticoncepcion, prevencion de its y de cancer de cuello uterino",numero de inyectables trimestrales suministrados,2015-07-01,0,1,9,5,0,15
UMALA,"anticoncepcion, prevencion de its y de cancer de cuello uterino",numero de inyectables trimestrales suministrados,2015-07-01,1,1,8,6,0,16
UNCIA,"anticoncepcion, prevencion de its y de cancer de cuello uterino",numero de inyectables trimestrales suministrados,2015-07-01,0,7,42,29,0,78
URIONDO (A. CONCEPCION),"anticoncepcion, prevencion de its y de cancer de cuello uterino",numero de inyectables trimestrales suministrados,2015-07-01,0,9,70,35,0,114
URUBICHA,"anticoncepcion, prevencion de its y de cancer de cuello uterino",numero de inyectables trimestrales suministrados,2015-07-01,0,0,9,4,0,13
UYUNI,"anticoncepcion, prevencion de its y de cancer de cuello uterino",numero de inyectables trimestrales suministrados,2015-07-01,0,4,37,10,0,51
VACAS,"anticoncepcion, prevencion de its y de cancer de cuello uterino",numero de inyectables trimestrales suministrados,2015-07-01,0,4,34,15,1,54
VALLEGRANDE,"anticoncepcion, prevencion de its y de cancer de cuello uterino",numero de inyectables trimestrales suministrados,2015-07-01,0,17,63,7,0,87
VIACHA,"anticoncepcion, prevencion de its y de cancer de cuello uterino",numero de inyectables trimestrales suministrados,2015-07-01,0,16,139,62,1,218
VILA VILA,"anticoncepcion, prevencion de its y de cancer de cuello uterino",numero de inyectables trimestrales suministrados,2015-07-01,0,0,6,4,0,10
VILLA CHARCAS,"anticoncepcion, prevencion de its y de cancer de cuello uterino",numero de inyectables trimestrales suministrados,2015-07-01,0,4,47,32,1,84
VILLA MONTES,"anticoncepcion, prevencion de its y de cancer de cuello uterino",numero de inyectables trimestrales suministrados,2015-07-01,3,16,98,31,0,148
VILLA NUEVA (LOMA ALTA),"anticoncepcion, prevencion de its y de cancer de cuello uterino",numero de inyectables trimestrales suministrados,2015-07-01,0,0,4,1,0,5
VILLA RIVERO,"anticoncepcion, prevencion de its y de cancer de cuello uterino",numero de inyectables trimestrales suministrados,2015-07-01,0,5,34,19,0,58
VILLA SERRANO,"anticoncepcion, prevencion de its y de cancer de cuello uterino",numero de inyectables trimestrales suministrados,2015-07-01,0,6,29,28,3,66
VILLA TUNARI,"anticoncepcion, prevencion de its y de cancer de cuello uterino",numero de inyectables trimestrales suministrados,2015-07-01,3,42,300,103,0,448
VILLA VACA GUZMAN (MUYUPAMPA),"anticoncepcion, prevencion de its y de cancer de cuello uterino",numero de inyectables trimestrales suministrados,2015-07-01,0,3,36,17,0,56
VILLAZON,"anticoncepcion, prevencion de its y de cancer de cuello uterino",numero de inyectables trimestrales suministrados,2015-07-01,0,21,119,51,0,191
VINTO,"anticoncepcion, prevencion de its y de cancer de cuello uterino",numero de inyectables trimestrales suministrados,2015-07-01,0,12,95,15,0,122
VITICHI,"anticoncepcion, prevencion de its y de cancer de cuello uterino",numero de inyectables trimestrales suministrados,2015-07-01,0,3,11,9,0,23
WALDO BALLIVIAN,"anticoncepcion, prevencion de its y de cancer de cuello uterino",numero de inyectables trimestrales suministrados,2015-07-01,0,0,2,3,0,5
WARNES,"anticoncepcion, prevencion de its y de cancer de cuello uterino",numero de inyectables trimestrales suministrados,2015-07-01,2,52,196,50,2,302
YACO,"anticoncepcion, prevencion de its y de cancer de cuello uterino",numero de inyectables trimestrales suministrados,2015-07-01,0,1,15,7,0,23
YACUIBA,"anticoncepcion, prevencion de its y de cancer de cuello uterino",numero de inyectables trimestrales suministrados,2015-07-01,1,48,227,96,2,374
YAMPARAEZ,"anticoncepcion, prevencion de its y de cancer de cuello uterino",numero de inyectables trimestrales suministrados,2015-07-01,0,2,3,8,0,13
YANACACHI,"anticoncepcion, prevencion de its y de cancer de cuello uterino",numero de inyectables trimestrales suministrados,2015-07-01,0,0,18,11,0,29
YAPACANI,"anticoncepcion, prevencion de its y de cancer de cuello uterino",numero de inyectables trimestrales suministrados,2015-07-01,1,17,92,28,0,138
YOCALLA,"anticoncepcion, prevencion de its y de cancer de cuello uterino",numero de inyectables trimestrales suministrados,2015-07-01,0,1,14,3,0,18
YOTALA,"anticoncepcion, prevencion de its y de cancer de cuello uterino",numero de inyectables trimestrales suministrados,2015-07-01,0,3,16,7,1,27
YUNCHARA,"anticoncepcion, prevencion de its y de cancer de cuello uterino",numero de inyectables trimestrales suministrados,2015-07-01,0,6,39,18,0,63
YUNGUYO DE LITORAL,"anticoncepcion, prevencion de its y de cancer de cuello uterino",numero de inyectables trimestrales suministrados,2015-07-01,0,0,0,1,0,1
ZUDAÑEZ,"anticoncepcion, prevencion de its y de cancer de cuello uterino",numero de inyectables trimestrales suministrados,2015-07-01,0,2,40,18,1,61
ACACIO,"anticoncepcion, prevencion de its y de cancer de cuello uterino",numero de inyectables trimestrales suministrados,2015-08-01,0,6,11,6,0,23
ACHACACHI,"anticoncepcion, prevencion de its y de cancer de cuello uterino",numero de inyectables trimestrales suministrados,2015-08-01,1,6,62,44,0,113
ACHOCALLA,"anticoncepcion, prevencion de its y de cancer de cuello uterino",numero de inyectables trimestrales suministrados,2015-08-01,0,6,39,20,1,66
AIQUILE,"anticoncepcion, prevencion de its y de cancer de cuello uterino",numero de inyectables trimestrales suministrados,2015-08-01,0,6,36,33,0,75
ALALAY,"anticoncepcion, prevencion de its y de cancer de cuello uterino",numero de inyectables trimestrales suministrados,2015-08-01,0,0,7,4,0,11
ALCALA,"anticoncepcion, prevencion de its y de cancer de cuello uterino",numero de inyectables trimestrales suministrados,2015-08-01,0,1,18,12,1,32
ALTO BENI,"anticoncepcion, prevencion de its y de cancer de cuello uterino",numero de inyectables trimestrales suministrados,2015-08-01,0,4,24,13,0,41
ANCORAIMES,"anticoncepcion, prevencion de its y de cancer de cuello uterino",numero de inyectables trimestrales suministrados,2015-08-01,0,2,10,6,0,18
ANDAMARCA,"anticoncepcion, prevencion de its y de cancer de cuello uterino",numero de inyectables trimestrales suministrados,2015-08-01,0,0,5,5,0,10
ANTEQUERA,"anticoncepcion, prevencion de its y de cancer de cuello uterino",numero de inyectables trimestrales suministrados,2015-08-01,0,0,6,1,0,7
ANZALDO,"anticoncepcion, prevencion de its y de cancer de cuello uterino",numero de inyectables trimestrales suministrados,2015-08-01,0,3,32,16,1,52
APOLO,"anticoncepcion, prevencion de its y de cancer de cuello uterino",numero de inyectables trimestrales suministrados,2015-08-01,0,3,36,19,0,58
ARAMPAMPA,"anticoncepcion, prevencion de its y de cancer de cuello uterino",numero de inyectables trimestrales suministrados,2015-08-01,0,2,7,3,0,12
ARANI,"anticoncepcion, prevencion de its y de cancer de cuello uterino",numero de inyectables trimestrales suministrados,2015-08-01,0,0,17,9,0,26
ARBIETO,"anticoncepcion, prevencion de its y de cancer de cuello uterino",numero de inyectables trimestrales suministrados,2015-08-01,2,5,61,24,0,92
ARQUE,"anticoncepcion, prevencion de its y de cancer de cuello uterino",numero de inyectables trimestrales suministrados,2015-08-01,0,4,46,29,0,79
ASCENCION DE GUARAYOS,"anticoncepcion, prevencion de its y de cancer de cuello uterino",numero de inyectables trimestrales suministrados,2015-08-01,0,11,32,11,0,54
ATOCHA,"anticoncepcion, prevencion de its y de cancer de cuello uterino",numero de inyectables trimestrales suministrados,2015-08-01,0,3,37,25,0,65
AUCAPATA,"anticoncepcion, prevencion de its y de cancer de cuello uterino",numero de inyectables trimestrales suministrados,2015-08-01,0,1,7,4,0,12
AYATA,"anticoncepcion, prevencion de its y de cancer de cuello uterino",numero de inyectables trimestrales suministrados,2015-08-01,0,4,23,21,0,48
AYO AYO,"anticoncepcion, prevencion de its y de cancer de cuello uterino",numero de inyectables trimestrales suministrados,2015-08-01,0,1,9,7,0,17
AYOPAYA (V. DE INDEPENDENCIA),"anticoncepcion, prevencion de its y de cancer de cuello uterino",numero de inyectables trimestrales suministrados,2015-08-01,0,8,102,67,1,178
AZURDUY,"anticoncepcion, prevencion de its y de cancer de cuello uterino",numero de inyectables trimestrales suministrados,2015-08-01,0,6,39,30,1,76
BATALLAS,"anticoncepcion, prevencion de its y de cancer de cuello uterino",numero de inyectables trimestrales suministrados,2015-08-01,0,4,24,15,0,43
BAURES,"anticoncepcion, prevencion de its y de cancer de cuello uterino",numero de inyectables trimestrales suministrados,2015-08-01,0,3,8,0,0,11
BELEN DE ANDAMARCA,"anticoncepcion, prevencion de its y de cancer de cuello uterino",numero de inyectables trimestrales suministrados,2015-08-01,0,0,0,1,0,1
BELLA FLOR,"anticoncepcion, prevencion de its y de cancer de cuello uterino",numero de inyectables trimestrales suministrados,2015-08-01,0,3,6,7,0,16
BERMEJO,"anticoncepcion, prevencion de its y de cancer de cuello uterino",numero de inyectables trimestrales suministrados,2015-08-01,0,16,82,30,0,128
BETANZOS,"anticoncepcion, prevencion de its y de cancer de cuello uterino",numero de inyectables trimestrales suministrados,2015-08-01,0,5,50,46,0,101
BOLIVAR,"anticoncepcion, prevencion de its y de cancer de cuello uterino",numero de inyectables trimestrales suministrados,2015-08-01,0,0,14,10,0,24
BOLPEBRA,"anticoncepcion, prevencion de its y de cancer de cuello uterino",numero de inyectables trimestrales suministrados,2015-08-01,0,2,4,1,0,7
BOYUIBE,"anticoncepcion, prevencion de its y de cancer de cuello uterino",numero de inyectables trimestrales suministrados,2015-08-01,0,0,10,3,0,13
BUENA VISTA,"anticoncepcion, prevencion de its y de cancer de cuello uterino",numero de inyectables trimestrales suministrados,2015-08-01,0,8,39,15,0,62
CABEZAS,"anticoncepcion, prevencion de its y de cancer de cuello uterino",numero de inyectables trimestrales suministrados,2015-08-01,1,17,101,28,2,149
CAIROMA,"anticoncepcion, prevencion de its y de cancer de cuello uterino",numero de inyectables trimestrales suministrados,2015-08-01,0,1,28,16,0,45
"CAIZA ""D""","anticoncepcion, prevencion de its y de cancer de cuello uterino",numero de inyectables trimestrales suministrados,2015-08-01,0,1,11,5,1,18
CAJUATA,"anticoncepcion, prevencion de its y de cancer de cuello uterino",numero de inyectables trimestrales suministrados,2015-08-01,0,3,26,10,0,39
CALACOTO,"anticoncepcion, prevencion de its y de cancer de cuello uterino",numero de inyectables trimestrales suministrados,2015-08-01,0,0,3,3,0,6
CALAMARCA,"anticoncepcion, prevencion de its y de cancer de cuello uterino",numero de inyectables trimestrales suministrados,2015-08-01,0,3,39,16,0,58
CAMARGO,"anticoncepcion, prevencion de its y de cancer de cuello uterino",numero de inyectables trimestrales suministrados,2015-08-01,0,2,16,21,0,39
CAMATAQUI (C. VILLA ABECIA),"anticoncepcion, prevencion de its y de cancer de cuello uterino",numero de inyectables trimestrales suministrados,2015-08-01,0,0,10,11,0,21
CAMIRI,"anticoncepcion, prevencion de its y de cancer de cuello uterino",numero de inyectables trimestrales suministrados,2015-08-01,0,9,66,14,0,89
CAPINOTA,"anticoncepcion, prevencion de its y de cancer de cuello uterino",numero de inyectables trimestrales suministrados,2015-08-01,0,9,54,24,0,87
CAQUIAVIRI,"anticoncepcion, prevencion de its y de cancer de cuello uterino",numero de inyectables trimestrales suministrados,2015-08-01,0,2,19,5,0,26
CARACOLLO,"anticoncepcion, prevencion de its y de cancer de cuello uterino",numero de inyectables trimestrales suministrados,2015-08-01,0,1,43,23,0,67
CARANAVI,"anticoncepcion, prevencion de its y de cancer de cuello uterino",numero de inyectables trimestrales suministrados,2015-08-01,0,11,97,36,0,144
CARANGAS,"anticoncepcion, prevencion de its y de cancer de cuello uterino",numero de inyectables trimestrales suministrados,2015-08-01,0,1,0,0,0,1
CARAPARI,"anticoncepcion, prevencion de its y de cancer de cuello uterino",numero de inyectables trimestrales suministrados,2015-08-01,0,3,40,26,0,69
CARIPUYO,"anticoncepcion, prevencion de its y de cancer de cuello uterino",numero de inyectables trimestrales suministrados,2015-08-01,0,5,9,8,0,22
CARMEN RIVERO TORREZ,"anticoncepcion, prevencion de its y de cancer de cuello uterino",numero de inyectables trimestrales suministrados,2015-08-01,0,0,11,2,0,13
CATACORA,"anticoncepcion, prevencion de its y de cancer de cuello uterino",numero de inyectables trimestrales suministrados,2015-08-01,0,1,7,4,0,12
CHACARILLA,"anticoncepcion, prevencion de its y de cancer de cuello uterino",numero de inyectables trimestrales suministrados,2015-08-01,0,1,5,2,0,8
CHALLAPATA,"anticoncepcion, prevencion de its y de cancer de cuello uterino",numero de inyectables trimestrales suministrados,2015-08-01,0,1,19,17,0,37
CHAQUI,"anticoncepcion, prevencion de its y de cancer de cuello uterino",numero de inyectables trimestrales suministrados,2015-08-01,0,3,22,11,0,36
CHARAGUA,"anticoncepcion, prevencion de its y de cancer de cuello uterino",numero de inyectables trimestrales suministrados,2015-08-01,0,4,36,26,0,66
CHARAÑA,"anticoncepcion, prevencion de its y de cancer de cuello uterino",numero de inyectables trimestrales suministrados,2015-08-01,0,0,4,1,0,5
CHAYANTA,"anticoncepcion, prevencion de its y de cancer de cuello uterino",numero de inyectables trimestrales suministrados,2015-08-01,0,2,39,24,0,65
CHIMORE,"anticoncepcion, prevencion de its y de cancer de cuello uterino",numero de inyectables trimestrales suministrados,2015-08-01,0,1,49,14,0,64
CHIPAYA,"anticoncepcion, prevencion de its y de cancer de cuello uterino",numero de inyectables trimestrales suministrados,2015-08-01,0,2,7,0,0,9
CHOQUE COTA,"anticoncepcion, prevencion de its y de cancer de cuello uterino",numero de inyectables trimestrales suministrados,2015-08-01,0,0,2,1,0,3
CHUA COCANI,"anticoncepcion, prevencion de its y de cancer de cuello uterino",numero de inyectables trimestrales suministrados,2015-08-01,0,0,5,4,0,9
CHULUMANI (V. DE LA LIBERTAD),"anticoncepcion, prevencion de its y de cancer de cuello uterino",numero de inyectables trimestrales suministrados,2015-08-01,0,3,26,9,0,38
CHUMA,"anticoncepcion, prevencion de its y de cancer de cuello uterino",numero de inyectables trimestrales suministrados,2015-08-01,0,2,39,15,0,56
CHUQUIHUTA AYLLU JUCUMANI,"anticoncepcion, prevencion de its y de cancer de cuello uterino",numero de inyectables trimestrales suministrados,2015-08-01,0,1,16,7,0,24
CKOCHAS,"anticoncepcion, prevencion de its y de cancer de cuello uterino",numero de inyectables trimestrales suministrados,2015-08-01,0,2,23,22,0,47
CLIZA,"anticoncepcion, prevencion de its y de cancer de cuello uterino",numero de inyectables trimestrales suministrados,2015-08-01,0,1,45,8,0,54
COBIJA,"anticoncepcion, prevencion de its y de cancer de cuello uterino",numero de inyectables trimestrales suministrados,2015-08-01,1,31,99,19,0,150
COCAPATA,"anticoncepcion, prevencion de its y de cancer de cuello uterino",numero de inyectables trimestrales suministrados,2015-08-01,0,6,47,12,0,65
COCHABAMBA,"anticoncepcion, prevencion de its y de cancer de cuello uterino",numero de inyectables trimestrales suministrados,2015-08-01,0,48,421,86,1,556
COIPASA,"anticoncepcion, prevencion de its y de cancer de cuello uterino",numero de inyectables trimestrales suministrados,2015-08-01,0,0,2,1,0,3
COLCAPIRHUA,"anticoncepcion, prevencion de its y de cancer de cuello uterino",numero de inyectables trimestrales suministrados,2015-08-01,0,8,77,4,0,89
"COLCHA ""K""","anticoncepcion, prevencion de its y de cancer de cuello uterino",numero de inyectables trimestrales suministrados,2015-08-01,0,4,44,20,0,68
COLLANA,"anticoncepcion, prevencion de its y de cancer de cuello uterino",numero de inyectables trimestrales suministrados,2015-08-01,0,0,7,2,0,9
COLOMI,"anticoncepcion, prevencion de its y de cancer de cuello uterino",numero de inyectables trimestrales suministrados,2015-08-01,0,14,63,20,0,97
COLPA BELGICA,"anticoncepcion, prevencion de its y de cancer de cuello uterino",numero de inyectables trimestrales suministrados,2015-08-01,0,2,14,2,0,18
COLQUECHACA,"anticoncepcion, prevencion de its y de cancer de cuello uterino",numero de inyectables trimestrales suministrados,2015-08-01,0,4,44,29,0,77
COLQUENCHA,"anticoncepcion, prevencion de its y de cancer de cuello uterino",numero de inyectables trimestrales suministrados,2015-08-01,0,3,22,7,0,32
COLQUIRI,"anticoncepcion, prevencion de its y de cancer de cuello uterino",numero de inyectables trimestrales suministrados,2015-08-01,0,0,21,9,0,30
COMANCHE,"anticoncepcion, prevencion de its y de cancer de cuello uterino",numero de inyectables trimestrales suministrados,2015-08-01,0,2,4,0,0,6
COMARAPA,"anticoncepcion, prevencion de its y de cancer de cuello uterino",numero de inyectables trimestrales suministrados,2015-08-01,0,16,58,30,0,104
COMBAYA,"anticoncepcion, prevencion de its y de cancer de cuello uterino",numero de inyectables trimestrales suministrados,2015-08-01,0,2,2,0,0,4
CONCEPCION,"anticoncepcion, prevencion de its y de cancer de cuello uterino",numero de inyectables trimestrales suministrados,2015-08-01,0,14,30,6,0,50
COPACABANA,"anticoncepcion, prevencion de its y de cancer de cuello uterino",numero de inyectables trimestrales suministrados,2015-08-01,0,5,38,18,0,61
CORIPATA,"anticoncepcion, prevencion de its y de cancer de cuello uterino",numero de inyectables trimestrales suministrados,2015-08-01,0,5,26,12,0,43
CORO CORO,"anticoncepcion, prevencion de its y de cancer de cuello uterino",numero de inyectables trimestrales suministrados,2015-08-01,0,0,12,5,0,17
COROICO,"anticoncepcion, prevencion de its y de cancer de cuello uterino",numero de inyectables trimestrales suministrados,2015-08-01,0,3,14,3,0,20
CORQUE,"anticoncepcion, prevencion de its y de cancer de cuello uterino",numero de inyectables trimestrales suministrados,2015-08-01,0,1,9,5,0,15
COTAGAITA,"anticoncepcion, prevencion de its y de cancer de cuello uterino",numero de inyectables trimestrales suministrados,2015-08-01,0,4,58,35,0,97
COTOCA,"anticoncepcion, prevencion de its y de cancer de cuello uterino",numero de inyectables trimestrales suministrados,2015-08-01,0,21,109,33,0,163
CUATRO CAÑADAS,"anticoncepcion, prevencion de its y de cancer de cuello uterino",numero de inyectables trimestrales suministrados,2015-08-01,0,10,24,18,0,52
CUCHUMUELA (V. G. VILLARROEL),"anticoncepcion, prevencion de its y de cancer de cuello uterino",numero de inyectables trimestrales suministrados,2015-08-01,0,1,5,2,0,8
CUEVO,"anticoncepcion, prevencion de its y de cancer de cuello uterino",numero de inyectables trimestrales suministrados,2015-08-01,0,1,14,7,0,22
CULPINA,"anticoncepcion, prevencion de its y de cancer de cuello uterino",numero de inyectables trimestrales suministrados,2015-08-01,0,8,82,54,0,144
CURAHUARA DE CARANGAS,"anticoncepcion, prevencion de its y de cancer de cuello uterino",numero de inyectables trimestrales suministrados,2015-08-01,0,1,13,8,0,22
CURVA,"anticoncepcion, prevencion de its y de cancer de cuello uterino",numero de inyectables trimestrales suministrados,2015-08-01,0,0,10,0,0,10
DESAGUADERO,"anticoncepcion, prevencion de its y de cancer de cuello uterino",numero de inyectables trimestrales suministrados,2015-08-01,0,1,17,4,0,22
EL ALTO,"anticoncepcion, prevencion de its y de cancer de cuello uterino",numero de inyectables trimestrales suministrados,2015-08-01,1,83,1016,364,1,1465
EL CHORO,"anticoncepcion, prevencion de its y de cancer de cuello uterino",numero de inyectables trimestrales suministrados,2015-08-01,0,3,9,3,0,15
EL PUENTE(STC),"anticoncepcion, prevencion de its y de cancer de cuello uterino",numero de inyectables trimestrales suministrados,2015-08-01,0,16,36,7,0,59
EL PUENTE(TJA),"anticoncepcion, prevencion de its y de cancer de cuello uterino",numero de inyectables trimestrales suministrados,2015-08-01,0,7,59,43,2,111
EL TORNO,"anticoncepcion, prevencion de its y de cancer de cuello uterino",numero de inyectables trimestrales suministrados,2015-08-01,8,31,107,43,0,189
EL VILLAR,"anticoncepcion, prevencion de its y de cancer de cuello uterino",numero de inyectables trimestrales suministrados,2015-08-01,0,3,20,20,0,43
ENTRE RIOS TRJ,"anticoncepcion, prevencion de its y de cancer de cuello uterino",numero de inyectables trimestrales suministrados,2015-08-01,3,24,110,51,1,189
ENTRE RIOS CBBA,"anticoncepcion, prevencion de its y de cancer de cuello uterino",numero de inyectables trimestrales suministrados,2015-08-01,0,14,56,17,0,87
ESCOMA,"anticoncepcion, prevencion de its y de cancer de cuello uterino",numero de inyectables trimestrales suministrados,2015-08-01,0,0,2,2,0,4
ESMERALDA,"anticoncepcion, prevencion de its y de cancer de cuello uterino",numero de inyectables trimestrales suministrados,2015-08-01,0,0,2,0,0,2
EUCALIPTUS,"anticoncepcion, prevencion de its y de cancer de cuello uterino",numero de inyectables trimestrales suministrados,2015-08-01,0,0,7,3,0,10
EUREKA (SANTOS MERCADO),"anticoncepcion, prevencion de its y de cancer de cuello uterino",numero de inyectables trimestrales suministrados,2015-08-01,0,2,4,1,0,7
EXALTACION,"anticoncepcion, prevencion de its y de cancer de cuello uterino",numero de inyectables trimestrales suministrados,2015-08-01,0,0,3,0,0,3
FERNANDEZ ALONSO,"anticoncepcion, prevencion de its y de cancer de cuello uterino",numero de inyectables trimestrales suministrados,2015-08-01,0,3,31,20,1,55
FILADELFIA,"anticoncepcion, prevencion de its y de cancer de cuello uterino",numero de inyectables trimestrales suministrados,2015-08-01,0,4,9,0,0,13
GENERAL SAAVEDRA,"anticoncepcion, prevencion de its y de cancer de cuello uterino",numero de inyectables trimestrales suministrados,2015-08-01,0,7,57,14,1,79
GRAL. J.J. PEREZ (CHARAZANI),"anticoncepcion, prevencion de its y de cancer de cuello uterino",numero de inyectables trimestrales suministrados,2015-08-01,0,0,23,6,0,29
GUANAY,"anticoncepcion, prevencion de its y de cancer de cuello uterino",numero de inyectables trimestrales suministrados,2015-08-01,0,2,15,5,0,22
GUAQUI,"anticoncepcion, prevencion de its y de cancer de cuello uterino",numero de inyectables trimestrales suministrados,2015-08-01,0,0,18,10,1,29
GUAYARAMERIN,"anticoncepcion, prevencion de its y de cancer de cuello uterino",numero de inyectables trimestrales suministrados,2015-08-01,1,7,17,0,0,25
GUTIERREZ,"anticoncepcion, prevencion de its y de cancer de cuello uterino",numero de inyectables trimestrales suministrados,2015-08-01,0,1,24,6,0,31
HUACARETA,"anticoncepcion, prevencion de its y de cancer de cuello uterino",numero de inyectables trimestrales suministrados,2015-08-01,0,11,43,10,1,65
HUACAYA (VILLA DE HUACAYA),"anticoncepcion, prevencion de its y de cancer de cuello uterino",numero de inyectables trimestrales suministrados,2015-08-01,0,0,13,2,0,15
HUACHACALLA,"anticoncepcion, prevencion de its y de cancer de cuello uterino",numero de inyectables trimestrales suministrados,2015-08-01,0,0,2,1,0,3
HUANUNI,"anticoncepcion, prevencion de its y de cancer de cuello uterino",numero de inyectables trimestrales suministrados,2015-08-01,0,1,14,5,0,20
HUARACAJE,"anticoncepcion, prevencion de its y de cancer de cuello uterino",numero de inyectables trimestrales suministrados,2015-08-01,0,1,13,4,1,19
HUARINA,"anticoncepcion, prevencion de its y de cancer de cuello uterino",numero de inyectables trimestrales suministrados,2015-08-01,0,2,8,8,0,18
HUATAJATA,"anticoncepcion, prevencion de its y de cancer de cuello uterino",numero de inyectables trimestrales suministrados,2015-08-01,0,0,3,5,0,8
HUAYLLAMARCA,"anticoncepcion, prevencion de its y de cancer de cuello uterino",numero de inyectables trimestrales suministrados,2015-08-01,0,3,7,11,0,21
HUMANATA,"anticoncepcion, prevencion de its y de cancer de cuello uterino",numero de inyectables trimestrales suministrados,2015-08-01,0,2,4,6,0,12
ICHOCA,"anticoncepcion, prevencion de its y de cancer de cuello uterino",numero de inyectables trimestrales suministrados,2015-08-01,0,1,6,2,0,9
ICLA,"anticoncepcion, prevencion de its y de cancer de cuello uterino",numero de inyectables trimestrales suministrados,2015-08-01,0,3,15,21,0,39
INCAHUASI,"anticoncepcion, prevencion de its y de cancer de cuello uterino",numero de inyectables trimestrales suministrados,2015-08-01,0,6,34,15,0,55
INGAVI (HUMAITA),"anticoncepcion, prevencion de its y de cancer de cuello uterino",numero de inyectables trimestrales suministrados,2015-08-01,0,0,14,0,1,15
INQUISIVI,"anticoncepcion, prevencion de its y de cancer de cuello uterino",numero de inyectables trimestrales suministrados,2015-08-01,0,1,20,12,0,33
IRUPANA (VILLA DE LANZA),"anticoncepcion, prevencion de its y de cancer de cuello uterino",numero de inyectables trimestrales suministrados,2015-08-01,0,4,55,16,1,76
IXIAMAS,"anticoncepcion, prevencion de its y de cancer de cuello uterino",numero de inyectables trimestrales suministrados,2015-08-01,1,7,15,2,0,25
JESUS DE MACHACA,"anticoncepcion, prevencion de its y de cancer de cuello uterino",numero de inyectables trimestrales suministrados,2015-08-01,0,1,17,15,0,33
LA ASUNTA,"anticoncepcion, prevencion de its y de cancer de cuello uterino",numero de inyectables trimestrales suministrados,2015-08-01,0,17,143,43,0,203
LA GUARDIA,"anticoncepcion, prevencion de its y de cancer de cuello uterino",numero de inyectables trimestrales suministrados,2015-08-01,4,41,125,40,0,210
LA PAZ,"anticoncepcion, prevencion de its y de cancer de cuello uterino",numero de inyectables trimestrales suministrados,2015-08-01,3,48,420,92,2,565
LAGUNILLAS,"anticoncepcion, prevencion de its y de cancer de cuello uterino",numero de inyectables trimestrales suministrados,2015-08-01,0,3,13,6,0,22
LAJA,"anticoncepcion, prevencion de its y de cancer de cuello uterino",numero de inyectables trimestrales suministrados,2015-08-01,1,2,26,14,0,43
LAS CARRERAS,"anticoncepcion, prevencion de its y de cancer de cuello uterino",numero de inyectables trimestrales suministrados,2015-08-01,0,4,14,4,0,22
LICOMA PAMPA,"anticoncepcion, prevencion de its y de cancer de cuello uterino",numero de inyectables trimestrales suministrados,2015-08-01,0,2,8,10,0,20
LLALLAGUA,"anticoncepcion, prevencion de its y de cancer de cuello uterino",numero de inyectables trimestrales suministrados,2015-08-01,0,2,48,23,0,73
LLICA,"anticoncepcion, prevencion de its y de cancer de cuello uterino",numero de inyectables trimestrales suministrados,2015-08-01,0,1,20,7,1,29
LORETO,"anticoncepcion, prevencion de its y de cancer de cuello uterino",numero de inyectables trimestrales suministrados,2015-08-01,0,0,6,0,0,6
LURIBAY,"anticoncepcion, prevencion de its y de cancer de cuello uterino",numero de inyectables trimestrales suministrados,2015-08-01,1,5,20,18,0,44
MACHACAMARCA,"anticoncepcion, prevencion de its y de cancer de cuello uterino",numero de inyectables trimestrales suministrados,2015-08-01,0,0,2,1,0,3
MACHARETI,"anticoncepcion, prevencion de its y de cancer de cuello uterino",numero de inyectables trimestrales suministrados,2015-08-01,0,8,44,15,0,67
MAGDALENA,"anticoncepcion, prevencion de its y de cancer de cuello uterino",numero de inyectables trimestrales suministrados,2015-08-01,0,6,29,20,0,55
MAIRANA,"anticoncepcion, prevencion de its y de cancer de cuello uterino",numero de inyectables trimestrales suministrados,2015-08-01,0,7,23,12,0,42
MALLA,"anticoncepcion, prevencion de its y de cancer de cuello uterino",numero de inyectables trimestrales suministrados,2015-08-01,0,0,6,4,0,10
MAPIRI,"anticoncepcion, prevencion de its y de cancer de cuello uterino",numero de inyectables trimestrales suministrados,2015-08-01,0,4,12,8,0,24
MECAPACA,"anticoncepcion, prevencion de its y de cancer de cuello uterino",numero de inyectables trimestrales suministrados,2015-08-01,0,2,21,10,0,33
MINEROS,"anticoncepcion, prevencion de its y de cancer de cuello uterino",numero de inyectables trimestrales suministrados,2015-08-01,0,17,65,18,0,100
MIZQUE,"anticoncepcion, prevencion de its y de cancer de cuello uterino",numero de inyectables trimestrales suministrados,2015-08-01,0,19,84,34,0,137
MOCOMOCO,"anticoncepcion, prevencion de its y de cancer de cuello uterino",numero de inyectables trimestrales suministrados,2015-08-01,0,1,16,13,0,30
MOJINETE,"anticoncepcion, prevencion de its y de cancer de cuello uterino",numero de inyectables trimestrales suministrados,2015-08-01,0,0,0,1,0,1
MOJOCOYA,"anticoncepcion, prevencion de its y de cancer de cuello uterino",numero de inyectables trimestrales suministrados,2015-08-01,0,6,41,21,1,69
MONTEAGUDO,"anticoncepcion, prevencion de its y de cancer de cuello uterino",numero de inyectables trimestrales suministrados,2015-08-01,0,13,41,39,0,93
MONTERO,"anticoncepcion, prevencion de its y de cancer de cuello uterino",numero de inyectables trimestrales suministrados,2015-08-01,0,36,181,54,0,271
MORO MORO,"anticoncepcion, prevencion de its y de cancer de cuello uterino",numero de inyectables trimestrales suministrados,2015-08-01,0,1,8,6,0,15
MOROCHATA,"anticoncepcion, prevencion de its y de cancer de cuello uterino",numero de inyectables trimestrales suministrados,2015-08-01,0,7,35,39,2,83
NACEBE (SANTA ROSA DEL ABUNA),"anticoncepcion, prevencion de its y de cancer de cuello uterino",numero de inyectables trimestrales suministrados,2015-08-01,0,5,10,2,0,17
NAZACARA DE PACAJES,"anticoncepcion, prevencion de its y de cancer de cuello uterino",numero de inyectables trimestrales suministrados,2015-08-01,0,1,0,1,0,2
NUEVO MANOA (NUEVA ESPERANZA),"anticoncepcion, prevencion de its y de cancer de cuello uterino",numero de inyectables trimestrales suministrados,2015-08-01,0,3,3,1,0,7
OCURI,"anticoncepcion, prevencion de its y de cancer de cuello uterino",numero de inyectables trimestrales suministrados,2015-08-01,0,1,34,15,0,50
OKINAWA,"anticoncepcion, prevencion de its y de cancer de cuello uterino",numero de inyectables trimestrales suministrados,2015-08-01,1,8,28,9,0,46
OMEREQUE,"anticoncepcion, prevencion de its y de cancer de cuello uterino",numero de inyectables trimestrales suministrados,2015-08-01,0,5,19,18,0,42
ORURO,"anticoncepcion, prevencion de its y de cancer de cuello uterino",numero de inyectables trimestrales suministrados,2015-08-01,0,33,372,128,1,534
PADCAYA,"anticoncepcion, prevencion de its y de cancer de cuello uterino",numero de inyectables trimestrales suministrados,2015-08-01,2,17,95,64,3,181
PADILLA,"anticoncepcion, prevencion de its y de cancer de cuello uterino",numero de inyectables trimestrales suministrados,2015-08-01,1,3,63,24,0,91
PAILON,"anticoncepcion, prevencion de its y de cancer de cuello uterino",numero de inyectables trimestrales suministrados,2015-08-01,0,6,38,5,0,49
PALCA,"anticoncepcion, prevencion de its y de cancer de cuello uterino",numero de inyectables trimestrales suministrados,2015-08-01,0,6,26,12,0,44
PALOS BLANCOS,"anticoncepcion, prevencion de its y de cancer de cuello uterino",numero de inyectables trimestrales suministrados,2015-08-01,1,10,47,31,0,89
PAMPA AULLAGAS,"anticoncepcion, prevencion de its y de cancer de cuello uterino",numero de inyectables trimestrales suministrados,2015-08-01,0,0,3,3,0,6
PAMPA GRANDE,"anticoncepcion, prevencion de its y de cancer de cuello uterino",numero de inyectables trimestrales suministrados,2015-08-01,0,1,27,18,0,46
PAPEL PAMPA,"anticoncepcion, prevencion de its y de cancer de cuello uterino",numero de inyectables trimestrales suministrados,2015-08-01,0,5,13,7,0,25
PASORAPA,"anticoncepcion, prevencion de its y de cancer de cuello uterino",numero de inyectables trimestrales suministrados,2015-08-01,0,2,17,8,3,30
PATACAMAYA,"anticoncepcion, prevencion de its y de cancer de cuello uterino",numero de inyectables trimestrales suministrados,2015-08-01,0,2,17,9,0,28
PAZÑA,"anticoncepcion, prevencion de its y de cancer de cuello uterino",numero de inyectables trimestrales suministrados,2015-08-01,0,0,19,7,0,26
PELECHUCO,"anticoncepcion, prevencion de its y de cancer de cuello uterino",numero de inyectables trimestrales suministrados,2015-08-01,0,2,13,8,0,23
POCOATA,"anticoncepcion, prevencion de its y de cancer de cuello uterino",numero de inyectables trimestrales suministrados,2015-08-01,0,1,30,29,0,60
POCONA,"anticoncepcion, prevencion de its y de cancer de cuello uterino",numero de inyectables trimestrales suministrados,2015-08-01,1,11,64,31,1,108
POJO (CBBA),"anticoncepcion, prevencion de its y de cancer de cuello uterino",numero de inyectables trimestrales suministrados,2015-08-01,0,4,50,31,1,86
POOPO,"anticoncepcion, prevencion de its y de cancer de cuello uterino",numero de inyectables trimestrales suministrados,2015-08-01,0,0,12,2,0,14
PORCO,"anticoncepcion, prevencion de its y de cancer de cuello uterino",numero de inyectables trimestrales suministrados,2015-08-01,0,0,31,7,0,38
POROMA,"anticoncepcion, prevencion de its y de cancer de cuello uterino",numero de inyectables trimestrales suministrados,2015-08-01,1,9,42,41,0,93
PORONGO,"anticoncepcion, prevencion de its y de cancer de cuello uterino",numero de inyectables trimestrales suministrados,2015-08-01,0,4,17,6,0,27
PORTACHUELO,"anticoncepcion, prevencion de its y de cancer de cuello uterino",numero de inyectables trimestrales suministrados,2015-08-01,0,3,38,8,0,49
PORVENIR,"anticoncepcion, prevencion de its y de cancer de cuello uterino",numero de inyectables trimestrales suministrados,2015-08-01,1,4,24,6,0,35
POSTRER VALLE,"anticoncepcion, prevencion de its y de cancer de cuello uterino",numero de inyectables trimestrales suministrados,2015-08-01,0,0,7,4,0,11
POTOSI,"anticoncepcion, prevencion de its y de cancer de cuello uterino",numero de inyectables trimestrales suministrados,2015-08-01,0,51,519,152,0,722
PRESTO,"anticoncepcion, prevencion de its y de cancer de cuello uterino",numero de inyectables trimestrales suministrados,2015-08-01,1,2,27,17,0,47
PUCARA,"anticoncepcion, prevencion de its y de cancer de cuello uterino",numero de inyectables trimestrales suministrados,2015-08-01,0,0,13,5,0,18
PUCARANI,"anticoncepcion, prevencion de its y de cancer de cuello uterino",numero de inyectables trimestrales suministrados,2015-08-01,0,6,87,44,2,139
PUERTO ACOSTA,"anticoncepcion, prevencion de its y de cancer de cuello uterino",numero de inyectables trimestrales suministrados,2015-08-01,0,1,11,7,0,19
PUERTO CARABUCO,"anticoncepcion, prevencion de its y de cancer de cuello uterino",numero de inyectables trimestrales suministrados,2015-08-01,0,2,22,16,0,40
PUERTO GONZALO MORENO,"anticoncepcion, prevencion de its y de cancer de cuello uterino",numero de inyectables trimestrales suministrados,2015-08-01,1,5,23,3,0,32
PUERTO PEREZ,"anticoncepcion, prevencion de its y de cancer de cuello uterino",numero de inyectables trimestrales suministrados,2015-08-01,0,0,5,7,0,12
PUERTO QUIJARRO,"anticoncepcion, prevencion de its y de cancer de cuello uterino",numero de inyectables trimestrales suministrados,2015-08-01,0,6,16,4,0,26
PUERTO RICO,"anticoncepcion, prevencion de its y de cancer de cuello uterino",numero de inyectables trimestrales suministrados,2015-08-01,0,12,48,15,1,76
PUERTO SUAREZ,"anticoncepcion, prevencion de its y de cancer de cuello uterino",numero de inyectables trimestrales suministrados,2015-08-01,0,2,9,0,0,11
PUERTO VILLARROEL,"anticoncepcion, prevencion de its y de cancer de cuello uterino",numero de inyectables trimestrales suministrados,2015-08-01,0,12,82,24,2,120
PUNA,"anticoncepcion, prevencion de its y de cancer de cuello uterino",numero de inyectables trimestrales suministrados,2015-08-01,0,6,34,22,0,62
PUNATA,"anticoncepcion, prevencion de its y de cancer de cuello uterino",numero de inyectables trimestrales suministrados,2015-08-01,0,5,59,10,0,74
QUIABAYA,"anticoncepcion, prevencion de its y de cancer de cuello uterino",numero de inyectables trimestrales suministrados,2015-08-01,0,1,5,6,1,13
QUILLACOLLO,"anticoncepcion, prevencion de its y de cancer de cuello uterino",numero de inyectables trimestrales suministrados,2015-08-01,0,20,171,34,0,225
QUIME,"anticoncepcion, prevencion de its y de cancer de cuello uterino",numero de inyectables trimestrales suministrados,2015-08-01,0,5,25,6,1,37
QUIRUSILLAS,"anticoncepcion, prevencion de its y de cancer de cuello uterino",numero de inyectables trimestrales suministrados,2015-08-01,0,0,3,1,0,4
RAVELO,"anticoncepcion, prevencion de its y de cancer de cuello uterino",numero de inyectables trimestrales suministrados,2015-08-01,1,6,48,45,1,101
REYES,"anticoncepcion, prevencion de its y de cancer de cuello uterino",numero de inyectables trimestrales suministrados,2015-08-01,1,3,22,4,0,30
RIBERALTA,"anticoncepcion, prevencion de its y de cancer de cuello uterino",numero de inyectables trimestrales suministrados,2015-08-01,2,46,119,25,0,192
ROBORE,"anticoncepcion, prevencion de its y de cancer de cuello uterino",numero de inyectables trimestrales suministrados,2015-08-01,0,7,37,2,0,46
RURRENABAQUE,"anticoncepcion, prevencion de its y de cancer de cuello uterino",numero de inyectables trimestrales suministrados,2015-08-01,0,5,33,6,0,44
SABAYA,"anticoncepcion, prevencion de its y de cancer de cuello uterino",numero de inyectables trimestrales suministrados,2015-08-01,0,0,7,0,0,7
SACABA,"anticoncepcion, prevencion de its y de cancer de cuello uterino",numero de inyectables trimestrales suministrados,2015-08-01,0,31,154,40,0,225
SACABAMBA,"anticoncepcion, prevencion de its y de cancer de cuello uterino",numero de inyectables trimestrales suministrados,2015-08-01,0,1,8,7,0,16
SACACA,"anticoncepcion, prevencion de its y de cancer de cuello uterino",numero de inyectables trimestrales suministrados,2015-08-01,0,3,38,20,0,61
SAIPINA,"anticoncepcion, prevencion de its y de cancer de cuello uterino",numero de inyectables trimestrales suministrados,2015-08-01,0,5,15,7,0,27
SALINAS DE GARCI MENDOZA,"anticoncepcion, prevencion de its y de cancer de cuello uterino",numero de inyectables trimestrales suministrados,2015-08-01,0,0,20,7,0,27
SAMAIPATA,"anticoncepcion, prevencion de its y de cancer de cuello uterino",numero de inyectables trimestrales suministrados,2015-08-01,0,5,20,8,0,33
SAN AGUSTIN,"anticoncepcion, prevencion de its y de cancer de cuello uterino",numero de inyectables trimestrales suministrados,2015-08-01,0,1,11,3,0,15
SAN ANDRES,"anticoncepcion, prevencion de its y de cancer de cuello uterino",numero de inyectables trimestrales suministrados,2015-08-01,0,17,18,13,0,48
SAN ANDRES DE MACHACA,"anticoncepcion, prevencion de its y de cancer de cuello uterino",numero de inyectables trimestrales suministrados,2015-08-01,0,1,3,1,0,5
SAN ANTONIO DE ESMORUCO,"anticoncepcion, prevencion de its y de cancer de cuello uterino",numero de inyectables trimestrales suministrados,2015-08-01,0,1,6,1,0,8
SAN ANTONIO DE LOMERIO,"anticoncepcion, prevencion de its y de cancer de cuello uterino",numero de inyectables trimestrales suministrados,2015-08-01,1,4,36,23,1,65
SAN BENITO,"anticoncepcion, prevencion de its y de cancer de cuello uterino",numero de inyectables trimestrales suministrados,2015-08-01,0,5,22,14,0,41
SAN BORJA,"anticoncepcion, prevencion de its y de cancer de cuello uterino",numero de inyectables trimestrales suministrados,2015-08-01,1,22,111,40,0,174
SAN BUENA VENTURA,"anticoncepcion, prevencion de its y de cancer de cuello uterino",numero de inyectables trimestrales suministrados,2015-08-01,0,2,22,6,0,30
SAN CARLOS,"anticoncepcion, prevencion de its y de cancer de cuello uterino",numero de inyectables trimestrales suministrados,2015-08-01,0,12,44,17,1,74
SAN IGNACIO,"anticoncepcion, prevencion de its y de cancer de cuello uterino",numero de inyectables trimestrales suministrados,2015-08-01,0,20,90,19,1,130
SAN IGNACIO DE VELASCO,"anticoncepcion, prevencion de its y de cancer de cuello uterino",numero de inyectables trimestrales suministrados,2015-08-01,0,21,154,51,1,227
SAN JAVIER(BNI),"anticoncepcion, prevencion de its y de cancer de cuello uterino",numero de inyectables trimestrales suministrados,2015-08-01,0,2,11,0,0,13
SAN JAVIER(STC),"anticoncepcion, prevencion de its y de cancer de cuello uterino",numero de inyectables trimestrales suministrados,2015-08-01,2,8,31,11,0,52
SAN JOAQUIN,"anticoncepcion, prevencion de its y de cancer de cuello uterino",numero de inyectables trimestrales suministrados,2015-08-01,0,3,3,0,0,6
SAN JOSE DE CHIQUITOS,"anticoncepcion, prevencion de its y de cancer de cuello uterino",numero de inyectables trimestrales suministrados,2015-08-01,2,6,38,10,0,56
SAN JUAN DE YAPACANI,"anticoncepcion, prevencion de its y de cancer de cuello uterino",numero de inyectables trimestrales suministrados,2015-08-01,0,6,25,13,0,44
SAN JULIAN,"anticoncepcion, prevencion de its y de cancer de cuello uterino",numero de inyectables trimestrales suministrados,2015-08-01,0,15,49,31,0,95
SAN LORENZO(PND),"anticoncepcion, prevencion de its y de cancer de cuello uterino",numero de inyectables trimestrales suministrados,2015-08-01,0,4,11,5,0,20
SAN LORENZO(TJA),"anticoncepcion, prevencion de its y de cancer de cuello uterino",numero de inyectables trimestrales suministrados,2015-08-01,0,14,87,39,1,141
SAN LUCAS,"anticoncepcion, prevencion de its y de cancer de cuello uterino",numero de inyectables trimestrales suministrados,2015-08-01,0,11,57,60,0,128
SAN MATIAS,"anticoncepcion, prevencion de its y de cancer de cuello uterino",numero de inyectables trimestrales suministrados,2015-08-01,0,0,25,9,0,34
SAN MIGUEL DE VELASCO,"anticoncepcion, prevencion de its y de cancer de cuello uterino",numero de inyectables trimestrales suministrados,2015-08-01,0,5,37,21,1,64
SAN PABLO DE LIPEZ,"anticoncepcion, prevencion de its y de cancer de cuello uterino",numero de inyectables trimestrales suministrados,2015-08-01,0,0,6,0,0,6
SAN PEDRO,"anticoncepcion, prevencion de its y de cancer de cuello uterino",numero de inyectables trimestrales suministrados,2015-08-01,0,11,33,20,0,64
SAN PEDRO DE BUENA VISTA,"anticoncepcion, prevencion de its y de cancer de cuello uterino",numero de inyectables trimestrales suministrados,2015-08-01,0,8,52,33,0,93
SAN PEDRO DE CURAHUARA,"anticoncepcion, prevencion de its y de cancer de cuello uterino",numero de inyectables trimestrales suministrados,2015-08-01,0,0,5,6,0,11
SAN PEDRO DE QUEMES,"anticoncepcion, prevencion de its y de cancer de cuello uterino",numero de inyectables trimestrales suministrados,2015-08-01,0,0,2,1,0,3
SAN PEDRO DE TIQUINA,"anticoncepcion, prevencion de its y de cancer de cuello uterino",numero de inyectables trimestrales suministrados,2015-08-01,0,1,10,6,0,17
SAN PEDRO(PND),"anticoncepcion, prevencion de its y de cancer de cuello uterino",numero de inyectables trimestrales suministrados,2015-08-01,0,1,4,2,0,7
SAN RAFAEL,"anticoncepcion, prevencion de its y de cancer de cuello uterino",numero de inyectables trimestrales suministrados,2015-08-01,0,7,32,15,1,55
SAN RAMON BENI,"anticoncepcion, prevencion de its y de cancer de cuello uterino",numero de inyectables trimestrales suministrados,2015-08-01,1,3,6,0,0,10
SAN RAMON SCZ,"anticoncepcion, prevencion de its y de cancer de cuello uterino",numero de inyectables trimestrales suministrados,2015-08-01,0,18,34,7,0,59
SANTA ANA,"anticoncepcion, prevencion de its y de cancer de cuello uterino",numero de inyectables trimestrales suministrados,2015-08-01,1,2,21,2,0,26
SANTA CRUZ DE LA SIERRA,"anticoncepcion, prevencion de its y de cancer de cuello uterino",numero de inyectables trimestrales suministrados,2015-08-01,3,145,512,135,0,795
SANTA ROSA,"anticoncepcion, prevencion de its y de cancer de cuello uterino",numero de inyectables trimestrales suministrados,2015-08-01,0,3,1,2,0,6
SANTA ROSA DEL SARA,"anticoncepcion, prevencion de its y de cancer de cuello uterino",numero de inyectables trimestrales suministrados,2015-08-01,0,10,41,12,0,63
SANTIAGO DE CALLAPA,"anticoncepcion, prevencion de its y de cancer de cuello uterino",numero de inyectables trimestrales suministrados,2015-08-01,0,1,2,3,0,6
SANTIAGO DE HUARI,"anticoncepcion, prevencion de its y de cancer de cuello uterino",numero de inyectables trimestrales suministrados,2015-08-01,0,1,12,6,0,19
SANTIAGO DE HUATA,"anticoncepcion, prevencion de its y de cancer de cuello uterino",numero de inyectables trimestrales suministrados,2015-08-01,0,0,11,4,1,16
SANTIAGO DE MACHACA,"anticoncepcion, prevencion de its y de cancer de cuello uterino",numero de inyectables trimestrales suministrados,2015-08-01,0,1,5,7,0,13
SANTIVAÑES,"anticoncepcion, prevencion de its y de cancer de cuello uterino",numero de inyectables trimestrales suministrados,2015-08-01,0,2,30,9,0,41
SANTUARIO DE QUILLACAS,"anticoncepcion, prevencion de its y de cancer de cuello uterino",numero de inyectables trimestrales suministrados,2015-08-01,0,1,10,3,0,14
SAPAHAQUI,"anticoncepcion, prevencion de its y de cancer de cuello uterino",numero de inyectables trimestrales suministrados,2015-08-01,0,2,23,13,0,38
SENA,"anticoncepcion, prevencion de its y de cancer de cuello uterino",numero de inyectables trimestrales suministrados,2015-08-01,0,5,14,2,0,21
SHINAOTA,"anticoncepcion, prevencion de its y de cancer de cuello uterino",numero de inyectables trimestrales suministrados,2015-08-01,0,11,44,15,0,70
SICA SICA (VILLA AROMA),"anticoncepcion, prevencion de its y de cancer de cuello uterino",numero de inyectables trimestrales suministrados,2015-08-01,0,3,38,24,1,66
SICAYA,"anticoncepcion, prevencion de its y de cancer de cuello uterino",numero de inyectables trimestrales suministrados,2015-08-01,0,1,15,6,0,22
SIPE SIPE,"anticoncepcion, prevencion de its y de cancer de cuello uterino",numero de inyectables trimestrales suministrados,2015-08-01,0,19,151,57,1,228
SOPACHUY,"anticoncepcion, prevencion de its y de cancer de cuello uterino",numero de inyectables trimestrales suministrados,2015-08-01,0,3,28,16,1,48
SORACACHI,"anticoncepcion, prevencion de its y de cancer de cuello uterino",numero de inyectables trimestrales suministrados,2015-08-01,0,0,17,8,0,25
SORATA,"anticoncepcion, prevencion de its y de cancer de cuello uterino",numero de inyectables trimestrales suministrados,2015-08-01,0,3,43,18,0,64
SUCRE,"anticoncepcion, prevencion de its y de cancer de cuello uterino",numero de inyectables trimestrales suministrados,2015-08-01,0,93,516,179,3,791
TACACHI,"anticoncepcion, prevencion de its y de cancer de cuello uterino",numero de inyectables trimestrales suministrados,2015-08-01,0,1,1,1,0,3
TACACOMA,"anticoncepcion, prevencion de its y de cancer de cuello uterino",numero de inyectables trimestrales suministrados,2015-08-01,0,7,36,10,0,53
TACOBAMBA,"anticoncepcion, prevencion de its y de cancer de cuello uterino",numero de inyectables trimestrales suministrados,2015-08-01,0,4,14,8,1,27
TACOPAYA,"anticoncepcion, prevencion de its y de cancer de cuello uterino",numero de inyectables trimestrales suministrados,2015-08-01,1,0,22,9,0,32
TAHUA,"anticoncepcion, prevencion de its y de cancer de cuello uterino",numero de inyectables trimestrales suministrados,2015-08-01,0,0,2,6,0,8
TAPACARI,"anticoncepcion, prevencion de its y de cancer de cuello uterino",numero de inyectables trimestrales suministrados,2015-08-01,0,6,52,38,0,96
TARABUCO,"anticoncepcion, prevencion de its y de cancer de cuello uterino",numero de inyectables trimestrales suministrados,2015-08-01,0,3,30,20,0,53
TARACO,"anticoncepcion, prevencion de its y de cancer de cuello uterino",numero de inyectables trimestrales suministrados,2015-08-01,0,0,11,14,1,26
TARATA,"anticoncepcion, prevencion de its y de cancer de cuello uterino",numero de inyectables trimestrales suministrados,2015-08-01,0,0,3,2,0,5
TARIJA,"anticoncepcion, prevencion de its y de cancer de cuello uterino",numero de inyectables trimestrales suministrados,2015-08-01,1,49,221,70,1,342
TARVITA,"anticoncepcion, prevencion de its y de cancer de cuello uterino",numero de inyectables trimestrales suministrados,2015-08-01,0,10,38,30,0,78
TEOPONTE,"anticoncepcion, prevencion de its y de cancer de cuello uterino",numero de inyectables trimestrales suministrados,2015-08-01,0,6,15,10,0,31
TIAWANACU,"anticoncepcion, prevencion de its y de cancer de cuello uterino",numero de inyectables trimestrales suministrados,2015-08-01,0,2,28,17,0,47
TINGUIPAYA,"anticoncepcion, prevencion de its y de cancer de cuello uterino",numero de inyectables trimestrales suministrados,2015-08-01,0,1,16,13,0,30
TIPUANI,"anticoncepcion, prevencion de its y de cancer de cuello uterino",numero de inyectables trimestrales suministrados,2015-08-01,0,2,15,7,0,24
TIQUIPAYA,"anticoncepcion, prevencion de its y de cancer de cuello uterino",numero de inyectables trimestrales suministrados,2015-08-01,0,16,123,22,0,161
TIRAQUE (CBBA),"anticoncepcion, prevencion de its y de cancer de cuello uterino",numero de inyectables trimestrales suministrados,2015-08-01,0,4,55,32,0,91
TITO YUPANQUI (PARQUIPUJIO),"anticoncepcion, prevencion de its y de cancer de cuello uterino",numero de inyectables trimestrales suministrados,2015-08-01,0,0,1,1,0,2
TOCO,"anticoncepcion, prevencion de its y de cancer de cuello uterino",numero de inyectables trimestrales suministrados,2015-08-01,0,1,16,13,1,31
TODOS SANTOS,"anticoncepcion, prevencion de its y de cancer de cuello uterino",numero de inyectables trimestrales suministrados,2015-08-01,0,1,0,0,0,1
TOLATA,"anticoncepcion, prevencion de its y de cancer de cuello uterino",numero de inyectables trimestrales suministrados,2015-08-01,0,1,11,7,0,19
TOLEDO,"anticoncepcion, prevencion de its y de cancer de cuello uterino",numero de inyectables trimestrales suministrados,2015-08-01,0,0,9,4,0,13
TOMAVE,"anticoncepcion, prevencion de its y de cancer de cuello uterino",numero de inyectables trimestrales suministrados,2015-08-01,0,0,18,15,0,33
TOMINA,"anticoncepcion, prevencion de its y de cancer de cuello uterino",numero de inyectables trimestrales suministrados,2015-08-01,0,9,49,38,0,96
TORO TORO,"anticoncepcion, prevencion de its y de cancer de cuello uterino",numero de inyectables trimestrales suministrados,2015-08-01,0,1,28,20,0,49
TOTORA(CBBA),"anticoncepcion, prevencion de its y de cancer de cuello uterino",numero de inyectables trimestrales suministrados,2015-08-01,0,19,54,26,55,154
TOTORA(ORR),"anticoncepcion, prevencion de its y de cancer de cuello uterino",numero de inyectables trimestrales suministrados,2015-08-01,0,2,11,0,0,13
TRIGAL,"anticoncepcion, prevencion de its y de cancer de cuello uterino",numero de inyectables trimestrales suministrados,2015-08-01,0,1,4,4,0,9
TRINIDAD,"anticoncepcion, prevencion de its y de cancer de cuello uterino",numero de inyectables trimestrales suministrados,2015-08-01,0,12,26,4,0,42
TUPIZA,"anticoncepcion, prevencion de its y de cancer de cuello uterino",numero de inyectables trimestrales suministrados,2015-08-01,0,13,121,58,1,193
TURCO,"anticoncepcion, prevencion de its y de cancer de cuello uterino",numero de inyectables trimestrales suministrados,2015-08-01,0,1,5,2,0,8
UMALA,"anticoncepcion, prevencion de its y de cancer de cuello uterino",numero de inyectables trimestrales suministrados,2015-08-01,0,5,12,7,0,24
UNCIA,"anticoncepcion, prevencion de its y de cancer de cuello uterino",numero de inyectables trimestrales suministrados,2015-08-01,0,6,31,27,0,64
URIONDO (A. CONCEPCION),"anticoncepcion, prevencion de its y de cancer de cuello uterino",numero de inyectables trimestrales suministrados,2015-08-01,0,12,67,40,3,122
URUBICHA,"anticoncepcion, prevencion de its y de cancer de cuello uterino",numero de inyectables trimestrales suministrados,2015-08-01,0,0,4,7,0,11
UYUNI,"anticoncepcion, prevencion de its y de cancer de cuello uterino",numero de inyectables trimestrales suministrados,2015-08-01,0,6,40,14,0,60
VACAS,"anticoncepcion, prevencion de its y de cancer de cuello uterino",numero de inyectables trimestrales suministrados,2015-08-01,0,8,19,25,0,52
VALLEGRANDE,"anticoncepcion, prevencion de its y de cancer de cuello uterino",numero de inyectables trimestrales suministrados,2015-08-01,0,11,41,9,0,61
VIACHA,"anticoncepcion, prevencion de its y de cancer de cuello uterino",numero de inyectables trimestrales suministrados,2015-08-01,3,73,141,45,0,262
VILA VILA,"anticoncepcion, prevencion de its y de cancer de cuello uterino",numero de inyectables trimestrales suministrados,2015-08-01,0,2,3,3,0,8
VILLA CHARCAS,"anticoncepcion, prevencion de its y de cancer de cuello uterino",numero de inyectables trimestrales suministrados,2015-08-01,0,11,37,32,2,82
VILLA MONTES,"anticoncepcion, prevencion de its y de cancer de cuello uterino",numero de inyectables trimestrales suministrados,2015-08-01,0,27,95,29,0,151
VILLA NUEVA (LOMA ALTA),"anticoncepcion, prevencion de its y de cancer de cuello uterino",numero de inyectables trimestrales suministrados,2015-08-01,0,9,7,0,0,16
VILLA RIVERO,"anticoncepcion, prevencion de its y de cancer de cuello uterino",numero de inyectables trimestrales suministrados,2015-08-01,0,9,42,18,0,69
VILLA SERRANO,"anticoncepcion, prevencion de its y de cancer de cuello uterino",numero de inyectables trimestrales suministrados,2015-08-01,1,6,23,28,0,58
VILLA TUNARI,"anticoncepcion, prevencion de its y de cancer de cuello uterino",numero de inyectables trimestrales suministrados,2015-08-01,2,48,299,89,2,440
VILLA VACA GUZMAN (MUYUPAMPA),"anticoncepcion, prevencion de its y de cancer de cuello uterino",numero de inyectables trimestrales suministrados,2015-08-01,0,8,42,23,2,75
VILLAZON,"anticoncepcion, prevencion de its y de cancer de cuello uterino",numero de inyectables trimestrales suministrados,2015-08-01,0,13,129,48,0,190
VINTO,"anticoncepcion, prevencion de its y de cancer de cuello uterino",numero de inyectables trimestrales suministrados,2015-08-01,1,17,54,12,0,84
VITICHI,"anticoncepcion, prevencion de its y de cancer de cuello uterino",numero de inyectables trimestrales suministrados,2015-08-01,0,1,15,14,0,30
WALDO BALLIVIAN,"anticoncepcion, prevencion de its y de cancer de cuello uterino",numero de inyectables trimestrales suministrados,2015-08-01,0,0,8,3,0,11
WARNES,"anticoncepcion, prevencion de its y de cancer de cuello uterino",numero de inyectables trimestrales suministrados,2015-08-01,3,49,149,44,1,246
YACO,"anticoncepcion, prevencion de its y de cancer de cuello uterino",numero de inyectables trimestrales suministrados,2015-08-01,0,1,11,7,0,19
YACUIBA,"anticoncepcion, prevencion de its y de cancer de cuello uterino",numero de inyectables trimestrales suministrados,2015-08-01,1,36,183,92,2,314
YAMPARAEZ,"anticoncepcion, prevencion de its y de cancer de cuello uterino",numero de inyectables trimestrales suministrados,2015-08-01,0,2,4,4,0,10
YANACACHI,"anticoncepcion, prevencion de its y de cancer de cuello uterino",numero de inyectables trimestrales suministrados,2015-08-01,0,0,9,3,0,12
YAPACANI,"anticoncepcion, prevencion de its y de cancer de cuello uterino",numero de inyectables trimestrales suministrados,2015-08-01,0,12,61,17,2,92
YOCALLA,"anticoncepcion, prevencion de its y de cancer de cuello uterino",numero de inyectables trimestrales suministrados,2015-08-01,0,0,16,5,0,21
YOTALA,"anticoncepcion, prevencion de its y de cancer de cuello uterino",numero de inyectables trimestrales suministrados,2015-08-01,0,0,6,10,0,16
YUNCHARA,"anticoncepcion, prevencion de its y de cancer de cuello uterino",numero de inyectables trimestrales suministrados,2015-08-01,0,6,39,22,0,67
ZUDAÑEZ,"anticoncepcion, prevencion de its y de cancer de cuello uterino",numero de inyectables trimestrales suministrados,2015-08-01,0,3,36,12,1,52
ACACIO,"anticoncepcion, prevencion de its y de cancer de cuello uterino",numero de inyectables trimestrales suministrados,2015-09-01,0,2,14,5,0,21
ACHACACHI,"anticoncepcion, prevencion de its y de cancer de cuello uterino",numero de inyectables trimestrales suministrados,2015-09-01,0,9,70,35,0,114
ACHOCALLA,"anticoncepcion, prevencion de its y de cancer de cuello uterino",numero de inyectables trimestrales suministrados,2015-09-01,0,1,50,27,0,78
AIQUILE,"anticoncepcion, prevencion de its y de cancer de cuello uterino",numero de inyectables trimestrales suministrados,2015-09-01,0,3,37,26,1,67
ALALAY,"anticoncepcion, prevencion de its y de cancer de cuello uterino",numero de inyectables trimestrales suministrados,2015-09-01,0,1,3,2,0,6
ALCALA,"anticoncepcion, prevencion de its y de cancer de cuello uterino",numero de inyectables trimestrales suministrados,2015-09-01,0,0,13,13,2,28
ALTO BENI,"anticoncepcion, prevencion de its y de cancer de cuello uterino",numero de inyectables trimestrales suministrados,2015-09-01,0,0,32,21,1,54
ANCORAIMES,"anticoncepcion, prevencion de its y de cancer de cuello uterino",numero de inyectables trimestrales suministrados,2015-09-01,0,2,12,9,0,23
ANDAMARCA,"anticoncepcion, prevencion de its y de cancer de cuello uterino",numero de inyectables trimestrales suministrados,2015-09-01,0,0,8,2,0,10
ANTEQUERA,"anticoncepcion, prevencion de its y de cancer de cuello uterino",numero de inyectables trimestrales suministrados,2015-09-01,0,0,3,6,0,9
ANZALDO,"anticoncepcion, prevencion de its y de cancer de cuello uterino",numero de inyectables trimestrales suministrados,2015-09-01,0,2,14,12,0,28
APOLO,"anticoncepcion, prevencion de its y de cancer de cuello uterino",numero de inyectables trimestrales suministrados,2015-09-01,0,4,30,30,2,66
ARAMPAMPA,"anticoncepcion, prevencion de its y de cancer de cuello uterino",numero de inyectables trimestrales suministrados,2015-09-01,0,1,11,5,0,17
ARANI,"anticoncepcion, prevencion de its y de cancer de cuello uterino",numero de inyectables trimestrales suministrados,2015-09-01,0,1,9,2,0,12
ARBIETO,"anticoncepcion, prevencion de its y de cancer de cuello uterino",numero de inyectables trimestrales suministrados,2015-09-01,0,8,51,13,0,72
ARQUE,"anticoncepcion, prevencion de its y de cancer de cuello uterino",numero de inyectables trimestrales suministrados,2015-09-01,0,8,31,31,3,73
ASCENCION DE GUARAYOS,"anticoncepcion, prevencion de its y de cancer de cuello uterino",numero de inyectables trimestrales suministrados,2015-09-01,0,10,30,8,0,48
ATOCHA,"anticoncepcion, prevencion de its y de cancer de cuello uterino",numero de inyectables trimestrales suministrados,2015-09-01,0,0,55,17,0,72
AUCAPATA,"anticoncepcion, prevencion de its y de cancer de cuello uterino",numero de inyectables trimestrales suministrados,2015-09-01,0,4,17,8,0,29
AYATA,"anticoncepcion, prevencion de its y de cancer de cuello uterino",numero de inyectables trimestrales suministrados,2015-09-01,0,2,22,24,0,48
AYO AYO,"anticoncepcion, prevencion de its y de cancer de cuello uterino",numero de inyectables trimestrales suministrados,2015-09-01,0,2,27,6,0,35
AYOPAYA (V. DE INDEPENDENCIA),"anticoncepcion, prevencion de its y de cancer de cuello uterino",numero de inyectables trimestrales suministrados,2015-09-01,0,12,79,57,0,148
AZURDUY,"anticoncepcion, prevencion de its y de cancer de cuello uterino",numero de inyectables trimestrales suministrados,2015-09-01,0,8,37,30,0,75
BATALLAS,"anticoncepcion, prevencion de its y de cancer de cuello uterino",numero de inyectables trimestrales suministrados,2015-09-01,0,1,26,14,0,41
BAURES,"anticoncepcion, prevencion de its y de cancer de cuello uterino",numero de inyectables trimestrales suministrados,2015-09-01,0,0,5,0,0,5
BELEN DE ANDAMARCA,"anticoncepcion, prevencion de its y de cancer de cuello uterino",numero de inyectables trimestrales suministrados,2015-09-01,0,0,5,5,0,10
BELEN DE URMIRI,"anticoncepcion, prevencion de its y de cancer de cuello uterino",numero de inyectables trimestrales suministrados,2015-09-01,0,0,0,3,0,3
BELLA FLOR,"anticoncepcion, prevencion de its y de cancer de cuello uterino",numero de inyectables trimestrales suministrados,2015-09-01,1,3,5,3,0,12
BERMEJO,"anticoncepcion, prevencion de its y de cancer de cuello uterino",numero de inyectables trimestrales suministrados,2015-09-01,1,27,83,26,1,138
BETANZOS,"anticoncepcion, prevencion de its y de cancer de cuello uterino",numero de inyectables trimestrales suministrados,2015-09-01,0,4,55,55,0,114
BOLIVAR,"anticoncepcion, prevencion de its y de cancer de cuello uterino",numero de inyectables trimestrales suministrados,2015-09-01,0,0,10,8,0,18
BOLPEBRA,"anticoncepcion, prevencion de its y de cancer de cuello uterino",numero de inyectables trimestrales suministrados,2015-09-01,0,0,0,2,0,2
BOYUIBE,"anticoncepcion, prevencion de its y de cancer de cuello uterino",numero de inyectables trimestrales suministrados,2015-09-01,0,1,10,9,0,20
BUENA VISTA,"anticoncepcion, prevencion de its y de cancer de cuello uterino",numero de inyectables trimestrales suministrados,2015-09-01,0,8,21,14,0,43
CABEZAS,"anticoncepcion, prevencion de its y de cancer de cuello uterino",numero de inyectables trimestrales suministrados,2015-09-01,0,30,109,28,7,174
CAIROMA,"anticoncepcion, prevencion de its y de cancer de cuello uterino",numero de inyectables trimestrales suministrados,2015-09-01,0,1,17,6,0,24
"CAIZA ""D""","anticoncepcion, prevencion de its y de cancer de cuello uterino",numero de inyectables trimestrales suministrados,2015-09-01,0,1,24,15,0,40
CAJUATA,"anticoncepcion, prevencion de its y de cancer de cuello uterino",numero de inyectables trimestrales suministrados,2015-09-01,1,8,33,19,0,61
CALACOTO,"anticoncepcion, prevencion de its y de cancer de cuello uterino",numero de inyectables trimestrales suministrados,2015-09-01,0,0,4,3,2,9
CALAMARCA,"anticoncepcion, prevencion de its y de cancer de cuello uterino",numero de inyectables trimestrales suministrados,2015-09-01,0,3,39,12,1,55
CAMARGO,"anticoncepcion, prevencion de its y de cancer de cuello uterino",numero de inyectables trimestrales suministrados,2015-09-01,0,1,29,19,0,49
CAMATAQUI (C. VILLA ABECIA),"anticoncepcion, prevencion de its y de cancer de cuello uterino",numero de inyectables trimestrales suministrados,2015-09-01,0,1,8,13,0,22
CAMIRI,"anticoncepcion, prevencion de its y de cancer de cuello uterino",numero de inyectables trimestrales suministrados,2015-09-01,0,5,36,22,0,63
CAPINOTA,"anticoncepcion, prevencion de its y de cancer de cuello uterino",numero de inyectables trimestrales suministrados,2015-09-01,0,9,43,27,0,79
CAQUIAVIRI,"anticoncepcion, prevencion de its y de cancer de cuello uterino",numero de inyectables trimestrales suministrados,2015-09-01,0,0,6,3,0,9
CARACOLLO,"anticoncepcion, prevencion de its y de cancer de cuello uterino",numero de inyectables trimestrales suministrados,2015-09-01,0,1,30,25,0,56
CARANAVI,"anticoncepcion, prevencion de its y de cancer de cuello uterino",numero de inyectables trimestrales suministrados,2015-09-01,0,13,86,41,2,142
CARANGAS,"anticoncepcion, prevencion de its y de cancer de cuello uterino",numero de inyectables trimestrales suministrados,2015-09-01,0,0,1,2,0,3
CARAPARI,"anticoncepcion, prevencion de its y de cancer de cuello uterino",numero de inyectables trimestrales suministrados,2015-09-01,1,13,63,21,0,98
CARIPUYO,"anticoncepcion, prevencion de its y de cancer de cuello uterino",numero de inyectables trimestrales suministrados,2015-09-01,0,5,15,10,1,31
CARMEN RIVERO TORREZ,"anticoncepcion, prevencion de its y de cancer de cuello uterino",numero de inyectables trimestrales suministrados,2015-09-01,0,1,8,2,0,11
CATACORA,"anticoncepcion, prevencion de its y de cancer de cuello uterino",numero de inyectables trimestrales suministrados,2015-09-01,0,2,1,3,0,6
CHACARILLA,"anticoncepcion, prevencion de its y de cancer de cuello uterino",numero de inyectables trimestrales suministrados,2015-09-01,0,0,4,1,0,5
CHALLAPATA,"anticoncepcion, prevencion de its y de cancer de cuello uterino",numero de inyectables trimestrales suministrados,2015-09-01,0,5,48,17,1,71
CHAQUI,"anticoncepcion, prevencion de its y de cancer de cuello uterino",numero de inyectables trimestrales suministrados,2015-09-01,0,2,24,12,0,38
CHARAGUA,"anticoncepcion, prevencion de its y de cancer de cuello uterino",numero de inyectables trimestrales suministrados,2015-09-01,0,3,39,13,0,55
CHARAÑA,"anticoncepcion, prevencion de its y de cancer de cuello uterino",numero de inyectables trimestrales suministrados,2015-09-01,0,0,4,3,0,7
CHAYANTA,"anticoncepcion, prevencion de its y de cancer de cuello uterino",numero de inyectables trimestrales suministrados,2015-09-01,0,4,48,28,0,80
CHIMORE,"anticoncepcion, prevencion de its y de cancer de cuello uterino",numero de inyectables trimestrales suministrados,2015-09-01,0,13,72,18,0,103
CHIPAYA,"anticoncepcion, prevencion de its y de cancer de cuello uterino",numero de inyectables trimestrales suministrados,2015-09-01,1,4,12,4,0,21
CHOQUE COTA,"anticoncepcion, prevencion de its y de cancer de cuello uterino",numero de inyectables trimestrales suministrados,2015-09-01,0,0,1,2,0,3
CHUA COCANI,"anticoncepcion, prevencion de its y de cancer de cuello uterino",numero de inyectables trimestrales suministrados,2015-09-01,0,1,2,3,0,6
CHULUMANI (V. DE LA LIBERTAD),"anticoncepcion, prevencion de its y de cancer de cuello uterino",numero de inyectables trimestrales suministrados,2015-09-01,0,4,36,8,0,48
CHUMA,"anticoncepcion, prevencion de its y de cancer de cuello uterino",numero de inyectables trimestrales suministrados,2015-09-01,0,4,25,25,0,54
CHUQUIHUTA AYLLU JUCUMANI,"anticoncepcion, prevencion de its y de cancer de cuello uterino",numero de inyectables trimestrales suministrados,2015-09-01,0,1,11,3,0,15
CKOCHAS,"anticoncepcion, prevencion de its y de cancer de cuello uterino",numero de inyectables trimestrales suministrados,2015-09-01,0,3,24,31,0,58
CLIZA,"anticoncepcion, prevencion de its y de cancer de cuello uterino",numero de inyectables trimestrales suministrados,2015-09-01,0,8,35,16,1,60
COBIJA,"anticoncepcion, prevencion de its y de cancer de cuello uterino",numero de inyectables trimestrales suministrados,2015-09-01,2,32,111,34,0,179
COCAPATA,"anticoncepcion, prevencion de its y de cancer de cuello uterino",numero de inyectables trimestrales suministrados,2015-09-01,0,6,41,34,0,81
COCHABAMBA,"anticoncepcion, prevencion de its y de cancer de cuello uterino",numero de inyectables trimestrales suministrados,2015-09-01,0,45,421,105,2,573
COIPASA,"anticoncepcion, prevencion de its y de cancer de cuello uterino",numero de inyectables trimestrales suministrados,2015-09-01,0,0,3,0,0,3
COLCAPIRHUA,"anticoncepcion, prevencion de its y de cancer de cuello uterino",numero de inyectables trimestrales suministrados,2015-09-01,0,5,64,10,0,79
"COLCHA ""K""","anticoncepcion, prevencion de its y de cancer de cuello uterino",numero de inyectables trimestrales suministrados,2015-09-01,0,7,44,22,0,73
COLLANA,"anticoncepcion, prevencion de its y de cancer de cuello uterino",numero de inyectables trimestrales suministrados,2015-09-01,0,1,10,6,0,17
COLOMI,"anticoncepcion, prevencion de its y de cancer de cuello uterino",numero de inyectables trimestrales suministrados,2015-09-01,0,11,66,20,0,97
COLPA BELGICA,"anticoncepcion, prevencion de its y de cancer de cuello uterino",numero de inyectables trimestrales suministrados,2015-09-01,0,2,14,2,0,18
COLQUECHACA,"anticoncepcion, prevencion de its y de cancer de cuello uterino",numero de inyectables trimestrales suministrados,2015-09-01,0,3,51,33,0,87
COLQUENCHA,"anticoncepcion, prevencion de its y de cancer de cuello uterino",numero de inyectables trimestrales suministrados,2015-09-01,0,1,27,21,0,49
COLQUIRI,"anticoncepcion, prevencion de its y de cancer de cuello uterino",numero de inyectables trimestrales suministrados,2015-09-01,1,3,36,14,1,55
COMANCHE,"anticoncepcion, prevencion de its y de cancer de cuello uterino",numero de inyectables trimestrales suministrados,2015-09-01,0,1,2,0,0,3
COMARAPA,"anticoncepcion, prevencion de its y de cancer de cuello uterino",numero de inyectables trimestrales suministrados,2015-09-01,0,18,93,35,0,146
COMBAYA,"anticoncepcion, prevencion de its y de cancer de cuello uterino",numero de inyectables trimestrales suministrados,2015-09-01,0,1,1,1,0,3
CONCEPCION,"anticoncepcion, prevencion de its y de cancer de cuello uterino",numero de inyectables trimestrales suministrados,2015-09-01,0,7,46,5,0,58
COPACABANA,"anticoncepcion, prevencion de its y de cancer de cuello uterino",numero de inyectables trimestrales suministrados,2015-09-01,0,2,38,16,0,56
CORIPATA,"anticoncepcion, prevencion de its y de cancer de cuello uterino",numero de inyectables trimestrales suministrados,2015-09-01,0,0,49,23,0,72
CORO CORO,"anticoncepcion, prevencion de its y de cancer de cuello uterino",numero de inyectables trimestrales suministrados,2015-09-01,0,1,18,11,0,30
COROICO,"anticoncepcion, prevencion de its y de cancer de cuello uterino",numero de inyectables trimestrales suministrados,2015-09-01,0,2,17,5,1,25
CORQUE,"anticoncepcion, prevencion de its y de cancer de cuello uterino",numero de inyectables trimestrales suministrados,2015-09-01,0,3,12,4,0,19
COTAGAITA,"anticoncepcion, prevencion de its y de cancer de cuello uterino",numero de inyectables trimestrales suministrados,2015-09-01,0,3,81,35,0,119
COTOCA,"anticoncepcion, prevencion de its y de cancer de cuello uterino",numero de inyectables trimestrales suministrados,2015-09-01,1,28,108,31,0,168
CUATRO CAÑADAS,"anticoncepcion, prevencion de its y de cancer de cuello uterino",numero de inyectables trimestrales suministrados,2015-09-01,1,14,44,17,0,76
CUCHUMUELA (V. G. VILLARROEL),"anticoncepcion, prevencion de its y de cancer de cuello uterino",numero de inyectables trimestrales suministrados,2015-09-01,0,0,9,7,0,16
CUEVO,"anticoncepcion, prevencion de its y de cancer de cuello uterino",numero de inyectables trimestrales suministrados,2015-09-01,0,0,20,9,0,29
CULPINA,"anticoncepcion, prevencion de its y de cancer de cuello uterino",numero de inyectables trimestrales suministrados,2015-09-01,0,9,44,39,1,93
CURAHUARA DE CARANGAS,"anticoncepcion, prevencion de its y de cancer de cuello uterino",numero de inyectables trimestrales suministrados,2015-09-01,0,2,11,5,0,18
CURVA,"anticoncepcion, prevencion de its y de cancer de cuello uterino",numero de inyectables trimestrales suministrados,2015-09-01,0,0,0,1,0,1
DESAGUADERO,"anticoncepcion, prevencion de its y de cancer de cuello uterino",numero de inyectables trimestrales suministrados,2015-09-01,0,0,6,2,0,8
EL ALTO,"anticoncepcion, prevencion de its y de cancer de cuello uterino",numero de inyectables trimestrales suministrados,2015-09-01,1,100,981,382,3,1467
EL CHORO,"anticoncepcion, prevencion de its y de cancer de cuello uterino",numero de inyectables trimestrales suministrados,2015-09-01,0,0,7,4,0,11
EL PUENTE(STC),"anticoncepcion, prevencion de its y de cancer de cuello uterino",numero de inyectables trimestrales suministrados,2015-09-01,1,7,49,26,0,83
EL PUENTE(TJA),"anticoncepcion, prevencion de its y de cancer de cuello uterino",numero de inyectables trimestrales suministrados,2015-09-01,0,5,54,32,1,92
EL TORNO,"anticoncepcion, prevencion de its y de cancer de cuello uterino",numero de inyectables trimestrales suministrados,2015-09-01,6,30,95,31,1,163
EL VILLAR,"anticoncepcion, prevencion de its y de cancer de cuello uterino",numero de inyectables trimestrales suministrados,2015-09-01,0,5,14,24,0,43
ENTRE RIOS TRJ,"anticoncepcion, prevencion de its y de cancer de cuello uterino",numero de inyectables trimestrales suministrados,2015-09-01,1,18,82,50,1,152
ENTRE RIOS CBBA,"anticoncepcion, prevencion de its y de cancer de cuello uterino",numero de inyectables trimestrales suministrados,2015-09-01,0,8,60,25,0,93
ESCOMA,"anticoncepcion, prevencion de its y de cancer de cuello uterino",numero de inyectables trimestrales suministrados,2015-09-01,0,1,2,1,0,4
EUCALIPTUS,"anticoncepcion, prevencion de its y de cancer de cuello uterino",numero de inyectables trimestrales suministrados,2015-09-01,0,1,8,4,0,13
EUREKA (SANTOS MERCADO),"anticoncepcion, prevencion de its y de cancer de cuello uterino",numero de inyectables trimestrales suministrados,2015-09-01,1,0,6,1,0,8
EXALTACION,"anticoncepcion, prevencion de its y de cancer de cuello uterino",numero de inyectables trimestrales suministrados,2015-09-01,0,0,2,0,0,2
FERNANDEZ ALONSO,"anticoncepcion, prevencion de its y de cancer de cuello uterino",numero de inyectables trimestrales suministrados,2015-09-01,0,8,48,18,1,75
FILADELFIA,"anticoncepcion, prevencion de its y de cancer de cuello uterino",numero de inyectables trimestrales suministrados,2015-09-01,0,2,8,1,0,11
GENERAL SAAVEDRA,"anticoncepcion, prevencion de its y de cancer de cuello uterino",numero de inyectables trimestrales suministrados,2015-09-01,0,17,44,15,1,77
GRAL. J.J. PEREZ (CHARAZANI),"anticoncepcion, prevencion de its y de cancer de cuello uterino",numero de inyectables trimestrales suministrados,2015-09-01,0,1,10,8,0,19
GUANAY,"anticoncepcion, prevencion de its y de cancer de cuello uterino",numero de inyectables trimestrales suministrados,2015-09-01,0,4,11,5,0,20
GUAQUI,"anticoncepcion, prevencion de its y de cancer de cuello uterino",numero de inyectables trimestrales suministrados,2015-09-01,0,1,8,9,1,19
GUAYARAMERIN,"anticoncepcion, prevencion de its y de cancer de cuello uterino",numero de inyectables trimestrales suministrados,2015-09-01,0,5,17,3,0,25
GUTIERREZ,"anticoncepcion, prevencion de its y de cancer de cuello uterino",numero de inyectables trimestrales suministrados,2015-09-01,0,7,22,12,0,41
HUACARETA,"anticoncepcion, prevencion de its y de cancer de cuello uterino",numero de inyectables trimestrales suministrados,2015-09-01,0,5,19,22,0,46
HUACAYA (VILLA DE HUACAYA),"anticoncepcion, prevencion de its y de cancer de cuello uterino",numero de inyectables trimestrales suministrados,2015-09-01,0,0,12,4,0,16
HUACHACALLA,"anticoncepcion, prevencion de its y de cancer de cuello uterino",numero de inyectables trimestrales suministrados,2015-09-01,0,0,1,1,0,2
HUANUNI,"anticoncepcion, prevencion de its y de cancer de cuello uterino",numero de inyectables trimestrales suministrados,2015-09-01,0,3,35,7,0,45
HUARACAJE,"anticoncepcion, prevencion de its y de cancer de cuello uterino",numero de inyectables trimestrales suministrados,2015-09-01,0,3,5,3,0,11
HUARINA,"anticoncepcion, prevencion de its y de cancer de cuello uterino",numero de inyectables trimestrales suministrados,2015-09-01,0,2,7,4,0,13
HUATAJATA,"anticoncepcion, prevencion de its y de cancer de cuello uterino",numero de inyectables trimestrales suministrados,2015-09-01,0,0,2,2,0,4
HUAYLLAMARCA,"anticoncepcion, prevencion de its y de cancer de cuello uterino",numero de inyectables trimestrales suministrados,2015-09-01,0,3,11,11,0,25
HUMANATA,"anticoncepcion, prevencion de its y de cancer de cuello uterino",numero de inyectables trimestrales suministrados,2015-09-01,0,1,3,4,1,9
ICHOCA,"anticoncepcion, prevencion de its y de cancer de cuello uterino",numero de inyectables trimestrales suministrados,2015-09-01,0,1,5,2,0,8
ICLA,"anticoncepcion, prevencion de its y de cancer de cuello uterino",numero de inyectables trimestrales suministrados,2015-09-01,0,2,12,15,0,29
INCAHUASI,"anticoncepcion, prevencion de its y de cancer de cuello uterino",numero de inyectables trimestrales suministrados,2015-09-01,1,3,26,21,0,51
INGAVI (HUMAITA),"anticoncepcion, prevencion de its y de cancer de cuello uterino",numero de inyectables trimestrales suministrados,2015-09-01,0,0,11,0,0,11
INQUISIVI,"anticoncepcion, prevencion de its y de cancer de cuello uterino",numero de inyectables trimestrales suministrados,2015-09-01,0,1,23,22,0,46
IRUPANA (VILLA DE LANZA),"anticoncepcion, prevencion de its y de cancer de cuello uterino",numero de inyectables trimestrales suministrados,2015-09-01,0,5,49,30,0,84
IXIAMAS,"anticoncepcion, prevencion de its y de cancer de cuello uterino",numero de inyectables trimestrales suministrados,2015-09-01,0,1,25,14,0,40
JESUS DE MACHACA,"anticoncepcion, prevencion de its y de cancer de cuello uterino",numero de inyectables trimestrales suministrados,2015-09-01,0,3,17,13,1,34
LA ASUNTA,"anticoncepcion, prevencion de its y de cancer de cuello uterino",numero de inyectables trimestrales suministrados,2015-09-01,0,9,124,34,0,167
LA GUARDIA,"anticoncepcion, prevencion de its y de cancer de cuello uterino",numero de inyectables trimestrales suministrados,2015-09-01,1,26,147,47,0,221
LA PAZ,"anticoncepcion, prevencion de its y de cancer de cuello uterino",numero de inyectables trimestrales suministrados,2015-09-01,0,42,467,126,3,638
LA RIVERA,"anticoncepcion, prevencion de its y de cancer de cuello uterino",numero de inyectables trimestrales suministrados,2015-09-01,0,0,2,0,0,2
LAGUNILLAS,"anticoncepcion, prevencion de its y de cancer de cuello uterino",numero de inyectables trimestrales suministrados,2015-09-01,0,2,17,9,0,28
LAJA,"anticoncepcion, prevencion de its y de cancer de cuello uterino",numero de inyectables trimestrales suministrados,2015-09-01,0,6,36,8,0,50
LAS CARRERAS,"anticoncepcion, prevencion de its y de cancer de cuello uterino",numero de inyectables trimestrales suministrados,2015-09-01,0,1,12,4,0,17
LICOMA PAMPA,"anticoncepcion, prevencion de its y de cancer de cuello uterino",numero de inyectables trimestrales suministrados,2015-09-01,0,2,9,7,0,18
LLALLAGUA,"anticoncepcion, prevencion de its y de cancer de cuello uterino",numero de inyectables trimestrales suministrados,2015-09-01,0,9,108,23,0,140
LLICA,"anticoncepcion, prevencion de its y de cancer de cuello uterino",numero de inyectables trimestrales suministrados,2015-09-01,0,5,19,6,0,30
LORETO,"anticoncepcion, prevencion de its y de cancer de cuello uterino",numero de inyectables trimestrales suministrados,2015-09-01,0,0,8,3,0,11
LURIBAY,"anticoncepcion, prevencion de its y de cancer de cuello uterino",numero de inyectables trimestrales suministrados,2015-09-01,0,2,27,18,3,50
MACHACAMARCA,"anticoncepcion, prevencion de its y de cancer de cuello uterino",numero de inyectables trimestrales suministrados,2015-09-01,0,0,8,0,0,8
MACHARETI,"anticoncepcion, prevencion de its y de cancer de cuello uterino",numero de inyectables trimestrales suministrados,2015-09-01,0,4,48,13,1,66
MAGDALENA,"anticoncepcion, prevencion de its y de cancer de cuello uterino",numero de inyectables trimestrales suministrados,2015-09-01,0,13,34,10,0,57
MAIRANA,"anticoncepcion, prevencion de its y de cancer de cuello uterino",numero de inyectables trimestrales suministrados,2015-09-01,0,11,33,10,0,54
MALLA,"anticoncepcion, prevencion de its y de cancer de cuello uterino",numero de inyectables trimestrales suministrados,2015-09-01,0,1,4,2,0,7
MAPIRI,"anticoncepcion, prevencion de its y de cancer de cuello uterino",numero de inyectables trimestrales suministrados,2015-09-01,0,2,16,6,0,24
MECAPACA,"anticoncepcion, prevencion de its y de cancer de cuello uterino",numero de inyectables trimestrales suministrados,2015-09-01,0,0,23,14,0,37
MINEROS,"anticoncepcion, prevencion de its y de cancer de cuello uterino",numero de inyectables trimestrales suministrados,2015-09-01,0,17,62,23,1,103
MIZQUE,"anticoncepcion, prevencion de its y de cancer de cuello uterino",numero de inyectables trimestrales suministrados,2015-09-01,0,14,87,40,0,141
MOCOMOCO,"anticoncepcion, prevencion de its y de cancer de cuello uterino",numero de inyectables trimestrales suministrados,2015-09-01,0,0,21,19,0,40
MOJINETE,"anticoncepcion, prevencion de its y de cancer de cuello uterino",numero de inyectables trimestrales suministrados,2015-09-01,0,0,1,2,0,3
MOJOCOYA,"anticoncepcion, prevencion de its y de cancer de cuello uterino",numero de inyectables trimestrales suministrados,2015-09-01,0,8,25,32,0,65
MONTEAGUDO,"anticoncepcion, prevencion de its y de cancer de cuello uterino",numero de inyectables trimestrales suministrados,2015-09-01,1,17,59,30,0,107
MONTERO,"anticoncepcion, prevencion de its y de cancer de cuello uterino",numero de inyectables trimestrales suministrados,2015-09-01,1,68,213,64,1,347
MORO MORO,"anticoncepcion, prevencion de its y de cancer de cuello uterino",numero de inyectables trimestrales suministrados,2015-09-01,0,5,13,8,0,26
MOROCHATA,"anticoncepcion, prevencion de its y de cancer de cuello uterino",numero de inyectables trimestrales suministrados,2015-09-01,1,7,31,26,0,65
NACEBE (SANTA ROSA DEL ABUNA),"anticoncepcion, prevencion de its y de cancer de cuello uterino",numero de inyectables trimestrales suministrados,2015-09-01,0,8,8,5,0,21
NAZACARA DE PACAJES,"anticoncepcion, prevencion de its y de cancer de cuello uterino",numero de inyectables trimestrales suministrados,2015-09-01,0,0,3,0,0,3
NUEVO MANOA (NUEVA ESPERANZA),"anticoncepcion, prevencion de its y de cancer de cuello uterino",numero de inyectables trimestrales suministrados,2015-09-01,0,1,1,1,0,3
OCURI,"anticoncepcion, prevencion de its y de cancer de cuello uterino",numero de inyectables trimestrales suministrados,2015-09-01,0,4,31,22,1,58
OKINAWA,"anticoncepcion, prevencion de its y de cancer de cuello uterino",numero de inyectables trimestrales suministrados,2015-09-01,1,6,26,11,0,44
OMEREQUE,"anticoncepcion, prevencion de its y de cancer de cuello uterino",numero de inyectables trimestrales suministrados,2015-09-01,0,7,29,12,0,48
ORURO,"anticoncepcion, prevencion de its y de cancer de cuello uterino",numero de inyectables trimestrales suministrados,2015-09-01,0,43,493,190,1,727
PADCAYA,"anticoncepcion, prevencion de its y de cancer de cuello uterino",numero de inyectables trimestrales suministrados,2015-09-01,2,23,116,90,0,231
PADILLA,"anticoncepcion, prevencion de its y de cancer de cuello uterino",numero de inyectables trimestrales suministrados,2015-09-01,0,3,77,33,0,113
PAILON,"anticoncepcion, prevencion de its y de cancer de cuello uterino",numero de inyectables trimestrales suministrados,2015-09-01,1,11,38,10,0,60
PALCA,"anticoncepcion, prevencion de its y de cancer de cuello uterino",numero de inyectables trimestrales suministrados,2015-09-01,0,3,38,7,0,48
PALOS BLANCOS,"anticoncepcion, prevencion de its y de cancer de cuello uterino",numero de inyectables trimestrales suministrados,2015-09-01,0,7,62,35,0,104
PAMPA AULLAGAS,"anticoncepcion, prevencion de its y de cancer de cuello uterino",numero de inyectables trimestrales suministrados,2015-09-01,0,0,2,2,0,4
PAMPA GRANDE,"anticoncepcion, prevencion de its y de cancer de cuello uterino",numero de inyectables trimestrales suministrados,2015-09-01,0,4,32,13,1,50
PAPEL PAMPA,"anticoncepcion, prevencion de its y de cancer de cuello uterino",numero de inyectables trimestrales suministrados,2015-09-01,0,1,13,14,0,28
PASORAPA,"anticoncepcion, prevencion de its y de cancer de cuello uterino",numero de inyectables trimestrales suministrados,2015-09-01,1,0,24,15,0,40
PATACAMAYA,"anticoncepcion, prevencion de its y de cancer de cuello uterino",numero de inyectables trimestrales suministrados,2015-09-01,0,10,12,3,0,25
PAZÑA,"anticoncepcion, prevencion de its y de cancer de cuello uterino",numero de inyectables trimestrales suministrados,2015-09-01,0,0,16,13,0,29
PELECHUCO,"anticoncepcion, prevencion de its y de cancer de cuello uterino",numero de inyectables trimestrales suministrados,2015-09-01,0,0,14,7,0,21
POCOATA,"anticoncepcion, prevencion de its y de cancer de cuello uterino",numero de inyectables trimestrales suministrados,2015-09-01,0,1,14,15,0,30
POCONA,"anticoncepcion, prevencion de its y de cancer de cuello uterino",numero de inyectables trimestrales suministrados,2015-09-01,0,11,65,36,2,114
POJO (CBBA),"anticoncepcion, prevencion de its y de cancer de cuello uterino",numero de inyectables trimestrales suministrados,2015-09-01,0,15,52,19,0,86
POOPO,"anticoncepcion, prevencion de its y de cancer de cuello uterino",numero de inyectables trimestrales suministrados,2015-09-01,0,0,4,3,0,7
PORCO,"anticoncepcion, prevencion de its y de cancer de cuello uterino",numero de inyectables trimestrales suministrados,2015-09-01,0,4,16,9,0,29
POROMA,"anticoncepcion, prevencion de its y de cancer de cuello uterino",numero de inyectables trimestrales suministrados,2015-09-01,0,4,43,22,0,69
PORONGO,"anticoncepcion, prevencion de its y de cancer de cuello uterino",numero de inyectables trimestrales suministrados,2015-09-01,0,2,27,10,0,39
PORTACHUELO,"anticoncepcion, prevencion de its y de cancer de cuello uterino",numero de inyectables trimestrales suministrados,2015-09-01,0,4,18,7,0,29
PORVENIR,"anticoncepcion, prevencion de its y de cancer de cuello uterino",numero de inyectables trimestrales suministrados,2015-09-01,0,5,23,3,0,31
POSTRER VALLE,"anticoncepcion, prevencion de its y de cancer de cuello uterino",numero de inyectables trimestrales suministrados,2015-09-01,0,0,7,1,0,8
POTOSI,"anticoncepcion, prevencion de its y de cancer de cuello uterino",numero de inyectables trimestrales suministrados,2015-09-01,0,41,457,178,0,676
PRESTO,"anticoncepcion, prevencion de its y de cancer de cuello uterino",numero de inyectables trimestrales suministrados,2015-09-01,0,2,30,24,1,57
PUCARA,"anticoncepcion, prevencion de its y de cancer de cuello uterino",numero de inyectables trimestrales suministrados,2015-09-01,0,2,7,5,1,15
PUCARANI,"anticoncepcion, prevencion de its y de cancer de cuello uterino",numero de inyectables trimestrales suministrados,2015-09-01,0,8,83,47,0,138
PUERTO ACOSTA,"anticoncepcion, prevencion de its y de cancer de cuello uterino",numero de inyectables trimestrales suministrados,2015-09-01,0,1,8,4,0,13
PUERTO CARABUCO,"anticoncepcion, prevencion de its y de cancer de cuello uterino",numero de inyectables trimestrales suministrados,2015-09-01,0,1,21,14,0,36
PUERTO GONZALO MORENO,"anticoncepcion, prevencion de its y de cancer de cuello uterino",numero de inyectables trimestrales suministrados,2015-09-01,3,10,23,9,0,45
PUERTO PEREZ,"anticoncepcion, prevencion de its y de cancer de cuello uterino",numero de inyectables trimestrales suministrados,2015-09-01,0,0,6,2,0,8
PUERTO QUIJARRO,"anticoncepcion, prevencion de its y de cancer de cuello uterino",numero de inyectables trimestrales suministrados,2015-09-01,0,8,29,2,0,39
PUERTO RICO,"anticoncepcion, prevencion de its y de cancer de cuello uterino",numero de inyectables trimestrales suministrados,2015-09-01,0,11,35,10,0,56
PUERTO SILES,"anticoncepcion, prevencion de its y de cancer de cuello uterino",numero de inyectables trimestrales suministrados,2015-09-01,0,1,0,1,0,2
PUERTO SUAREZ,"anticoncepcion, prevencion de its y de cancer de cuello uterino",numero de inyectables trimestrales suministrados,2015-09-01,0,1,19,2,0,22
PUERTO VILLARROEL,"anticoncepcion, prevencion de its y de cancer de cuello uterino",numero de inyectables trimestrales suministrados,2015-09-01,0,14,67,29,0,110
PUNA,"anticoncepcion, prevencion de its y de cancer de cuello uterino",numero de inyectables trimestrales suministrados,2015-09-01,0,3,35,23,0,61
PUNATA,"anticoncepcion, prevencion de its y de cancer de cuello uterino",numero de inyectables trimestrales suministrados,2015-09-01,0,2,61,25,0,88
QUIABAYA,"anticoncepcion, prevencion de its y de cancer de cuello uterino",numero de inyectables trimestrales suministrados,2015-09-01,0,1,9,5,0,15
QUILLACOLLO,"anticoncepcion, prevencion de its y de cancer de cuello uterino",numero de inyectables trimestrales suministrados,2015-09-01,0,25,196,39,0,260
QUIME,"anticoncepcion, prevencion de its y de cancer de cuello uterino",numero de inyectables trimestrales suministrados,2015-09-01,0,4,31,12,0,47
RAVELO,"anticoncepcion, prevencion de its y de cancer de cuello uterino",numero de inyectables trimestrales suministrados,2015-09-01,0,3,40,45,0,88
REYES,"anticoncepcion, prevencion de its y de cancer de cuello uterino",numero de inyectables trimestrales suministrados,2015-09-01,2,9,35,8,0,54
RIBERALTA,"anticoncepcion, prevencion de its y de cancer de cuello uterino",numero de inyectables trimestrales suministrados,2015-09-01,4,62,143,23,1,233
ROBORE,"anticoncepcion, prevencion de its y de cancer de cuello uterino",numero de inyectables trimestrales suministrados,2015-09-01,0,10,48,17,0,75
RURRENABAQUE,"anticoncepcion, prevencion de its y de cancer de cuello uterino",numero de inyectables trimestrales suministrados,2015-09-01,0,6,46,12,0,64
SABAYA,"anticoncepcion, prevencion de its y de cancer de cuello uterino",numero de inyectables trimestrales suministrados,2015-09-01,0,0,6,2,0,8
SACABA,"anticoncepcion, prevencion de its y de cancer de cuello uterino",numero de inyectables trimestrales suministrados,2015-09-01,0,35,175,43,0,253
SACABAMBA,"anticoncepcion, prevencion de its y de cancer de cuello uterino",numero de inyectables trimestrales suministrados,2015-09-01,0,0,6,6,0,12
SACACA,"anticoncepcion, prevencion de its y de cancer de cuello uterino",numero de inyectables trimestrales suministrados,2015-09-01,0,3,42,17,0,62
SAIPINA,"anticoncepcion, prevencion de its y de cancer de cuello uterino",numero de inyectables trimestrales suministrados,2015-09-01,0,5,22,4,0,31
SALINAS DE GARCI MENDOZA,"anticoncepcion, prevencion de its y de cancer de cuello uterino",numero de inyectables trimestrales suministrados,2015-09-01,0,6,30,11,0,47
SAMAIPATA,"anticoncepcion, prevencion de its y de cancer de cuello uterino",numero de inyectables trimestrales suministrados,2015-09-01,1,9,32,6,0,48
SAN AGUSTIN,"anticoncepcion, prevencion de its y de cancer de cuello uterino",numero de inyectables trimestrales suministrados,2015-09-01,0,0,11,3,0,14
SAN ANDRES,"anticoncepcion, prevencion de its y de cancer de cuello uterino",numero de inyectables trimestrales suministrados,2015-09-01,0,5,48,11,0,64
SAN ANDRES DE MACHACA,"anticoncepcion, prevencion de its y de cancer de cuello uterino",numero de inyectables trimestrales suministrados,2015-09-01,0,0,1,3,0,4
SAN ANTONIO DE ESMORUCO,"anticoncepcion, prevencion de its y de cancer de cuello uterino",numero de inyectables trimestrales suministrados,2015-09-01,0,0,8,0,0,8
SAN ANTONIO DE LOMERIO,"anticoncepcion, prevencion de its y de cancer de cuello uterino",numero de inyectables trimestrales suministrados,2015-09-01,0,14,43,16,0,73
SAN BENITO,"anticoncepcion, prevencion de its y de cancer de cuello uterino",numero de inyectables trimestrales suministrados,2015-09-01,0,1,33,18,0,52
SAN BORJA,"anticoncepcion, prevencion de its y de cancer de cuello uterino",numero de inyectables trimestrales suministrados,2015-09-01,2,22,104,47,1,176
SAN BUENA VENTURA,"anticoncepcion, prevencion de its y de cancer de cuello uterino",numero de inyectables trimestrales suministrados,2015-09-01,0,2,21,1,0,24
SAN CARLOS,"anticoncepcion, prevencion de its y de cancer de cuello uterino",numero de inyectables trimestrales suministrados,2015-09-01,0,9,49,10,0,68
SAN IGNACIO,"anticoncepcion, prevencion de its y de cancer de cuello uterino",numero de inyectables trimestrales suministrados,2015-09-01,1,17,72,29,1,120
SAN IGNACIO DE VELASCO,"anticoncepcion, prevencion de its y de cancer de cuello uterino",numero de inyectables trimestrales suministrados,2015-09-01,0,28,154,44,0,226
SAN JAVIER(BNI),"anticoncepcion, prevencion de its y de cancer de cuello uterino",numero de inyectables trimestrales suministrados,2015-09-01,0,3,10,1,0,14
SAN JAVIER(STC),"anticoncepcion, prevencion de its y de cancer de cuello uterino",numero de inyectables trimestrales suministrados,2015-09-01,0,3,32,15,0,50
SAN JOSE DE CHIQUITOS,"anticoncepcion, prevencion de its y de cancer de cuello uterino",numero de inyectables trimestrales suministrados,2015-09-01,0,11,33,9,0,53
SAN JUAN DE YAPACANI,"anticoncepcion, prevencion de its y de cancer de cuello uterino",numero de inyectables trimestrales suministrados,2015-09-01,0,3,33,13,0,49
SAN JULIAN,"anticoncepcion, prevencion de its y de cancer de cuello uterino",numero de inyectables trimestrales suministrados,2015-09-01,1,8,72,50,1,132
SAN LORENZO(PND),"anticoncepcion, prevencion de its y de cancer de cuello uterino",numero de inyectables trimestrales suministrados,2015-09-01,1,4,8,2,0,15
SAN LORENZO(TJA),"anticoncepcion, prevencion de its y de cancer de cuello uterino",numero de inyectables trimestrales suministrados,2015-09-01,1,12,82,57,3,155
SAN LUCAS,"anticoncepcion, prevencion de its y de cancer de cuello uterino",numero de inyectables trimestrales suministrados,2015-09-01,1,6,61,41,0,109
SAN MATIAS,"anticoncepcion, prevencion de its y de cancer de cuello uterino",numero de inyectables trimestrales suministrados,2015-09-01,0,1,4,4,0,9
SAN MIGUEL DE VELASCO,"anticoncepcion, prevencion de its y de cancer de cuello uterino",numero de inyectables trimestrales suministrados,2015-09-01,0,11,57,33,1,102
SAN PABLO DE LIPEZ,"anticoncepcion, prevencion de its y de cancer de cuello uterino",numero de inyectables trimestrales suministrados,2015-09-01,0,1,2,1,0,4
SAN PEDRO,"anticoncepcion, prevencion de its y de cancer de cuello uterino",numero de inyectables trimestrales suministrados,2015-09-01,0,5,41,17,0,63
SAN PEDRO DE BUENA VISTA,"anticoncepcion, prevencion de its y de cancer de cuello uterino",numero de inyectables trimestrales suministrados,2015-09-01,0,5,25,28,0,58
SAN PEDRO DE CURAHUARA,"anticoncepcion, prevencion de its y de cancer de cuello uterino",numero de inyectables trimestrales suministrados,2015-09-01,0,0,6,6,0,12
SAN PEDRO DE QUEMES,"anticoncepcion, prevencion de its y de cancer de cuello uterino",numero de inyectables trimestrales suministrados,2015-09-01,0,1,3,2,0,6
SAN PEDRO DE TIQUINA,"anticoncepcion, prevencion de its y de cancer de cuello uterino",numero de inyectables trimestrales suministrados,2015-09-01,0,0,10,5,0,15
SAN PEDRO(PND),"anticoncepcion, prevencion de its y de cancer de cuello uterino",numero de inyectables trimestrales suministrados,2015-09-01,0,4,2,0,0,6
SAN RAFAEL,"anticoncepcion, prevencion de its y de cancer de cuello uterino",numero de inyectables trimestrales suministrados,2015-09-01,0,8,33,19,1,61
SAN RAMON BENI,"anticoncepcion, prevencion de its y de cancer de cuello uterino",numero de inyectables trimestrales suministrados,2015-09-01,0,0,9,1,0,10
SAN RAMON SCZ,"anticoncepcion, prevencion de its y de cancer de cuello uterino",numero de inyectables trimestrales suministrados,2015-09-01,0,11,23,16,0,50
SANTA ANA,"anticoncepcion, prevencion de its y de cancer de cuello uterino",numero de inyectables trimestrales suministrados,2015-09-01,0,6,23,1,1,31
SANTA CRUZ DE LA SIERRA,"anticoncepcion, prevencion de its y de cancer de cuello uterino",numero de inyectables trimestrales suministrados,2015-09-01,4,137,605,139,0,885
SANTA ROSA DEL SARA,"anticoncepcion, prevencion de its y de cancer de cuello uterino",numero de inyectables trimestrales suministrados,2015-09-01,0,4,35,15,0,54
SANTIAGO DE CALLAPA,"anticoncepcion, prevencion de its y de cancer de cuello uterino",numero de inyectables trimestrales suministrados,2015-09-01,0,2,1,1,0,4
SANTIAGO DE HUARI,"anticoncepcion, prevencion de its y de cancer de cuello uterino",numero de inyectables trimestrales suministrados,2015-09-01,0,4,9,3,0,16
SANTIAGO DE HUATA,"anticoncepcion, prevencion de its y de cancer de cuello uterino",numero de inyectables trimestrales suministrados,2015-09-01,0,1,3,9,0,13
SANTIAGO DE MACHACA,"anticoncepcion, prevencion de its y de cancer de cuello uterino",numero de inyectables trimestrales suministrados,2015-09-01,0,2,4,6,0,12
SANTIVAÑES,"anticoncepcion, prevencion de its y de cancer de cuello uterino",numero de inyectables trimestrales suministrados,2015-09-01,0,2,16,7,0,25
SANTUARIO DE QUILLACAS,"anticoncepcion, prevencion de its y de cancer de cuello uterino",numero de inyectables trimestrales suministrados,2015-09-01,0,0,8,5,0,13
SAPAHAQUI,"anticoncepcion, prevencion de its y de cancer de cuello uterino",numero de inyectables trimestrales suministrados,2015-09-01,0,2,29,21,0,52
SENA,"anticoncepcion, prevencion de its y de cancer de cuello uterino",numero de inyectables trimestrales suministrados,2015-09-01,0,4,17,2,0,23
SHINAOTA,"anticoncepcion, prevencion de its y de cancer de cuello uterino",numero de inyectables trimestrales suministrados,2015-09-01,0,9,37,22,0,68
SICA SICA (VILLA AROMA),"anticoncepcion, prevencion de its y de cancer de cuello uterino",numero de inyectables trimestrales suministrados,2015-09-01,0,3,47,19,0,69
SICAYA,"anticoncepcion, prevencion de its y de cancer de cuello uterino",numero de inyectables trimestrales suministrados,2015-09-01,0,4,17,5,0,26
SIPE SIPE,"anticoncepcion, prevencion de its y de cancer de cuello uterino",numero de inyectables trimestrales suministrados,2015-09-01,0,21,166,60,2,249
SOPACHUY,"anticoncepcion, prevencion de its y de cancer de cuello uterino",numero de inyectables trimestrales suministrados,2015-09-01,0,3,18,20,0,41
SORACACHI,"anticoncepcion, prevencion de its y de cancer de cuello uterino",numero de inyectables trimestrales suministrados,2015-09-01,0,3,29,9,0,41
SORATA,"anticoncepcion, prevencion de its y de cancer de cuello uterino",numero de inyectables trimestrales suministrados,2015-09-01,0,1,31,26,0,58
SUCRE,"anticoncepcion, prevencion de its y de cancer de cuello uterino",numero de inyectables trimestrales suministrados,2015-09-01,1,90,532,189,1,813
TACACOMA,"anticoncepcion, prevencion de its y de cancer de cuello uterino",numero de inyectables trimestrales suministrados,2015-09-01,1,5,39,7,0,52
TACOBAMBA,"anticoncepcion, prevencion de its y de cancer de cuello uterino",numero de inyectables trimestrales suministrados,2015-09-01,0,1,27,16,1,45
TACOPAYA,"anticoncepcion, prevencion de its y de cancer de cuello uterino",numero de inyectables trimestrales suministrados,2015-09-01,0,0,13,11,0,24
TAHUA,"anticoncepcion, prevencion de its y de cancer de cuello uterino",numero de inyectables trimestrales suministrados,2015-09-01,0,2,3,1,0,6
TAPACARI,"anticoncepcion, prevencion de its y de cancer de cuello uterino",numero de inyectables trimestrales suministrados,2015-09-01,0,6,65,53,0,124
TARABUCO,"anticoncepcion, prevencion de its y de cancer de cuello uterino",numero de inyectables trimestrales suministrados,2015-09-01,0,4,37,22,0,63
TARACO,"anticoncepcion, prevencion de its y de cancer de cuello uterino",numero de inyectables trimestrales suministrados,2015-09-01,0,0,15,5,0,20
TARATA,"anticoncepcion, prevencion de its y de cancer de cuello uterino",numero de inyectables trimestrales suministrados,2015-09-01,0,1,4,1,0,6
TARIJA,"anticoncepcion, prevencion de its y de cancer de cuello uterino",numero de inyectables trimestrales suministrados,2015-09-01,1,85,262,83,2,433
TARVITA,"anticoncepcion, prevencion de its y de cancer de cuello uterino",numero de inyectables trimestrales suministrados,2015-09-01,0,7,27,18,0,52
TEOPONTE,"anticoncepcion, prevencion de its y de cancer de cuello uterino",numero de inyectables trimestrales suministrados,2015-09-01,0,2,24,7,0,33
TIAWANACU,"anticoncepcion, prevencion de its y de cancer de cuello uterino",numero de inyectables trimestrales suministrados,2015-09-01,0,2,31,18,0,51
TINGUIPAYA,"anticoncepcion, prevencion de its y de cancer de cuello uterino",numero de inyectables trimestrales suministrados,2015-09-01,0,0,9,17,1,27
TIPUANI,"anticoncepcion, prevencion de its y de cancer de cuello uterino",numero de inyectables trimestrales suministrados,2015-09-01,0,1,17,9,1,28
TIQUIPAYA,"anticoncepcion, prevencion de its y de cancer de cuello uterino",numero de inyectables trimestrales suministrados,2015-09-01,0,7,89,28,0,124
TIRAQUE (CBBA),"anticoncepcion, prevencion de its y de cancer de cuello uterino",numero de inyectables trimestrales suministrados,2015-09-01,0,5,42,30,0,77
TITO YUPANQUI (PARQUIPUJIO),"anticoncepcion, prevencion de its y de cancer de cuello uterino",numero de inyectables trimestrales suministrados,2015-09-01,0,0,1,1,0,2
TOCO,"anticoncepcion, prevencion de its y de cancer de cuello uterino",numero de inyectables trimestrales suministrados,2015-09-01,0,3,15,9,0,27
TODOS SANTOS,"anticoncepcion, prevencion de its y de cancer de cuello uterino",numero de inyectables trimestrales suministrados,2015-09-01,0,1,1,0,0,2
TOLATA,"anticoncepcion, prevencion de its y de cancer de cuello uterino",numero de inyectables trimestrales suministrados,2015-09-01,0,0,25,2,0,27
TOLEDO,"anticoncepcion, prevencion de its y de cancer de cuello uterino",numero de inyectables trimestrales suministrados,2015-09-01,0,1,7,5,0,13
TOMAVE,"anticoncepcion, prevencion de its y de cancer de cuello uterino",numero de inyectables trimestrales suministrados,2015-09-01,0,4,17,11,0,32
TOMINA,"anticoncepcion, prevencion de its y de cancer de cuello uterino",numero de inyectables trimestrales suministrados,2015-09-01,1,5,55,43,0,104
TORO TORO,"anticoncepcion, prevencion de its y de cancer de cuello uterino",numero de inyectables trimestrales suministrados,2015-09-01,0,4,21,12,0,37
TOTORA(CBBA),"anticoncepcion, prevencion de its y de cancer de cuello uterino",numero de inyectables trimestrales suministrados,2015-09-01,0,17,81,35,0,133
TOTORA(ORR),"anticoncepcion, prevencion de its y de cancer de cuello uterino",numero de inyectables trimestrales suministrados,2015-09-01,0,2,9,6,0,17
TRIGAL,"anticoncepcion, prevencion de its y de cancer de cuello uterino",numero de inyectables trimestrales suministrados,2015-09-01,0,0,3,2,0,5
TRINIDAD,"anticoncepcion, prevencion de its y de cancer de cuello uterino",numero de inyectables trimestrales suministrados,2015-09-01,0,27,86,5,0,118
TUPIZA,"anticoncepcion, prevencion de its y de cancer de cuello uterino",numero de inyectables trimestrales suministrados,2015-09-01,0,17,133,65,0,215
TURCO,"anticoncepcion, prevencion de its y de cancer de cuello uterino",numero de inyectables trimestrales suministrados,2015-09-01,0,0,5,5,0,10
UMALA,"anticoncepcion, prevencion de its y de cancer de cuello uterino",numero de inyectables trimestrales suministrados,2015-09-01,0,1,11,10,0,22
UNCIA,"anticoncepcion, prevencion de its y de cancer de cuello uterino",numero de inyectables trimestrales suministrados,2015-09-01,0,1,59,21,0,81
URIONDO (A. CONCEPCION),"anticoncepcion, prevencion de its y de cancer de cuello uterino",numero de inyectables trimestrales suministrados,2015-09-01,1,11,56,37,0,105
URUBICHA,"anticoncepcion, prevencion de its y de cancer de cuello uterino",numero de inyectables trimestrales suministrados,2015-09-01,0,2,7,6,0,15
UYUNI,"anticoncepcion, prevencion de its y de cancer de cuello uterino",numero de inyectables trimestrales suministrados,2015-09-01,0,3,48,14,0,65
VACAS,"anticoncepcion, prevencion de its y de cancer de cuello uterino",numero de inyectables trimestrales suministrados,2015-09-01,1,3,16,14,0,34
VALLEGRANDE,"anticoncepcion, prevencion de its y de cancer de cuello uterino",numero de inyectables trimestrales suministrados,2015-09-01,0,9,45,12,0,66
VIACHA,"anticoncepcion, prevencion de its y de cancer de cuello uterino",numero de inyectables trimestrales suministrados,2015-09-01,1,18,147,76,0,242
VILA VILA,"anticoncepcion, prevencion de its y de cancer de cuello uterino",numero de inyectables trimestrales suministrados,2015-09-01,0,2,3,0,0,5
VILLA CHARCAS,"anticoncepcion, prevencion de its y de cancer de cuello uterino",numero de inyectables trimestrales suministrados,2015-09-01,0,6,58,29,1,94
VILLA MONTES,"anticoncepcion, prevencion de its y de cancer de cuello uterino",numero de inyectables trimestrales suministrados,2015-09-01,1,34,97,34,1,167
VILLA NUEVA (LOMA ALTA),"anticoncepcion, prevencion de its y de cancer de cuello uterino",numero de inyectables trimestrales suministrados,2015-09-01,0,0,4,0,0,4
VILLA RIVERO,"anticoncepcion, prevencion de its y de cancer de cuello uterino",numero de inyectables trimestrales suministrados,2015-09-01,0,8,30,11,0,49
VILLA SERRANO,"anticoncepcion, prevencion de its y de cancer de cuello uterino",numero de inyectables trimestrales suministrados,2015-09-01,0,7,30,28,1,66
VILLA TUNARI,"anticoncepcion, prevencion de its y de cancer de cuello uterino",numero de inyectables trimestrales suministrados,2015-09-01,0,41,264,65,0,370
VILLA VACA GUZMAN (MUYUPAMPA),"anticoncepcion, prevencion de its y de cancer de cuello uterino",numero de inyectables trimestrales suministrados,2015-09-01,0,5,45,23,1,74
VILLAZON,"anticoncepcion, prevencion de its y de cancer de cuello uterino",numero de inyectables trimestrales suministrados,2015-09-01,0,15,95,43,1,154
VINTO,"anticoncepcion, prevencion de its y de cancer de cuello uterino",numero de inyectables trimestrales suministrados,2015-09-01,0,9,85,26,0,120
VITICHI,"anticoncepcion, prevencion de its y de cancer de cuello uterino",numero de inyectables trimestrales suministrados,2015-09-01,0,3,12,10,0,25
WALDO BALLIVIAN,"anticoncepcion, prevencion de its y de cancer de cuello uterino",numero de inyectables trimestrales suministrados,2015-09-01,0,0,4,2,0,6
WARNES,"anticoncepcion, prevencion de its y de cancer de cuello uterino",numero de inyectables trimestrales suministrados,2015-09-01,3,50,175,68,9,305
YACO,"anticoncepcion, prevencion de its y de cancer de cuello uterino",numero de inyectables trimestrales suministrados,2015-09-01,0,2,19,11,0,32
YACUIBA,"anticoncepcion, prevencion de its y de cancer de cuello uterino",numero de inyectables trimestrales suministrados,2015-09-01,1,47,219,117,5,389
YAMPARAEZ,"anticoncepcion, prevencion de its y de cancer de cuello uterino",numero de inyectables trimestrales suministrados,2015-09-01,0,4,13,11,0,28
YANACACHI,"anticoncepcion, prevencion de its y de cancer de cuello uterino",numero de inyectables trimestrales suministrados,2015-09-01,0,1,15,5,0,21
YAPACANI,"anticoncepcion, prevencion de its y de cancer de cuello uterino",numero de inyectables trimestrales suministrados,2015-09-01,0,16,62,18,0,96
YOCALLA,"anticoncepcion, prevencion de its y de cancer de cuello uterino",numero de inyectables trimestrales suministrados,2015-09-01,0,1,10,5,0,16
YOTALA,"anticoncepcion, prevencion de its y de cancer de cuello uterino",numero de inyectables trimestrales suministrados,2015-09-01,0,2,3,5,0,10
YUNCHARA,"anticoncepcion, prevencion de its y de cancer de cuello uterino",numero de inyectables trimestrales suministrados,2015-09-01,0,6,31,23,0,60
ZUDAÑEZ,"anticoncepcion, prevencion de its y de cancer de cuello uterino",numero de inyectables trimestrales suministrados,2015-09-01,0,4,42,29,0,75
ACACIO,"anticoncepcion, prevencion de its y de cancer de cuello uterino",numero de inyectables trimestrales suministrados,2015-10-01,0,0,8,5,0,13
ACHACACHI,"anticoncepcion, prevencion de its y de cancer de cuello uterino",numero de inyectables trimestrales suministrados,2015-10-01,0,6,56,30,0,92
ACHOCALLA,"anticoncepcion, prevencion de its y de cancer de cuello uterino",numero de inyectables trimestrales suministrados,2015-10-01,0,5,34,17,0,56
AIQUILE,"anticoncepcion, prevencion de its y de cancer de cuello uterino",numero de inyectables trimestrales suministrados,2015-10-01,0,4,24,35,0,63
ALALAY,"anticoncepcion, prevencion de its y de cancer de cuello uterino",numero de inyectables trimestrales suministrados,2015-10-01,0,0,8,3,0,11
ALCALA,"anticoncepcion, prevencion de its y de cancer de cuello uterino",numero de inyectables trimestrales suministrados,2015-10-01,0,6,15,16,1,38
ALTO BENI,"anticoncepcion, prevencion de its y de cancer de cuello uterino",numero de inyectables trimestrales suministrados,2015-10-01,1,5,24,18,0,48
ANCORAIMES,"anticoncepcion, prevencion de its y de cancer de cuello uterino",numero de inyectables trimestrales suministrados,2015-10-01,0,4,14,12,0,30
ANDAMARCA,"anticoncepcion, prevencion de its y de cancer de cuello uterino",numero de inyectables trimestrales suministrados,2015-10-01,0,1,4,2,0,7
ANTEQUERA,"anticoncepcion, prevencion de its y de cancer de cuello uterino",numero de inyectables trimestrales suministrados,2015-10-01,0,0,2,1,0,3
ANZALDO,"anticoncepcion, prevencion de its y de cancer de cuello uterino",numero de inyectables trimestrales suministrados,2015-10-01,0,3,23,13,0,39
APOLO,"anticoncepcion, prevencion de its y de cancer de cuello uterino",numero de inyectables trimestrales suministrados,2015-10-01,0,3,33,19,1,56
ARAMPAMPA,"anticoncepcion, prevencion de its y de cancer de cuello uterino",numero de inyectables trimestrales suministrados,2015-10-01,0,1,6,1,0,8
ARANI,"anticoncepcion, prevencion de its y de cancer de cuello uterino",numero de inyectables trimestrales suministrados,2015-10-01,0,4,11,9,0,24
ARBIETO,"anticoncepcion, prevencion de its y de cancer de cuello uterino",numero de inyectables trimestrales suministrados,2015-10-01,0,8,49,24,0,81
ARQUE,"anticoncepcion, prevencion de its y de cancer de cuello uterino",numero de inyectables trimestrales suministrados,2015-10-01,0,6,27,32,0,65
ASCENCION DE GUARAYOS,"anticoncepcion, prevencion de its y de cancer de cuello uterino",numero de inyectables trimestrales suministrados,2015-10-01,0,11,39,23,0,73
ATOCHA,"anticoncepcion, prevencion de its y de cancer de cuello uterino",numero de inyectables trimestrales suministrados,2015-10-01,1,1,34,19,0,55
AUCAPATA,"anticoncepcion, prevencion de its y de cancer de cuello uterino",numero de inyectables trimestrales suministrados,2015-10-01,0,3,14,9,0,26
AYATA,"anticoncepcion, prevencion de its y de cancer de cuello uterino",numero de inyectables trimestrales suministrados,2015-10-01,0,1,22,18,0,41
AYO AYO,"anticoncepcion, prevencion de its y de cancer de cuello uterino",numero de inyectables trimestrales suministrados,2015-10-01,0,1,20,12,0,33
AYOPAYA (V. DE INDEPENDENCIA),"anticoncepcion, prevencion de its y de cancer de cuello uterino",numero de inyectables trimestrales suministrados,2015-10-01,0,9,67,72,0,148
AZURDUY,"anticoncepcion, prevencion de its y de cancer de cuello uterino",numero de inyectables trimestrales suministrados,2015-10-01,0,6,55,23,2,86
BATALLAS,"anticoncepcion, prevencion de its y de cancer de cuello uterino",numero de inyectables trimestrales suministrados,2015-10-01,0,4,29,22,1,56
BAURES,"anticoncepcion, prevencion de its y de cancer de cuello uterino",numero de inyectables trimestrales suministrados,2015-10-01,0,4,10,2,0,16
BELEN DE ANDAMARCA,"anticoncepcion, prevencion de its y de cancer de cuello uterino",numero de inyectables trimestrales suministrados,2015-10-01,0,0,1,3,0,4
BELEN DE URMIRI,"anticoncepcion, prevencion de its y de cancer de cuello uterino",numero de inyectables trimestrales suministrados,2015-10-01,0,0,2,3,0,5
BELLA FLOR,"anticoncepcion, prevencion de its y de cancer de cuello uterino",numero de inyectables trimestrales suministrados,2015-10-01,0,3,10,2,0,15
BERMEJO,"anticoncepcion, prevencion de its y de cancer de cuello uterino",numero de inyectables trimestrales suministrados,2015-10-01,0,12,76,36,1,125
BETANZOS,"anticoncepcion, prevencion de its y de cancer de cuello uterino",numero de inyectables trimestrales suministrados,2015-10-01,0,6,55,44,0,105
BOLIVAR,"anticoncepcion, prevencion de its y de cancer de cuello uterino",numero de inyectables trimestrales suministrados,2015-10-01,0,0,5,3,0,8
BOLPEBRA,"anticoncepcion, prevencion de its y de cancer de cuello uterino",numero de inyectables trimestrales suministrados,2015-10-01,2,2,2,0,0,6
BOYUIBE,"anticoncepcion, prevencion de its y de cancer de cuello uterino",numero de inyectables trimestrales suministrados,2015-10-01,0,2,15,3,0,20
BUENA VISTA,"anticoncepcion, prevencion de its y de cancer de cuello uterino",numero de inyectables trimestrales suministrados,2015-10-01,0,6,27,10,0,43
CABEZAS,"anticoncepcion, prevencion de its y de cancer de cuello uterino",numero de inyectables trimestrales suministrados,2015-10-01,1,24,110,25,2,162
CAIROMA,"anticoncepcion, prevencion de its y de cancer de cuello uterino",numero de inyectables trimestrales suministrados,2015-10-01,0,5,26,13,1,45
"CAIZA ""D""","anticoncepcion, prevencion de its y de cancer de cuello uterino",numero de inyectables trimestrales suministrados,2015-10-01,0,3,20,14,0,37
CAJUATA,"anticoncepcion, prevencion de its y de cancer de cuello uterino",numero de inyectables trimestrales suministrados,2015-10-01,0,2,31,18,0,51
CALACOTO,"anticoncepcion, prevencion de its y de cancer de cuello uterino",numero de inyectables trimestrales suministrados,2015-10-01,0,0,3,4,0,7
CALAMARCA,"anticoncepcion, prevencion de its y de cancer de cuello uterino",numero de inyectables trimestrales suministrados,2015-10-01,0,2,52,16,2,72
CAMARGO,"anticoncepcion, prevencion de its y de cancer de cuello uterino",numero de inyectables trimestrales suministrados,2015-10-01,0,6,23,17,0,46
CAMATAQUI (C. VILLA ABECIA),"anticoncepcion, prevencion de its y de cancer de cuello uterino",numero de inyectables trimestrales suministrados,2015-10-01,0,2,8,8,0,18
CAMIRI,"anticoncepcion, prevencion de its y de cancer de cuello uterino",numero de inyectables trimestrales suministrados,2015-10-01,0,9,42,16,0,67
CAPINOTA,"anticoncepcion, prevencion de its y de cancer de cuello uterino",numero de inyectables trimestrales suministrados,2015-10-01,0,9,54,23,1,87
CAQUIAVIRI,"anticoncepcion, prevencion de its y de cancer de cuello uterino",numero de inyectables trimestrales suministrados,2015-10-01,0,3,16,6,0,25
CARACOLLO,"anticoncepcion, prevencion de its y de cancer de cuello uterino",numero de inyectables trimestrales suministrados,2015-10-01,1,3,38,19,0,61
CARANAVI,"anticoncepcion, prevencion de its y de cancer de cuello uterino",numero de inyectables trimestrales suministrados,2015-10-01,0,14,103,43,0,160
CARAPARI,"anticoncepcion, prevencion de its y de cancer de cuello uterino",numero de inyectables trimestrales suministrados,2015-10-01,0,8,55,33,0,96
CARIPUYO,"anticoncepcion, prevencion de its y de cancer de cuello uterino",numero de inyectables trimestrales suministrados,2015-10-01,0,2,9,7,0,18
CARMEN RIVERO TORREZ,"anticoncepcion, prevencion de its y de cancer de cuello uterino",numero de inyectables trimestrales suministrados,2015-10-01,0,1,4,1,0,6
CATACORA,"anticoncepcion, prevencion de its y de cancer de cuello uterino",numero de inyectables trimestrales suministrados,2015-10-01,0,0,2,2,0,4
CHACARILLA,"anticoncepcion, prevencion de its y de cancer de cuello uterino",numero de inyectables trimestrales suministrados,2015-10-01,0,0,1,0,1,2
CHALLAPATA,"anticoncepcion, prevencion de its y de cancer de cuello uterino",numero de inyectables trimestrales suministrados,2015-10-01,0,7,38,17,0,62
CHAQUI,"anticoncepcion, prevencion de its y de cancer de cuello uterino",numero de inyectables trimestrales suministrados,2015-10-01,0,2,23,12,0,37
CHARAGUA,"anticoncepcion, prevencion de its y de cancer de cuello uterino",numero de inyectables trimestrales suministrados,2015-10-01,0,3,51,9,0,63
CHARAÑA,"anticoncepcion, prevencion de its y de cancer de cuello uterino",numero de inyectables trimestrales suministrados,2015-10-01,0,0,5,2,0,7
CHAYANTA,"anticoncepcion, prevencion de its y de cancer de cuello uterino",numero de inyectables trimestrales suministrados,2015-10-01,0,11,26,15,0,52
CHIMORE,"anticoncepcion, prevencion de its y de cancer de cuello uterino",numero de inyectables trimestrales suministrados,2015-10-01,0,13,63,20,0,96
CHIPAYA,"anticoncepcion, prevencion de its y de cancer de cuello uterino",numero de inyectables trimestrales suministrados,2015-10-01,0,6,13,4,0,23
CHOQUE COTA,"anticoncepcion, prevencion de its y de cancer de cuello uterino",numero de inyectables trimestrales suministrados,2015-10-01,0,0,1,1,0,2
CHUA COCANI,"anticoncepcion, prevencion de its y de cancer de cuello uterino",numero de inyectables trimestrales suministrados,2015-10-01,0,1,7,4,0,12
CHULUMANI (V. DE LA LIBERTAD),"anticoncepcion, prevencion de its y de cancer de cuello uterino",numero de inyectables trimestrales suministrados,2015-10-01,0,2,40,9,0,51
CHUMA,"anticoncepcion, prevencion de its y de cancer de cuello uterino",numero de inyectables trimestrales suministrados,2015-10-01,0,5,24,21,0,50
CHUQUIHUTA AYLLU JUCUMANI,"anticoncepcion, prevencion de its y de cancer de cuello uterino",numero de inyectables trimestrales suministrados,2015-10-01,0,4,11,6,0,21
CKOCHAS,"anticoncepcion, prevencion de its y de cancer de cuello uterino",numero de inyectables trimestrales suministrados,2015-10-01,0,1,22,16,0,39
CLIZA,"anticoncepcion, prevencion de its y de cancer de cuello uterino",numero de inyectables trimestrales suministrados,2015-10-01,0,7,49,18,0,74
COBIJA,"anticoncepcion, prevencion de its y de cancer de cuello uterino",numero de inyectables trimestrales suministrados,2015-10-01,1,48,126,18,1,194
COCAPATA,"anticoncepcion, prevencion de its y de cancer de cuello uterino",numero de inyectables trimestrales suministrados,2015-10-01,1,5,59,27,0,92
COCHABAMBA,"anticoncepcion, prevencion de its y de cancer de cuello uterino",numero de inyectables trimestrales suministrados,2015-10-01,0,88,413,94,1,596
COIPASA,"anticoncepcion, prevencion de its y de cancer de cuello uterino",numero de inyectables trimestrales suministrados,2015-10-01,0,1,4,1,0,6
COLCAPIRHUA,"anticoncepcion, prevencion de its y de cancer de cuello uterino",numero de inyectables trimestrales suministrados,2015-10-01,0,4,70,6,0,80
"COLCHA ""K""","anticoncepcion, prevencion de its y de cancer de cuello uterino",numero de inyectables trimestrales suministrados,2015-10-01,0,1,44,17,0,62
COLLANA,"anticoncepcion, prevencion de its y de cancer de cuello uterino",numero de inyectables trimestrales suministrados,2015-10-01,0,1,5,3,0,9
COLOMI,"anticoncepcion, prevencion de its y de cancer de cuello uterino",numero de inyectables trimestrales suministrados,2015-10-01,0,11,54,24,0,89
COLPA BELGICA,"anticoncepcion, prevencion de its y de cancer de cuello uterino",numero de inyectables trimestrales suministrados,2015-10-01,0,5,15,5,0,25
COLQUECHACA,"anticoncepcion, prevencion de its y de cancer de cuello uterino",numero de inyectables trimestrales suministrados,2015-10-01,0,4,65,37,0,106
COLQUENCHA,"anticoncepcion, prevencion de its y de cancer de cuello uterino",numero de inyectables trimestrales suministrados,2015-10-01,0,1,25,17,0,43
COLQUIRI,"anticoncepcion, prevencion de its y de cancer de cuello uterino",numero de inyectables trimestrales suministrados,2015-10-01,0,2,31,16,0,49
COMANCHE,"anticoncepcion, prevencion de its y de cancer de cuello uterino",numero de inyectables trimestrales suministrados,2015-10-01,0,0,1,0,0,1
COMARAPA,"anticoncepcion, prevencion de its y de cancer de cuello uterino",numero de inyectables trimestrales suministrados,2015-10-01,0,21,72,33,1,127
COMBAYA,"anticoncepcion, prevencion de its y de cancer de cuello uterino",numero de inyectables trimestrales suministrados,2015-10-01,0,0,4,3,0,7
CONCEPCION,"anticoncepcion, prevencion de its y de cancer de cuello uterino",numero de inyectables trimestrales suministrados,2015-10-01,0,4,36,4,0,44
COPACABANA,"anticoncepcion, prevencion de its y de cancer de cuello uterino",numero de inyectables trimestrales suministrados,2015-10-01,0,1,25,17,0,43
CORIPATA,"anticoncepcion, prevencion de its y de cancer de cuello uterino",numero de inyectables trimestrales suministrados,2015-10-01,0,2,33,10,0,45
CORO CORO,"anticoncepcion, prevencion de its y de cancer de cuello uterino",numero de inyectables trimestrales suministrados,2015-10-01,0,1,11,6,0,18
COROICO,"anticoncepcion, prevencion de its y de cancer de cuello uterino",numero de inyectables trimestrales suministrados,2015-10-01,0,0,14,3,0,17
CORQUE,"anticoncepcion, prevencion de its y de cancer de cuello uterino",numero de inyectables trimestrales suministrados,2015-10-01,0,5,8,8,0,21
COTAGAITA,"anticoncepcion, prevencion de its y de cancer de cuello uterino",numero de inyectables trimestrales suministrados,2015-10-01,0,6,64,41,0,111
COTOCA,"anticoncepcion, prevencion de its y de cancer de cuello uterino",numero de inyectables trimestrales suministrados,2015-10-01,2,25,89,34,0,150
CUATRO CAÑADAS,"anticoncepcion, prevencion de its y de cancer de cuello uterino",numero de inyectables trimestrales suministrados,2015-10-01,0,15,47,21,1,84
CUCHUMUELA (V. G. VILLARROEL),"anticoncepcion, prevencion de its y de cancer de cuello uterino",numero de inyectables trimestrales suministrados,2015-10-01,0,1,6,2,0,9
CUEVO,"anticoncepcion, prevencion de its y de cancer de cuello uterino",numero de inyectables trimestrales suministrados,2015-10-01,0,4,23,8,0,35
CULPINA,"anticoncepcion, prevencion de its y de cancer de cuello uterino",numero de inyectables trimestrales suministrados,2015-10-01,0,5,57,42,0,104
CURAHUARA DE CARANGAS,"anticoncepcion, prevencion de its y de cancer de cuello uterino",numero de inyectables trimestrales suministrados,2015-10-01,0,3,8,9,1,21
CURVA,"anticoncepcion, prevencion de its y de cancer de cuello uterino",numero de inyectables trimestrales suministrados,2015-10-01,0,0,4,5,0,9
DESAGUADERO,"anticoncepcion, prevencion de its y de cancer de cuello uterino",numero de inyectables trimestrales suministrados,2015-10-01,0,0,13,7,0,20
EL ALTO,"anticoncepcion, prevencion de its y de cancer de cuello uterino",numero de inyectables trimestrales suministrados,2015-10-01,0,78,1086,363,1,1528
EL CHORO,"anticoncepcion, prevencion de its y de cancer de cuello uterino",numero de inyectables trimestrales suministrados,2015-10-01,0,2,11,3,0,16
EL PUENTE(STC),"anticoncepcion, prevencion de its y de cancer de cuello uterino",numero de inyectables trimestrales suministrados,2015-10-01,0,7,48,16,1,72
EL PUENTE(TJA),"anticoncepcion, prevencion de its y de cancer de cuello uterino",numero de inyectables trimestrales suministrados,2015-10-01,0,6,66,41,0,113
EL TORNO,"anticoncepcion, prevencion de its y de cancer de cuello uterino",numero de inyectables trimestrales suministrados,2015-10-01,3,24,108,38,3,176
EL VILLAR,"anticoncepcion, prevencion de its y de cancer de cuello uterino",numero de inyectables trimestrales suministrados,2015-10-01,0,7,16,16,0,39
ENTRE RIOS TRJ,"anticoncepcion, prevencion de its y de cancer de cuello uterino",numero de inyectables trimestrales suministrados,2015-10-01,0,23,99,54,1,177
ENTRE RIOS CBBA,"anticoncepcion, prevencion de its y de cancer de cuello uterino",numero de inyectables trimestrales suministrados,2015-10-01,0,7,64,18,0,89
ESCOMA,"anticoncepcion, prevencion de its y de cancer de cuello uterino",numero de inyectables trimestrales suministrados,2015-10-01,0,0,4,1,0,5
EUCALIPTUS,"anticoncepcion, prevencion de its y de cancer de cuello uterino",numero de inyectables trimestrales suministrados,2015-10-01,0,0,9,2,0,11
EUREKA (SANTOS MERCADO),"anticoncepcion, prevencion de its y de cancer de cuello uterino",numero de inyectables trimestrales suministrados,2015-10-01,0,1,3,1,0,5
FERNANDEZ ALONSO,"anticoncepcion, prevencion de its y de cancer de cuello uterino",numero de inyectables trimestrales suministrados,2015-10-01,0,7,33,14,0,54
FILADELFIA,"anticoncepcion, prevencion de its y de cancer de cuello uterino",numero de inyectables trimestrales suministrados,2015-10-01,1,5,19,10,0,35
GENERAL SAAVEDRA,"anticoncepcion, prevencion de its y de cancer de cuello uterino",numero de inyectables trimestrales suministrados,2015-10-01,0,11,49,15,0,75
GRAL. J.J. PEREZ (CHARAZANI),"anticoncepcion, prevencion de its y de cancer de cuello uterino",numero de inyectables trimestrales suministrados,2015-10-01,0,4,12,17,0,33
GUANAY,"anticoncepcion, prevencion de its y de cancer de cuello uterino",numero de inyectables trimestrales suministrados,2015-10-01,0,1,15,9,1,26
GUAQUI,"anticoncepcion, prevencion de its y de cancer de cuello uterino",numero de inyectables trimestrales suministrados,2015-10-01,0,2,13,5,0,20
GUAYARAMERIN,"anticoncepcion, prevencion de its y de cancer de cuello uterino",numero de inyectables trimestrales suministrados,2015-10-01,0,8,18,1,0,27
GUTIERREZ,"anticoncepcion, prevencion de its y de cancer de cuello uterino",numero de inyectables trimestrales suministrados,2015-10-01,0,4,24,11,0,39
HUACARETA,"anticoncepcion, prevencion de its y de cancer de cuello uterino",numero de inyectables trimestrales suministrados,2015-10-01,0,8,21,21,1,51
HUACAYA (VILLA DE HUACAYA),"anticoncepcion, prevencion de its y de cancer de cuello uterino",numero de inyectables trimestrales suministrados,2015-10-01,0,1,15,3,0,19
HUACHACALLA,"anticoncepcion, prevencion de its y de cancer de cuello uterino",numero de inyectables trimestrales suministrados,2015-10-01,0,0,0,2,0,2
HUANUNI,"anticoncepcion, prevencion de its y de cancer de cuello uterino",numero de inyectables trimestrales suministrados,2015-10-01,0,1,19,9,0,29
HUARACAJE,"anticoncepcion, prevencion de its y de cancer de cuello uterino",numero de inyectables trimestrales suministrados,2015-10-01,0,1,9,1,0,11
HUARINA,"anticoncepcion, prevencion de its y de cancer de cuello uterino",numero de inyectables trimestrales suministrados,2015-10-01,0,1,6,6,0,13
HUATAJATA,"anticoncepcion, prevencion de its y de cancer de cuello uterino",numero de inyectables trimestrales suministrados,2015-10-01,0,0,3,4,0,7
HUAYLLAMARCA,"anticoncepcion, prevencion de its y de cancer de cuello uterino",numero de inyectables trimestrales suministrados,2015-10-01,0,0,8,5,1,14
HUMANATA,"anticoncepcion, prevencion de its y de cancer de cuello uterino",numero de inyectables trimestrales suministrados,2015-10-01,0,0,11,4,0,15
ICHOCA,"anticoncepcion, prevencion de its y de cancer de cuello uterino",numero de inyectables trimestrales suministrados,2015-10-01,0,1,3,5,0,9
ICLA,"anticoncepcion, prevencion de its y de cancer de cuello uterino",numero de inyectables trimestrales suministrados,2015-10-01,0,3,12,13,1,29
INCAHUASI,"anticoncepcion, prevencion de its y de cancer de cuello uterino",numero de inyectables trimestrales suministrados,2015-10-01,0,2,31,23,1,57
INGAVI (HUMAITA),"anticoncepcion, prevencion de its y de cancer de cuello uterino",numero de inyectables trimestrales suministrados,2015-10-01,0,1,11,0,0,12
INQUISIVI,"anticoncepcion, prevencion de its y de cancer de cuello uterino",numero de inyectables trimestrales suministrados,2015-10-01,0,1,30,15,0,46
IRUPANA (VILLA DE LANZA),"anticoncepcion, prevencion de its y de cancer de cuello uterino",numero de inyectables trimestrales suministrados,2015-10-01,0,3,52,15,0,70
IXIAMAS,"anticoncepcion, prevencion de its y de cancer de cuello uterino",numero de inyectables trimestrales suministrados,2015-10-01,0,6,23,8,0,37
JESUS DE MACHACA,"anticoncepcion, prevencion de its y de cancer de cuello uterino",numero de inyectables trimestrales suministrados,2015-10-01,0,3,14,9,0,26
LA ASUNTA,"anticoncepcion, prevencion de its y de cancer de cuello uterino",numero de inyectables trimestrales suministrados,2015-10-01,0,12,122,50,0,184
LA GUARDIA,"anticoncepcion, prevencion de its y de cancer de cuello uterino",numero de inyectables trimestrales suministrados,2015-10-01,0,30,113,32,0,175
LA PAZ,"anticoncepcion, prevencion de its y de cancer de cuello uterino",numero de inyectables trimestrales suministrados,2015-10-01,0,48,436,138,1,623
LA RIVERA,"anticoncepcion, prevencion de its y de cancer de cuello uterino",numero de inyectables trimestrales suministrados,2015-10-01,0,0,1,0,0,1
LAGUNILLAS,"anticoncepcion, prevencion de its y de cancer de cuello uterino",numero de inyectables trimestrales suministrados,2015-10-01,0,2,23,6,0,31
LAJA,"anticoncepcion, prevencion de its y de cancer de cuello uterino",numero de inyectables trimestrales suministrados,2015-10-01,0,7,48,19,1,75
LAS CARRERAS,"anticoncepcion, prevencion de its y de cancer de cuello uterino",numero de inyectables trimestrales suministrados,2015-10-01,0,2,9,4,0,15
LICOMA PAMPA,"anticoncepcion, prevencion de its y de cancer de cuello uterino",numero de inyectables trimestrales suministrados,2015-10-01,0,2,6,3,0,11
LLALLAGUA,"anticoncepcion, prevencion de its y de cancer de cuello uterino",numero de inyectables trimestrales suministrados,2015-10-01,0,9,73,16,0,98
LLICA,"anticoncepcion, prevencion de its y de cancer de cuello uterino",numero de inyectables trimestrales suministrados,2015-10-01,0,3,15,6,0,24
LORETO,"anticoncepcion, prevencion de its y de cancer de cuello uterino",numero de inyectables trimestrales suministrados,2015-10-01,0,2,1,0,0,3
LURIBAY,"anticoncepcion, prevencion de its y de cancer de cuello uterino",numero de inyectables trimestrales suministrados,2015-10-01,0,2,25,18,0,45
MACHACAMARCA,"anticoncepcion, prevencion de its y de cancer de cuello uterino",numero de inyectables trimestrales suministrados,2015-10-01,0,0,2,0,0,2
MACHARETI,"anticoncepcion, prevencion de its y de cancer de cuello uterino",numero de inyectables trimestrales suministrados,2015-10-01,0,4,41,23,0,68
MAGDALENA,"anticoncepcion, prevencion de its y de cancer de cuello uterino",numero de inyectables trimestrales suministrados,2015-10-01,0,9,41,7,0,57
MAIRANA,"anticoncepcion, prevencion de its y de cancer de cuello uterino",numero de inyectables trimestrales suministrados,2015-10-01,0,9,27,7,0,43
MALLA,"anticoncepcion, prevencion de its y de cancer de cuello uterino",numero de inyectables trimestrales suministrados,2015-10-01,0,0,4,4,0,8
MAPIRI,"anticoncepcion, prevencion de its y de cancer de cuello uterino",numero de inyectables trimestrales suministrados,2015-10-01,0,5,19,5,0,29
MECAPACA,"anticoncepcion, prevencion de its y de cancer de cuello uterino",numero de inyectables trimestrales suministrados,2015-10-01,0,0,19,17,0,36
MINEROS,"anticoncepcion, prevencion de its y de cancer de cuello uterino",numero de inyectables trimestrales suministrados,2015-10-01,0,8,57,15,0,80
MIZQUE,"anticoncepcion, prevencion de its y de cancer de cuello uterino",numero de inyectables trimestrales suministrados,2015-10-01,2,14,77,33,0,126
MOCOMOCO,"anticoncepcion, prevencion de its y de cancer de cuello uterino",numero de inyectables trimestrales suministrados,2015-10-01,0,3,20,16,0,39
MOJINETE,"anticoncepcion, prevencion de its y de cancer de cuello uterino",numero de inyectables trimestrales suministrados,2015-10-01,0,0,0,2,0,2
MOJOCOYA,"anticoncepcion, prevencion de its y de cancer de cuello uterino",numero de inyectables trimestrales suministrados,2015-10-01,0,5,26,23,1,55
MONTEAGUDO,"anticoncepcion, prevencion de its y de cancer de cuello uterino",numero de inyectables trimestrales suministrados,2015-10-01,1,7,59,39,0,106
MONTERO,"anticoncepcion, prevencion de its y de cancer de cuello uterino",numero de inyectables trimestrales suministrados,2015-10-01,1,39,166,42,0,248
MORO MORO,"anticoncepcion, prevencion de its y de cancer de cuello uterino",numero de inyectables trimestrales suministrados,2015-10-01,1,5,12,12,2,32
MOROCHATA,"anticoncepcion, prevencion de its y de cancer de cuello uterino",numero de inyectables trimestrales suministrados,2015-10-01,0,3,37,39,1,80
NACEBE (SANTA ROSA DEL ABUNA),"anticoncepcion, prevencion de its y de cancer de cuello uterino",numero de inyectables trimestrales suministrados,2015-10-01,0,2,15,2,0,19
NUEVO MANOA (NUEVA ESPERANZA),"anticoncepcion, prevencion de its y de cancer de cuello uterino",numero de inyectables trimestrales suministrados,2015-10-01,0,1,2,1,0,4
OCURI,"anticoncepcion, prevencion de its y de cancer de cuello uterino",numero de inyectables trimestrales suministrados,2015-10-01,0,4,22,16,0,42
OKINAWA,"anticoncepcion, prevencion de its y de cancer de cuello uterino",numero de inyectables trimestrales suministrados,2015-10-01,0,10,19,8,1,38
OMEREQUE,"anticoncepcion, prevencion de its y de cancer de cuello uterino",numero de inyectables trimestrales suministrados,2015-10-01,0,3,27,22,0,52
ORURO,"anticoncepcion, prevencion de its y de cancer de cuello uterino",numero de inyectables trimestrales suministrados,2015-10-01,0,29,521,189,2,741
PADCAYA,"anticoncepcion, prevencion de its y de cancer de cuello uterino",numero de inyectables trimestrales suministrados,2015-10-01,1,23,100,61,1,186
PADILLA,"anticoncepcion, prevencion de its y de cancer de cuello uterino",numero de inyectables trimestrales suministrados,2015-10-01,0,10,51,29,0,90
PAILON,"anticoncepcion, prevencion de its y de cancer de cuello uterino",numero de inyectables trimestrales suministrados,2015-10-01,3,13,39,10,0,65
PALCA,"anticoncepcion, prevencion de its y de cancer de cuello uterino",numero de inyectables trimestrales suministrados,2015-10-01,0,4,40,17,0,61
PALOS BLANCOS,"anticoncepcion, prevencion de its y de cancer de cuello uterino",numero de inyectables trimestrales suministrados,2015-10-01,0,10,76,48,0,134
PAMPA AULLAGAS,"anticoncepcion, prevencion de its y de cancer de cuello uterino",numero de inyectables trimestrales suministrados,2015-10-01,0,1,4,0,0,5
PAMPA GRANDE,"anticoncepcion, prevencion de its y de cancer de cuello uterino",numero de inyectables trimestrales suministrados,2015-10-01,0,3,35,8,1,47
PAPEL PAMPA,"anticoncepcion, prevencion de its y de cancer de cuello uterino",numero de inyectables trimestrales suministrados,2015-10-01,0,3,7,9,0,19
PASORAPA,"anticoncepcion, prevencion de its y de cancer de cuello uterino",numero de inyectables trimestrales suministrados,2015-10-01,0,4,10,15,1,30
PATACAMAYA,"anticoncepcion, prevencion de its y de cancer de cuello uterino",numero de inyectables trimestrales suministrados,2015-10-01,0,0,20,5,0,25
PAZÑA,"anticoncepcion, prevencion de its y de cancer de cuello uterino",numero de inyectables trimestrales suministrados,2015-10-01,0,0,14,8,0,22
PELECHUCO,"anticoncepcion, prevencion de its y de cancer de cuello uterino",numero de inyectables trimestrales suministrados,2015-10-01,0,0,22,7,0,29
POCOATA,"anticoncepcion, prevencion de its y de cancer de cuello uterino",numero de inyectables trimestrales suministrados,2015-10-01,0,4,21,16,0,41
POCONA,"anticoncepcion, prevencion de its y de cancer de cuello uterino",numero de inyectables trimestrales suministrados,2015-10-01,0,15,53,48,0,116
POJO (CBBA),"anticoncepcion, prevencion de its y de cancer de cuello uterino",numero de inyectables trimestrales suministrados,2015-10-01,0,17,77,34,1,129
POOPO,"anticoncepcion, prevencion de its y de cancer de cuello uterino",numero de inyectables trimestrales suministrados,2015-10-01,0,1,9,1,0,11
PORCO,"anticoncepcion, prevencion de its y de cancer de cuello uterino",numero de inyectables trimestrales suministrados,2015-10-01,0,3,21,4,0,28
POROMA,"anticoncepcion, prevencion de its y de cancer de cuello uterino",numero de inyectables trimestrales suministrados,2015-10-01,0,8,48,32,0,88
PORONGO,"anticoncepcion, prevencion de its y de cancer de cuello uterino",numero de inyectables trimestrales suministrados,2015-10-01,1,7,29,18,0,55
PORTACHUELO,"anticoncepcion, prevencion de its y de cancer de cuello uterino",numero de inyectables trimestrales suministrados,2015-10-01,0,10,44,10,0,64
PORVENIR,"anticoncepcion, prevencion de its y de cancer de cuello uterino",numero de inyectables trimestrales suministrados,2015-10-01,0,5,25,3,0,33
POSTRER VALLE,"anticoncepcion, prevencion de its y de cancer de cuello uterino",numero de inyectables trimestrales suministrados,2015-10-01,0,1,9,3,0,13
POTOSI,"anticoncepcion, prevencion de its y de cancer de cuello uterino",numero de inyectables trimestrales suministrados,2015-10-01,1,51,357,140,1,550
PRESTO,"anticoncepcion, prevencion de its y de cancer de cuello uterino",numero de inyectables trimestrales suministrados,2015-10-01,0,4,35,19,0,58
PUCARA,"anticoncepcion, prevencion de its y de cancer de cuello uterino",numero de inyectables trimestrales suministrados,2015-10-01,0,1,10,1,0,12
PUCARANI,"anticoncepcion, prevencion de its y de cancer de cuello uterino",numero de inyectables trimestrales suministrados,2015-10-01,1,12,63,40,0,116
PUERTO ACOSTA,"anticoncepcion, prevencion de its y de cancer de cuello uterino",numero de inyectables trimestrales suministrados,2015-10-01,0,3,7,3,0,13
PUERTO CARABUCO,"anticoncepcion, prevencion de its y de cancer de cuello uterino",numero de inyectables trimestrales suministrados,2015-10-01,0,0,11,13,0,24
PUERTO GONZALO MORENO,"anticoncepcion, prevencion de its y de cancer de cuello uterino",numero de inyectables trimestrales suministrados,2015-10-01,0,12,21,8,0,41
PUERTO PEREZ,"anticoncepcion, prevencion de its y de cancer de cuello uterino",numero de inyectables trimestrales suministrados,2015-10-01,0,0,8,8,1,17
PUERTO QUIJARRO,"anticoncepcion, prevencion de its y de cancer de cuello uterino",numero de inyectables trimestrales suministrados,2015-10-01,0,4,30,4,0,38
PUERTO RICO,"anticoncepcion, prevencion de its y de cancer de cuello uterino",numero de inyectables trimestrales suministrados,2015-10-01,0,0,4,3,0,7
PUERTO SUAREZ,"anticoncepcion, prevencion de its y de cancer de cuello uterino",numero de inyectables trimestrales suministrados,2015-10-01,0,1,11,0,0,12
PUERTO VILLARROEL,"anticoncepcion, prevencion de its y de cancer de cuello uterino",numero de inyectables trimestrales suministrados,2015-10-01,1,15,96,31,0,143
PUNA,"anticoncepcion, prevencion de its y de cancer de cuello uterino",numero de inyectables trimestrales suministrados,2015-10-01,0,1,13,9,0,23
PUNATA,"anticoncepcion, prevencion de its y de cancer de cuello uterino",numero de inyectables trimestrales suministrados,2015-10-01,0,10,56,23,0,89
QUIABAYA,"anticoncepcion, prevencion de its y de cancer de cuello uterino",numero de inyectables trimestrales suministrados,2015-10-01,0,0,10,5,0,15
QUILLACOLLO,"anticoncepcion, prevencion de its y de cancer de cuello uterino",numero de inyectables trimestrales suministrados,2015-10-01,1,23,196,46,0,266
QUIME,"anticoncepcion, prevencion de its y de cancer de cuello uterino",numero de inyectables trimestrales suministrados,2015-10-01,0,4,26,12,0,42
QUIRUSILLAS,"anticoncepcion, prevencion de its y de cancer de cuello uterino",numero de inyectables trimestrales suministrados,2015-10-01,0,1,5,5,0,11
RAVELO,"anticoncepcion, prevencion de its y de cancer de cuello uterino",numero de inyectables trimestrales suministrados,2015-10-01,0,8,43,33,0,84
REYES,"anticoncepcion, prevencion de its y de cancer de cuello uterino",numero de inyectables trimestrales suministrados,2015-10-01,0,10,26,10,0,46
RIBERALTA,"anticoncepcion, prevencion de its y de cancer de cuello uterino",numero de inyectables trimestrales suministrados,2015-10-01,1,44,176,23,0,244
ROBORE,"anticoncepcion, prevencion de its y de cancer de cuello uterino",numero de inyectables trimestrales suministrados,2015-10-01,1,5,28,2,0,36
RURRENABAQUE,"anticoncepcion, prevencion de its y de cancer de cuello uterino",numero de inyectables trimestrales suministrados,2015-10-01,1,6,46,12,0,65
SABAYA,"anticoncepcion, prevencion de its y de cancer de cuello uterino",numero de inyectables trimestrales suministrados,2015-10-01,0,2,9,4,0,15
SACABA,"anticoncepcion, prevencion de its y de cancer de cuello uterino",numero de inyectables trimestrales suministrados,2015-10-01,0,25,178,46,0,249
SACABAMBA,"anticoncepcion, prevencion de its y de cancer de cuello uterino",numero de inyectables trimestrales suministrados,2015-10-01,0,0,8,5,0,13
SACACA,"anticoncepcion, prevencion de its y de cancer de cuello uterino",numero de inyectables trimestrales suministrados,2015-10-01,0,5,50,25,0,80
SAIPINA,"anticoncepcion, prevencion de its y de cancer de cuello uterino",numero de inyectables trimestrales suministrados,2015-10-01,0,4,25,10,0,39
SALINAS DE GARCI MENDOZA,"anticoncepcion, prevencion de its y de cancer de cuello uterino",numero de inyectables trimestrales suministrados,2015-10-01,1,8,26,14,0,49
SAMAIPATA,"anticoncepcion, prevencion de its y de cancer de cuello uterino",numero de inyectables trimestrales suministrados,2015-10-01,0,10,35,6,0,51
SAN AGUSTIN,"anticoncepcion, prevencion de its y de cancer de cuello uterino",numero de inyectables trimestrales suministrados,2015-10-01,0,2,4,1,0,7
SAN ANDRES,"anticoncepcion, prevencion de its y de cancer de cuello uterino",numero de inyectables trimestrales suministrados,2015-10-01,1,9,35,14,0,59
SAN ANDRES DE MACHACA,"anticoncepcion, prevencion de its y de cancer de cuello uterino",numero de inyectables trimestrales suministrados,2015-10-01,0,0,5,3,0,8
SAN ANTONIO DE ESMORUCO,"anticoncepcion, prevencion de its y de cancer de cuello uterino",numero de inyectables trimestrales suministrados,2015-10-01,0,0,7,2,0,9
SAN ANTONIO DE LOMERIO,"anticoncepcion, prevencion de its y de cancer de cuello uterino",numero de inyectables trimestrales suministrados,2015-10-01,0,5,36,30,0,71
SAN BENITO,"anticoncepcion, prevencion de its y de cancer de cuello uterino",numero de inyectables trimestrales suministrados,2015-10-01,0,6,23,12,0,41
SAN BORJA,"anticoncepcion, prevencion de its y de cancer de cuello uterino",numero de inyectables trimestrales suministrados,2015-10-01,0,17,102,30,0,149
SAN BUENA VENTURA,"anticoncepcion, prevencion de its y de cancer de cuello uterino",numero de inyectables trimestrales suministrados,2015-10-01,0,3,32,8,0,43
SAN CARLOS,"anticoncepcion, prevencion de its y de cancer de cuello uterino",numero de inyectables trimestrales suministrados,2015-10-01,0,12,51,11,0,74
SAN IGNACIO,"anticoncepcion, prevencion de its y de cancer de cuello uterino",numero de inyectables trimestrales suministrados,2015-10-01,1,10,64,35,1,111
SAN IGNACIO DE VELASCO,"anticoncepcion, prevencion de its y de cancer de cuello uterino",numero de inyectables trimestrales suministrados,2015-10-01,1,19,115,45,0,180
SAN JAVIER(BNI),"anticoncepcion, prevencion de its y de cancer de cuello uterino",numero de inyectables trimestrales suministrados,2015-10-01,0,2,11,1,0,14
SAN JAVIER(STC),"anticoncepcion, prevencion de its y de cancer de cuello uterino",numero de inyectables trimestrales suministrados,2015-10-01,0,10,42,11,0,63
SAN JOAQUIN,"anticoncepcion, prevencion de its y de cancer de cuello uterino",numero de inyectables trimestrales suministrados,2015-10-01,0,1,3,1,0,5
SAN JOSE DE CHIQUITOS,"anticoncepcion, prevencion de its y de cancer de cuello uterino",numero de inyectables trimestrales suministrados,2015-10-01,0,7,27,13,0,47
SAN JUAN DE YAPACANI,"anticoncepcion, prevencion de its y de cancer de cuello uterino",numero de inyectables trimestrales suministrados,2015-10-01,0,2,25,6,0,33
SAN JULIAN,"anticoncepcion, prevencion de its y de cancer de cuello uterino",numero de inyectables trimestrales suministrados,2015-10-01,0,23,90,24,1,138
SAN LORENZO(PND),"anticoncepcion, prevencion de its y de cancer de cuello uterino",numero de inyectables trimestrales suministrados,2015-10-01,0,4,16,4,0,24
SAN LORENZO(TJA),"anticoncepcion, prevencion de its y de cancer de cuello uterino",numero de inyectables trimestrales suministrados,2015-10-01,1,13,76,49,1,140
SAN LUCAS,"anticoncepcion, prevencion de its y de cancer de cuello uterino",numero de inyectables trimestrales suministrados,2015-10-01,0,7,63,31,0,101
SAN MATIAS,"anticoncepcion, prevencion de its y de cancer de cuello uterino",numero de inyectables trimestrales suministrados,2015-10-01,0,8,35,15,0,58
SAN MIGUEL DE VELASCO,"anticoncepcion, prevencion de its y de cancer de cuello uterino",numero de inyectables trimestrales suministrados,2015-10-01,1,14,69,42,3,129
SAN PABLO DE LIPEZ,"anticoncepcion, prevencion de its y de cancer de cuello uterino",numero de inyectables trimestrales suministrados,2015-10-01,0,0,10,2,0,12
SAN PEDRO,"anticoncepcion, prevencion de its y de cancer de cuello uterino",numero de inyectables trimestrales suministrados,2015-10-01,2,9,42,16,0,69
SAN PEDRO DE BUENA VISTA,"anticoncepcion, prevencion de its y de cancer de cuello uterino",numero de inyectables trimestrales suministrados,2015-10-01,1,4,32,27,0,64
SAN PEDRO DE CURAHUARA,"anticoncepcion, prevencion de its y de cancer de cuello uterino",numero de inyectables trimestrales suministrados,2015-10-01,0,3,10,9,0,22
SAN PEDRO DE QUEMES,"anticoncepcion, prevencion de its y de cancer de cuello uterino",numero de inyectables trimestrales suministrados,2015-10-01,0,0,1,0,0,1
SAN PEDRO DE TIQUINA,"anticoncepcion, prevencion de its y de cancer de cuello uterino",numero de inyectables trimestrales suministrados,2015-10-01,0,0,6,1,0,7
SAN PEDRO(PND),"anticoncepcion, prevencion de its y de cancer de cuello uterino",numero de inyectables trimestrales suministrados,2015-10-01,0,0,1,0,0,1
SAN RAFAEL,"anticoncepcion, prevencion de its y de cancer de cuello uterino",numero de inyectables trimestrales suministrados,2015-10-01,0,9,35,13,0,57
SAN RAMON BENI,"anticoncepcion, prevencion de its y de cancer de cuello uterino",numero de inyectables trimestrales suministrados,2015-10-01,0,2,4,1,0,7
SAN RAMON SCZ,"anticoncepcion, prevencion de its y de cancer de cuello uterino",numero de inyectables trimestrales suministrados,2015-10-01,0,13,36,9,0,58
SANTA ANA,"anticoncepcion, prevencion de its y de cancer de cuello uterino",numero de inyectables trimestrales suministrados,2015-10-01,0,1,9,0,0,10
SANTA CRUZ DE LA SIERRA,"anticoncepcion, prevencion de its y de cancer de cuello uterino",numero de inyectables trimestrales suministrados,2015-10-01,7,157,516,112,3,795
SANTA ROSA DEL SARA,"anticoncepcion, prevencion de its y de cancer de cuello uterino",numero de inyectables trimestrales suministrados,2015-10-01,2,7,48,24,1,82
SANTIAGO DE CALLAPA,"anticoncepcion, prevencion de its y de cancer de cuello uterino",numero de inyectables trimestrales suministrados,2015-10-01,0,0,2,3,0,5
SANTIAGO DE HUARI,"anticoncepcion, prevencion de its y de cancer de cuello uterino",numero de inyectables trimestrales suministrados,2015-10-01,0,1,8,6,0,15
SANTIAGO DE HUATA,"anticoncepcion, prevencion de its y de cancer de cuello uterino",numero de inyectables trimestrales suministrados,2015-10-01,0,0,8,2,0,10
SANTIAGO DE MACHACA,"anticoncepcion, prevencion de its y de cancer de cuello uterino",numero de inyectables trimestrales suministrados,2015-10-01,0,2,8,2,0,12
SANTIVAÑES,"anticoncepcion, prevencion de its y de cancer de cuello uterino",numero de inyectables trimestrales suministrados,2015-10-01,0,1,21,8,0,30
SANTUARIO DE QUILLACAS,"anticoncepcion, prevencion de its y de cancer de cuello uterino",numero de inyectables trimestrales suministrados,2015-10-01,0,1,11,4,0,16
SAPAHAQUI,"anticoncepcion, prevencion de its y de cancer de cuello uterino",numero de inyectables trimestrales suministrados,2015-10-01,0,3,15,16,0,34
SENA,"anticoncepcion, prevencion de its y de cancer de cuello uterino",numero de inyectables trimestrales suministrados,2015-10-01,0,7,33,2,0,42
SHINAOTA,"anticoncepcion, prevencion de its y de cancer de cuello uterino",numero de inyectables trimestrales suministrados,2015-10-01,0,6,43,7,0,56
SICA SICA (VILLA AROMA),"anticoncepcion, prevencion de its y de cancer de cuello uterino",numero de inyectables trimestrales suministrados,2015-10-01,0,3,49,36,0,88
SICAYA,"anticoncepcion, prevencion de its y de cancer de cuello uterino",numero de inyectables trimestrales suministrados,2015-10-01,0,1,5,5,0,11
SIPE SIPE,"anticoncepcion, prevencion de its y de cancer de cuello uterino",numero de inyectables trimestrales suministrados,2015-10-01,0,22,177,71,0,270
SOPACHUY,"anticoncepcion, prevencion de its y de cancer de cuello uterino",numero de inyectables trimestrales suministrados,2015-10-01,0,4,15,23,0,42
SORACACHI,"anticoncepcion, prevencion de its y de cancer de cuello uterino",numero de inyectables trimestrales suministrados,2015-10-01,0,3,19,14,0,36
SORATA,"anticoncepcion, prevencion de its y de cancer de cuello uterino",numero de inyectables trimestrales suministrados,2015-10-01,0,4,29,20,0,53
SUCRE,"anticoncepcion, prevencion de its y de cancer de cuello uterino",numero de inyectables trimestrales suministrados,2015-10-01,0,85,508,172,2,767
TACACHI,"anticoncepcion, prevencion de its y de cancer de cuello uterino",numero de inyectables trimestrales suministrados,2015-10-01,0,0,5,0,0,5
TACACOMA,"anticoncepcion, prevencion de its y de cancer de cuello uterino",numero de inyectables trimestrales suministrados,2015-10-01,0,4,32,12,0,48
TACOBAMBA,"anticoncepcion, prevencion de its y de cancer de cuello uterino",numero de inyectables trimestrales suministrados,2015-10-01,0,3,19,13,0,35
TACOPAYA,"anticoncepcion, prevencion de its y de cancer de cuello uterino",numero de inyectables trimestrales suministrados,2015-10-01,0,0,6,9,0,15
TAHUA,"anticoncepcion, prevencion de its y de cancer de cuello uterino",numero de inyectables trimestrales suministrados,2015-10-01,0,0,5,1,0,6
TAPACARI,"anticoncepcion, prevencion de its y de cancer de cuello uterino",numero de inyectables trimestrales suministrados,2015-10-01,0,7,68,49,0,124
TARABUCO,"anticoncepcion, prevencion de its y de cancer de cuello uterino",numero de inyectables trimestrales suministrados,2015-10-01,0,3,32,32,0,67
TARACO,"anticoncepcion, prevencion de its y de cancer de cuello uterino",numero de inyectables trimestrales suministrados,2015-10-01,0,2,14,10,0,26
TARATA,"anticoncepcion, prevencion de its y de cancer de cuello uterino",numero de inyectables trimestrales suministrados,2015-10-01,0,4,26,11,0,41
TARIJA,"anticoncepcion, prevencion de its y de cancer de cuello uterino",numero de inyectables trimestrales suministrados,2015-10-01,1,39,126,69,0,235
TARVITA,"anticoncepcion, prevencion de its y de cancer de cuello uterino",numero de inyectables trimestrales suministrados,2015-10-01,0,7,20,23,1,51
TEOPONTE,"anticoncepcion, prevencion de its y de cancer de cuello uterino",numero de inyectables trimestrales suministrados,2015-10-01,0,9,28,5,0,42
TIAWANACU,"anticoncepcion, prevencion de its y de cancer de cuello uterino",numero de inyectables trimestrales suministrados,2015-10-01,0,3,26,23,0,52
TINGUIPAYA,"anticoncepcion, prevencion de its y de cancer de cuello uterino",numero de inyectables trimestrales suministrados,2015-10-01,0,3,18,17,0,38
TIPUANI,"anticoncepcion, prevencion de its y de cancer de cuello uterino",numero de inyectables trimestrales suministrados,2015-10-01,0,3,18,6,0,27
TIQUIPAYA,"anticoncepcion, prevencion de its y de cancer de cuello uterino",numero de inyectables trimestrales suministrados,2015-10-01,0,16,102,26,0,144
TIRAQUE (CBBA),"anticoncepcion, prevencion de its y de cancer de cuello uterino",numero de inyectables trimestrales suministrados,2015-10-01,0,11,53,34,0,98
TITO YUPANQUI (PARQUIPUJIO),"anticoncepcion, prevencion de its y de cancer de cuello uterino",numero de inyectables trimestrales suministrados,2015-10-01,0,0,1,0,0,1
TOCO,"anticoncepcion, prevencion de its y de cancer de cuello uterino",numero de inyectables trimestrales suministrados,2015-10-01,0,3,11,9,1,24
TOLATA,"anticoncepcion, prevencion de its y de cancer de cuello uterino",numero de inyectables trimestrales suministrados,2015-10-01,0,6,23,8,0,37
TOLEDO,"anticoncepcion, prevencion de its y de cancer de cuello uterino",numero de inyectables trimestrales suministrados,2015-10-01,0,0,3,7,0,10
TOMAVE,"anticoncepcion, prevencion de its y de cancer de cuello uterino",numero de inyectables trimestrales suministrados,2015-10-01,0,1,31,16,0,48
TOMINA,"anticoncepcion, prevencion de its y de cancer de cuello uterino",numero de inyectables trimestrales suministrados,2015-10-01,0,2,40,30,0,72
TORO TORO,"anticoncepcion, prevencion de its y de cancer de cuello uterino",numero de inyectables trimestrales suministrados,2015-10-01,0,8,18,13,0,39
TOTORA(CBBA),"anticoncepcion, prevencion de its y de cancer de cuello uterino",numero de inyectables trimestrales suministrados,2015-10-01,0,24,66,29,0,119
TOTORA(ORR),"anticoncepcion, prevencion de its y de cancer de cuello uterino",numero de inyectables trimestrales suministrados,2015-10-01,0,4,13,6,1,24
TRIGAL,"anticoncepcion, prevencion de its y de cancer de cuello uterino",numero de inyectables trimestrales suministrados,2015-10-01,0,1,10,2,0,13
TRINIDAD,"anticoncepcion, prevencion de its y de cancer de cuello uterino",numero de inyectables trimestrales suministrados,2015-10-01,0,21,58,6,0,85
TUPIZA,"anticoncepcion, prevencion de its y de cancer de cuello uterino",numero de inyectables trimestrales suministrados,2015-10-01,0,18,123,43,0,184
TURCO,"anticoncepcion, prevencion de its y de cancer de cuello uterino",numero de inyectables trimestrales suministrados,2015-10-01,0,2,5,4,0,11
UMALA,"anticoncepcion, prevencion de its y de cancer de cuello uterino",numero de inyectables trimestrales suministrados,2015-10-01,0,2,9,9,0,20
UNCIA,"anticoncepcion, prevencion de its y de cancer de cuello uterino",numero de inyectables trimestrales suministrados,2015-10-01,0,7,49,26,0,82
URIONDO (A. CONCEPCION),"anticoncepcion, prevencion de its y de cancer de cuello uterino",numero de inyectables trimestrales suministrados,2015-10-01,0,9,60,46,0,115
URUBICHA,"anticoncepcion, prevencion de its y de cancer de cuello uterino",numero de inyectables trimestrales suministrados,2015-10-01,0,1,10,7,0,18
UYUNI,"anticoncepcion, prevencion de its y de cancer de cuello uterino",numero de inyectables trimestrales suministrados,2015-10-01,0,3,45,13,0,61
VACAS,"anticoncepcion, prevencion de its y de cancer de cuello uterino",numero de inyectables trimestrales suministrados,2015-10-01,0,8,27,18,0,53
VALLEGRANDE,"anticoncepcion, prevencion de its y de cancer de cuello uterino",numero de inyectables trimestrales suministrados,2015-10-01,0,19,57,15,0,91
VIACHA,"anticoncepcion, prevencion de its y de cancer de cuello uterino",numero de inyectables trimestrales suministrados,2015-10-01,0,20,197,64,2,283
VILA VILA,"anticoncepcion, prevencion de its y de cancer de cuello uterino",numero de inyectables trimestrales suministrados,2015-10-01,0,0,7,6,0,13
VILLA CHARCAS,"anticoncepcion, prevencion de its y de cancer de cuello uterino",numero de inyectables trimestrales suministrados,2015-10-01,0,9,49,35,0,93
VILLA MONTES,"anticoncepcion, prevencion de its y de cancer de cuello uterino",numero de inyectables trimestrales suministrados,2015-10-01,1,22,94,28,0,145
VILLA NUEVA (LOMA ALTA),"anticoncepcion, prevencion de its y de cancer de cuello uterino",numero de inyectables trimestrales suministrados,2015-10-01,0,2,8,2,0,12
VILLA RIVERO,"anticoncepcion, prevencion de its y de cancer de cuello uterino",numero de inyectables trimestrales suministrados,2015-10-01,0,3,27,10,0,40
VILLA SERRANO,"anticoncepcion, prevencion de its y de cancer de cuello uterino",numero de inyectables trimestrales suministrados,2015-10-01,0,8,28,26,2,64
VILLA TUNARI,"anticoncepcion, prevencion de its y de cancer de cuello uterino",numero de inyectables trimestrales suministrados,2015-10-01,0,63,371,120,0,554
VILLA VACA GUZMAN (MUYUPAMPA),"anticoncepcion, prevencion de its y de cancer de cuello uterino",numero de inyectables trimestrales suministrados,2015-10-01,0,3,38,21,0,62
VILLAZON,"anticoncepcion, prevencion de its y de cancer de cuello uterino",numero de inyectables trimestrales suministrados,2015-10-01,0,16,110,52,0,178
VINTO,"anticoncepcion, prevencion de its y de cancer de cuello uterino",numero de inyectables trimestrales suministrados,2015-10-01,0,9,72,13,0,94
VITICHI,"anticoncepcion, prevencion de its y de cancer de cuello uterino",numero de inyectables trimestrales suministrados,2015-10-01,0,0,18,14,0,32
WALDO BALLIVIAN,"anticoncepcion, prevencion de its y de cancer de cuello uterino",numero de inyectables trimestrales suministrados,2015-10-01,0,0,0,2,0,2
WARNES,"anticoncepcion, prevencion de its y de cancer de cuello uterino",numero de inyectables trimestrales suministrados,2015-10-01,4,35,204,46,1,290
YACO,"anticoncepcion, prevencion de its y de cancer de cuello uterino",numero de inyectables trimestrales suministrados,2015-10-01,0,1,13,4,0,18
YACUIBA,"anticoncepcion, prevencion de its y de cancer de cuello uterino",numero de inyectables trimestrales suministrados,2015-10-01,1,43,225,101,0,370
YAMPARAEZ,"anticoncepcion, prevencion de its y de cancer de cuello uterino",numero de inyectables trimestrales suministrados,2015-10-01,0,1,8,10,0,19
YANACACHI,"anticoncepcion, prevencion de its y de cancer de cuello uterino",numero de inyectables trimestrales suministrados,2015-10-01,0,1,28,10,0,39
YAPACANI,"anticoncepcion, prevencion de its y de cancer de cuello uterino",numero de inyectables trimestrales suministrados,2015-10-01,0,14,75,15,0,104
YOCALLA,"anticoncepcion, prevencion de its y de cancer de cuello uterino",numero de inyectables trimestrales suministrados,2015-10-01,0,1,10,1,0,12
YOTALA,"anticoncepcion, prevencion de its y de cancer de cuello uterino",numero de inyectables trimestrales suministrados,2015-10-01,1,2,13,9,1,26
YUNCHARA,"anticoncepcion, prevencion de its y de cancer de cuello uterino",numero de inyectables trimestrales suministrados,2015-10-01,1,6,38,19,0,64
YUNGUYO DE LITORAL,"anticoncepcion, prevencion de its y de cancer de cuello uterino",numero de inyectables trimestrales suministrados,2015-10-01,0,0,0,1,0,1
ZUDAÑEZ,"anticoncepcion, prevencion de its y de cancer de cuello uterino",numero de inyectables trimestrales suministrados,2015-10-01,0,6,37,25,0,68
ACACIO,"anticoncepcion, prevencion de its y de cancer de cuello uterino",numero de inyectables trimestrales suministrados,2015-11-01,0,3,11,7,0,21
ACHACACHI,"anticoncepcion, prevencion de its y de cancer de cuello uterino",numero de inyectables trimestrales suministrados,2015-11-01,0,6,57,36,1,100
ACHOCALLA,"anticoncepcion, prevencion de its y de cancer de cuello uterino",numero de inyectables trimestrales suministrados,2015-11-01,0,19,27,14,0,60
AIQUILE,"anticoncepcion, prevencion de its y de cancer de cuello uterino",numero de inyectables trimestrales suministrados,2015-11-01,0,4,44,29,0,77
ALALAY,"anticoncepcion, prevencion de its y de cancer de cuello uterino",numero de inyectables trimestrales suministrados,2015-11-01,0,1,7,3,0,11
ALCALA,"anticoncepcion, prevencion de its y de cancer de cuello uterino",numero de inyectables trimestrales suministrados,2015-11-01,0,4,17,9,0,30
ALTO BENI,"anticoncepcion, prevencion de its y de cancer de cuello uterino",numero de inyectables trimestrales suministrados,2015-11-01,0,4,17,12,0,33
ANCORAIMES,"anticoncepcion, prevencion de its y de cancer de cuello uterino",numero de inyectables trimestrales suministrados,2015-11-01,0,3,9,3,0,15
ANDAMARCA,"anticoncepcion, prevencion de its y de cancer de cuello uterino",numero de inyectables trimestrales suministrados,2015-11-01,0,0,6,8,0,14
ANTEQUERA,"anticoncepcion, prevencion de its y de cancer de cuello uterino",numero de inyectables trimestrales suministrados,2015-11-01,0,0,3,3,0,6
ANZALDO,"anticoncepcion, prevencion de its y de cancer de cuello uterino",numero de inyectables trimestrales suministrados,2015-11-01,0,3,28,17,0,48
APOLO,"anticoncepcion, prevencion de its y de cancer de cuello uterino",numero de inyectables trimestrales suministrados,2015-11-01,0,2,35,31,0,68
ARAMPAMPA,"anticoncepcion, prevencion de its y de cancer de cuello uterino",numero de inyectables trimestrales suministrados,2015-11-01,1,0,7,6,5,19
ARANI,"anticoncepcion, prevencion de its y de cancer de cuello uterino",numero de inyectables trimestrales suministrados,2015-11-01,0,0,16,9,0,25
ARBIETO,"anticoncepcion, prevencion de its y de cancer de cuello uterino",numero de inyectables trimestrales suministrados,2015-11-01,0,8,51,19,0,78
ARQUE,"anticoncepcion, prevencion de its y de cancer de cuello uterino",numero de inyectables trimestrales suministrados,2015-11-01,0,4,41,31,0,76
ASCENCION DE GUARAYOS,"anticoncepcion, prevencion de its y de cancer de cuello uterino",numero de inyectables trimestrales suministrados,2015-11-01,0,8,44,14,0,66
ATOCHA,"anticoncepcion, prevencion de its y de cancer de cuello uterino",numero de inyectables trimestrales suministrados,2015-11-01,0,1,30,18,0,49
AUCAPATA,"anticoncepcion, prevencion de its y de cancer de cuello uterino",numero de inyectables trimestrales suministrados,2015-11-01,0,1,13,5,0,19
AYATA,"anticoncepcion, prevencion de its y de cancer de cuello uterino",numero de inyectables trimestrales suministrados,2015-11-01,0,2,33,27,0,62
AYO AYO,"anticoncepcion, prevencion de its y de cancer de cuello uterino",numero de inyectables trimestrales suministrados,2015-11-01,0,2,10,8,0,20
AYOPAYA (V. DE INDEPENDENCIA),"anticoncepcion, prevencion de its y de cancer de cuello uterino",numero de inyectables trimestrales suministrados,2015-11-01,0,11,94,57,0,162
AZURDUY,"anticoncepcion, prevencion de its y de cancer de cuello uterino",numero de inyectables trimestrales suministrados,2015-11-01,1,10,37,33,2,83
BATALLAS,"anticoncepcion, prevencion de its y de cancer de cuello uterino",numero de inyectables trimestrales suministrados,2015-11-01,0,3,38,20,0,61
BAURES,"anticoncepcion, prevencion de its y de cancer de cuello uterino",numero de inyectables trimestrales suministrados,2015-11-01,0,2,9,3,0,14
BELEN DE ANDAMARCA,"anticoncepcion, prevencion de its y de cancer de cuello uterino",numero de inyectables trimestrales suministrados,2015-11-01,0,0,0,1,0,1
BELEN DE URMIRI,"anticoncepcion, prevencion de its y de cancer de cuello uterino",numero de inyectables trimestrales suministrados,2015-11-01,0,0,1,0,0,1
BELLA FLOR,"anticoncepcion, prevencion de its y de cancer de cuello uterino",numero de inyectables trimestrales suministrados,2015-11-01,0,2,9,8,1,20
BERMEJO,"anticoncepcion, prevencion de its y de cancer de cuello uterino",numero de inyectables trimestrales suministrados,2015-11-01,2,15,76,27,0,120
BETANZOS,"anticoncepcion, prevencion de its y de cancer de cuello uterino",numero de inyectables trimestrales suministrados,2015-11-01,0,1,51,34,6,92
BOLIVAR,"anticoncepcion, prevencion de its y de cancer de cuello uterino",numero de inyectables trimestrales suministrados,2015-11-01,0,0,13,10,0,23
BOLPEBRA,"anticoncepcion, prevencion de its y de cancer de cuello uterino",numero de inyectables trimestrales suministrados,2015-11-01,1,1,9,3,0,14
BOYUIBE,"anticoncepcion, prevencion de its y de cancer de cuello uterino",numero de inyectables trimestrales suministrados,2015-11-01,0,1,6,3,0,10
BUENA VISTA,"anticoncepcion, prevencion de its y de cancer de cuello uterino",numero de inyectables trimestrales suministrados,2015-11-01,0,7,23,16,0,46
CABEZAS,"anticoncepcion, prevencion de its y de cancer de cuello uterino",numero de inyectables trimestrales suministrados,2015-11-01,2,20,105,18,0,145
CAIROMA,"anticoncepcion, prevencion de its y de cancer de cuello uterino",numero de inyectables trimestrales suministrados,2015-11-01,0,4,26,15,0,45
"CAIZA ""D""","anticoncepcion, prevencion de its y de cancer de cuello uterino",numero de inyectables trimestrales suministrados,2015-11-01,0,0,11,5,0,16
CAJUATA,"anticoncepcion, prevencion de its y de cancer de cuello uterino",numero de inyectables trimestrales suministrados,2015-11-01,0,3,30,8,0,41
CALACOTO,"anticoncepcion, prevencion de its y de cancer de cuello uterino",numero de inyectables trimestrales suministrados,2015-11-01,0,2,1,3,0,6
CALAMARCA,"anticoncepcion, prevencion de its y de cancer de cuello uterino",numero de inyectables trimestrales suministrados,2015-11-01,0,5,39,19,1,64
CAMARGO,"anticoncepcion, prevencion de its y de cancer de cuello uterino",numero de inyectables trimestrales suministrados,2015-11-01,0,3,33,19,0,55
CAMATAQUI (C. VILLA ABECIA),"anticoncepcion, prevencion de its y de cancer de cuello uterino",numero de inyectables trimestrales suministrados,2015-11-01,0,1,9,8,0,18
CAMIRI,"anticoncepcion, prevencion de its y de cancer de cuello uterino",numero de inyectables trimestrales suministrados,2015-11-01,0,14,50,9,0,73
CAPINOTA,"anticoncepcion, prevencion de its y de cancer de cuello uterino",numero de inyectables trimestrales suministrados,2015-11-01,0,7,46,26,0,79
CAQUIAVIRI,"anticoncepcion, prevencion de its y de cancer de cuello uterino",numero de inyectables trimestrales suministrados,2015-11-01,0,1,20,11,0,32
CARACOLLO,"anticoncepcion, prevencion de its y de cancer de cuello uterino",numero de inyectables trimestrales suministrados,2015-11-01,0,0,35,21,0,56
CARANAVI,"anticoncepcion, prevencion de its y de cancer de cuello uterino",numero de inyectables trimestrales suministrados,2015-11-01,0,11,100,58,0,169
CARANGAS,"anticoncepcion, prevencion de its y de cancer de cuello uterino",numero de inyectables trimestrales suministrados,2015-11-01,0,1,0,0,0,1
CARAPARI,"anticoncepcion, prevencion de its y de cancer de cuello uterino",numero de inyectables trimestrales suministrados,2015-11-01,1,9,48,23,0,81
CARIPUYO,"anticoncepcion, prevencion de its y de cancer de cuello uterino",numero de inyectables trimestrales suministrados,2015-11-01,0,1,11,7,0,19
CARMEN RIVERO TORREZ,"anticoncepcion, prevencion de its y de cancer de cuello uterino",numero de inyectables trimestrales suministrados,2015-11-01,0,2,5,3,0,10
CATACORA,"anticoncepcion, prevencion de its y de cancer de cuello uterino",numero de inyectables trimestrales suministrados,2015-11-01,0,0,1,1,0,2
CHACARILLA,"anticoncepcion, prevencion de its y de cancer de cuello uterino",numero de inyectables trimestrales suministrados,2015-11-01,0,1,5,2,0,8
CHALLAPATA,"anticoncepcion, prevencion de its y de cancer de cuello uterino",numero de inyectables trimestrales suministrados,2015-11-01,0,5,35,15,0,55
CHAQUI,"anticoncepcion, prevencion de its y de cancer de cuello uterino",numero de inyectables trimestrales suministrados,2015-11-01,0,2,25,10,0,37
CHARAGUA,"anticoncepcion, prevencion de its y de cancer de cuello uterino",numero de inyectables trimestrales suministrados,2015-11-01,0,6,40,33,0,79
CHARAÑA,"anticoncepcion, prevencion de its y de cancer de cuello uterino",numero de inyectables trimestrales suministrados,2015-11-01,0,0,3,2,0,5
CHAYANTA,"anticoncepcion, prevencion de its y de cancer de cuello uterino",numero de inyectables trimestrales suministrados,2015-11-01,0,5,26,17,0,48
CHIMORE,"anticoncepcion, prevencion de its y de cancer de cuello uterino",numero de inyectables trimestrales suministrados,2015-11-01,0,9,54,18,0,81
CHIPAYA,"anticoncepcion, prevencion de its y de cancer de cuello uterino",numero de inyectables trimestrales suministrados,2015-11-01,2,7,6,1,0,16
CHOQUE COTA,"anticoncepcion, prevencion de its y de cancer de cuello uterino",numero de inyectables trimestrales suministrados,2015-11-01,0,0,3,2,0,5
CHUA COCANI,"anticoncepcion, prevencion de its y de cancer de cuello uterino",numero de inyectables trimestrales suministrados,2015-11-01,0,1,7,1,0,9
CHULUMANI (V. DE LA LIBERTAD),"anticoncepcion, prevencion de its y de cancer de cuello uterino",numero de inyectables trimestrales suministrados,2015-11-01,0,2,21,13,0,36
CHUMA,"anticoncepcion, prevencion de its y de cancer de cuello uterino",numero de inyectables trimestrales suministrados,2015-11-01,0,5,28,26,0,59
CHUQUIHUTA AYLLU JUCUMANI,"anticoncepcion, prevencion de its y de cancer de cuello uterino",numero de inyectables trimestrales suministrados,2015-11-01,0,1,25,12,0,38
CKOCHAS,"anticoncepcion, prevencion de its y de cancer de cuello uterino",numero de inyectables trimestrales suministrados,2015-11-01,0,3,17,23,0,43
CLIZA,"anticoncepcion, prevencion de its y de cancer de cuello uterino",numero de inyectables trimestrales suministrados,2015-11-01,1,4,51,7,0,63
COBIJA,"anticoncepcion, prevencion de its y de cancer de cuello uterino",numero de inyectables trimestrales suministrados,2015-11-01,2,21,84,25,1,133
COCAPATA,"anticoncepcion, prevencion de its y de cancer de cuello uterino",numero de inyectables trimestrales suministrados,2015-11-01,0,21,82,44,0,147
COCHABAMBA,"anticoncepcion, prevencion de its y de cancer de cuello uterino",numero de inyectables trimestrales suministrados,2015-11-01,0,65,429,87,2,583
COIPASA,"anticoncepcion, prevencion de its y de cancer de cuello uterino",numero de inyectables trimestrales suministrados,2015-11-01,0,0,0,3,0,3
COLCAPIRHUA,"anticoncepcion, prevencion de its y de cancer de cuello uterino",numero de inyectables trimestrales suministrados,2015-11-01,0,4,70,12,0,86
"COLCHA ""K""","anticoncepcion, prevencion de its y de cancer de cuello uterino",numero de inyectables trimestrales suministrados,2015-11-01,0,7,40,19,1,67
COLLANA,"anticoncepcion, prevencion de its y de cancer de cuello uterino",numero de inyectables trimestrales suministrados,2015-11-01,0,0,9,3,0,12
COLOMI,"anticoncepcion, prevencion de its y de cancer de cuello uterino",numero de inyectables trimestrales suministrados,2015-11-01,0,10,65,15,0,90
COLPA BELGICA,"anticoncepcion, prevencion de its y de cancer de cuello uterino",numero de inyectables trimestrales suministrados,2015-11-01,0,3,6,3,0,12
COLQUECHACA,"anticoncepcion, prevencion de its y de cancer de cuello uterino",numero de inyectables trimestrales suministrados,2015-11-01,0,8,54,34,1,97
COLQUENCHA,"anticoncepcion, prevencion de its y de cancer de cuello uterino",numero de inyectables trimestrales suministrados,2015-11-01,0,3,20,11,0,34
COLQUIRI,"anticoncepcion, prevencion de its y de cancer de cuello uterino",numero de inyectables trimestrales suministrados,2015-11-01,0,1,28,12,0,41
COMANCHE,"anticoncepcion, prevencion de its y de cancer de cuello uterino",numero de inyectables trimestrales suministrados,2015-11-01,0,1,3,0,0,4
COMARAPA,"anticoncepcion, prevencion de its y de cancer de cuello uterino",numero de inyectables trimestrales suministrados,2015-11-01,0,15,59,31,0,105
COMBAYA,"anticoncepcion, prevencion de its y de cancer de cuello uterino",numero de inyectables trimestrales suministrados,2015-11-01,0,1,6,1,0,8
CONCEPCION,"anticoncepcion, prevencion de its y de cancer de cuello uterino",numero de inyectables trimestrales suministrados,2015-11-01,0,7,34,6,0,47
COPACABANA,"anticoncepcion, prevencion de its y de cancer de cuello uterino",numero de inyectables trimestrales suministrados,2015-11-01,0,3,25,20,0,48
CORIPATA,"anticoncepcion, prevencion de its y de cancer de cuello uterino",numero de inyectables trimestrales suministrados,2015-11-01,0,5,35,12,0,52
CORO CORO,"anticoncepcion, prevencion de its y de cancer de cuello uterino",numero de inyectables trimestrales suministrados,2015-11-01,0,0,12,1,0,13
COROICO,"anticoncepcion, prevencion de its y de cancer de cuello uterino",numero de inyectables trimestrales suministrados,2015-11-01,0,2,16,5,0,23
CORQUE,"anticoncepcion, prevencion de its y de cancer de cuello uterino",numero de inyectables trimestrales suministrados,2015-11-01,0,0,8,5,0,13
COTAGAITA,"anticoncepcion, prevencion de its y de cancer de cuello uterino",numero de inyectables trimestrales suministrados,2015-11-01,0,0,57,32,1,90
COTOCA,"anticoncepcion, prevencion de its y de cancer de cuello uterino",numero de inyectables trimestrales suministrados,2015-11-01,0,20,95,38,0,153
CRUZ DE MACHACAMARCA,"anticoncepcion, prevencion de its y de cancer de cuello uterino",numero de inyectables trimestrales suministrados,2015-11-01,0,0,1,0,0,1
CUATRO CAÑADAS,"anticoncepcion, prevencion de its y de cancer de cuello uterino",numero de inyectables trimestrales suministrados,2015-11-01,3,18,29,15,0,65
CUCHUMUELA (V. G. VILLARROEL),"anticoncepcion, prevencion de its y de cancer de cuello uterino",numero de inyectables trimestrales suministrados,2015-11-01,0,1,9,2,0,12
CUEVO,"anticoncepcion, prevencion de its y de cancer de cuello uterino",numero de inyectables trimestrales suministrados,2015-11-01,0,0,12,6,0,18
CULPINA,"anticoncepcion, prevencion de its y de cancer de cuello uterino",numero de inyectables trimestrales suministrados,2015-11-01,0,7,65,41,0,113
CURAHUARA DE CARANGAS,"anticoncepcion, prevencion de its y de cancer de cuello uterino",numero de inyectables trimestrales suministrados,2015-11-01,0,1,12,7,0,20
CURVA,"anticoncepcion, prevencion de its y de cancer de cuello uterino",numero de inyectables trimestrales suministrados,2015-11-01,0,0,10,1,0,11
DESAGUADERO,"anticoncepcion, prevencion de its y de cancer de cuello uterino",numero de inyectables trimestrales suministrados,2015-11-01,0,0,16,5,0,21
EL ALTO,"anticoncepcion, prevencion de its y de cancer de cuello uterino",numero de inyectables trimestrales suministrados,2015-11-01,0,81,877,334,3,1295
EL CHORO,"anticoncepcion, prevencion de its y de cancer de cuello uterino",numero de inyectables trimestrales suministrados,2015-11-01,0,1,12,4,0,17
EL PUENTE(STC),"anticoncepcion, prevencion de its y de cancer de cuello uterino",numero de inyectables trimestrales suministrados,2015-11-01,1,21,35,12,0,69
EL PUENTE(TJA),"anticoncepcion, prevencion de its y de cancer de cuello uterino",numero de inyectables trimestrales suministrados,2015-11-01,0,8,59,39,1,107
EL TORNO,"anticoncepcion, prevencion de its y de cancer de cuello uterino",numero de inyectables trimestrales suministrados,2015-11-01,3,30,114,52,2,201
EL VILLAR,"anticoncepcion, prevencion de its y de cancer de cuello uterino",numero de inyectables trimestrales suministrados,2015-11-01,0,3,17,17,1,38
ENTRE RIOS TRJ,"anticoncepcion, prevencion de its y de cancer de cuello uterino",numero de inyectables trimestrales suministrados,2015-11-01,0,34,111,58,4,207
ENTRE RIOS CBBA,"anticoncepcion, prevencion de its y de cancer de cuello uterino",numero de inyectables trimestrales suministrados,2015-11-01,0,10,44,20,0,74
ESCOMA,"anticoncepcion, prevencion de its y de cancer de cuello uterino",numero de inyectables trimestrales suministrados,2015-11-01,0,0,3,1,0,4
ESMERALDA,"anticoncepcion, prevencion de its y de cancer de cuello uterino",numero de inyectables trimestrales suministrados,2015-11-01,0,0,1,1,0,2
EUCALIPTUS,"anticoncepcion, prevencion de its y de cancer de cuello uterino",numero de inyectables trimestrales suministrados,2015-11-01,0,0,7,6,0,13
EUREKA (SANTOS MERCADO),"anticoncepcion, prevencion de its y de cancer de cuello uterino",numero de inyectables trimestrales suministrados,2015-11-01,0,2,2,0,0,4
EXALTACION,"anticoncepcion, prevencion de its y de cancer de cuello uterino",numero de inyectables trimestrales suministrados,2015-11-01,0,0,3,0,0,3
FERNANDEZ ALONSO,"anticoncepcion, prevencion de its y de cancer de cuello uterino",numero de inyectables trimestrales suministrados,2015-11-01,0,7,19,13,0,39
FILADELFIA,"anticoncepcion, prevencion de its y de cancer de cuello uterino",numero de inyectables trimestrales suministrados,2015-11-01,0,3,10,5,0,18
GENERAL SAAVEDRA,"anticoncepcion, prevencion de its y de cancer de cuello uterino",numero de inyectables trimestrales suministrados,2015-11-01,0,13,50,19,0,82
GRAL. J.J. PEREZ (CHARAZANI),"anticoncepcion, prevencion de its y de cancer de cuello uterino",numero de inyectables trimestrales suministrados,2015-11-01,0,0,23,7,0,30
GUANAY,"anticoncepcion, prevencion de its y de cancer de cuello uterino",numero de inyectables trimestrales suministrados,2015-11-01,0,2,13,4,0,19
GUAQUI,"anticoncepcion, prevencion de its y de cancer de cuello uterino",numero de inyectables trimestrales suministrados,2015-11-01,0,1,14,5,0,20
GUAYARAMERIN,"anticoncepcion, prevencion de its y de cancer de cuello uterino",numero de inyectables trimestrales suministrados,2015-11-01,0,9,36,8,0,53
GUTIERREZ,"anticoncepcion, prevencion de its y de cancer de cuello uterino",numero de inyectables trimestrales suministrados,2015-11-01,0,6,30,14,0,50
HUACARETA,"anticoncepcion, prevencion de its y de cancer de cuello uterino",numero de inyectables trimestrales suministrados,2015-11-01,0,4,30,9,1,44
HUACAYA (VILLA DE HUACAYA),"anticoncepcion, prevencion de its y de cancer de cuello uterino",numero de inyectables trimestrales suministrados,2015-11-01,0,0,11,3,0,14
HUACHACALLA,"anticoncepcion, prevencion de its y de cancer de cuello uterino",numero de inyectables trimestrales suministrados,2015-11-01,0,0,1,1,0,2
HUANUNI,"anticoncepcion, prevencion de its y de cancer de cuello uterino",numero de inyectables trimestrales suministrados,2015-11-01,0,2,12,9,1,24
HUARACAJE,"anticoncepcion, prevencion de its y de cancer de cuello uterino",numero de inyectables trimestrales suministrados,2015-11-01,0,0,0,1,0,1
HUARINA,"anticoncepcion, prevencion de its y de cancer de cuello uterino",numero de inyectables trimestrales suministrados,2015-11-01,0,1,6,7,0,14
HUATAJATA,"anticoncepcion, prevencion de its y de cancer de cuello uterino",numero de inyectables trimestrales suministrados,2015-11-01,0,1,5,4,0,10
HUAYLLAMARCA,"anticoncepcion, prevencion de its y de cancer de cuello uterino",numero de inyectables trimestrales suministrados,2015-11-01,0,4,7,8,0,19
HUMANATA,"anticoncepcion, prevencion de its y de cancer de cuello uterino",numero de inyectables trimestrales suministrados,2015-11-01,0,1,3,3,0,7
ICHOCA,"anticoncepcion, prevencion de its y de cancer de cuello uterino",numero de inyectables trimestrales suministrados,2015-11-01,0,0,3,3,0,6
ICLA,"anticoncepcion, prevencion de its y de cancer de cuello uterino",numero de inyectables trimestrales suministrados,2015-11-01,0,4,14,19,0,37
INCAHUASI,"anticoncepcion, prevencion de its y de cancer de cuello uterino",numero de inyectables trimestrales suministrados,2015-11-01,0,3,35,14,1,53
INGAVI (HUMAITA),"anticoncepcion, prevencion de its y de cancer de cuello uterino",numero de inyectables trimestrales suministrados,2015-11-01,0,2,8,4,0,14
INQUISIVI,"anticoncepcion, prevencion de its y de cancer de cuello uterino",numero de inyectables trimestrales suministrados,2015-11-01,1,3,28,13,0,45
IRUPANA (VILLA DE LANZA),"anticoncepcion, prevencion de its y de cancer de cuello uterino",numero de inyectables trimestrales suministrados,2015-11-01,0,2,61,15,0,78
IXIAMAS,"anticoncepcion, prevencion de its y de cancer de cuello uterino",numero de inyectables trimestrales suministrados,2015-11-01,0,11,25,6,0,42
JESUS DE MACHACA,"anticoncepcion, prevencion de its y de cancer de cuello uterino",numero de inyectables trimestrales suministrados,2015-11-01,0,12,15,4,0,31
LA ASUNTA,"anticoncepcion, prevencion de its y de cancer de cuello uterino",numero de inyectables trimestrales suministrados,2015-11-01,0,15,137,42,0,194
LA GUARDIA,"anticoncepcion, prevencion de its y de cancer de cuello uterino",numero de inyectables trimestrales suministrados,2015-11-01,0,40,96,45,2,183
LA PAZ,"anticoncepcion, prevencion de its y de cancer de cuello uterino",numero de inyectables trimestrales suministrados,2015-11-01,2,31,406,82,0,521
LAGUNILLAS,"anticoncepcion, prevencion de its y de cancer de cuello uterino",numero de inyectables trimestrales suministrados,2015-11-01,0,1,11,10,0,22
LAJA,"anticoncepcion, prevencion de its y de cancer de cuello uterino",numero de inyectables trimestrales suministrados,2015-11-01,0,7,29,13,1,50
LAS CARRERAS,"anticoncepcion, prevencion de its y de cancer de cuello uterino",numero de inyectables trimestrales suministrados,2015-11-01,0,3,7,2,0,12
LICOMA PAMPA,"anticoncepcion, prevencion de its y de cancer de cuello uterino",numero de inyectables trimestrales suministrados,2015-11-01,0,1,8,6,0,15
LLALLAGUA,"anticoncepcion, prevencion de its y de cancer de cuello uterino",numero de inyectables trimestrales suministrados,2015-11-01,0,3,61,22,0,86
LLICA,"anticoncepcion, prevencion de its y de cancer de cuello uterino",numero de inyectables trimestrales suministrados,2015-11-01,0,2,12,12,0,26
LORETO,"anticoncepcion, prevencion de its y de cancer de cuello uterino",numero de inyectables trimestrales suministrados,2015-11-01,0,0,5,0,0,5
LURIBAY,"anticoncepcion, prevencion de its y de cancer de cuello uterino",numero de inyectables trimestrales suministrados,2015-11-01,0,4,21,17,0,42
MACHACAMARCA,"anticoncepcion, prevencion de its y de cancer de cuello uterino",numero de inyectables trimestrales suministrados,2015-11-01,0,0,1,1,0,2
MACHARETI,"anticoncepcion, prevencion de its y de cancer de cuello uterino",numero de inyectables trimestrales suministrados,2015-11-01,0,4,37,21,0,62
MAGDALENA,"anticoncepcion, prevencion de its y de cancer de cuello uterino",numero de inyectables trimestrales suministrados,2015-11-01,0,11,30,11,0,52
MAIRANA,"anticoncepcion, prevencion de its y de cancer de cuello uterino",numero de inyectables trimestrales suministrados,2015-11-01,0,5,30,11,0,46
MALLA,"anticoncepcion, prevencion de its y de cancer de cuello uterino",numero de inyectables trimestrales suministrados,2015-11-01,0,1,3,5,0,9
MAPIRI,"anticoncepcion, prevencion de its y de cancer de cuello uterino",numero de inyectables trimestrales suministrados,2015-11-01,0,5,16,6,0,27
MECAPACA,"anticoncepcion, prevencion de its y de cancer de cuello uterino",numero de inyectables trimestrales suministrados,2015-11-01,0,1,25,14,0,40
MINEROS,"anticoncepcion, prevencion de its y de cancer de cuello uterino",numero de inyectables trimestrales suministrados,2015-11-01,0,10,59,14,1,84
MIZQUE,"anticoncepcion, prevencion de its y de cancer de cuello uterino",numero de inyectables trimestrales suministrados,2015-11-01,0,11,80,30,0,121
MOCOMOCO,"anticoncepcion, prevencion de its y de cancer de cuello uterino",numero de inyectables trimestrales suministrados,2015-11-01,0,2,17,13,0,32
MOJINETE,"anticoncepcion, prevencion de its y de cancer de cuello uterino",numero de inyectables trimestrales suministrados,2015-11-01,0,0,1,0,0,1
MOJOCOYA,"anticoncepcion, prevencion de its y de cancer de cuello uterino",numero de inyectables trimestrales suministrados,2015-11-01,0,3,32,16,1,52
MONTEAGUDO,"anticoncepcion, prevencion de its y de cancer de cuello uterino",numero de inyectables trimestrales suministrados,2015-11-01,0,14,49,38,1,102
MONTERO,"anticoncepcion, prevencion de its y de cancer de cuello uterino",numero de inyectables trimestrales suministrados,2015-11-01,2,53,221,75,1,352
MORO MORO,"anticoncepcion, prevencion de its y de cancer de cuello uterino",numero de inyectables trimestrales suministrados,2015-11-01,0,3,11,8,1,23
MOROCHATA,"anticoncepcion, prevencion de its y de cancer de cuello uterino",numero de inyectables trimestrales suministrados,2015-11-01,0,5,47,37,1,90
NACEBE (SANTA ROSA DEL ABUNA),"anticoncepcion, prevencion de its y de cancer de cuello uterino",numero de inyectables trimestrales suministrados,2015-11-01,0,5,14,4,0,23
NAZACARA DE PACAJES,"anticoncepcion, prevencion de its y de cancer de cuello uterino",numero de inyectables trimestrales suministrados,2015-11-01,0,1,0,0,0,1
NUEVO MANOA (NUEVA ESPERANZA),"anticoncepcion, prevencion de its y de cancer de cuello uterino",numero de inyectables trimestrales suministrados,2015-11-01,0,5,11,0,0,16
OCURI,"anticoncepcion, prevencion de its y de cancer de cuello uterino",numero de inyectables trimestrales suministrados,2015-11-01,0,0,28,15,0,43
OKINAWA,"anticoncepcion, prevencion de its y de cancer de cuello uterino",numero de inyectables trimestrales suministrados,2015-11-01,0,10,32,15,0,57
OMEREQUE,"anticoncepcion, prevencion de its y de cancer de cuello uterino",numero de inyectables trimestrales suministrados,2015-11-01,0,6,29,14,0,49
ORURO,"anticoncepcion, prevencion de its y de cancer de cuello uterino",numero de inyectables trimestrales suministrados,2015-11-01,0,24,388,130,1,543
PADCAYA,"anticoncepcion, prevencion de its y de cancer de cuello uterino",numero de inyectables trimestrales suministrados,2015-11-01,1,11,83,57,3,155
PADILLA,"anticoncepcion, prevencion de its y de cancer de cuello uterino",numero de inyectables trimestrales suministrados,2015-11-01,0,3,59,35,0,97
PAILON,"anticoncepcion, prevencion de its y de cancer de cuello uterino",numero de inyectables trimestrales suministrados,2015-11-01,0,3,27,6,0,36
PALCA,"anticoncepcion, prevencion de its y de cancer de cuello uterino",numero de inyectables trimestrales suministrados,2015-11-01,0,4,29,10,0,43
PALOS BLANCOS,"anticoncepcion, prevencion de its y de cancer de cuello uterino",numero de inyectables trimestrales suministrados,2015-11-01,0,6,56,24,0,86
PAMPA AULLAGAS,"anticoncepcion, prevencion de its y de cancer de cuello uterino",numero de inyectables trimestrales suministrados,2015-11-01,0,0,4,3,0,7
PAMPA GRANDE,"anticoncepcion, prevencion de its y de cancer de cuello uterino",numero de inyectables trimestrales suministrados,2015-11-01,0,2,29,9,0,40
PAPEL PAMPA,"anticoncepcion, prevencion de its y de cancer de cuello uterino",numero de inyectables trimestrales suministrados,2015-11-01,1,5,13,10,0,29
PASORAPA,"anticoncepcion, prevencion de its y de cancer de cuello uterino",numero de inyectables trimestrales suministrados,2015-11-01,0,0,17,4,3,24
PATACAMAYA,"anticoncepcion, prevencion de its y de cancer de cuello uterino",numero de inyectables trimestrales suministrados,2015-11-01,0,3,11,6,0,20
PAZÑA,"anticoncepcion, prevencion de its y de cancer de cuello uterino",numero de inyectables trimestrales suministrados,2015-11-01,0,1,17,4,0,22
PELECHUCO,"anticoncepcion, prevencion de its y de cancer de cuello uterino",numero de inyectables trimestrales suministrados,2015-11-01,0,1,22,6,0,29
POCOATA,"anticoncepcion, prevencion de its y de cancer de cuello uterino",numero de inyectables trimestrales suministrados,2015-11-01,0,3,30,42,0,75
POCONA,"anticoncepcion, prevencion de its y de cancer de cuello uterino",numero de inyectables trimestrales suministrados,2015-11-01,0,11,60,36,1,108
POJO (CBBA),"anticoncepcion, prevencion de its y de cancer de cuello uterino",numero de inyectables trimestrales suministrados,2015-11-01,0,8,55,35,1,99
POOPO,"anticoncepcion, prevencion de its y de cancer de cuello uterino",numero de inyectables trimestrales suministrados,2015-11-01,0,0,11,4,0,15
PORCO,"anticoncepcion, prevencion de its y de cancer de cuello uterino",numero de inyectables trimestrales suministrados,2015-11-01,0,2,17,4,0,23
POROMA,"anticoncepcion, prevencion de its y de cancer de cuello uterino",numero de inyectables trimestrales suministrados,2015-11-01,1,12,49,33,0,95
PORONGO,"anticoncepcion, prevencion de its y de cancer de cuello uterino",numero de inyectables trimestrales suministrados,2015-11-01,0,3,8,1,0,12
PORTACHUELO,"anticoncepcion, prevencion de its y de cancer de cuello uterino",numero de inyectables trimestrales suministrados,2015-11-01,0,4,14,10,0,28
PORVENIR,"anticoncepcion, prevencion de its y de cancer de cuello uterino",numero de inyectables trimestrales suministrados,2015-11-01,1,6,12,7,0,26
POSTRER VALLE,"anticoncepcion, prevencion de its y de cancer de cuello uterino",numero de inyectables trimestrales suministrados,2015-11-01,0,0,6,3,0,9
POTOSI,"anticoncepcion, prevencion de its y de cancer de cuello uterino",numero de inyectables trimestrales suministrados,2015-11-01,0,44,494,160,0,698
PRESTO,"anticoncepcion, prevencion de its y de cancer de cuello uterino",numero de inyectables trimestrales suministrados,2015-11-01,2,2,29,21,0,54
PUCARA,"anticoncepcion, prevencion de its y de cancer de cuello uterino",numero de inyectables trimestrales suministrados,2015-11-01,0,1,8,6,0,15
PUCARANI,"anticoncepcion, prevencion de its y de cancer de cuello uterino",numero de inyectables trimestrales suministrados,2015-11-01,0,6,99,46,4,155
PUERTO ACOSTA,"anticoncepcion, prevencion de its y de cancer de cuello uterino",numero de inyectables trimestrales suministrados,2015-11-01,0,3,14,5,0,22
PUERTO CARABUCO,"anticoncepcion, prevencion de its y de cancer de cuello uterino",numero de inyectables trimestrales suministrados,2015-11-01,0,0,18,15,0,33
PUERTO GONZALO MORENO,"anticoncepcion, prevencion de its y de cancer de cuello uterino",numero de inyectables trimestrales suministrados,2015-11-01,1,10,23,3,0,37
PUERTO PEREZ,"anticoncepcion, prevencion de its y de cancer de cuello uterino",numero de inyectables trimestrales suministrados,2015-11-01,0,0,7,4,0,11
PUERTO QUIJARRO,"anticoncepcion, prevencion de its y de cancer de cuello uterino",numero de inyectables trimestrales suministrados,2015-11-01,0,1,22,3,0,26
PUERTO RICO,"anticoncepcion, prevencion de its y de cancer de cuello uterino",numero de inyectables trimestrales suministrados,2015-11-01,0,6,39,5,1,51
PUERTO SILES,"anticoncepcion, prevencion de its y de cancer de cuello uterino",numero de inyectables trimestrales suministrados,2015-11-01,0,0,1,0,0,1
PUERTO SUAREZ,"anticoncepcion, prevencion de its y de cancer de cuello uterino",numero de inyectables trimestrales suministrados,2015-11-01,0,6,10,0,0,16
PUERTO VILLARROEL,"anticoncepcion, prevencion de its y de cancer de cuello uterino",numero de inyectables trimestrales suministrados,2015-11-01,0,18,80,16,0,114
PUNA,"anticoncepcion, prevencion de its y de cancer de cuello uterino",numero de inyectables trimestrales suministrados,2015-11-01,0,2,17,12,0,31
PUNATA,"anticoncepcion, prevencion de its y de cancer de cuello uterino",numero de inyectables trimestrales suministrados,2015-11-01,0,5,64,22,0,91
QUIABAYA,"anticoncepcion, prevencion de its y de cancer de cuello uterino",numero de inyectables trimestrales suministrados,2015-11-01,0,1,6,12,0,19
QUILLACOLLO,"anticoncepcion, prevencion de its y de cancer de cuello uterino",numero de inyectables trimestrales suministrados,2015-11-01,0,22,236,38,0,296
QUIME,"anticoncepcion, prevencion de its y de cancer de cuello uterino",numero de inyectables trimestrales suministrados,2015-11-01,0,4,21,7,0,32
QUIRUSILLAS,"anticoncepcion, prevencion de its y de cancer de cuello uterino",numero de inyectables trimestrales suministrados,2015-11-01,0,2,6,4,0,12
RAVELO,"anticoncepcion, prevencion de its y de cancer de cuello uterino",numero de inyectables trimestrales suministrados,2015-11-01,0,4,45,48,0,97
REYES,"anticoncepcion, prevencion de its y de cancer de cuello uterino",numero de inyectables trimestrales suministrados,2015-11-01,3,5,26,9,0,43
RIBERALTA,"anticoncepcion, prevencion de its y de cancer de cuello uterino",numero de inyectables trimestrales suministrados,2015-11-01,2,50,160,28,0,240
ROBORE,"anticoncepcion, prevencion de its y de cancer de cuello uterino",numero de inyectables trimestrales suministrados,2015-11-01,0,4,37,2,0,43
RURRENABAQUE,"anticoncepcion, prevencion de its y de cancer de cuello uterino",numero de inyectables trimestrales suministrados,2015-11-01,0,11,27,6,0,44
SABAYA,"anticoncepcion, prevencion de its y de cancer de cuello uterino",numero de inyectables trimestrales suministrados,2015-11-01,0,0,9,2,0,11
SACABA,"anticoncepcion, prevencion de its y de cancer de cuello uterino",numero de inyectables trimestrales suministrados,2015-11-01,0,24,167,70,0,261
SACABAMBA,"anticoncepcion, prevencion de its y de cancer de cuello uterino",numero de inyectables trimestrales suministrados,2015-11-01,0,1,4,6,0,11
SACACA,"anticoncepcion, prevencion de its y de cancer de cuello uterino",numero de inyectables trimestrales suministrados,2015-11-01,0,8,44,19,0,71
SAIPINA,"anticoncepcion, prevencion de its y de cancer de cuello uterino",numero de inyectables trimestrales suministrados,2015-11-01,0,4,12,11,0,27
SALINAS DE GARCI MENDOZA,"anticoncepcion, prevencion de its y de cancer de cuello uterino",numero de inyectables trimestrales suministrados,2015-11-01,1,2,27,14,0,44
SAMAIPATA,"anticoncepcion, prevencion de its y de cancer de cuello uterino",numero de inyectables trimestrales suministrados,2015-11-01,0,2,21,14,0,37
SAN AGUSTIN,"anticoncepcion, prevencion de its y de cancer de cuello uterino",numero de inyectables trimestrales suministrados,2015-11-01,0,0,5,1,0,6
SAN ANDRES,"anticoncepcion, prevencion de its y de cancer de cuello uterino",numero de inyectables trimestrales suministrados,2015-11-01,1,1,22,15,0,39
SAN ANDRES DE MACHACA,"anticoncepcion, prevencion de its y de cancer de cuello uterino",numero de inyectables trimestrales suministrados,2015-11-01,0,1,3,0,0,4
SAN ANTONIO DE ESMORUCO,"anticoncepcion, prevencion de its y de cancer de cuello uterino",numero de inyectables trimestrales suministrados,2015-11-01,0,0,5,1,0,6
SAN ANTONIO DE LOMERIO,"anticoncepcion, prevencion de its y de cancer de cuello uterino",numero de inyectables trimestrales suministrados,2015-11-01,0,5,36,29,0,70
SAN BENITO,"anticoncepcion, prevencion de its y de cancer de cuello uterino",numero de inyectables trimestrales suministrados,2015-11-01,0,3,28,11,0,42
SAN BORJA,"anticoncepcion, prevencion de its y de cancer de cuello uterino",numero de inyectables trimestrales suministrados,2015-11-01,3,26,92,53,0,174
SAN BUENA VENTURA,"anticoncepcion, prevencion de its y de cancer de cuello uterino",numero de inyectables trimestrales suministrados,2015-11-01,0,7,29,4,0,40
SAN CARLOS,"anticoncepcion, prevencion de its y de cancer de cuello uterino",numero de inyectables trimestrales suministrados,2015-11-01,0,14,33,16,0,63
SAN IGNACIO,"anticoncepcion, prevencion de its y de cancer de cuello uterino",numero de inyectables trimestrales suministrados,2015-11-01,0,17,78,37,0,132
SAN IGNACIO DE VELASCO,"anticoncepcion, prevencion de its y de cancer de cuello uterino",numero de inyectables trimestrales suministrados,2015-11-01,1,25,152,52,0,230
SAN JAVIER(BNI),"anticoncepcion, prevencion de its y de cancer de cuello uterino",numero de inyectables trimestrales suministrados,2015-11-01,1,5,10,1,0,17
SAN JAVIER(STC),"anticoncepcion, prevencion de its y de cancer de cuello uterino",numero de inyectables trimestrales suministrados,2015-11-01,0,6,33,13,0,52
SAN JOAQUIN,"anticoncepcion, prevencion de its y de cancer de cuello uterino",numero de inyectables trimestrales suministrados,2015-11-01,0,0,5,0,0,5
SAN JOSE DE CHIQUITOS,"anticoncepcion, prevencion de its y de cancer de cuello uterino",numero de inyectables trimestrales suministrados,2015-11-01,3,11,36,11,0,61
SAN JUAN DE YAPACANI,"anticoncepcion, prevencion de its y de cancer de cuello uterino",numero de inyectables trimestrales suministrados,2015-11-01,0,9,24,11,1,45
SAN JULIAN,"anticoncepcion, prevencion de its y de cancer de cuello uterino",numero de inyectables trimestrales suministrados,2015-11-01,0,14,56,26,2,98
SAN LORENZO(PND),"anticoncepcion, prevencion de its y de cancer de cuello uterino",numero de inyectables trimestrales suministrados,2015-11-01,0,5,16,3,0,24
SAN LORENZO(TJA),"anticoncepcion, prevencion de its y de cancer de cuello uterino",numero de inyectables trimestrales suministrados,2015-11-01,1,10,68,34,2,115
SAN LUCAS,"anticoncepcion, prevencion de its y de cancer de cuello uterino",numero de inyectables trimestrales suministrados,2015-11-01,0,7,71,54,0,132
SAN MATIAS,"anticoncepcion, prevencion de its y de cancer de cuello uterino",numero de inyectables trimestrales suministrados,2015-11-01,0,4,21,8,0,33
SAN MIGUEL DE VELASCO,"anticoncepcion, prevencion de its y de cancer de cuello uterino",numero de inyectables trimestrales suministrados,2015-11-01,0,8,47,27,0,82
SAN PABLO DE LIPEZ,"anticoncepcion, prevencion de its y de cancer de cuello uterino",numero de inyectables trimestrales suministrados,2015-11-01,0,0,3,4,0,7
SAN PEDRO,"anticoncepcion, prevencion de its y de cancer de cuello uterino",numero de inyectables trimestrales suministrados,2015-11-01,0,8,31,14,0,53
SAN PEDRO DE BUENA VISTA,"anticoncepcion, prevencion de its y de cancer de cuello uterino",numero de inyectables trimestrales suministrados,2015-11-01,0,6,33,27,1,67
SAN PEDRO DE CURAHUARA,"anticoncepcion, prevencion de its y de cancer de cuello uterino",numero de inyectables trimestrales suministrados,2015-11-01,0,2,9,7,0,18
SAN PEDRO DE QUEMES,"anticoncepcion, prevencion de its y de cancer de cuello uterino",numero de inyectables trimestrales suministrados,2015-11-01,0,0,4,3,0,7
SAN PEDRO DE TIQUINA,"anticoncepcion, prevencion de its y de cancer de cuello uterino",numero de inyectables trimestrales suministrados,2015-11-01,0,1,6,6,0,13
SAN PEDRO(PND),"anticoncepcion, prevencion de its y de cancer de cuello uterino",numero de inyectables trimestrales suministrados,2015-11-01,0,2,4,6,0,12
SAN RAFAEL,"anticoncepcion, prevencion de its y de cancer de cuello uterino",numero de inyectables trimestrales suministrados,2015-11-01,0,10,37,17,0,64
SAN RAMON BENI,"anticoncepcion, prevencion de its y de cancer de cuello uterino",numero de inyectables trimestrales suministrados,2015-11-01,0,2,2,0,0,4
SAN RAMON SCZ,"anticoncepcion, prevencion de its y de cancer de cuello uterino",numero de inyectables trimestrales suministrados,2015-11-01,0,7,19,5,0,31
SANTA ANA,"anticoncepcion, prevencion de its y de cancer de cuello uterino",numero de inyectables trimestrales suministrados,2015-11-01,0,0,5,2,0,7
SANTA CRUZ DE LA SIERRA,"anticoncepcion, prevencion de its y de cancer de cuello uterino",numero de inyectables trimestrales suministrados,2015-11-01,4,134,522,76,0,736
SANTA ROSA,"anticoncepcion, prevencion de its y de cancer de cuello uterino",numero de inyectables trimestrales suministrados,2015-11-01,0,1,2,0,0,3
SANTA ROSA DEL SARA,"anticoncepcion, prevencion de its y de cancer de cuello uterino",numero de inyectables trimestrales suministrados,2015-11-01,2,6,56,12,0,76
SANTIAGO DE CALLAPA,"anticoncepcion, prevencion de its y de cancer de cuello uterino",numero de inyectables trimestrales suministrados,2015-11-01,0,2,3,4,0,9
SANTIAGO DE HUARI,"anticoncepcion, prevencion de its y de cancer de cuello uterino",numero de inyectables trimestrales suministrados,2015-11-01,0,0,6,3,0,9
SANTIAGO DE HUATA,"anticoncepcion, prevencion de its y de cancer de cuello uterino",numero de inyectables trimestrales suministrados,2015-11-01,0,1,9,5,1,16
SANTIAGO DE MACHACA,"anticoncepcion, prevencion de its y de cancer de cuello uterino",numero de inyectables trimestrales suministrados,2015-11-01,0,0,8,8,1,17
SANTIVAÑES,"anticoncepcion, prevencion de its y de cancer de cuello uterino",numero de inyectables trimestrales suministrados,2015-11-01,0,4,22,7,0,33
SANTUARIO DE QUILLACAS,"anticoncepcion, prevencion de its y de cancer de cuello uterino",numero de inyectables trimestrales suministrados,2015-11-01,0,0,5,3,0,8
SAPAHAQUI,"anticoncepcion, prevencion de its y de cancer de cuello uterino",numero de inyectables trimestrales suministrados,2015-11-01,0,2,20,13,0,35
SENA,"anticoncepcion, prevencion de its y de cancer de cuello uterino",numero de inyectables trimestrales suministrados,2015-11-01,0,5,12,4,0,21
SHINAOTA,"anticoncepcion, prevencion de its y de cancer de cuello uterino",numero de inyectables trimestrales suministrados,2015-11-01,0,3,35,18,0,56
SICA SICA (VILLA AROMA),"anticoncepcion, prevencion de its y de cancer de cuello uterino",numero de inyectables trimestrales suministrados,2015-11-01,0,3,40,28,3,74
SICAYA,"anticoncepcion, prevencion de its y de cancer de cuello uterino",numero de inyectables trimestrales suministrados,2015-11-01,0,2,6,3,0,11
SIPE SIPE,"anticoncepcion, prevencion de its y de cancer de cuello uterino",numero de inyectables trimestrales suministrados,2015-11-01,0,14,153,51,1,219
SOPACHUY,"anticoncepcion, prevencion de its y de cancer de cuello uterino",numero de inyectables trimestrales suministrados,2015-11-01,0,2,29,11,0,42
SORACACHI,"anticoncepcion, prevencion de its y de cancer de cuello uterino",numero de inyectables trimestrales suministrados,2015-11-01,0,0,17,8,0,25
SORATA,"anticoncepcion, prevencion de its y de cancer de cuello uterino",numero de inyectables trimestrales suministrados,2015-11-01,0,6,46,22,0,74
SUCRE,"anticoncepcion, prevencion de its y de cancer de cuello uterino",numero de inyectables trimestrales suministrados,2015-11-01,5,75,451,170,2,703
TACACHI,"anticoncepcion, prevencion de its y de cancer de cuello uterino",numero de inyectables trimestrales suministrados,2015-11-01,0,0,2,2,0,4
TACACOMA,"anticoncepcion, prevencion de its y de cancer de cuello uterino",numero de inyectables trimestrales suministrados,2015-11-01,0,3,23,8,0,34
TACOBAMBA,"anticoncepcion, prevencion de its y de cancer de cuello uterino",numero de inyectables trimestrales suministrados,2015-11-01,1,2,20,13,1,37
TACOPAYA,"anticoncepcion, prevencion de its y de cancer de cuello uterino",numero de inyectables trimestrales suministrados,2015-11-01,0,0,13,5,0,18
TAHUA,"anticoncepcion, prevencion de its y de cancer de cuello uterino",numero de inyectables trimestrales suministrados,2015-11-01,0,0,2,5,0,7
TAPACARI,"anticoncepcion, prevencion de its y de cancer de cuello uterino",numero de inyectables trimestrales suministrados,2015-11-01,0,6,43,29,0,78
TARABUCO,"anticoncepcion, prevencion de its y de cancer de cuello uterino",numero de inyectables trimestrales suministrados,2015-11-01,0,3,26,22,0,51
TARACO,"anticoncepcion, prevencion de its y de cancer de cuello uterino",numero de inyectables trimestrales suministrados,2015-11-01,0,4,16,12,1,33
TARATA,"anticoncepcion, prevencion de its y de cancer de cuello uterino",numero de inyectables trimestrales suministrados,2015-11-01,0,3,19,11,0,33
TARIJA,"anticoncepcion, prevencion de its y de cancer de cuello uterino",numero de inyectables trimestrales suministrados,2015-11-01,1,32,223,62,0,318
TARVITA,"anticoncepcion, prevencion de its y de cancer de cuello uterino",numero de inyectables trimestrales suministrados,2015-11-01,0,9,24,20,0,53
TEOPONTE,"anticoncepcion, prevencion de its y de cancer de cuello uterino",numero de inyectables trimestrales suministrados,2015-11-01,0,7,25,12,0,44
TIAWANACU,"anticoncepcion, prevencion de its y de cancer de cuello uterino",numero de inyectables trimestrales suministrados,2015-11-01,2,7,26,11,0,46
TINGUIPAYA,"anticoncepcion, prevencion de its y de cancer de cuello uterino",numero de inyectables trimestrales suministrados,2015-11-01,0,2,23,16,0,41
TIPUANI,"anticoncepcion, prevencion de its y de cancer de cuello uterino",numero de inyectables trimestrales suministrados,2015-11-01,0,4,11,8,0,23
TIQUIPAYA,"anticoncepcion, prevencion de its y de cancer de cuello uterino",numero de inyectables trimestrales suministrados,2015-11-01,2,15,99,15,0,131
TIRAQUE (CBBA),"anticoncepcion, prevencion de its y de cancer de cuello uterino",numero de inyectables trimestrales suministrados,2015-11-01,0,5,51,36,1,93
TITO YUPANQUI (PARQUIPUJIO),"anticoncepcion, prevencion de its y de cancer de cuello uterino",numero de inyectables trimestrales suministrados,2015-11-01,0,0,2,2,0,4
TOCO,"anticoncepcion, prevencion de its y de cancer de cuello uterino",numero de inyectables trimestrales suministrados,2015-11-01,0,3,14,10,1,28
TOLATA,"anticoncepcion, prevencion de its y de cancer de cuello uterino",numero de inyectables trimestrales suministrados,2015-11-01,0,1,13,5,0,19
TOLEDO,"anticoncepcion, prevencion de its y de cancer de cuello uterino",numero de inyectables trimestrales suministrados,2015-11-01,0,1,8,5,0,14
TOMAVE,"anticoncepcion, prevencion de its y de cancer de cuello uterino",numero de inyectables trimestrales suministrados,2015-11-01,0,2,12,13,0,27
TOMINA,"anticoncepcion, prevencion de its y de cancer de cuello uterino",numero de inyectables trimestrales suministrados,2015-11-01,0,9,34,25,1,69
TORO TORO,"anticoncepcion, prevencion de its y de cancer de cuello uterino",numero de inyectables trimestrales suministrados,2015-11-01,0,2,21,13,0,36
TOTORA(CBBA),"anticoncepcion, prevencion de its y de cancer de cuello uterino",numero de inyectables trimestrales suministrados,2015-11-01,0,15,64,28,0,107
TOTORA(ORR),"anticoncepcion, prevencion de its y de cancer de cuello uterino",numero de inyectables trimestrales suministrados,2015-11-01,0,1,17,0,0,18
TRIGAL,"anticoncepcion, prevencion de its y de cancer de cuello uterino",numero de inyectables trimestrales suministrados,2015-11-01,0,1,7,2,0,10
TRINIDAD,"anticoncepcion, prevencion de its y de cancer de cuello uterino",numero de inyectables trimestrales suministrados,2015-11-01,0,16,35,14,0,65
TUPIZA,"anticoncepcion, prevencion de its y de cancer de cuello uterino",numero de inyectables trimestrales suministrados,2015-11-01,0,9,96,50,4,159
TURCO,"anticoncepcion, prevencion de its y de cancer de cuello uterino",numero de inyectables trimestrales suministrados,2015-11-01,0,1,3,8,0,12
UMALA,"anticoncepcion, prevencion de its y de cancer de cuello uterino",numero de inyectables trimestrales suministrados,2015-11-01,0,5,16,6,0,27
UNCIA,"anticoncepcion, prevencion de its y de cancer de cuello uterino",numero de inyectables trimestrales suministrados,2015-11-01,0,9,42,27,0,78
URIONDO (A. CONCEPCION),"anticoncepcion, prevencion de its y de cancer de cuello uterino",numero de inyectables trimestrales suministrados,2015-11-01,1,20,69,36,1,127
URUBICHA,"anticoncepcion, prevencion de its y de cancer de cuello uterino",numero de inyectables trimestrales suministrados,2015-11-01,1,0,10,8,0,19
UYUNI,"anticoncepcion, prevencion de its y de cancer de cuello uterino",numero de inyectables trimestrales suministrados,2015-11-01,0,3,28,16,0,47
VACAS,"anticoncepcion, prevencion de its y de cancer de cuello uterino",numero de inyectables trimestrales suministrados,2015-11-01,0,8,26,20,0,54
VALLEGRANDE,"anticoncepcion, prevencion de its y de cancer de cuello uterino",numero de inyectables trimestrales suministrados,2015-11-01,1,7,49,17,0,74
VIACHA,"anticoncepcion, prevencion de its y de cancer de cuello uterino",numero de inyectables trimestrales suministrados,2015-11-01,0,16,177,44,0,237
VILA VILA,"anticoncepcion, prevencion de its y de cancer de cuello uterino",numero de inyectables trimestrales suministrados,2015-11-01,1,0,5,1,0,7
VILLA CHARCAS,"anticoncepcion, prevencion de its y de cancer de cuello uterino",numero de inyectables trimestrales suministrados,2015-11-01,0,3,38,37,1,79
VILLA MONTES,"anticoncepcion, prevencion de its y de cancer de cuello uterino",numero de inyectables trimestrales suministrados,2015-11-01,1,17,64,27,0,109
VILLA NUEVA (LOMA ALTA),"anticoncepcion, prevencion de its y de cancer de cuello uterino",numero de inyectables trimestrales suministrados,2015-11-01,0,2,6,1,0,9
VILLA RIVERO,"anticoncepcion, prevencion de its y de cancer de cuello uterino",numero de inyectables trimestrales suministrados,2015-11-01,0,9,43,17,0,69
VILLA SERRANO,"anticoncepcion, prevencion de its y de cancer de cuello uterino",numero de inyectables trimestrales suministrados,2015-11-01,0,2,12,10,0,24
VILLA TUNARI,"anticoncepcion, prevencion de its y de cancer de cuello uterino",numero de inyectables trimestrales suministrados,2015-11-01,0,34,280,95,0,409
VILLA VACA GUZMAN (MUYUPAMPA),"anticoncepcion, prevencion de its y de cancer de cuello uterino",numero de inyectables trimestrales suministrados,2015-11-01,0,6,37,19,3,65
VILLAZON,"anticoncepcion, prevencion de its y de cancer de cuello uterino",numero de inyectables trimestrales suministrados,2015-11-01,0,8,121,50,0,179
VINTO,"anticoncepcion, prevencion de its y de cancer de cuello uterino",numero de inyectables trimestrales suministrados,2015-11-01,0,6,43,22,0,71
VITICHI,"anticoncepcion, prevencion de its y de cancer de cuello uterino",numero de inyectables trimestrales suministrados,2015-11-01,0,2,17,19,0,38
WALDO BALLIVIAN,"anticoncepcion, prevencion de its y de cancer de cuello uterino",numero de inyectables trimestrales suministrados,2015-11-01,0,0,6,5,0,11
WARNES,"anticoncepcion, prevencion de its y de cancer de cuello uterino",numero de inyectables trimestrales suministrados,2015-11-01,3,33,130,35,2,203
YACO,"anticoncepcion, prevencion de its y de cancer de cuello uterino",numero de inyectables trimestrales suministrados,2015-11-01,0,1,14,5,0,20
YACUIBA,"anticoncepcion, prevencion de its y de cancer de cuello uterino",numero de inyectables trimestrales suministrados,2015-11-01,0,26,205,103,2,336
YAMPARAEZ,"anticoncepcion, prevencion de its y de cancer de cuello uterino",numero de inyectables trimestrales suministrados,2015-11-01,0,2,9,6,0,17
YANACACHI,"anticoncepcion, prevencion de its y de cancer de cuello uterino",numero de inyectables trimestrales suministrados,2015-11-01,0,1,15,2,0,18
YAPACANI,"anticoncepcion, prevencion de its y de cancer de cuello uterino",numero de inyectables trimestrales suministrados,2015-11-01,0,17,40,15,0,72
YOCALLA,"anticoncepcion, prevencion de its y de cancer de cuello uterino",numero de inyectables trimestrales suministrados,2015-11-01,0,0,15,1,1,17
YOTALA,"anticoncepcion, prevencion de its y de cancer de cuello uterino",numero de inyectables trimestrales suministrados,2015-11-01,0,0,0,5,0,5
YUNCHARA,"anticoncepcion, prevencion de its y de cancer de cuello uterino",numero de inyectables trimestrales suministrados,2015-11-01,0,6,30,27,0,63
YUNGUYO DE LITORAL,"anticoncepcion, prevencion de its y de cancer de cuello uterino",numero de inyectables trimestrales suministrados,2015-11-01,0,3,0,0,0,3
ZUDAÑEZ,"anticoncepcion, prevencion de its y de cancer de cuello uterino",numero de inyectables trimestrales suministrados,2015-11-01,0,4,38,13,0,55
ACACIO,"anticoncepcion, prevencion de its y de cancer de cuello uterino",numero de inyectables trimestrales suministrados,2015-12-01,0,1,10,3,0,14
ACHACACHI,"anticoncepcion, prevencion de its y de cancer de cuello uterino",numero de inyectables trimestrales suministrados,2015-12-01,0,6,55,30,1,92
ACHOCALLA,"anticoncepcion, prevencion de its y de cancer de cuello uterino",numero de inyectables trimestrales suministrados,2015-12-01,0,2,44,26,0,72
AIQUILE,"anticoncepcion, prevencion de its y de cancer de cuello uterino",numero de inyectables trimestrales suministrados,2015-12-01,0,4,31,20,0,55
ALALAY,"anticoncepcion, prevencion de its y de cancer de cuello uterino",numero de inyectables trimestrales suministrados,2015-12-01,0,0,4,3,0,7
ALCALA,"anticoncepcion, prevencion de its y de cancer de cuello uterino",numero de inyectables trimestrales suministrados,2015-12-01,0,3,6,7,0,16
ALTO BENI,"anticoncepcion, prevencion de its y de cancer de cuello uterino",numero de inyectables trimestrales suministrados,2015-12-01,0,0,32,21,0,53
ANCORAIMES,"anticoncepcion, prevencion de its y de cancer de cuello uterino",numero de inyectables trimestrales suministrados,2015-12-01,0,0,17,14,0,31
ANDAMARCA,"anticoncepcion, prevencion de its y de cancer de cuello uterino",numero de inyectables trimestrales suministrados,2015-12-01,0,0,7,6,0,13
ANTEQUERA,"anticoncepcion, prevencion de its y de cancer de cuello uterino",numero de inyectables trimestrales suministrados,2015-12-01,0,0,7,2,0,9
ANZALDO,"anticoncepcion, prevencion de its y de cancer de cuello uterino",numero de inyectables trimestrales suministrados,2015-12-01,0,3,18,11,0,32
APOLO,"anticoncepcion, prevencion de its y de cancer de cuello uterino",numero de inyectables trimestrales suministrados,2015-12-01,0,5,28,24,0,57
ARAMPAMPA,"anticoncepcion, prevencion de its y de cancer de cuello uterino",numero de inyectables trimestrales suministrados,2015-12-01,0,0,19,6,0,25
ARANI,"anticoncepcion, prevencion de its y de cancer de cuello uterino",numero de inyectables trimestrales suministrados,2015-12-01,0,0,14,3,0,17
ARBIETO,"anticoncepcion, prevencion de its y de cancer de cuello uterino",numero de inyectables trimestrales suministrados,2015-12-01,0,11,33,12,0,56
ARQUE,"anticoncepcion, prevencion de its y de cancer de cuello uterino",numero de inyectables trimestrales suministrados,2015-12-01,0,7,27,26,0,60
ASCENCION DE GUARAYOS,"anticoncepcion, prevencion de its y de cancer de cuello uterino",numero de inyectables trimestrales suministrados,2015-12-01,0,8,54,18,0,80
ATOCHA,"anticoncepcion, prevencion de its y de cancer de cuello uterino",numero de inyectables trimestrales suministrados,2015-12-01,0,1,25,4,0,30
AUCAPATA,"anticoncepcion, prevencion de its y de cancer de cuello uterino",numero de inyectables trimestrales suministrados,2015-12-01,0,1,11,12,0,24
AYATA,"anticoncepcion, prevencion de its y de cancer de cuello uterino",numero de inyectables trimestrales suministrados,2015-12-01,0,6,28,28,0,62
AYO AYO,"anticoncepcion, prevencion de its y de cancer de cuello uterino",numero de inyectables trimestrales suministrados,2015-12-01,0,1,20,10,0,31
AYOPAYA (V. DE INDEPENDENCIA),"anticoncepcion, prevencion de its y de cancer de cuello uterino",numero de inyectables trimestrales suministrados,2015-12-01,0,10,84,61,0,155
AZURDUY,"anticoncepcion, prevencion de its y de cancer de cuello uterino",numero de inyectables trimestrales suministrados,2015-12-01,0,7,39,20,0,66
BATALLAS,"anticoncepcion, prevencion de its y de cancer de cuello uterino",numero de inyectables trimestrales suministrados,2015-12-01,0,4,26,18,1,49
BAURES,"anticoncepcion, prevencion de its y de cancer de cuello uterino",numero de inyectables trimestrales suministrados,2015-12-01,0,0,6,3,0,9
BELEN DE ANDAMARCA,"anticoncepcion, prevencion de its y de cancer de cuello uterino",numero de inyectables trimestrales suministrados,2015-12-01,0,0,6,2,0,8
BELEN DE URMIRI,"anticoncepcion, prevencion de its y de cancer de cuello uterino",numero de inyectables trimestrales suministrados,2015-12-01,0,0,5,3,0,8
BELLA FLOR,"anticoncepcion, prevencion de its y de cancer de cuello uterino",numero de inyectables trimestrales suministrados,2015-12-01,0,4,13,4,0,21
BERMEJO,"anticoncepcion, prevencion de its y de cancer de cuello uterino",numero de inyectables trimestrales suministrados,2015-12-01,0,22,109,43,0,174
BETANZOS,"anticoncepcion, prevencion de its y de cancer de cuello uterino",numero de inyectables trimestrales suministrados,2015-12-01,0,3,49,49,0,101
BOLIVAR,"anticoncepcion, prevencion de its y de cancer de cuello uterino",numero de inyectables trimestrales suministrados,2015-12-01,0,0,10,5,0,15
BOLPEBRA,"anticoncepcion, prevencion de its y de cancer de cuello uterino",numero de inyectables trimestrales suministrados,2015-12-01,0,0,2,1,0,3
BOYUIBE,"anticoncepcion, prevencion de its y de cancer de cuello uterino",numero de inyectables trimestrales suministrados,2015-12-01,1,0,4,5,0,10
BUENA VISTA,"anticoncepcion, prevencion de its y de cancer de cuello uterino",numero de inyectables trimestrales suministrados,2015-12-01,0,3,22,14,0,39
CABEZAS,"anticoncepcion, prevencion de its y de cancer de cuello uterino",numero de inyectables trimestrales suministrados,2015-12-01,0,17,85,31,0,133
CAIROMA,"anticoncepcion, prevencion de its y de cancer de cuello uterino",numero de inyectables trimestrales suministrados,2015-12-01,0,2,16,8,0,26
"CAIZA ""D""","anticoncepcion, prevencion de its y de cancer de cuello uterino",numero de inyectables trimestrales suministrados,2015-12-01,0,0,12,14,0,26
CAJUATA,"anticoncepcion, prevencion de its y de cancer de cuello uterino",numero de inyectables trimestrales suministrados,2015-12-01,0,5,28,14,0,47
CALACOTO,"anticoncepcion, prevencion de its y de cancer de cuello uterino",numero de inyectables trimestrales suministrados,2015-12-01,0,0,4,8,0,12
CALAMARCA,"anticoncepcion, prevencion de its y de cancer de cuello uterino",numero de inyectables trimestrales suministrados,2015-12-01,0,2,42,17,0,61
CAMARGO,"anticoncepcion, prevencion de its y de cancer de cuello uterino",numero de inyectables trimestrales suministrados,2015-12-01,0,6,22,16,0,44
CAMATAQUI (C. VILLA ABECIA),"anticoncepcion, prevencion de its y de cancer de cuello uterino",numero de inyectables trimestrales suministrados,2015-12-01,0,2,9,13,0,24
CAMIRI,"anticoncepcion, prevencion de its y de cancer de cuello uterino",numero de inyectables trimestrales suministrados,2015-12-01,3,7,34,22,0,66
CAPINOTA,"anticoncepcion, prevencion de its y de cancer de cuello uterino",numero de inyectables trimestrales suministrados,2015-12-01,0,9,35,18,0,62
CAQUIAVIRI,"anticoncepcion, prevencion de its y de cancer de cuello uterino",numero de inyectables trimestrales suministrados,2015-12-01,0,2,12,3,0,17
CARACOLLO,"anticoncepcion, prevencion de its y de cancer de cuello uterino",numero de inyectables trimestrales suministrados,2015-12-01,0,2,27,15,0,44
CARANAVI,"anticoncepcion, prevencion de its y de cancer de cuello uterino",numero de inyectables trimestrales suministrados,2015-12-01,0,16,87,43,0,146
CARANGAS,"anticoncepcion, prevencion de its y de cancer de cuello uterino",numero de inyectables trimestrales suministrados,2015-12-01,0,0,0,1,0,1
CARAPARI,"anticoncepcion, prevencion de its y de cancer de cuello uterino",numero de inyectables trimestrales suministrados,2015-12-01,1,6,37,26,1,71
CARIPUYO,"anticoncepcion, prevencion de its y de cancer de cuello uterino",numero de inyectables trimestrales suministrados,2015-12-01,0,1,9,9,0,19
CARMEN RIVERO TORREZ,"anticoncepcion, prevencion de its y de cancer de cuello uterino",numero de inyectables trimestrales suministrados,2015-12-01,0,1,7,2,0,10
CATACORA,"anticoncepcion, prevencion de its y de cancer de cuello uterino",numero de inyectables trimestrales suministrados,2015-12-01,0,3,2,1,0,6
CHACARILLA,"anticoncepcion, prevencion de its y de cancer de cuello uterino",numero de inyectables trimestrales suministrados,2015-12-01,0,0,2,1,0,3
CHALLAPATA,"anticoncepcion, prevencion de its y de cancer de cuello uterino",numero de inyectables trimestrales suministrados,2015-12-01,0,4,43,12,0,59
CHAQUI,"anticoncepcion, prevencion de its y de cancer de cuello uterino",numero de inyectables trimestrales suministrados,2015-12-01,0,0,24,7,0,31
CHARAGUA,"anticoncepcion, prevencion de its y de cancer de cuello uterino",numero de inyectables trimestrales suministrados,2015-12-01,0,4,37,17,0,58
CHARAÑA,"anticoncepcion, prevencion de its y de cancer de cuello uterino",numero de inyectables trimestrales suministrados,2015-12-01,0,1,3,4,0,8
CHAYANTA,"anticoncepcion, prevencion de its y de cancer de cuello uterino",numero de inyectables trimestrales suministrados,2015-12-01,0,5,40,15,0,60
CHIMORE,"anticoncepcion, prevencion de its y de cancer de cuello uterino",numero de inyectables trimestrales suministrados,2015-12-01,0,11,62,16,0,89
CHIPAYA,"anticoncepcion, prevencion de its y de cancer de cuello uterino",numero de inyectables trimestrales suministrados,2015-12-01,0,4,14,4,0,22
CHOQUE COTA,"anticoncepcion, prevencion de its y de cancer de cuello uterino",numero de inyectables trimestrales suministrados,2015-12-01,0,0,1,2,0,3
CHUA COCANI,"anticoncepcion, prevencion de its y de cancer de cuello uterino",numero de inyectables trimestrales suministrados,2015-12-01,0,1,2,3,0,6
CHULUMANI (V. DE LA LIBERTAD),"anticoncepcion, prevencion de its y de cancer de cuello uterino",numero de inyectables trimestrales suministrados,2015-12-01,0,5,24,12,1,42
CHUMA,"anticoncepcion, prevencion de its y de cancer de cuello uterino",numero de inyectables trimestrales suministrados,2015-12-01,0,7,28,16,0,51
CHUQUIHUTA AYLLU JUCUMANI,"anticoncepcion, prevencion de its y de cancer de cuello uterino",numero de inyectables trimestrales suministrados,2015-12-01,0,1,13,6,0,20
CKOCHAS,"anticoncepcion, prevencion de its y de cancer de cuello uterino",numero de inyectables trimestrales suministrados,2015-12-01,0,1,15,15,1,32
CLIZA,"anticoncepcion, prevencion de its y de cancer de cuello uterino",numero de inyectables trimestrales suministrados,2015-12-01,0,6,41,12,1,60
COBIJA,"anticoncepcion, prevencion de its y de cancer de cuello uterino",numero de inyectables trimestrales suministrados,2015-12-01,1,28,113,22,0,164
COCAPATA,"anticoncepcion, prevencion de its y de cancer de cuello uterino",numero de inyectables trimestrales suministrados,2015-12-01,0,4,48,30,0,82
COCHABAMBA,"anticoncepcion, prevencion de its y de cancer de cuello uterino",numero de inyectables trimestrales suministrados,2015-12-01,0,43,391,96,0,530
COIPASA,"anticoncepcion, prevencion de its y de cancer de cuello uterino",numero de inyectables trimestrales suministrados,2015-12-01,0,0,2,1,0,3
COLCAPIRHUA,"anticoncepcion, prevencion de its y de cancer de cuello uterino",numero de inyectables trimestrales suministrados,2015-12-01,0,3,63,14,0,80
"COLCHA ""K""","anticoncepcion, prevencion de its y de cancer de cuello uterino",numero de inyectables trimestrales suministrados,2015-12-01,0,5,32,22,0,59
COLLANA,"anticoncepcion, prevencion de its y de cancer de cuello uterino",numero de inyectables trimestrales suministrados,2015-12-01,0,1,10,5,0,16
COLOMI,"anticoncepcion, prevencion de its y de cancer de cuello uterino",numero de inyectables trimestrales suministrados,2015-12-01,0,11,55,21,0,87
COLPA BELGICA,"anticoncepcion, prevencion de its y de cancer de cuello uterino",numero de inyectables trimestrales suministrados,2015-12-01,0,2,13,0,0,15
COLQUECHACA,"anticoncepcion, prevencion de its y de cancer de cuello uterino",numero de inyectables trimestrales suministrados,2015-12-01,0,6,53,28,0,87
COLQUENCHA,"anticoncepcion, prevencion de its y de cancer de cuello uterino",numero de inyectables trimestrales suministrados,2015-12-01,0,3,25,21,1,50
COLQUIRI,"anticoncepcion, prevencion de its y de cancer de cuello uterino",numero de inyectables trimestrales suministrados,2015-12-01,1,3,33,18,0,55
COMANCHE,"anticoncepcion, prevencion de its y de cancer de cuello uterino",numero de inyectables trimestrales suministrados,2015-12-01,0,0,2,0,0,2
COMARAPA,"anticoncepcion, prevencion de its y de cancer de cuello uterino",numero de inyectables trimestrales suministrados,2015-12-01,0,17,97,41,0,155
COMBAYA,"anticoncepcion, prevencion de its y de cancer de cuello uterino",numero de inyectables trimestrales suministrados,2015-12-01,0,2,3,2,0,7
CONCEPCION,"anticoncepcion, prevencion de its y de cancer de cuello uterino",numero de inyectables trimestrales suministrados,2015-12-01,0,4,31,13,0,48
COPACABANA,"anticoncepcion, prevencion de its y de cancer de cuello uterino",numero de inyectables trimestrales suministrados,2015-12-01,0,2,31,21,0,54
CORIPATA,"anticoncepcion, prevencion de its y de cancer de cuello uterino",numero de inyectables trimestrales suministrados,2015-12-01,0,1,49,22,0,72
CORO CORO,"anticoncepcion, prevencion de its y de cancer de cuello uterino",numero de inyectables trimestrales suministrados,2015-12-01,0,0,14,12,0,26
COROICO,"anticoncepcion, prevencion de its y de cancer de cuello uterino",numero de inyectables trimestrales suministrados,2015-12-01,0,1,12,2,1,16
CORQUE,"anticoncepcion, prevencion de its y de cancer de cuello uterino",numero de inyectables trimestrales suministrados,2015-12-01,0,2,7,2,0,11
COTAGAITA,"anticoncepcion, prevencion de its y de cancer de cuello uterino",numero de inyectables trimestrales suministrados,2015-12-01,0,2,38,21,0,61
COTOCA,"anticoncepcion, prevencion de its y de cancer de cuello uterino",numero de inyectables trimestrales suministrados,2015-12-01,0,19,90,33,0,142
CUATRO CAÑADAS,"anticoncepcion, prevencion de its y de cancer de cuello uterino",numero de inyectables trimestrales suministrados,2015-12-01,1,6,32,26,1,66
CUCHUMUELA (V. G. VILLARROEL),"anticoncepcion, prevencion de its y de cancer de cuello uterino",numero de inyectables trimestrales suministrados,2015-12-01,0,2,7,6,0,15
CUEVO,"anticoncepcion, prevencion de its y de cancer de cuello uterino",numero de inyectables trimestrales suministrados,2015-12-01,0,1,16,9,0,26
CULPINA,"anticoncepcion, prevencion de its y de cancer de cuello uterino",numero de inyectables trimestrales suministrados,2015-12-01,0,10,39,36,0,85
CURAHUARA DE CARANGAS,"anticoncepcion, prevencion de its y de cancer de cuello uterino",numero de inyectables trimestrales suministrados,2015-12-01,0,2,10,5,0,17
CURVA,"anticoncepcion, prevencion de its y de cancer de cuello uterino",numero de inyectables trimestrales suministrados,2015-12-01,0,0,0,1,0,1
DESAGUADERO,"anticoncepcion, prevencion de its y de cancer de cuello uterino",numero de inyectables trimestrales suministrados,2015-12-01,0,0,8,3,0,11
EL ALTO,"anticoncepcion, prevencion de its y de cancer de cuello uterino",numero de inyectables trimestrales suministrados,2015-12-01,2,112,907,353,2,1376
EL CHORO,"anticoncepcion, prevencion de its y de cancer de cuello uterino",numero de inyectables trimestrales suministrados,2015-12-01,0,1,5,6,0,12
EL PUENTE(STC),"anticoncepcion, prevencion de its y de cancer de cuello uterino",numero de inyectables trimestrales suministrados,2015-12-01,0,7,42,21,0,70
EL PUENTE(TJA),"anticoncepcion, prevencion de its y de cancer de cuello uterino",numero de inyectables trimestrales suministrados,2015-12-01,0,27,119,78,2,226
EL TORNO,"anticoncepcion, prevencion de its y de cancer de cuello uterino",numero de inyectables trimestrales suministrados,2015-12-01,4,30,105,37,1,177
EL VILLAR,"anticoncepcion, prevencion de its y de cancer de cuello uterino",numero de inyectables trimestrales suministrados,2015-12-01,0,1,7,12,0,20
ENTRE RIOS TRJ,"anticoncepcion, prevencion de its y de cancer de cuello uterino",numero de inyectables trimestrales suministrados,2015-12-01,0,18,96,57,1,172
ENTRE RIOS CBBA,"anticoncepcion, prevencion de its y de cancer de cuello uterino",numero de inyectables trimestrales suministrados,2015-12-01,0,11,41,19,0,71
ESCOMA,"anticoncepcion, prevencion de its y de cancer de cuello uterino",numero de inyectables trimestrales suministrados,2015-12-01,0,0,7,2,0,9
EUCALIPTUS,"anticoncepcion, prevencion de its y de cancer de cuello uterino",numero de inyectables trimestrales suministrados,2015-12-01,0,1,6,5,0,12
EUREKA (SANTOS MERCADO),"anticoncepcion, prevencion de its y de cancer de cuello uterino",numero de inyectables trimestrales suministrados,2015-12-01,0,1,8,0,0,9
FERNANDEZ ALONSO,"anticoncepcion, prevencion de its y de cancer de cuello uterino",numero de inyectables trimestrales suministrados,2015-12-01,0,7,45,13,0,65
FILADELFIA,"anticoncepcion, prevencion de its y de cancer de cuello uterino",numero de inyectables trimestrales suministrados,2015-12-01,0,2,13,2,0,17
GENERAL SAAVEDRA,"anticoncepcion, prevencion de its y de cancer de cuello uterino",numero de inyectables trimestrales suministrados,2015-12-01,0,15,43,17,0,75
GRAL. J.J. PEREZ (CHARAZANI),"anticoncepcion, prevencion de its y de cancer de cuello uterino",numero de inyectables trimestrales suministrados,2015-12-01,0,1,13,4,0,18
GUANAY,"anticoncepcion, prevencion de its y de cancer de cuello uterino",numero de inyectables trimestrales suministrados,2015-12-01,0,2,16,2,0,20
GUAQUI,"anticoncepcion, prevencion de its y de cancer de cuello uterino",numero de inyectables trimestrales suministrados,2015-12-01,0,3,11,5,0,19
GUAYARAMERIN,"anticoncepcion, prevencion de its y de cancer de cuello uterino",numero de inyectables trimestrales suministrados,2015-12-01,0,2,16,4,0,22
GUTIERREZ,"anticoncepcion, prevencion de its y de cancer de cuello uterino",numero de inyectables trimestrales suministrados,2015-12-01,0,3,17,6,0,26
HUACARETA,"anticoncepcion, prevencion de its y de cancer de cuello uterino",numero de inyectables trimestrales suministrados,2015-12-01,0,5,15,13,0,33
HUACAYA (VILLA DE HUACAYA),"anticoncepcion, prevencion de its y de cancer de cuello uterino",numero de inyectables trimestrales suministrados,2015-12-01,0,1,8,5,0,14
HUACHACALLA,"anticoncepcion, prevencion de its y de cancer de cuello uterino",numero de inyectables trimestrales suministrados,2015-12-01,0,1,3,0,0,4
HUANUNI,"anticoncepcion, prevencion de its y de cancer de cuello uterino",numero de inyectables trimestrales suministrados,2015-12-01,0,6,28,7,0,41
HUARACAJE,"anticoncepcion, prevencion de its y de cancer de cuello uterino",numero de inyectables trimestrales suministrados,2015-12-01,0,1,2,1,0,4
HUARINA,"anticoncepcion, prevencion de its y de cancer de cuello uterino",numero de inyectables trimestrales suministrados,2015-12-01,0,2,7,3,0,12
HUATAJATA,"anticoncepcion, prevencion de its y de cancer de cuello uterino",numero de inyectables trimestrales suministrados,2015-12-01,0,0,4,2,0,6
HUAYLLAMARCA,"anticoncepcion, prevencion de its y de cancer de cuello uterino",numero de inyectables trimestrales suministrados,2015-12-01,0,2,11,10,0,23
HUMANATA,"anticoncepcion, prevencion de its y de cancer de cuello uterino",numero de inyectables trimestrales suministrados,2015-12-01,0,4,2,5,0,11
ICHOCA,"anticoncepcion, prevencion de its y de cancer de cuello uterino",numero de inyectables trimestrales suministrados,2015-12-01,0,0,1,1,0,2
ICLA,"anticoncepcion, prevencion de its y de cancer de cuello uterino",numero de inyectables trimestrales suministrados,2015-12-01,0,3,17,19,0,39
INCAHUASI,"anticoncepcion, prevencion de its y de cancer de cuello uterino",numero de inyectables trimestrales suministrados,2015-12-01,0,2,32,24,0,58
INGAVI (HUMAITA),"anticoncepcion, prevencion de its y de cancer de cuello uterino",numero de inyectables trimestrales suministrados,2015-12-01,0,2,4,0,0,6
INQUISIVI,"anticoncepcion, prevencion de its y de cancer de cuello uterino",numero de inyectables trimestrales suministrados,2015-12-01,0,1,20,13,0,34
IRUPANA (VILLA DE LANZA),"anticoncepcion, prevencion de its y de cancer de cuello uterino",numero de inyectables trimestrales suministrados,2015-12-01,0,4,36,25,1,66
IXIAMAS,"anticoncepcion, prevencion de its y de cancer de cuello uterino",numero de inyectables trimestrales suministrados,2015-12-01,0,4,26,8,0,38
JESUS DE MACHACA,"anticoncepcion, prevencion de its y de cancer de cuello uterino",numero de inyectables trimestrales suministrados,2015-12-01,0,2,9,11,0,22
LA ASUNTA,"anticoncepcion, prevencion de its y de cancer de cuello uterino",numero de inyectables trimestrales suministrados,2015-12-01,0,5,122,35,0,162
LA GUARDIA,"anticoncepcion, prevencion de its y de cancer de cuello uterino",numero de inyectables trimestrales suministrados,2015-12-01,0,15,108,30,0,153
LA PAZ,"anticoncepcion, prevencion de its y de cancer de cuello uterino",numero de inyectables trimestrales suministrados,2015-12-01,0,37,406,117,0,560
LAGUNILLAS,"anticoncepcion, prevencion de its y de cancer de cuello uterino",numero de inyectables trimestrales suministrados,2015-12-01,0,4,18,8,0,30
LAJA,"anticoncepcion, prevencion de its y de cancer de cuello uterino",numero de inyectables trimestrales suministrados,2015-12-01,1,6,33,14,0,54
LAS CARRERAS,"anticoncepcion, prevencion de its y de cancer de cuello uterino",numero de inyectables trimestrales suministrados,2015-12-01,0,1,11,5,0,17
LICOMA PAMPA,"anticoncepcion, prevencion de its y de cancer de cuello uterino",numero de inyectables trimestrales suministrados,2015-12-01,0,6,8,7,0,21
LLALLAGUA,"anticoncepcion, prevencion de its y de cancer de cuello uterino",numero de inyectables trimestrales suministrados,2015-12-01,0,9,80,31,0,120
LLICA,"anticoncepcion, prevencion de its y de cancer de cuello uterino",numero de inyectables trimestrales suministrados,2015-12-01,0,4,12,1,0,17
LORETO,"anticoncepcion, prevencion de its y de cancer de cuello uterino",numero de inyectables trimestrales suministrados,2015-12-01,0,0,1,1,0,2
LURIBAY,"anticoncepcion, prevencion de its y de cancer de cuello uterino",numero de inyectables trimestrales suministrados,2015-12-01,0,3,25,19,2,49
MACHACAMARCA,"anticoncepcion, prevencion de its y de cancer de cuello uterino",numero de inyectables trimestrales suministrados,2015-12-01,0,0,5,3,0,8
MACHARETI,"anticoncepcion, prevencion de its y de cancer de cuello uterino",numero de inyectables trimestrales suministrados,2015-12-01,0,2,48,11,0,61
MAGDALENA,"anticoncepcion, prevencion de its y de cancer de cuello uterino",numero de inyectables trimestrales suministrados,2015-12-01,0,15,33,9,0,57
MAIRANA,"anticoncepcion, prevencion de its y de cancer de cuello uterino",numero de inyectables trimestrales suministrados,2015-12-01,0,6,30,14,0,50
MALLA,"anticoncepcion, prevencion de its y de cancer de cuello uterino",numero de inyectables trimestrales suministrados,2015-12-01,0,1,6,2,1,10
MAPIRI,"anticoncepcion, prevencion de its y de cancer de cuello uterino",numero de inyectables trimestrales suministrados,2015-12-01,0,1,21,6,0,28
MECAPACA,"anticoncepcion, prevencion de its y de cancer de cuello uterino",numero de inyectables trimestrales suministrados,2015-12-01,0,1,32,10,0,43
MINEROS,"anticoncepcion, prevencion de its y de cancer de cuello uterino",numero de inyectables trimestrales suministrados,2015-12-01,1,14,38,13,0,66
MIZQUE,"anticoncepcion, prevencion de its y de cancer de cuello uterino",numero de inyectables trimestrales suministrados,2015-12-01,0,8,72,36,0,116
MOCOMOCO,"anticoncepcion, prevencion de its y de cancer de cuello uterino",numero de inyectables trimestrales suministrados,2015-12-01,0,2,18,17,0,37
MOJOCOYA,"anticoncepcion, prevencion de its y de cancer de cuello uterino",numero de inyectables trimestrales suministrados,2015-12-01,0,5,21,22,0,48
MONTEAGUDO,"anticoncepcion, prevencion de its y de cancer de cuello uterino",numero de inyectables trimestrales suministrados,2015-12-01,1,16,52,29,1,99
MONTERO,"anticoncepcion, prevencion de its y de cancer de cuello uterino",numero de inyectables trimestrales suministrados,2015-12-01,1,63,231,58,1,354
MORO MORO,"anticoncepcion, prevencion de its y de cancer de cuello uterino",numero de inyectables trimestrales suministrados,2015-12-01,0,2,6,4,0,12
MOROCHATA,"anticoncepcion, prevencion de its y de cancer de cuello uterino",numero de inyectables trimestrales suministrados,2015-12-01,1,5,41,31,0,78
NACEBE (SANTA ROSA DEL ABUNA),"anticoncepcion, prevencion de its y de cancer de cuello uterino",numero de inyectables trimestrales suministrados,2015-12-01,0,4,17,9,0,30
NUEVO MANOA (NUEVA ESPERANZA),"anticoncepcion, prevencion de its y de cancer de cuello uterino",numero de inyectables trimestrales suministrados,2015-12-01,0,0,2,1,0,3
OCURI,"anticoncepcion, prevencion de its y de cancer de cuello uterino",numero de inyectables trimestrales suministrados,2015-12-01,0,2,21,20,0,43
OKINAWA,"anticoncepcion, prevencion de its y de cancer de cuello uterino",numero de inyectables trimestrales suministrados,2015-12-01,1,3,33,12,0,49
OMEREQUE,"anticoncepcion, prevencion de its y de cancer de cuello uterino",numero de inyectables trimestrales suministrados,2015-12-01,0,4,17,7,0,28
ORURO,"anticoncepcion, prevencion de its y de cancer de cuello uterino",numero de inyectables trimestrales suministrados,2015-12-01,0,44,521,217,1,783
PADCAYA,"anticoncepcion, prevencion de its y de cancer de cuello uterino",numero de inyectables trimestrales suministrados,2015-12-01,1,21,113,96,0,231
PADILLA,"anticoncepcion, prevencion de its y de cancer de cuello uterino",numero de inyectables trimestrales suministrados,2015-12-01,0,6,58,27,0,91
PAILON,"anticoncepcion, prevencion de its y de cancer de cuello uterino",numero de inyectables trimestrales suministrados,2015-12-01,0,18,41,8,0,67
PALCA,"anticoncepcion, prevencion de its y de cancer de cuello uterino",numero de inyectables trimestrales suministrados,2015-12-01,0,6,32,11,0,49
PALOS BLANCOS,"anticoncepcion, prevencion de its y de cancer de cuello uterino",numero de inyectables trimestrales suministrados,2015-12-01,1,10,66,38,1,116
PAMPA AULLAGAS,"anticoncepcion, prevencion de its y de cancer de cuello uterino",numero de inyectables trimestrales suministrados,2015-12-01,0,0,2,1,0,3
PAMPA GRANDE,"anticoncepcion, prevencion de its y de cancer de cuello uterino",numero de inyectables trimestrales suministrados,2015-12-01,0,9,39,9,1,58
PAPEL PAMPA,"anticoncepcion, prevencion de its y de cancer de cuello uterino",numero de inyectables trimestrales suministrados,2015-12-01,0,0,12,10,0,22
PASORAPA,"anticoncepcion, prevencion de its y de cancer de cuello uterino",numero de inyectables trimestrales suministrados,2015-12-01,0,1,16,16,1,34
PATACAMAYA,"anticoncepcion, prevencion de its y de cancer de cuello uterino",numero de inyectables trimestrales suministrados,2015-12-01,0,1,19,2,0,22
PAZÑA,"anticoncepcion, prevencion de its y de cancer de cuello uterino",numero de inyectables trimestrales suministrados,2015-12-01,0,0,13,9,0,22
PELECHUCO,"anticoncepcion, prevencion de its y de cancer de cuello uterino",numero de inyectables trimestrales suministrados,2015-12-01,0,0,13,7,0,20
POCOATA,"anticoncepcion, prevencion de its y de cancer de cuello uterino",numero de inyectables trimestrales suministrados,2015-12-01,0,1,36,26,0,63
POCONA,"anticoncepcion, prevencion de its y de cancer de cuello uterino",numero de inyectables trimestrales suministrados,2015-12-01,0,10,72,38,4,124
POJO (CBBA),"anticoncepcion, prevencion de its y de cancer de cuello uterino",numero de inyectables trimestrales suministrados,2015-12-01,1,9,50,20,0,80
POOPO,"anticoncepcion, prevencion de its y de cancer de cuello uterino",numero de inyectables trimestrales suministrados,2015-12-01,0,0,3,2,0,5
PORCO,"anticoncepcion, prevencion de its y de cancer de cuello uterino",numero de inyectables trimestrales suministrados,2015-12-01,0,0,17,6,0,23
POROMA,"anticoncepcion, prevencion de its y de cancer de cuello uterino",numero de inyectables trimestrales suministrados,2015-12-01,1,8,58,25,0,92
PORONGO,"anticoncepcion, prevencion de its y de cancer de cuello uterino",numero de inyectables trimestrales suministrados,2015-12-01,0,2,6,1,0,9
PORTACHUELO,"anticoncepcion, prevencion de its y de cancer de cuello uterino",numero de inyectables trimestrales suministrados,2015-12-01,0,10,29,4,0,43
PORVENIR,"anticoncepcion, prevencion de its y de cancer de cuello uterino",numero de inyectables trimestrales suministrados,2015-12-01,0,5,18,4,0,27
POSTRER VALLE,"anticoncepcion, prevencion de its y de cancer de cuello uterino",numero de inyectables trimestrales suministrados,2015-12-01,0,0,8,2,0,10
POTOSI,"anticoncepcion, prevencion de its y de cancer de cuello uterino",numero de inyectables trimestrales suministrados,2015-12-01,0,55,466,222,0,743
PRESTO,"anticoncepcion, prevencion de its y de cancer de cuello uterino",numero de inyectables trimestrales suministrados,2015-12-01,0,0,20,18,0,38
PUCARA,"anticoncepcion, prevencion de its y de cancer de cuello uterino",numero de inyectables trimestrales suministrados,2015-12-01,0,1,7,5,0,13
PUCARANI,"anticoncepcion, prevencion de its y de cancer de cuello uterino",numero de inyectables trimestrales suministrados,2015-12-01,0,9,69,40,0,118
PUERTO ACOSTA,"anticoncepcion, prevencion de its y de cancer de cuello uterino",numero de inyectables trimestrales suministrados,2015-12-01,0,0,1,5,0,6
PUERTO CARABUCO,"anticoncepcion, prevencion de its y de cancer de cuello uterino",numero de inyectables trimestrales suministrados,2015-12-01,0,1,12,14,0,27
PUERTO GONZALO MORENO,"anticoncepcion, prevencion de its y de cancer de cuello uterino",numero de inyectables trimestrales suministrados,2015-12-01,2,11,28,14,1,56
PUERTO PEREZ,"anticoncepcion, prevencion de its y de cancer de cuello uterino",numero de inyectables trimestrales suministrados,2015-12-01,0,0,4,5,0,9
PUERTO QUIJARRO,"anticoncepcion, prevencion de its y de cancer de cuello uterino",numero de inyectables trimestrales suministrados,2015-12-01,0,2,24,3,0,29
PUERTO RICO,"anticoncepcion, prevencion de its y de cancer de cuello uterino",numero de inyectables trimestrales suministrados,2015-12-01,1,10,28,14,0,53
PUERTO SILES,"anticoncepcion, prevencion de its y de cancer de cuello uterino",numero de inyectables trimestrales suministrados,2015-12-01,0,1,0,0,0,1
PUERTO SUAREZ,"anticoncepcion, prevencion de its y de cancer de cuello uterino",numero de inyectables trimestrales suministrados,2015-12-01,0,3,15,1,0,19
PUERTO VILLARROEL,"anticoncepcion, prevencion de its y de cancer de cuello uterino",numero de inyectables trimestrales suministrados,2015-12-01,1,21,91,38,0,151
PUNA,"anticoncepcion, prevencion de its y de cancer de cuello uterino",numero de inyectables trimestrales suministrados,2015-12-01,0,2,16,13,0,31
PUNATA,"anticoncepcion, prevencion de its y de cancer de cuello uterino",numero de inyectables trimestrales suministrados,2015-12-01,0,2,74,26,0,102
QUIABAYA,"anticoncepcion, prevencion de its y de cancer de cuello uterino",numero de inyectables trimestrales suministrados,2015-12-01,0,3,7,3,0,13
QUILLACOLLO,"anticoncepcion, prevencion de its y de cancer de cuello uterino",numero de inyectables trimestrales suministrados,2015-12-01,0,51,150,23,0,224
QUIME,"anticoncepcion, prevencion de its y de cancer de cuello uterino",numero de inyectables trimestrales suministrados,2015-12-01,0,3,23,16,0,42
QUIRUSILLAS,"anticoncepcion, prevencion de its y de cancer de cuello uterino",numero de inyectables trimestrales suministrados,2015-12-01,0,2,4,4,0,10
RAVELO,"anticoncepcion, prevencion de its y de cancer de cuello uterino",numero de inyectables trimestrales suministrados,2015-12-01,0,2,35,43,1,81
REYES,"anticoncepcion, prevencion de its y de cancer de cuello uterino",numero de inyectables trimestrales suministrados,2015-12-01,2,9,28,9,0,48
RIBERALTA,"anticoncepcion, prevencion de its y de cancer de cuello uterino",numero de inyectables trimestrales suministrados,2015-12-01,6,59,142,42,1,250
ROBORE,"anticoncepcion, prevencion de its y de cancer de cuello uterino",numero de inyectables trimestrales suministrados,2015-12-01,0,2,29,3,0,34
RURRENABAQUE,"anticoncepcion, prevencion de its y de cancer de cuello uterino",numero de inyectables trimestrales suministrados,2015-12-01,2,6,33,10,0,51
SABAYA,"anticoncepcion, prevencion de its y de cancer de cuello uterino",numero de inyectables trimestrales suministrados,2015-12-01,0,2,9,2,0,13
SACABA,"anticoncepcion, prevencion de its y de cancer de cuello uterino",numero de inyectables trimestrales suministrados,2015-12-01,0,20,181,48,0,249
SACABAMBA,"anticoncepcion, prevencion de its y de cancer de cuello uterino",numero de inyectables trimestrales suministrados,2015-12-01,0,0,7,5,0,12
SACACA,"anticoncepcion, prevencion de its y de cancer de cuello uterino",numero de inyectables trimestrales suministrados,2015-12-01,0,3,48,23,0,74
SAIPINA,"anticoncepcion, prevencion de its y de cancer de cuello uterino",numero de inyectables trimestrales suministrados,2015-12-01,0,6,24,8,0,38
SALINAS DE GARCI MENDOZA,"anticoncepcion, prevencion de its y de cancer de cuello uterino",numero de inyectables trimestrales suministrados,2015-12-01,0,6,38,12,0,56
SAMAIPATA,"anticoncepcion, prevencion de its y de cancer de cuello uterino",numero de inyectables trimestrales suministrados,2015-12-01,3,11,33,10,0,57
SAN AGUSTIN,"anticoncepcion, prevencion de its y de cancer de cuello uterino",numero de inyectables trimestrales suministrados,2015-12-01,0,0,8,1,0,9
SAN ANDRES,"anticoncepcion, prevencion de its y de cancer de cuello uterino",numero de inyectables trimestrales suministrados,2015-12-01,0,2,7,4,0,13
SAN ANDRES DE MACHACA,"anticoncepcion, prevencion de its y de cancer de cuello uterino",numero de inyectables trimestrales suministrados,2015-12-01,0,0,0,4,0,4
SAN ANTONIO DE ESMORUCO,"anticoncepcion, prevencion de its y de cancer de cuello uterino",numero de inyectables trimestrales suministrados,2015-12-01,0,0,6,1,0,7
SAN ANTONIO DE LOMERIO,"anticoncepcion, prevencion de its y de cancer de cuello uterino",numero de inyectables trimestrales suministrados,2015-12-01,0,3,36,11,0,50
SAN BENITO,"anticoncepcion, prevencion de its y de cancer de cuello uterino",numero de inyectables trimestrales suministrados,2015-12-01,0,2,32,15,0,49
SAN BORJA,"anticoncepcion, prevencion de its y de cancer de cuello uterino",numero de inyectables trimestrales suministrados,2015-12-01,1,19,107,40,0,167
SAN BUENA VENTURA,"anticoncepcion, prevencion de its y de cancer de cuello uterino",numero de inyectables trimestrales suministrados,2015-12-01,0,2,15,2,0,19
SAN CARLOS,"anticoncepcion, prevencion de its y de cancer de cuello uterino",numero de inyectables trimestrales suministrados,2015-12-01,0,8,52,17,0,77
SAN IGNACIO,"anticoncepcion, prevencion de its y de cancer de cuello uterino",numero de inyectables trimestrales suministrados,2015-12-01,0,24,71,26,1,122
SAN IGNACIO DE VELASCO,"anticoncepcion, prevencion de its y de cancer de cuello uterino",numero de inyectables trimestrales suministrados,2015-12-01,0,13,142,43,0,198
SAN JAVIER(BNI),"anticoncepcion, prevencion de its y de cancer de cuello uterino",numero de inyectables trimestrales suministrados,2015-12-01,0,1,5,2,0,8
SAN JAVIER(STC),"anticoncepcion, prevencion de its y de cancer de cuello uterino",numero de inyectables trimestrales suministrados,2015-12-01,0,4,19,11,0,34
SAN JOAQUIN,"anticoncepcion, prevencion de its y de cancer de cuello uterino",numero de inyectables trimestrales suministrados,2015-12-01,0,0,4,0,0,4
SAN JOSE DE CHIQUITOS,"anticoncepcion, prevencion de its y de cancer de cuello uterino",numero de inyectables trimestrales suministrados,2015-12-01,0,8,21,7,0,36
SAN JUAN DE YAPACANI,"anticoncepcion, prevencion de its y de cancer de cuello uterino",numero de inyectables trimestrales suministrados,2015-12-01,0,6,19,13,0,38
SAN JULIAN,"anticoncepcion, prevencion de its y de cancer de cuello uterino",numero de inyectables trimestrales suministrados,2015-12-01,1,12,64,51,0,128
SAN LORENZO(PND),"anticoncepcion, prevencion de its y de cancer de cuello uterino",numero de inyectables trimestrales suministrados,2015-12-01,0,4,8,1,0,13
SAN LORENZO(TJA),"anticoncepcion, prevencion de its y de cancer de cuello uterino",numero de inyectables trimestrales suministrados,2015-12-01,0,13,76,57,3,149
SAN LUCAS,"anticoncepcion, prevencion de its y de cancer de cuello uterino",numero de inyectables trimestrales suministrados,2015-12-01,0,6,69,37,0,112
SAN MATIAS,"anticoncepcion, prevencion de its y de cancer de cuello uterino",numero de inyectables trimestrales suministrados,2015-12-01,0,1,13,4,0,18
SAN MIGUEL DE VELASCO,"anticoncepcion, prevencion de its y de cancer de cuello uterino",numero de inyectables trimestrales suministrados,2015-12-01,0,18,57,28,1,104
SAN PABLO DE LIPEZ,"anticoncepcion, prevencion de its y de cancer de cuello uterino",numero de inyectables trimestrales suministrados,2015-12-01,0,2,5,2,0,9
SAN PEDRO,"anticoncepcion, prevencion de its y de cancer de cuello uterino",numero de inyectables trimestrales suministrados,2015-12-01,0,11,51,20,0,82
SAN PEDRO DE BUENA VISTA,"anticoncepcion, prevencion de its y de cancer de cuello uterino",numero de inyectables trimestrales suministrados,2015-12-01,0,5,33,23,0,61
SAN PEDRO DE CURAHUARA,"anticoncepcion, prevencion de its y de cancer de cuello uterino",numero de inyectables trimestrales suministrados,2015-12-01,0,1,8,6,0,15
SAN PEDRO DE QUEMES,"anticoncepcion, prevencion de its y de cancer de cuello uterino",numero de inyectables trimestrales suministrados,2015-12-01,0,1,6,2,0,9
SAN PEDRO DE TIQUINA,"anticoncepcion, prevencion de its y de cancer de cuello uterino",numero de inyectables trimestrales suministrados,2015-12-01,0,0,8,3,0,11
SAN PEDRO(PND),"anticoncepcion, prevencion de its y de cancer de cuello uterino",numero de inyectables trimestrales suministrados,2015-12-01,0,3,4,0,0,7
SAN RAFAEL,"anticoncepcion, prevencion de its y de cancer de cuello uterino",numero de inyectables trimestrales suministrados,2015-12-01,0,8,37,16,1,62
SAN RAMON BENI,"anticoncepcion, prevencion de its y de cancer de cuello uterino",numero de inyectables trimestrales suministrados,2015-12-01,0,0,6,1,0,7
SAN RAMON SCZ,"anticoncepcion, prevencion de its y de cancer de cuello uterino",numero de inyectables trimestrales suministrados,2015-12-01,0,8,28,10,0,46
SANTA ANA,"anticoncepcion, prevencion de its y de cancer de cuello uterino",numero de inyectables trimestrales suministrados,2015-12-01,0,1,5,0,0,6
SANTA CRUZ DE LA SIERRA,"anticoncepcion, prevencion de its y de cancer de cuello uterino",numero de inyectables trimestrales suministrados,2015-12-01,2,121,506,87,1,717
SANTA ROSA,"anticoncepcion, prevencion de its y de cancer de cuello uterino",numero de inyectables trimestrales suministrados,2015-12-01,3,1,14,8,0,26
SANTA ROSA DEL SARA,"anticoncepcion, prevencion de its y de cancer de cuello uterino",numero de inyectables trimestrales suministrados,2015-12-01,0,10,39,19,0,68
SANTIAGO DE CALLAPA,"anticoncepcion, prevencion de its y de cancer de cuello uterino",numero de inyectables trimestrales suministrados,2015-12-01,0,0,2,0,0,2
SANTIAGO DE HUARI,"anticoncepcion, prevencion de its y de cancer de cuello uterino",numero de inyectables trimestrales suministrados,2015-12-01,0,2,5,3,0,10
SANTIAGO DE HUATA,"anticoncepcion, prevencion de its y de cancer de cuello uterino",numero de inyectables trimestrales suministrados,2015-12-01,0,1,7,7,0,15
SANTIAGO DE MACHACA,"anticoncepcion, prevencion de its y de cancer de cuello uterino",numero de inyectables trimestrales suministrados,2015-12-01,0,1,3,5,0,9
SANTIVAÑES,"anticoncepcion, prevencion de its y de cancer de cuello uterino",numero de inyectables trimestrales suministrados,2015-12-01,0,2,13,9,0,24
SANTUARIO DE QUILLACAS,"anticoncepcion, prevencion de its y de cancer de cuello uterino",numero de inyectables trimestrales suministrados,2015-12-01,0,1,7,2,0,10
SAPAHAQUI,"anticoncepcion, prevencion de its y de cancer de cuello uterino",numero de inyectables trimestrales suministrados,2015-12-01,0,1,26,19,0,46
SENA,"anticoncepcion, prevencion de its y de cancer de cuello uterino",numero de inyectables trimestrales suministrados,2015-12-01,0,1,15,2,0,18
SHINAOTA,"anticoncepcion, prevencion de its y de cancer de cuello uterino",numero de inyectables trimestrales suministrados,2015-12-01,0,7,40,20,0,67
SICA SICA (VILLA AROMA),"anticoncepcion, prevencion de its y de cancer de cuello uterino",numero de inyectables trimestrales suministrados,2015-12-01,0,3,38,24,0,65
SICAYA,"anticoncepcion, prevencion de its y de cancer de cuello uterino",numero de inyectables trimestrales suministrados,2015-12-01,0,1,18,6,0,25
SIPE SIPE,"anticoncepcion, prevencion de its y de cancer de cuello uterino",numero de inyectables trimestrales suministrados,2015-12-01,0,18,156,54,1,229
SOPACHUY,"anticoncepcion, prevencion de its y de cancer de cuello uterino",numero de inyectables trimestrales suministrados,2015-12-01,0,4,16,13,0,33
SORACACHI,"anticoncepcion, prevencion de its y de cancer de cuello uterino",numero de inyectables trimestrales suministrados,2015-12-01,0,2,18,8,0,28
SORATA,"anticoncepcion, prevencion de its y de cancer de cuello uterino",numero de inyectables trimestrales suministrados,2015-12-01,0,0,8,9,0,17
SUCRE,"anticoncepcion, prevencion de its y de cancer de cuello uterino",numero de inyectables trimestrales suministrados,2015-12-01,0,60,427,171,1,659
TACACHI,"anticoncepcion, prevencion de its y de cancer de cuello uterino",numero de inyectables trimestrales suministrados,2015-12-01,0,0,1,0,0,1
TACACOMA,"anticoncepcion, prevencion de its y de cancer de cuello uterino",numero de inyectables trimestrales suministrados,2015-12-01,0,2,33,10,0,45
TACOBAMBA,"anticoncepcion, prevencion de its y de cancer de cuello uterino",numero de inyectables trimestrales suministrados,2015-12-01,0,1,23,19,0,43
TACOPAYA,"anticoncepcion, prevencion de its y de cancer de cuello uterino",numero de inyectables trimestrales suministrados,2015-12-01,0,0,8,7,0,15
TAHUA,"anticoncepcion, prevencion de its y de cancer de cuello uterino",numero de inyectables trimestrales suministrados,2015-12-01,0,0,1,2,0,3
TAPACARI,"anticoncepcion, prevencion de its y de cancer de cuello uterino",numero de inyectables trimestrales suministrados,2015-12-01,0,8,65,47,0,120
TARABUCO,"anticoncepcion, prevencion de its y de cancer de cuello uterino",numero de inyectables trimestrales suministrados,2015-12-01,0,1,40,28,0,69
TARACO,"anticoncepcion, prevencion de its y de cancer de cuello uterino",numero de inyectables trimestrales suministrados,2015-12-01,0,0,17,7,0,24
TARATA,"anticoncepcion, prevencion de its y de cancer de cuello uterino",numero de inyectables trimestrales suministrados,2015-12-01,0,2,23,16,0,41
TARIJA,"anticoncepcion, prevencion de its y de cancer de cuello uterino",numero de inyectables trimestrales suministrados,2015-12-01,1,51,184,77,13,326
TARVITA,"anticoncepcion, prevencion de its y de cancer de cuello uterino",numero de inyectables trimestrales suministrados,2015-12-01,0,8,35,31,0,74
TEOPONTE,"anticoncepcion, prevencion de its y de cancer de cuello uterino",numero de inyectables trimestrales suministrados,2015-12-01,0,5,28,5,0,38
TIAWANACU,"anticoncepcion, prevencion de its y de cancer de cuello uterino",numero de inyectables trimestrales suministrados,2015-12-01,0,4,27,9,0,40
TINGUIPAYA,"anticoncepcion, prevencion de its y de cancer de cuello uterino",numero de inyectables trimestrales suministrados,2015-12-01,0,0,11,15,0,26
TIPUANI,"anticoncepcion, prevencion de its y de cancer de cuello uterino",numero de inyectables trimestrales suministrados,2015-12-01,0,0,23,5,0,28
TIQUIPAYA,"anticoncepcion, prevencion de its y de cancer de cuello uterino",numero de inyectables trimestrales suministrados,2015-12-01,1,17,96,29,0,143
TIRAQUE (CBBA),"anticoncepcion, prevencion de its y de cancer de cuello uterino",numero de inyectables trimestrales suministrados,2015-12-01,0,7,44,35,0,86
TITO YUPANQUI (PARQUIPUJIO),"anticoncepcion, prevencion de its y de cancer de cuello uterino",numero de inyectables trimestrales suministrados,2015-12-01,0,0,0,1,0,1
TOCO,"anticoncepcion, prevencion de its y de cancer de cuello uterino",numero de inyectables trimestrales suministrados,2015-12-01,0,3,20,8,0,31
TODOS SANTOS,"anticoncepcion, prevencion de its y de cancer de cuello uterino",numero de inyectables trimestrales suministrados,2015-12-01,0,0,3,0,0,3
TOLATA,"anticoncepcion, prevencion de its y de cancer de cuello uterino",numero de inyectables trimestrales suministrados,2015-12-01,0,1,25,3,0,29
TOLEDO,"anticoncepcion, prevencion de its y de cancer de cuello uterino",numero de inyectables trimestrales suministrados,2015-12-01,0,0,7,5,0,12
TOMAVE,"anticoncepcion, prevencion de its y de cancer de cuello uterino",numero de inyectables trimestrales suministrados,2015-12-01,0,2,14,11,0,27
TOMINA,"anticoncepcion, prevencion de its y de cancer de cuello uterino",numero de inyectables trimestrales suministrados,2015-12-01,0,9,49,26,0,84
TORO TORO,"anticoncepcion, prevencion de its y de cancer de cuello uterino",numero de inyectables trimestrales suministrados,2015-12-01,0,3,22,15,1,41
TOTORA(CBBA),"anticoncepcion, prevencion de its y de cancer de cuello uterino",numero de inyectables trimestrales suministrados,2015-12-01,0,14,81,26,0,121
TOTORA(ORR),"anticoncepcion, prevencion de its y de cancer de cuello uterino",numero de inyectables trimestrales suministrados,2015-12-01,0,1,8,7,0,16
TRIGAL,"anticoncepcion, prevencion de its y de cancer de cuello uterino",numero de inyectables trimestrales suministrados,2015-12-01,0,0,4,1,0,5
TRINIDAD,"anticoncepcion, prevencion de its y de cancer de cuello uterino",numero de inyectables trimestrales suministrados,2015-12-01,1,23,49,14,0,87
TUPIZA,"anticoncepcion, prevencion de its y de cancer de cuello uterino",numero de inyectables trimestrales suministrados,2015-12-01,0,22,134,66,0,222
TURCO,"anticoncepcion, prevencion de its y de cancer de cuello uterino",numero de inyectables trimestrales suministrados,2015-12-01,0,1,7,5,0,13
UMALA,"anticoncepcion, prevencion de its y de cancer de cuello uterino",numero de inyectables trimestrales suministrados,2015-12-01,0,1,12,7,0,20
UNCIA,"anticoncepcion, prevencion de its y de cancer de cuello uterino",numero de inyectables trimestrales suministrados,2015-12-01,0,1,56,25,1,83
URIONDO (A. CONCEPCION),"anticoncepcion, prevencion de its y de cancer de cuello uterino",numero de inyectables trimestrales suministrados,2015-12-01,0,11,64,40,1,116
URUBICHA,"anticoncepcion, prevencion de its y de cancer de cuello uterino",numero de inyectables trimestrales suministrados,2015-12-01,0,3,9,7,0,19
UYUNI,"anticoncepcion, prevencion de its y de cancer de cuello uterino",numero de inyectables trimestrales suministrados,2015-12-01,0,8,47,8,0,63
VACAS,"anticoncepcion, prevencion de its y de cancer de cuello uterino",numero de inyectables trimestrales suministrados,2015-12-01,0,3,16,13,0,32
VALLEGRANDE,"anticoncepcion, prevencion de its y de cancer de cuello uterino",numero de inyectables trimestrales suministrados,2015-12-01,0,14,41,12,2,69
VIACHA,"anticoncepcion, prevencion de its y de cancer de cuello uterino",numero de inyectables trimestrales suministrados,2015-12-01,0,14,117,44,0,175
VILA VILA,"anticoncepcion, prevencion de its y de cancer de cuello uterino",numero de inyectables trimestrales suministrados,2015-12-01,0,2,5,1,0,8
VILLA CHARCAS,"anticoncepcion, prevencion de its y de cancer de cuello uterino",numero de inyectables trimestrales suministrados,2015-12-01,0,5,45,29,1,80
VILLA MONTES,"anticoncepcion, prevencion de its y de cancer de cuello uterino",numero de inyectables trimestrales suministrados,2015-12-01,0,24,85,22,1,132
VILLA NUEVA (LOMA ALTA),"anticoncepcion, prevencion de its y de cancer de cuello uterino",numero de inyectables trimestrales suministrados,2015-12-01,0,1,3,0,0,4
VILLA RIVERO,"anticoncepcion, prevencion de its y de cancer de cuello uterino",numero de inyectables trimestrales suministrados,2015-12-01,0,4,30,11,0,45
VILLA SERRANO,"anticoncepcion, prevencion de its y de cancer de cuello uterino",numero de inyectables trimestrales suministrados,2015-12-01,0,0,7,11,0,18
VILLA TUNARI,"anticoncepcion, prevencion de its y de cancer de cuello uterino",numero de inyectables trimestrales suministrados,2015-12-01,3,31,289,77,0,400
VILLA VACA GUZMAN (MUYUPAMPA),"anticoncepcion, prevencion de its y de cancer de cuello uterino",numero de inyectables trimestrales suministrados,2015-12-01,1,4,34,24,0,63
VILLAZON,"anticoncepcion, prevencion de its y de cancer de cuello uterino",numero de inyectables trimestrales suministrados,2015-12-01,0,14,111,42,1,168
VINTO,"anticoncepcion, prevencion de its y de cancer de cuello uterino",numero de inyectables trimestrales suministrados,2015-12-01,0,6,71,17,1,95
VITICHI,"anticoncepcion, prevencion de its y de cancer de cuello uterino",numero de inyectables trimestrales suministrados,2015-12-01,0,1,18,9,1,29
WALDO BALLIVIAN,"anticoncepcion, prevencion de its y de cancer de cuello uterino",numero de inyectables trimestrales suministrados,2015-12-01,0,0,5,3,0,8
WARNES,"anticoncepcion, prevencion de its y de cancer de cuello uterino",numero de inyectables trimestrales suministrados,2015-12-01,1,39,148,38,1,227
YACO,"anticoncepcion, prevencion de its y de cancer de cuello uterino",numero de inyectables trimestrales suministrados,2015-12-01,0,2,27,8,0,37
YACUIBA,"anticoncepcion, prevencion de its y de cancer de cuello uterino",numero de inyectables trimestrales suministrados,2015-12-01,1,39,224,125,4,393
YAMPARAEZ,"anticoncepcion, prevencion de its y de cancer de cuello uterino",numero de inyectables trimestrales suministrados,2015-12-01,0,1,14,14,1,30
YANACACHI,"anticoncepcion, prevencion de its y de cancer de cuello uterino",numero de inyectables trimestrales suministrados,2015-12-01,0,0,14,6,0,20
YAPACANI,"anticoncepcion, prevencion de its y de cancer de cuello uterino",numero de inyectables trimestrales suministrados,2015-12-01,1,14,71,13,1,100
YOCALLA,"anticoncepcion, prevencion de its y de cancer de cuello uterino",numero de inyectables trimestrales suministrados,2015-12-01,0,3,10,1,0,14
YOTALA,"anticoncepcion, prevencion de its y de cancer de cuello uterino",numero de inyectables trimestrales suministrados,2015-12-01,0,2,15,3,0,20
YUNCHARA,"anticoncepcion, prevencion de its y de cancer de cuello uterino",numero de inyectables trimestrales suministrados,2015-12-01,0,9,38,21,0,68
ZUDAÑEZ,"anticoncepcion, prevencion de its y de cancer de cuello uterino",numero de inyectables trimestrales suministrados,2015-12-01,0,3,35,27,1,66
