municipality,group,variable,month,Número de mujeres con resultados de PAP positivos tratadas,Número de mujeres con resultados de PAP positivos tratadas1,Número de mujeres con resultados de PAP positivos tratadas2,Número de mujeres con resultados de PAP positivos tratadas3,Número de mujeres con resultados de PAP positivos tratadas4,TOTAL
CAMATAQUI (C. VILLA ABECIA),"anticoncepcion, prevencion de its y de cancer de cuello uterino",numero de mujeres con resultados de pap positivos tratadas,2015-01-01,0,0,0,1,0,1
COCHABAMBA,"anticoncepcion, prevencion de its y de cancer de cuello uterino",numero de mujeres con resultados de pap positivos tratadas,2015-01-01,0,2,9,5,2,18
EL ALTO,"anticoncepcion, prevencion de its y de cancer de cuello uterino",numero de mujeres con resultados de pap positivos tratadas,2015-01-01,0,0,1,0,0,1
EL TORNO,"anticoncepcion, prevencion de its y de cancer de cuello uterino",numero de mujeres con resultados de pap positivos tratadas,2015-01-01,0,0,0,1,2,3
LA GUARDIA,"anticoncepcion, prevencion de its y de cancer de cuello uterino",numero de mujeres con resultados de pap positivos tratadas,2015-01-01,0,0,0,2,1,3
LA PAZ,"anticoncepcion, prevencion de its y de cancer de cuello uterino",numero de mujeres con resultados de pap positivos tratadas,2015-01-01,0,0,5,6,1,12
ORURO,"anticoncepcion, prevencion de its y de cancer de cuello uterino",numero de mujeres con resultados de pap positivos tratadas,2015-01-01,0,0,15,1,0,16
PALCA,"anticoncepcion, prevencion de its y de cancer de cuello uterino",numero de mujeres con resultados de pap positivos tratadas,2015-01-01,0,0,0,0,1,1
POTOSI,"anticoncepcion, prevencion de its y de cancer de cuello uterino",numero de mujeres con resultados de pap positivos tratadas,2015-01-01,0,0,3,2,0,5
RIBERALTA,"anticoncepcion, prevencion de its y de cancer de cuello uterino",numero de mujeres con resultados de pap positivos tratadas,2015-01-01,0,0,1,0,0,1
SANTA CRUZ DE LA SIERRA,"anticoncepcion, prevencion de its y de cancer de cuello uterino",numero de mujeres con resultados de pap positivos tratadas,2015-01-01,1,0,8,46,1,56
SUCRE,"anticoncepcion, prevencion de its y de cancer de cuello uterino",numero de mujeres con resultados de pap positivos tratadas,2015-01-01,0,0,4,22,10,36
TARIJA,"anticoncepcion, prevencion de its y de cancer de cuello uterino",numero de mujeres con resultados de pap positivos tratadas,2015-01-01,0,0,2,3,2,7
TRINIDAD,"anticoncepcion, prevencion de its y de cancer de cuello uterino",numero de mujeres con resultados de pap positivos tratadas,2015-01-01,0,0,3,4,0,7
YAMPARAEZ,"anticoncepcion, prevencion de its y de cancer de cuello uterino",numero de mujeres con resultados de pap positivos tratadas,2015-01-01,0,0,1,2,0,3
COCHABAMBA,"anticoncepcion, prevencion de its y de cancer de cuello uterino",numero de mujeres con resultados de pap positivos tratadas,2015-02-01,0,1,6,6,3,16
EL ALTO,"anticoncepcion, prevencion de its y de cancer de cuello uterino",numero de mujeres con resultados de pap positivos tratadas,2015-02-01,0,0,3,2,0,5
EL TORNO,"anticoncepcion, prevencion de its y de cancer de cuello uterino",numero de mujeres con resultados de pap positivos tratadas,2015-02-01,0,0,1,0,1,2
ENTRE RIOS TRJ,"anticoncepcion, prevencion de its y de cancer de cuello uterino",numero de mujeres con resultados de pap positivos tratadas,2015-02-01,0,0,0,1,0,1
LA GUARDIA,"anticoncepcion, prevencion de its y de cancer de cuello uterino",numero de mujeres con resultados de pap positivos tratadas,2015-02-01,0,0,0,0,2,2
LA PAZ,"anticoncepcion, prevencion de its y de cancer de cuello uterino",numero de mujeres con resultados de pap positivos tratadas,2015-02-01,0,1,6,6,4,17
MONTEAGUDO,"anticoncepcion, prevencion de its y de cancer de cuello uterino",numero de mujeres con resultados de pap positivos tratadas,2015-02-01,0,0,14,2,1,17
ORURO,"anticoncepcion, prevencion de its y de cancer de cuello uterino",numero de mujeres con resultados de pap positivos tratadas,2015-02-01,0,0,1,0,0,1
PATACAMAYA,"anticoncepcion, prevencion de its y de cancer de cuello uterino",numero de mujeres con resultados de pap positivos tratadas,2015-02-01,0,1,0,0,0,1
POTOSI,"anticoncepcion, prevencion de its y de cancer de cuello uterino",numero de mujeres con resultados de pap positivos tratadas,2015-02-01,0,0,1,3,0,4
SACABA,"anticoncepcion, prevencion de its y de cancer de cuello uterino",numero de mujeres con resultados de pap positivos tratadas,2015-02-01,0,0,0,1,0,1
SAN BORJA,"anticoncepcion, prevencion de its y de cancer de cuello uterino",numero de mujeres con resultados de pap positivos tratadas,2015-02-01,0,2,0,0,0,2
SANTA CRUZ DE LA SIERRA,"anticoncepcion, prevencion de its y de cancer de cuello uterino",numero de mujeres con resultados de pap positivos tratadas,2015-02-01,0,0,13,20,1,34
SUCRE,"anticoncepcion, prevencion de its y de cancer de cuello uterino",numero de mujeres con resultados de pap positivos tratadas,2015-02-01,0,0,1,0,1,2
TIPUANI,"anticoncepcion, prevencion de its y de cancer de cuello uterino",numero de mujeres con resultados de pap positivos tratadas,2015-02-01,0,0,5,2,0,7
TOTORA(CBBA),"anticoncepcion, prevencion de its y de cancer de cuello uterino",numero de mujeres con resultados de pap positivos tratadas,2015-02-01,0,0,1,1,0,2
TRINIDAD,"anticoncepcion, prevencion de its y de cancer de cuello uterino",numero de mujeres con resultados de pap positivos tratadas,2015-02-01,1,8,16,8,4,37
YAPACANI,"anticoncepcion, prevencion de its y de cancer de cuello uterino",numero de mujeres con resultados de pap positivos tratadas,2015-02-01,1,7,41,12,0,61
ACHACACHI,"anticoncepcion, prevencion de its y de cancer de cuello uterino",numero de mujeres con resultados de pap positivos tratadas,2015-03-01,0,0,0,1,0,1
CAMARGO,"anticoncepcion, prevencion de its y de cancer de cuello uterino",numero de mujeres con resultados de pap positivos tratadas,2015-03-01,0,0,1,1,0,2
CATACORA,"anticoncepcion, prevencion de its y de cancer de cuello uterino",numero de mujeres con resultados de pap positivos tratadas,2015-03-01,0,1,1,0,0,2
CKOCHAS,"anticoncepcion, prevencion de its y de cancer de cuello uterino",numero de mujeres con resultados de pap positivos tratadas,2015-03-01,0,0,0,3,0,3
COCHABAMBA,"anticoncepcion, prevencion de its y de cancer de cuello uterino",numero de mujeres con resultados de pap positivos tratadas,2015-03-01,0,2,24,7,0,33
EL ALTO,"anticoncepcion, prevencion de its y de cancer de cuello uterino",numero de mujeres con resultados de pap positivos tratadas,2015-03-01,0,2,36,17,17,72
EL TORNO,"anticoncepcion, prevencion de its y de cancer de cuello uterino",numero de mujeres con resultados de pap positivos tratadas,2015-03-01,0,0,0,0,1,1
LA ASUNTA,"anticoncepcion, prevencion de its y de cancer de cuello uterino",numero de mujeres con resultados de pap positivos tratadas,2015-03-01,0,1,1,0,0,2
LA PAZ,"anticoncepcion, prevencion de its y de cancer de cuello uterino",numero de mujeres con resultados de pap positivos tratadas,2015-03-01,0,0,6,5,8,19
ORURO,"anticoncepcion, prevencion de its y de cancer de cuello uterino",numero de mujeres con resultados de pap positivos tratadas,2015-03-01,0,0,1,0,0,1
POTOSI,"anticoncepcion, prevencion de its y de cancer de cuello uterino",numero de mujeres con resultados de pap positivos tratadas,2015-03-01,0,0,1,4,0,5
QUILLACOLLO,"anticoncepcion, prevencion de its y de cancer de cuello uterino",numero de mujeres con resultados de pap positivos tratadas,2015-03-01,0,0,0,1,0,1
SAN CARLOS,"anticoncepcion, prevencion de its y de cancer de cuello uterino",numero de mujeres con resultados de pap positivos tratadas,2015-03-01,0,1,0,0,0,1
SANTA CRUZ DE LA SIERRA,"anticoncepcion, prevencion de its y de cancer de cuello uterino",numero de mujeres con resultados de pap positivos tratadas,2015-03-01,0,1,6,2,1,10
SUCRE,"anticoncepcion, prevencion de its y de cancer de cuello uterino",numero de mujeres con resultados de pap positivos tratadas,2015-03-01,0,0,10,7,6,23
TARIJA,"anticoncepcion, prevencion de its y de cancer de cuello uterino",numero de mujeres con resultados de pap positivos tratadas,2015-03-01,0,5,115,187,46,353
TRINIDAD,"anticoncepcion, prevencion de its y de cancer de cuello uterino",numero de mujeres con resultados de pap positivos tratadas,2015-03-01,0,1,1,7,1,10
VIACHA,"anticoncepcion, prevencion de its y de cancer de cuello uterino",numero de mujeres con resultados de pap positivos tratadas,2015-03-01,0,0,0,0,1,1
VINTO,"anticoncepcion, prevencion de its y de cancer de cuello uterino",numero de mujeres con resultados de pap positivos tratadas,2015-03-01,0,0,10,15,7,32
BATALLAS,"anticoncepcion, prevencion de its y de cancer de cuello uterino",numero de mujeres con resultados de pap positivos tratadas,2015-04-01,0,0,0,0,18,18
CHARAGUA,"anticoncepcion, prevencion de its y de cancer de cuello uterino",numero de mujeres con resultados de pap positivos tratadas,2015-04-01,0,0,1,0,0,1
COBIJA,"anticoncepcion, prevencion de its y de cancer de cuello uterino",numero de mujeres con resultados de pap positivos tratadas,2015-04-01,0,0,1,2,0,3
COCHABAMBA,"anticoncepcion, prevencion de its y de cancer de cuello uterino",numero de mujeres con resultados de pap positivos tratadas,2015-04-01,0,1,11,1,0,13
EL ALTO,"anticoncepcion, prevencion de its y de cancer de cuello uterino",numero de mujeres con resultados de pap positivos tratadas,2015-04-01,0,0,0,1,0,1
EL TORNO,"anticoncepcion, prevencion de its y de cancer de cuello uterino",numero de mujeres con resultados de pap positivos tratadas,2015-04-01,0,0,4,0,2,6
ENTRE RIOS TRJ,"anticoncepcion, prevencion de its y de cancer de cuello uterino",numero de mujeres con resultados de pap positivos tratadas,2015-04-01,0,0,1,1,0,2
LA GUARDIA,"anticoncepcion, prevencion de its y de cancer de cuello uterino",numero de mujeres con resultados de pap positivos tratadas,2015-04-01,0,0,0,0,1,1
LA PAZ,"anticoncepcion, prevencion de its y de cancer de cuello uterino",numero de mujeres con resultados de pap positivos tratadas,2015-04-01,0,0,8,8,1,17
MIZQUE,"anticoncepcion, prevencion de its y de cancer de cuello uterino",numero de mujeres con resultados de pap positivos tratadas,2015-04-01,0,0,0,0,1,1
MONTEAGUDO,"anticoncepcion, prevencion de its y de cancer de cuello uterino",numero de mujeres con resultados de pap positivos tratadas,2015-04-01,0,0,4,7,0,11
MONTERO,"anticoncepcion, prevencion de its y de cancer de cuello uterino",numero de mujeres con resultados de pap positivos tratadas,2015-04-01,0,0,1,1,0,2
PORTACHUELO,"anticoncepcion, prevencion de its y de cancer de cuello uterino",numero de mujeres con resultados de pap positivos tratadas,2015-04-01,0,0,1,1,0,2
POTOSI,"anticoncepcion, prevencion de its y de cancer de cuello uterino",numero de mujeres con resultados de pap positivos tratadas,2015-04-01,0,0,8,2,1,11
QUILLACOLLO,"anticoncepcion, prevencion de its y de cancer de cuello uterino",numero de mujeres con resultados de pap positivos tratadas,2015-04-01,0,0,0,1,0,1
SACABA,"anticoncepcion, prevencion de its y de cancer de cuello uterino",numero de mujeres con resultados de pap positivos tratadas,2015-04-01,0,0,0,1,0,1
SANTA CRUZ DE LA SIERRA,"anticoncepcion, prevencion de its y de cancer de cuello uterino",numero de mujeres con resultados de pap positivos tratadas,2015-04-01,0,0,4,1,0,5
SUCRE,"anticoncepcion, prevencion de its y de cancer de cuello uterino",numero de mujeres con resultados de pap positivos tratadas,2015-04-01,0,0,4,3,1,8
TARIJA,"anticoncepcion, prevencion de its y de cancer de cuello uterino",numero de mujeres con resultados de pap positivos tratadas,2015-04-01,0,0,4,7,6,17
TRINIDAD,"anticoncepcion, prevencion de its y de cancer de cuello uterino",numero de mujeres con resultados de pap positivos tratadas,2015-04-01,0,4,24,6,2,36
VIACHA,"anticoncepcion, prevencion de its y de cancer de cuello uterino",numero de mujeres con resultados de pap positivos tratadas,2015-04-01,0,0,2,3,5,10
VINTO,"anticoncepcion, prevencion de its y de cancer de cuello uterino",numero de mujeres con resultados de pap positivos tratadas,2015-04-01,0,0,3,7,1,11
YOCALLA,"anticoncepcion, prevencion de its y de cancer de cuello uterino",numero de mujeres con resultados de pap positivos tratadas,2015-04-01,0,0,1,0,0,1
ACHACACHI,"anticoncepcion, prevencion de its y de cancer de cuello uterino",numero de mujeres con resultados de pap positivos tratadas,2015-05-01,0,0,1,0,0,1
CAMARGO,"anticoncepcion, prevencion de its y de cancer de cuello uterino",numero de mujeres con resultados de pap positivos tratadas,2015-05-01,0,0,1,0,0,1
COBIJA,"anticoncepcion, prevencion de its y de cancer de cuello uterino",numero de mujeres con resultados de pap positivos tratadas,2015-05-01,0,0,0,1,0,1
COCHABAMBA,"anticoncepcion, prevencion de its y de cancer de cuello uterino",numero de mujeres con resultados de pap positivos tratadas,2015-05-01,0,0,7,4,5,16
EL ALTO,"anticoncepcion, prevencion de its y de cancer de cuello uterino",numero de mujeres con resultados de pap positivos tratadas,2015-05-01,0,0,1,4,1,6
LA PAZ,"anticoncepcion, prevencion de its y de cancer de cuello uterino",numero de mujeres con resultados de pap positivos tratadas,2015-05-01,0,1,10,7,1,19
MONTERO,"anticoncepcion, prevencion de its y de cancer de cuello uterino",numero de mujeres con resultados de pap positivos tratadas,2015-05-01,2,31,11,4,0,48
POSTRER VALLE,"anticoncepcion, prevencion de its y de cancer de cuello uterino",numero de mujeres con resultados de pap positivos tratadas,2015-05-01,0,0,1,0,0,1
POTOSI,"anticoncepcion, prevencion de its y de cancer de cuello uterino",numero de mujeres con resultados de pap positivos tratadas,2015-05-01,0,0,8,8,0,16
SACABA,"anticoncepcion, prevencion de its y de cancer de cuello uterino",numero de mujeres con resultados de pap positivos tratadas,2015-05-01,0,0,0,1,0,1
SANTA CRUZ DE LA SIERRA,"anticoncepcion, prevencion de its y de cancer de cuello uterino",numero de mujeres con resultados de pap positivos tratadas,2015-05-01,0,1,12,3,1,17
SUCRE,"anticoncepcion, prevencion de its y de cancer de cuello uterino",numero de mujeres con resultados de pap positivos tratadas,2015-05-01,0,0,5,7,3,15
TARIJA,"anticoncepcion, prevencion de its y de cancer de cuello uterino",numero de mujeres con resultados de pap positivos tratadas,2015-05-01,0,0,3,4,2,9
TIQUIPAYA,"anticoncepcion, prevencion de its y de cancer de cuello uterino",numero de mujeres con resultados de pap positivos tratadas,2015-05-01,0,0,1,0,0,1
TRINIDAD,"anticoncepcion, prevencion de its y de cancer de cuello uterino",numero de mujeres con resultados de pap positivos tratadas,2015-05-01,0,0,10,5,6,21
VALLEGRANDE,"anticoncepcion, prevencion de its y de cancer de cuello uterino",numero de mujeres con resultados de pap positivos tratadas,2015-05-01,0,0,2,0,0,2
VIACHA,"anticoncepcion, prevencion de its y de cancer de cuello uterino",numero de mujeres con resultados de pap positivos tratadas,2015-05-01,0,0,1,0,0,1
VINTO,"anticoncepcion, prevencion de its y de cancer de cuello uterino",numero de mujeres con resultados de pap positivos tratadas,2015-05-01,0,2,25,21,6,54
YAPACANI,"anticoncepcion, prevencion de its y de cancer de cuello uterino",numero de mujeres con resultados de pap positivos tratadas,2015-05-01,0,0,1,1,0,2
BATALLAS,"anticoncepcion, prevencion de its y de cancer de cuello uterino",numero de mujeres con resultados de pap positivos tratadas,2015-06-01,0,0,0,1,0,1
CHALLAPATA,"anticoncepcion, prevencion de its y de cancer de cuello uterino",numero de mujeres con resultados de pap positivos tratadas,2015-06-01,0,1,3,0,0,4
CHULUMANI (V. DE LA LIBERTAD),"anticoncepcion, prevencion de its y de cancer de cuello uterino",numero de mujeres con resultados de pap positivos tratadas,2015-06-01,0,0,2,0,0,2
COBIJA,"anticoncepcion, prevencion de its y de cancer de cuello uterino",numero de mujeres con resultados de pap positivos tratadas,2015-06-01,0,0,1,0,0,1
COCHABAMBA,"anticoncepcion, prevencion de its y de cancer de cuello uterino",numero de mujeres con resultados de pap positivos tratadas,2015-06-01,0,3,11,5,2,21
EL ALTO,"anticoncepcion, prevencion de its y de cancer de cuello uterino",numero de mujeres con resultados de pap positivos tratadas,2015-06-01,0,0,2,0,0,2
EL TORNO,"anticoncepcion, prevencion de its y de cancer de cuello uterino",numero de mujeres con resultados de pap positivos tratadas,2015-06-01,0,0,0,2,1,3
LA GUARDIA,"anticoncepcion, prevencion de its y de cancer de cuello uterino",numero de mujeres con resultados de pap positivos tratadas,2015-06-01,0,0,1,0,0,1
LA PAZ,"anticoncepcion, prevencion de its y de cancer de cuello uterino",numero de mujeres con resultados de pap positivos tratadas,2015-06-01,0,1,12,7,1,21
MONTEAGUDO,"anticoncepcion, prevencion de its y de cancer de cuello uterino",numero de mujeres con resultados de pap positivos tratadas,2015-06-01,0,4,11,14,1,30
MONTERO,"anticoncepcion, prevencion de its y de cancer de cuello uterino",numero de mujeres con resultados de pap positivos tratadas,2015-06-01,0,0,2,1,0,3
MOROCHATA,"anticoncepcion, prevencion de its y de cancer de cuello uterino",numero de mujeres con resultados de pap positivos tratadas,2015-06-01,0,2,0,0,0,2
ORURO,"anticoncepcion, prevencion de its y de cancer de cuello uterino",numero de mujeres con resultados de pap positivos tratadas,2015-06-01,0,0,3,4,0,7
POTOSI,"anticoncepcion, prevencion de its y de cancer de cuello uterino",numero de mujeres con resultados de pap positivos tratadas,2015-06-01,0,0,3,9,1,13
QUILLACOLLO,"anticoncepcion, prevencion de its y de cancer de cuello uterino",numero de mujeres con resultados de pap positivos tratadas,2015-06-01,0,0,0,1,0,1
SANTA CRUZ DE LA SIERRA,"anticoncepcion, prevencion de its y de cancer de cuello uterino",numero de mujeres con resultados de pap positivos tratadas,2015-06-01,0,1,8,2,3,14
SIPE SIPE,"anticoncepcion, prevencion de its y de cancer de cuello uterino",numero de mujeres con resultados de pap positivos tratadas,2015-06-01,0,0,0,1,0,1
SUCRE,"anticoncepcion, prevencion de its y de cancer de cuello uterino",numero de mujeres con resultados de pap positivos tratadas,2015-06-01,0,0,46,12,4,62
TARIJA,"anticoncepcion, prevencion de its y de cancer de cuello uterino",numero de mujeres con resultados de pap positivos tratadas,2015-06-01,0,0,0,4,3,7
TIQUIPAYA,"anticoncepcion, prevencion de its y de cancer de cuello uterino",numero de mujeres con resultados de pap positivos tratadas,2015-06-01,0,1,0,0,0,1
TRINIDAD,"anticoncepcion, prevencion de its y de cancer de cuello uterino",numero de mujeres con resultados de pap positivos tratadas,2015-06-01,0,1,13,15,2,31
VILLA MONTES,"anticoncepcion, prevencion de its y de cancer de cuello uterino",numero de mujeres con resultados de pap positivos tratadas,2015-06-01,0,0,4,1,0,5
WARNES,"anticoncepcion, prevencion de its y de cancer de cuello uterino",numero de mujeres con resultados de pap positivos tratadas,2015-06-01,0,1,0,0,0,1
YAPACANI,"anticoncepcion, prevencion de its y de cancer de cuello uterino",numero de mujeres con resultados de pap positivos tratadas,2015-06-01,0,0,1,0,0,1
YOCALLA,"anticoncepcion, prevencion de its y de cancer de cuello uterino",numero de mujeres con resultados de pap positivos tratadas,2015-06-01,0,0,1,0,0,1
ACHACACHI,"anticoncepcion, prevencion de its y de cancer de cuello uterino",numero de mujeres con resultados de pap positivos tratadas,2015-07-01,0,0,3,0,0,3
ATOCHA,"anticoncepcion, prevencion de its y de cancer de cuello uterino",numero de mujeres con resultados de pap positivos tratadas,2015-07-01,0,0,2,1,0,3
BUENA VISTA,"anticoncepcion, prevencion de its y de cancer de cuello uterino",numero de mujeres con resultados de pap positivos tratadas,2015-07-01,0,0,1,0,0,1
COBIJA,"anticoncepcion, prevencion de its y de cancer de cuello uterino",numero de mujeres con resultados de pap positivos tratadas,2015-07-01,0,0,0,0,2,2
COCHABAMBA,"anticoncepcion, prevencion de its y de cancer de cuello uterino",numero de mujeres con resultados de pap positivos tratadas,2015-07-01,1,6,42,808,20,877
EL ALTO,"anticoncepcion, prevencion de its y de cancer de cuello uterino",numero de mujeres con resultados de pap positivos tratadas,2015-07-01,0,0,0,1,0,1
EL TORNO,"anticoncepcion, prevencion de its y de cancer de cuello uterino",numero de mujeres con resultados de pap positivos tratadas,2015-07-01,0,0,1,1,1,3
FILADELFIA,"anticoncepcion, prevencion de its y de cancer de cuello uterino",numero de mujeres con resultados de pap positivos tratadas,2015-07-01,0,0,1,0,0,1
LA GUARDIA,"anticoncepcion, prevencion de its y de cancer de cuello uterino",numero de mujeres con resultados de pap positivos tratadas,2015-07-01,0,0,6,1,0,7
LA PAZ,"anticoncepcion, prevencion de its y de cancer de cuello uterino",numero de mujeres con resultados de pap positivos tratadas,2015-07-01,0,0,19,17,13,49
MONTERO,"anticoncepcion, prevencion de its y de cancer de cuello uterino",numero de mujeres con resultados de pap positivos tratadas,2015-07-01,0,0,1,0,0,1
ORURO,"anticoncepcion, prevencion de its y de cancer de cuello uterino",numero de mujeres con resultados de pap positivos tratadas,2015-07-01,0,0,5,3,0,8
POTOSI,"anticoncepcion, prevencion de its y de cancer de cuello uterino",numero de mujeres con resultados de pap positivos tratadas,2015-07-01,0,0,0,1,1,2
QUILLACOLLO,"anticoncepcion, prevencion de its y de cancer de cuello uterino",numero de mujeres con resultados de pap positivos tratadas,2015-07-01,0,0,3,0,0,3
SANTA CRUZ DE LA SIERRA,"anticoncepcion, prevencion de its y de cancer de cuello uterino",numero de mujeres con resultados de pap positivos tratadas,2015-07-01,0,0,7,4,4,15
SIPE SIPE,"anticoncepcion, prevencion de its y de cancer de cuello uterino",numero de mujeres con resultados de pap positivos tratadas,2015-07-01,0,0,1,0,0,1
SUCRE,"anticoncepcion, prevencion de its y de cancer de cuello uterino",numero de mujeres con resultados de pap positivos tratadas,2015-07-01,0,0,6,6,2,14
TARABUCO,"anticoncepcion, prevencion de its y de cancer de cuello uterino",numero de mujeres con resultados de pap positivos tratadas,2015-07-01,0,2,8,13,6,29
TARIJA,"anticoncepcion, prevencion de its y de cancer de cuello uterino",numero de mujeres con resultados de pap positivos tratadas,2015-07-01,0,0,16,19,8,43
TIQUIPAYA,"anticoncepcion, prevencion de its y de cancer de cuello uterino",numero de mujeres con resultados de pap positivos tratadas,2015-07-01,0,0,0,1,0,1
TRINIDAD,"anticoncepcion, prevencion de its y de cancer de cuello uterino",numero de mujeres con resultados de pap positivos tratadas,2015-07-01,0,1,1,4,0,6
VALLEGRANDE,"anticoncepcion, prevencion de its y de cancer de cuello uterino",numero de mujeres con resultados de pap positivos tratadas,2015-07-01,0,0,1,1,0,2
VILLA MONTES,"anticoncepcion, prevencion de its y de cancer de cuello uterino",numero de mujeres con resultados de pap positivos tratadas,2015-07-01,0,0,1,0,0,1
VINTO,"anticoncepcion, prevencion de its y de cancer de cuello uterino",numero de mujeres con resultados de pap positivos tratadas,2015-07-01,0,0,7,7,6,20
ATOCHA,"anticoncepcion, prevencion de its y de cancer de cuello uterino",numero de mujeres con resultados de pap positivos tratadas,2015-08-01,0,0,3,0,0,3
CHULUMANI (V. DE LA LIBERTAD),"anticoncepcion, prevencion de its y de cancer de cuello uterino",numero de mujeres con resultados de pap positivos tratadas,2015-08-01,0,1,3,0,0,4
COCHABAMBA,"anticoncepcion, prevencion de its y de cancer de cuello uterino",numero de mujeres con resultados de pap positivos tratadas,2015-08-01,4,8,13,9,11,45
EL ALTO,"anticoncepcion, prevencion de its y de cancer de cuello uterino",numero de mujeres con resultados de pap positivos tratadas,2015-08-01,0,0,4,2,2,8
EL TORNO,"anticoncepcion, prevencion de its y de cancer de cuello uterino",numero de mujeres con resultados de pap positivos tratadas,2015-08-01,0,0,3,4,0,7
HUACARETA,"anticoncepcion, prevencion de its y de cancer de cuello uterino",numero de mujeres con resultados de pap positivos tratadas,2015-08-01,0,0,0,0,1,1
LA GUARDIA,"anticoncepcion, prevencion de its y de cancer de cuello uterino",numero de mujeres con resultados de pap positivos tratadas,2015-08-01,0,1,2,2,3,8
LA PAZ,"anticoncepcion, prevencion de its y de cancer de cuello uterino",numero de mujeres con resultados de pap positivos tratadas,2015-08-01,0,0,1,4,3,8
LORETO,"anticoncepcion, prevencion de its y de cancer de cuello uterino",numero de mujeres con resultados de pap positivos tratadas,2015-08-01,0,1,0,0,0,1
MONTEAGUDO,"anticoncepcion, prevencion de its y de cancer de cuello uterino",numero de mujeres con resultados de pap positivos tratadas,2015-08-01,0,2,9,3,1,15
POCONA,"anticoncepcion, prevencion de its y de cancer de cuello uterino",numero de mujeres con resultados de pap positivos tratadas,2015-08-01,0,0,1,1,0,2
POTOSI,"anticoncepcion, prevencion de its y de cancer de cuello uterino",numero de mujeres con resultados de pap positivos tratadas,2015-08-01,0,0,9,5,1,15
QUILLACOLLO,"anticoncepcion, prevencion de its y de cancer de cuello uterino",numero de mujeres con resultados de pap positivos tratadas,2015-08-01,0,0,5,0,0,5
SAN BORJA,"anticoncepcion, prevencion de its y de cancer de cuello uterino",numero de mujeres con resultados de pap positivos tratadas,2015-08-01,0,0,5,0,0,5
SANTA CRUZ DE LA SIERRA,"anticoncepcion, prevencion de its y de cancer de cuello uterino",numero de mujeres con resultados de pap positivos tratadas,2015-08-01,0,1,12,3,0,16
SUCRE,"anticoncepcion, prevencion de its y de cancer de cuello uterino",numero de mujeres con resultados de pap positivos tratadas,2015-08-01,0,0,7,3,3,13
TARIJA,"anticoncepcion, prevencion de its y de cancer de cuello uterino",numero de mujeres con resultados de pap positivos tratadas,2015-08-01,0,0,2,7,1,10
TRINIDAD,"anticoncepcion, prevencion de its y de cancer de cuello uterino",numero de mujeres con resultados de pap positivos tratadas,2015-08-01,0,0,2,3,1,6
VILLA MONTES,"anticoncepcion, prevencion de its y de cancer de cuello uterino",numero de mujeres con resultados de pap positivos tratadas,2015-08-01,0,0,0,2,0,2
VINTO,"anticoncepcion, prevencion de its y de cancer de cuello uterino",numero de mujeres con resultados de pap positivos tratadas,2015-08-01,0,0,3,4,2,9
YAPACANI,"anticoncepcion, prevencion de its y de cancer de cuello uterino",numero de mujeres con resultados de pap positivos tratadas,2015-08-01,0,0,0,1,0,1
BUENA VISTA,"anticoncepcion, prevencion de its y de cancer de cuello uterino",numero de mujeres con resultados de pap positivos tratadas,2015-09-01,0,0,3,0,0,3
CHAQUI,"anticoncepcion, prevencion de its y de cancer de cuello uterino",numero de mujeres con resultados de pap positivos tratadas,2015-09-01,0,0,2,0,0,2
CHAYANTA,"anticoncepcion, prevencion de its y de cancer de cuello uterino",numero de mujeres con resultados de pap positivos tratadas,2015-09-01,0,0,5,1,0,6
CLIZA,"anticoncepcion, prevencion de its y de cancer de cuello uterino",numero de mujeres con resultados de pap positivos tratadas,2015-09-01,0,0,1,0,0,1
COBIJA,"anticoncepcion, prevencion de its y de cancer de cuello uterino",numero de mujeres con resultados de pap positivos tratadas,2015-09-01,0,0,6,1,0,7
COCHABAMBA,"anticoncepcion, prevencion de its y de cancer de cuello uterino",numero de mujeres con resultados de pap positivos tratadas,2015-09-01,0,14,24,118,4,160
EL ALTO,"anticoncepcion, prevencion de its y de cancer de cuello uterino",numero de mujeres con resultados de pap positivos tratadas,2015-09-01,0,0,0,1,0,1
EL TORNO,"anticoncepcion, prevencion de its y de cancer de cuello uterino",numero de mujeres con resultados de pap positivos tratadas,2015-09-01,0,1,0,2,4,7
LA GUARDIA,"anticoncepcion, prevencion de its y de cancer de cuello uterino",numero de mujeres con resultados de pap positivos tratadas,2015-09-01,0,2,3,1,0,6
LA PAZ,"anticoncepcion, prevencion de its y de cancer de cuello uterino",numero de mujeres con resultados de pap positivos tratadas,2015-09-01,0,2,10,7,3,22
LLALLAGUA,"anticoncepcion, prevencion de its y de cancer de cuello uterino",numero de mujeres con resultados de pap positivos tratadas,2015-09-01,0,0,1,0,0,1
MONTERO,"anticoncepcion, prevencion de its y de cancer de cuello uterino",numero de mujeres con resultados de pap positivos tratadas,2015-09-01,0,0,2,1,0,3
POCONA,"anticoncepcion, prevencion de its y de cancer de cuello uterino",numero de mujeres con resultados de pap positivos tratadas,2015-09-01,0,1,3,1,0,5
POTOSI,"anticoncepcion, prevencion de its y de cancer de cuello uterino",numero de mujeres con resultados de pap positivos tratadas,2015-09-01,0,0,3,4,3,10
SAN IGNACIO DE VELASCO,"anticoncepcion, prevencion de its y de cancer de cuello uterino",numero de mujeres con resultados de pap positivos tratadas,2015-09-01,0,0,3,0,0,3
SANTA CRUZ DE LA SIERRA,"anticoncepcion, prevencion de its y de cancer de cuello uterino",numero de mujeres con resultados de pap positivos tratadas,2015-09-01,0,1,10,6,6,23
SANTIAGO DE HUARI,"anticoncepcion, prevencion de its y de cancer de cuello uterino",numero de mujeres con resultados de pap positivos tratadas,2015-09-01,0,0,1,0,0,1
SUCRE,"anticoncepcion, prevencion de its y de cancer de cuello uterino",numero de mujeres con resultados de pap positivos tratadas,2015-09-01,0,4,12,13,2,31
TARIJA,"anticoncepcion, prevencion de its y de cancer de cuello uterino",numero de mujeres con resultados de pap positivos tratadas,2015-09-01,0,1,9,11,1,22
TRINIDAD,"anticoncepcion, prevencion de its y de cancer de cuello uterino",numero de mujeres con resultados de pap positivos tratadas,2015-09-01,0,3,5,0,0,8
YAPACANI,"anticoncepcion, prevencion de its y de cancer de cuello uterino",numero de mujeres con resultados de pap positivos tratadas,2015-09-01,0,1,22,1,0,24
BATALLAS,"anticoncepcion, prevencion de its y de cancer de cuello uterino",numero de mujeres con resultados de pap positivos tratadas,2015-10-01,0,0,0,1,0,1
COCHABAMBA,"anticoncepcion, prevencion de its y de cancer de cuello uterino",numero de mujeres con resultados de pap positivos tratadas,2015-10-01,0,0,31,11,0,42
EL ALTO,"anticoncepcion, prevencion de its y de cancer de cuello uterino",numero de mujeres con resultados de pap positivos tratadas,2015-10-01,0,0,0,0,1,1
EL TORNO,"anticoncepcion, prevencion de its y de cancer de cuello uterino",numero de mujeres con resultados de pap positivos tratadas,2015-10-01,0,1,3,1,3,8
GUANAY,"anticoncepcion, prevencion de its y de cancer de cuello uterino",numero de mujeres con resultados de pap positivos tratadas,2015-10-01,0,0,0,2,0,2
LA GUARDIA,"anticoncepcion, prevencion de its y de cancer de cuello uterino",numero de mujeres con resultados de pap positivos tratadas,2015-10-01,0,10,4,2,0,16
LA PAZ,"anticoncepcion, prevencion de its y de cancer de cuello uterino",numero de mujeres con resultados de pap positivos tratadas,2015-10-01,0,0,9,4,1,14
MONTERO,"anticoncepcion, prevencion de its y de cancer de cuello uterino",numero de mujeres con resultados de pap positivos tratadas,2015-10-01,0,2,1,3,0,6
POTOSI,"anticoncepcion, prevencion de its y de cancer de cuello uterino",numero de mujeres con resultados de pap positivos tratadas,2015-10-01,0,2,14,5,2,23
PUERTO VILLARROEL,"anticoncepcion, prevencion de its y de cancer de cuello uterino",numero de mujeres con resultados de pap positivos tratadas,2015-10-01,0,9,0,0,0,9
SANTA CRUZ DE LA SIERRA,"anticoncepcion, prevencion de its y de cancer de cuello uterino",numero de mujeres con resultados de pap positivos tratadas,2015-10-01,0,4,7,10,5,26
SUCRE,"anticoncepcion, prevencion de its y de cancer de cuello uterino",numero de mujeres con resultados de pap positivos tratadas,2015-10-01,0,0,4,9,4,17
TARIJA,"anticoncepcion, prevencion de its y de cancer de cuello uterino",numero de mujeres con resultados de pap positivos tratadas,2015-10-01,0,0,3,1,0,4
TARVITA,"anticoncepcion, prevencion de its y de cancer de cuello uterino",numero de mujeres con resultados de pap positivos tratadas,2015-10-01,0,0,0,0,1,1
TINGUIPAYA,"anticoncepcion, prevencion de its y de cancer de cuello uterino",numero de mujeres con resultados de pap positivos tratadas,2015-10-01,0,0,0,1,1,2
TOTORA(CBBA),"anticoncepcion, prevencion de its y de cancer de cuello uterino",numero de mujeres con resultados de pap positivos tratadas,2015-10-01,0,0,1,0,0,1
TRINIDAD,"anticoncepcion, prevencion de its y de cancer de cuello uterino",numero de mujeres con resultados de pap positivos tratadas,2015-10-01,0,0,3,5,0,8
YOTALA,"anticoncepcion, prevencion de its y de cancer de cuello uterino",numero de mujeres con resultados de pap positivos tratadas,2015-10-01,1,0,0,0,0,1
BUENA VISTA,"anticoncepcion, prevencion de its y de cancer de cuello uterino",numero de mujeres con resultados de pap positivos tratadas,2015-11-01,0,1,1,2,0,4
CHALLAPATA,"anticoncepcion, prevencion de its y de cancer de cuello uterino",numero de mujeres con resultados de pap positivos tratadas,2015-11-01,0,0,1,0,0,1
COCAPATA,"anticoncepcion, prevencion de its y de cancer de cuello uterino",numero de mujeres con resultados de pap positivos tratadas,2015-11-01,0,2,3,2,0,7
COCHABAMBA,"anticoncepcion, prevencion de its y de cancer de cuello uterino",numero de mujeres con resultados de pap positivos tratadas,2015-11-01,0,8,245,44,1,298
EL ALTO,"anticoncepcion, prevencion de its y de cancer de cuello uterino",numero de mujeres con resultados de pap positivos tratadas,2015-11-01,0,2,24,35,18,79
EL TORNO,"anticoncepcion, prevencion de its y de cancer de cuello uterino",numero de mujeres con resultados de pap positivos tratadas,2015-11-01,0,0,2,1,0,3
HUACARETA,"anticoncepcion, prevencion de its y de cancer de cuello uterino",numero de mujeres con resultados de pap positivos tratadas,2015-11-01,0,0,7,2,0,9
LA GUARDIA,"anticoncepcion, prevencion de its y de cancer de cuello uterino",numero de mujeres con resultados de pap positivos tratadas,2015-11-01,0,2,1,2,0,5
LA PAZ,"anticoncepcion, prevencion de its y de cancer de cuello uterino",numero de mujeres con resultados de pap positivos tratadas,2015-11-01,0,0,5,5,1,11
ORURO,"anticoncepcion, prevencion de its y de cancer de cuello uterino",numero de mujeres con resultados de pap positivos tratadas,2015-11-01,0,0,1,1,0,2
POTOSI,"anticoncepcion, prevencion de its y de cancer de cuello uterino",numero de mujeres con resultados de pap positivos tratadas,2015-11-01,0,0,4,1,1,6
PUNA,"anticoncepcion, prevencion de its y de cancer de cuello uterino",numero de mujeres con resultados de pap positivos tratadas,2015-11-01,0,1,4,6,0,11
QUILLACOLLO,"anticoncepcion, prevencion de its y de cancer de cuello uterino",numero de mujeres con resultados de pap positivos tratadas,2015-11-01,0,0,1,0,0,1
SACABA,"anticoncepcion, prevencion de its y de cancer de cuello uterino",numero de mujeres con resultados de pap positivos tratadas,2015-11-01,0,0,2,1,0,3
SAN JULIAN,"anticoncepcion, prevencion de its y de cancer de cuello uterino",numero de mujeres con resultados de pap positivos tratadas,2015-11-01,0,0,0,0,2,2
SANTA CRUZ DE LA SIERRA,"anticoncepcion, prevencion de its y de cancer de cuello uterino",numero de mujeres con resultados de pap positivos tratadas,2015-11-01,0,1,14,6,1,22
SUCRE,"anticoncepcion, prevencion de its y de cancer de cuello uterino",numero de mujeres con resultados de pap positivos tratadas,2015-11-01,0,0,8,11,2,21
TARIJA,"anticoncepcion, prevencion de its y de cancer de cuello uterino",numero de mujeres con resultados de pap positivos tratadas,2015-11-01,0,2,1,1,0,4
TRINIDAD,"anticoncepcion, prevencion de its y de cancer de cuello uterino",numero de mujeres con resultados de pap positivos tratadas,2015-11-01,0,0,4,6,8,18
VIACHA,"anticoncepcion, prevencion de its y de cancer de cuello uterino",numero de mujeres con resultados de pap positivos tratadas,2015-11-01,0,0,1,0,0,1
YAPACANI,"anticoncepcion, prevencion de its y de cancer de cuello uterino",numero de mujeres con resultados de pap positivos tratadas,2015-11-01,0,1,4,0,0,5
CABEZAS,"anticoncepcion, prevencion de its y de cancer de cuello uterino",numero de mujeres con resultados de pap positivos tratadas,2015-12-01,0,0,1,0,0,1
COCHABAMBA,"anticoncepcion, prevencion de its y de cancer de cuello uterino",numero de mujeres con resultados de pap positivos tratadas,2015-12-01,0,13,80,151,20,264
EL ALTO,"anticoncepcion, prevencion de its y de cancer de cuello uterino",numero de mujeres con resultados de pap positivos tratadas,2015-12-01,0,0,1,0,0,1
EL TORNO,"anticoncepcion, prevencion de its y de cancer de cuello uterino",numero de mujeres con resultados de pap positivos tratadas,2015-12-01,0,0,1,4,3,8
ENTRE RIOS TRJ,"anticoncepcion, prevencion de its y de cancer de cuello uterino",numero de mujeres con resultados de pap positivos tratadas,2015-12-01,0,0,0,2,0,2
HUACARETA,"anticoncepcion, prevencion de its y de cancer de cuello uterino",numero de mujeres con resultados de pap positivos tratadas,2015-12-01,0,0,4,3,0,7
HUANUNI,"anticoncepcion, prevencion de its y de cancer de cuello uterino",numero de mujeres con resultados de pap positivos tratadas,2015-12-01,0,0,0,1,0,1
LA GUARDIA,"anticoncepcion, prevencion de its y de cancer de cuello uterino",numero de mujeres con resultados de pap positivos tratadas,2015-12-01,0,0,0,0,2,2
LA PAZ,"anticoncepcion, prevencion de its y de cancer de cuello uterino",numero de mujeres con resultados de pap positivos tratadas,2015-12-01,0,0,6,2,9,17
MACHARETI,"anticoncepcion, prevencion de its y de cancer de cuello uterino",numero de mujeres con resultados de pap positivos tratadas,2015-12-01,0,0,1,0,0,1
MONTEAGUDO,"anticoncepcion, prevencion de its y de cancer de cuello uterino",numero de mujeres con resultados de pap positivos tratadas,2015-12-01,0,0,6,2,0,8
MONTERO,"anticoncepcion, prevencion de its y de cancer de cuello uterino",numero de mujeres con resultados de pap positivos tratadas,2015-12-01,0,2,1,0,0,3
ORURO,"anticoncepcion, prevencion de its y de cancer de cuello uterino",numero de mujeres con resultados de pap positivos tratadas,2015-12-01,0,0,2,1,0,3
PAILON,"anticoncepcion, prevencion de its y de cancer de cuello uterino",numero de mujeres con resultados de pap positivos tratadas,2015-12-01,0,1,2,0,0,3
PORTACHUELO,"anticoncepcion, prevencion de its y de cancer de cuello uterino",numero de mujeres con resultados de pap positivos tratadas,2015-12-01,0,0,4,0,0,4
POTOSI,"anticoncepcion, prevencion de its y de cancer de cuello uterino",numero de mujeres con resultados de pap positivos tratadas,2015-12-01,0,0,4,3,0,7
SAN CARLOS,"anticoncepcion, prevencion de its y de cancer de cuello uterino",numero de mujeres con resultados de pap positivos tratadas,2015-12-01,0,0,0,10,0,10
SANTA CRUZ DE LA SIERRA,"anticoncepcion, prevencion de its y de cancer de cuello uterino",numero de mujeres con resultados de pap positivos tratadas,2015-12-01,0,0,12,2,3,17
SUCRE,"anticoncepcion, prevencion de its y de cancer de cuello uterino",numero de mujeres con resultados de pap positivos tratadas,2015-12-01,0,0,5,8,1,14
TARIJA,"anticoncepcion, prevencion de its y de cancer de cuello uterino",numero de mujeres con resultados de pap positivos tratadas,2015-12-01,0,1,6,4,1,12
TRINIDAD,"anticoncepcion, prevencion de its y de cancer de cuello uterino",numero de mujeres con resultados de pap positivos tratadas,2015-12-01,0,0,6,3,0,9
VALLEGRANDE,"anticoncepcion, prevencion de its y de cancer de cuello uterino",numero de mujeres con resultados de pap positivos tratadas,2015-12-01,0,0,1,2,1,4
