municipality,group,variable,month,Número de mujeres con IVAA,Número de mujeres con IVAA1,Número de mujeres con IVAA2,Número de mujeres con IVAA3,Número de mujeres con IVAA4,TOTAL
ANTEQUERA,"anticoncepcion, prevencion de its y de cancer de cuello uterino",numero de mujeres con ivaa,2015-01-01,0,0,1,1,0,2
AYOPAYA (V. DE INDEPENDENCIA),"anticoncepcion, prevencion de its y de cancer de cuello uterino",numero de mujeres con ivaa,2015-01-01,1,0,6,1,1,9
BELLA FLOR,"anticoncepcion, prevencion de its y de cancer de cuello uterino",numero de mujeres con ivaa,2015-01-01,0,3,0,0,0,3
BERMEJO,"anticoncepcion, prevencion de its y de cancer de cuello uterino",numero de mujeres con ivaa,2015-01-01,0,0,4,1,0,5
BUENA VISTA,"anticoncepcion, prevencion de its y de cancer de cuello uterino",numero de mujeres con ivaa,2015-01-01,0,0,10,0,0,10
CAMARGO,"anticoncepcion, prevencion de its y de cancer de cuello uterino",numero de mujeres con ivaa,2015-01-01,0,0,0,1,0,1
CAMIRI,"anticoncepcion, prevencion de its y de cancer de cuello uterino",numero de mujeres con ivaa,2015-01-01,0,0,4,3,0,7
CAPINOTA,"anticoncepcion, prevencion de its y de cancer de cuello uterino",numero de mujeres con ivaa,2015-01-01,3,10,55,23,4,95
CARANGAS,"anticoncepcion, prevencion de its y de cancer de cuello uterino",numero de mujeres con ivaa,2015-01-01,0,0,2,0,0,2
CHALLAPATA,"anticoncepcion, prevencion de its y de cancer de cuello uterino",numero de mujeres con ivaa,2015-01-01,0,0,2,0,0,2
CLIZA,"anticoncepcion, prevencion de its y de cancer de cuello uterino",numero de mujeres con ivaa,2015-01-01,0,0,2,0,0,2
COBIJA,"anticoncepcion, prevencion de its y de cancer de cuello uterino",numero de mujeres con ivaa,2015-01-01,1,9,45,22,10,87
COCHABAMBA,"anticoncepcion, prevencion de its y de cancer de cuello uterino",numero de mujeres con ivaa,2015-01-01,3,93,201,976,331,1604
COIPASA,"anticoncepcion, prevencion de its y de cancer de cuello uterino",numero de mujeres con ivaa,2015-01-01,0,0,2,0,0,2
CORQUE,"anticoncepcion, prevencion de its y de cancer de cuello uterino",numero de mujeres con ivaa,2015-01-01,0,0,0,1,0,1
EL ALTO,"anticoncepcion, prevencion de its y de cancer de cuello uterino",numero de mujeres con ivaa,2015-01-01,0,3,133,154,121,411
EL PUENTE(TJA),"anticoncepcion, prevencion de its y de cancer de cuello uterino",numero de mujeres con ivaa,2015-01-01,0,1,1,5,0,7
ENTRE RIOS TRJ,"anticoncepcion, prevencion de its y de cancer de cuello uterino",numero de mujeres con ivaa,2015-01-01,0,0,0,2,0,2
ESCOMA,"anticoncepcion, prevencion de its y de cancer de cuello uterino",numero de mujeres con ivaa,2015-01-01,0,1,3,1,2,7
GENERAL SAAVEDRA,"anticoncepcion, prevencion de its y de cancer de cuello uterino",numero de mujeres con ivaa,2015-01-01,0,0,1,1,2,4
HUACARETA,"anticoncepcion, prevencion de its y de cancer de cuello uterino",numero de mujeres con ivaa,2015-01-01,0,2,14,7,0,23
HUACHACALLA,"anticoncepcion, prevencion de its y de cancer de cuello uterino",numero de mujeres con ivaa,2015-01-01,0,0,3,1,0,4
HUANUNI,"anticoncepcion, prevencion de its y de cancer de cuello uterino",numero de mujeres con ivaa,2015-01-01,0,1,0,0,0,1
ICLA,"anticoncepcion, prevencion de its y de cancer de cuello uterino",numero de mujeres con ivaa,2015-01-01,0,0,0,1,0,1
LA PAZ,"anticoncepcion, prevencion de its y de cancer de cuello uterino",numero de mujeres con ivaa,2015-01-01,2,10,72,59,12,155
MACHARETI,"anticoncepcion, prevencion de its y de cancer de cuello uterino",numero de mujeres con ivaa,2015-01-01,0,1,2,1,0,4
MAPIRI,"anticoncepcion, prevencion de its y de cancer de cuello uterino",numero de mujeres con ivaa,2015-01-01,0,5,17,9,6,37
MIZQUE,"anticoncepcion, prevencion de its y de cancer de cuello uterino",numero de mujeres con ivaa,2015-01-01,0,3,21,5,2,31
MOJOCOYA,"anticoncepcion, prevencion de its y de cancer de cuello uterino",numero de mujeres con ivaa,2015-01-01,0,0,1,5,0,6
MONTEAGUDO,"anticoncepcion, prevencion de its y de cancer de cuello uterino",numero de mujeres con ivaa,2015-01-01,0,1,6,10,1,18
MONTERO,"anticoncepcion, prevencion de its y de cancer de cuello uterino",numero de mujeres con ivaa,2015-01-01,0,1,29,20,3,53
ORURO,"anticoncepcion, prevencion de its y de cancer de cuello uterino",numero de mujeres con ivaa,2015-01-01,0,0,32,32,6,70
PADCAYA,"anticoncepcion, prevencion de its y de cancer de cuello uterino",numero de mujeres con ivaa,2015-01-01,0,0,3,4,1,8
PADILLA,"anticoncepcion, prevencion de its y de cancer de cuello uterino",numero de mujeres con ivaa,2015-01-01,2,25,15,4,0,46
PAZÑA,"anticoncepcion, prevencion de its y de cancer de cuello uterino",numero de mujeres con ivaa,2015-01-01,0,0,2,0,0,2
POOPO,"anticoncepcion, prevencion de its y de cancer de cuello uterino",numero de mujeres con ivaa,2015-01-01,0,0,13,1,0,14
PORVENIR,"anticoncepcion, prevencion de its y de cancer de cuello uterino",numero de mujeres con ivaa,2015-01-01,0,1,3,1,0,5
POTOSI,"anticoncepcion, prevencion de its y de cancer de cuello uterino",numero de mujeres con ivaa,2015-01-01,0,1,18,24,3,46
PRESTO,"anticoncepcion, prevencion de its y de cancer de cuello uterino",numero de mujeres con ivaa,2015-01-01,0,3,8,3,2,16
PUERTO GONZALO MORENO,"anticoncepcion, prevencion de its y de cancer de cuello uterino",numero de mujeres con ivaa,2015-01-01,0,0,1,0,0,1
PUNATA,"anticoncepcion, prevencion de its y de cancer de cuello uterino",numero de mujeres con ivaa,2015-01-01,0,3,1,3,0,7
QUILLACOLLO,"anticoncepcion, prevencion de its y de cancer de cuello uterino",numero de mujeres con ivaa,2015-01-01,0,0,0,1,0,1
RIBERALTA,"anticoncepcion, prevencion de its y de cancer de cuello uterino",numero de mujeres con ivaa,2015-01-01,0,2,74,48,5,129
SABAYA,"anticoncepcion, prevencion de its y de cancer de cuello uterino",numero de mujeres con ivaa,2015-01-01,0,0,1,0,0,1
SACABA,"anticoncepcion, prevencion de its y de cancer de cuello uterino",numero de mujeres con ivaa,2015-01-01,0,0,1,4,0,5
SACACA,"anticoncepcion, prevencion de its y de cancer de cuello uterino",numero de mujeres con ivaa,2015-01-01,0,0,0,1,0,1
SAN LUCAS,"anticoncepcion, prevencion de its y de cancer de cuello uterino",numero de mujeres con ivaa,2015-01-01,0,9,47,25,12,93
SANTA CRUZ DE LA SIERRA,"anticoncepcion, prevencion de its y de cancer de cuello uterino",numero de mujeres con ivaa,2015-01-01,0,0,3,20,0,23
SANTA ROSA DEL SARA,"anticoncepcion, prevencion de its y de cancer de cuello uterino",numero de mujeres con ivaa,2015-01-01,0,0,0,0,1,1
SICAYA,"anticoncepcion, prevencion de its y de cancer de cuello uterino",numero de mujeres con ivaa,2015-01-01,0,0,0,2,0,2
SOPACHUY,"anticoncepcion, prevencion de its y de cancer de cuello uterino",numero de mujeres con ivaa,2015-01-01,0,2,1,0,0,3
SUCRE,"anticoncepcion, prevencion de its y de cancer de cuello uterino",numero de mujeres con ivaa,2015-01-01,0,13,82,44,8,147
TARIJA,"anticoncepcion, prevencion de its y de cancer de cuello uterino",numero de mujeres con ivaa,2015-01-01,0,17,135,199,38,389
TARVITA,"anticoncepcion, prevencion de its y de cancer de cuello uterino",numero de mujeres con ivaa,2015-01-01,0,0,30,17,1,48
TOMINA,"anticoncepcion, prevencion de its y de cancer de cuello uterino",numero de mujeres con ivaa,2015-01-01,0,0,3,1,2,6
TRINIDAD,"anticoncepcion, prevencion de its y de cancer de cuello uterino",numero de mujeres con ivaa,2015-01-01,0,0,10,6,2,18
UNCIA,"anticoncepcion, prevencion de its y de cancer de cuello uterino",numero de mujeres con ivaa,2015-01-01,0,0,5,5,2,12
URIONDO (A. CONCEPCION),"anticoncepcion, prevencion de its y de cancer de cuello uterino",numero de mujeres con ivaa,2015-01-01,0,0,1,0,1,2
VILLA CHARCAS,"anticoncepcion, prevencion de its y de cancer de cuello uterino",numero de mujeres con ivaa,2015-01-01,0,7,13,15,1,36
VILLA SERRANO,"anticoncepcion, prevencion de its y de cancer de cuello uterino",numero de mujeres con ivaa,2015-01-01,0,2,8,3,1,14
VILLA VACA GUZMAN (MUYUPAMPA),"anticoncepcion, prevencion de its y de cancer de cuello uterino",numero de mujeres con ivaa,2015-01-01,0,0,2,1,0,3
YAMPARAEZ,"anticoncepcion, prevencion de its y de cancer de cuello uterino",numero de mujeres con ivaa,2015-01-01,0,0,3,3,1,7
YAPACANI,"anticoncepcion, prevencion de its y de cancer de cuello uterino",numero de mujeres con ivaa,2015-01-01,1,8,40,12,0,61
ZUDAÑEZ,"anticoncepcion, prevencion de its y de cancer de cuello uterino",numero de mujeres con ivaa,2015-01-01,0,0,0,0,1,1
AYOPAYA (V. DE INDEPENDENCIA),"anticoncepcion, prevencion de its y de cancer de cuello uterino",numero de mujeres con ivaa,2015-02-01,0,0,6,4,0,10
AZURDUY,"anticoncepcion, prevencion de its y de cancer de cuello uterino",numero de mujeres con ivaa,2015-02-01,0,0,2,1,3,6
BELLA FLOR,"anticoncepcion, prevencion de its y de cancer de cuello uterino",numero de mujeres con ivaa,2015-02-01,0,1,3,0,1,5
BERMEJO,"anticoncepcion, prevencion de its y de cancer de cuello uterino",numero de mujeres con ivaa,2015-02-01,0,0,4,8,0,12
CAMIRI,"anticoncepcion, prevencion de its y de cancer de cuello uterino",numero de mujeres con ivaa,2015-02-01,0,1,14,14,8,37
CAPINOTA,"anticoncepcion, prevencion de its y de cancer de cuello uterino",numero de mujeres con ivaa,2015-02-01,0,8,43,10,1,62
CARIPUYO,"anticoncepcion, prevencion de its y de cancer de cuello uterino",numero de mujeres con ivaa,2015-02-01,0,0,3,0,0,3
CHALLAPATA,"anticoncepcion, prevencion de its y de cancer de cuello uterino",numero de mujeres con ivaa,2015-02-01,0,0,0,1,0,1
COBIJA,"anticoncepcion, prevencion de its y de cancer de cuello uterino",numero de mujeres con ivaa,2015-02-01,0,6,35,19,8,68
COCHABAMBA,"anticoncepcion, prevencion de its y de cancer de cuello uterino",numero de mujeres con ivaa,2015-02-01,1,47,115,590,44,797
COMARAPA,"anticoncepcion, prevencion de its y de cancer de cuello uterino",numero de mujeres con ivaa,2015-02-01,0,1,10,7,3,21
CULPINA,"anticoncepcion, prevencion de its y de cancer de cuello uterino",numero de mujeres con ivaa,2015-02-01,0,0,1,0,0,1
EL ALTO,"anticoncepcion, prevencion de its y de cancer de cuello uterino",numero de mujeres con ivaa,2015-02-01,0,10,131,123,50,314
EL PUENTE(TJA),"anticoncepcion, prevencion de its y de cancer de cuello uterino",numero de mujeres con ivaa,2015-02-01,0,1,0,2,0,3
EL TORNO,"anticoncepcion, prevencion de its y de cancer de cuello uterino",numero de mujeres con ivaa,2015-02-01,0,0,1,1,0,2
ESCOMA,"anticoncepcion, prevencion de its y de cancer de cuello uterino",numero de mujeres con ivaa,2015-02-01,0,3,9,9,4,25
GENERAL SAAVEDRA,"anticoncepcion, prevencion de its y de cancer de cuello uterino",numero de mujeres con ivaa,2015-02-01,0,0,1,1,0,2
HUACARETA,"anticoncepcion, prevencion de its y de cancer de cuello uterino",numero de mujeres con ivaa,2015-02-01,0,2,4,4,4,14
HUANUNI,"anticoncepcion, prevencion de its y de cancer de cuello uterino",numero de mujeres con ivaa,2015-02-01,0,1,0,1,0,2
ICLA,"anticoncepcion, prevencion de its y de cancer de cuello uterino",numero de mujeres con ivaa,2015-02-01,0,0,13,19,5,37
INCAHUASI,"anticoncepcion, prevencion de its y de cancer de cuello uterino",numero de mujeres con ivaa,2015-02-01,0,4,36,11,1,52
LA PAZ,"anticoncepcion, prevencion de its y de cancer de cuello uterino",numero de mujeres con ivaa,2015-02-01,0,0,33,28,34,95
MOJOCOYA,"anticoncepcion, prevencion de its y de cancer de cuello uterino",numero de mujeres con ivaa,2015-02-01,0,1,1,1,2,5
MONTERO,"anticoncepcion, prevencion de its y de cancer de cuello uterino",numero de mujeres con ivaa,2015-02-01,1,9,56,16,4,86
ORURO,"anticoncepcion, prevencion de its y de cancer de cuello uterino",numero de mujeres con ivaa,2015-02-01,0,4,107,48,0,159
PADCAYA,"anticoncepcion, prevencion de its y de cancer de cuello uterino",numero de mujeres con ivaa,2015-02-01,0,0,1,0,0,1
PADILLA,"anticoncepcion, prevencion de its y de cancer de cuello uterino",numero de mujeres con ivaa,2015-02-01,0,2,9,7,2,20
POCONA,"anticoncepcion, prevencion de its y de cancer de cuello uterino",numero de mujeres con ivaa,2015-02-01,0,1,1,1,1,4
POOPO,"anticoncepcion, prevencion de its y de cancer de cuello uterino",numero de mujeres con ivaa,2015-02-01,0,0,1,0,0,1
POTOSI,"anticoncepcion, prevencion de its y de cancer de cuello uterino",numero de mujeres con ivaa,2015-02-01,0,2,56,35,3,96
PRESTO,"anticoncepcion, prevencion de its y de cancer de cuello uterino",numero de mujeres con ivaa,2015-02-01,0,0,7,5,0,12
PUERTO RICO,"anticoncepcion, prevencion de its y de cancer de cuello uterino",numero de mujeres con ivaa,2015-02-01,0,0,1,1,0,2
QUILLACOLLO,"anticoncepcion, prevencion de its y de cancer de cuello uterino",numero de mujeres con ivaa,2015-02-01,0,0,1,2,0,3
RIBERALTA,"anticoncepcion, prevencion de its y de cancer de cuello uterino",numero de mujeres con ivaa,2015-02-01,1,18,99,59,9,186
SACABA,"anticoncepcion, prevencion de its y de cancer de cuello uterino",numero de mujeres con ivaa,2015-02-01,0,0,0,7,0,7
SAN IGNACIO DE VELASCO,"anticoncepcion, prevencion de its y de cancer de cuello uterino",numero de mujeres con ivaa,2015-02-01,0,0,3,0,0,3
SAN LUCAS,"anticoncepcion, prevencion de its y de cancer de cuello uterino",numero de mujeres con ivaa,2015-02-01,0,6,26,21,7,60
SANTA CRUZ DE LA SIERRA,"anticoncepcion, prevencion de its y de cancer de cuello uterino",numero de mujeres con ivaa,2015-02-01,0,3,33,37,4,77
SANTA ROSA DEL SARA,"anticoncepcion, prevencion de its y de cancer de cuello uterino",numero de mujeres con ivaa,2015-02-01,0,1,0,0,0,1
SOPACHUY,"anticoncepcion, prevencion de its y de cancer de cuello uterino",numero de mujeres con ivaa,2015-02-01,0,1,0,0,0,1
SUCRE,"anticoncepcion, prevencion de its y de cancer de cuello uterino",numero de mujeres con ivaa,2015-02-01,0,16,108,64,11,199
TARIJA,"anticoncepcion, prevencion de its y de cancer de cuello uterino",numero de mujeres con ivaa,2015-02-01,0,12,115,91,87,305
TARVITA,"anticoncepcion, prevencion de its y de cancer de cuello uterino",numero de mujeres con ivaa,2015-02-01,0,6,9,11,2,28
TOMINA,"anticoncepcion, prevencion de its y de cancer de cuello uterino",numero de mujeres con ivaa,2015-02-01,0,1,1,3,0,5
TRINIDAD,"anticoncepcion, prevencion de its y de cancer de cuello uterino",numero de mujeres con ivaa,2015-02-01,0,6,17,6,0,29
UNCIA,"anticoncepcion, prevencion de its y de cancer de cuello uterino",numero de mujeres con ivaa,2015-02-01,0,0,2,0,2,4
VILLA CHARCAS,"anticoncepcion, prevencion de its y de cancer de cuello uterino",numero de mujeres con ivaa,2015-02-01,0,5,12,11,1,29
VILLA SERRANO,"anticoncepcion, prevencion de its y de cancer de cuello uterino",numero de mujeres con ivaa,2015-02-01,0,3,9,7,1,20
VILLA VACA GUZMAN (MUYUPAMPA),"anticoncepcion, prevencion de its y de cancer de cuello uterino",numero de mujeres con ivaa,2015-02-01,0,2,1,3,0,6
YAMPARAEZ,"anticoncepcion, prevencion de its y de cancer de cuello uterino",numero de mujeres con ivaa,2015-02-01,0,0,7,2,1,10
YAPACANI,"anticoncepcion, prevencion de its y de cancer de cuello uterino",numero de mujeres con ivaa,2015-02-01,0,1,12,4,0,17
ACHACACHI,"anticoncepcion, prevencion de its y de cancer de cuello uterino",numero de mujeres con ivaa,2015-03-01,0,2,13,7,1,23
ALCALA,"anticoncepcion, prevencion de its y de cancer de cuello uterino",numero de mujeres con ivaa,2015-03-01,0,2,19,9,1,31
AYOPAYA (V. DE INDEPENDENCIA),"anticoncepcion, prevencion de its y de cancer de cuello uterino",numero de mujeres con ivaa,2015-03-01,0,1,6,3,0,10
AZURDUY,"anticoncepcion, prevencion de its y de cancer de cuello uterino",numero de mujeres con ivaa,2015-03-01,0,7,21,13,4,45
BELLA FLOR,"anticoncepcion, prevencion de its y de cancer de cuello uterino",numero de mujeres con ivaa,2015-03-01,0,0,2,1,0,3
BERMEJO,"anticoncepcion, prevencion de its y de cancer de cuello uterino",numero de mujeres con ivaa,2015-03-01,0,0,5,6,0,11
CAMIRI,"anticoncepcion, prevencion de its y de cancer de cuello uterino",numero de mujeres con ivaa,2015-03-01,0,0,6,4,6,16
CAPINOTA,"anticoncepcion, prevencion de its y de cancer de cuello uterino",numero de mujeres con ivaa,2015-03-01,0,21,45,14,5,85
CHALLAPATA,"anticoncepcion, prevencion de its y de cancer de cuello uterino",numero de mujeres con ivaa,2015-03-01,0,1,2,0,0,3
CLIZA,"anticoncepcion, prevencion de its y de cancer de cuello uterino",numero de mujeres con ivaa,2015-03-01,0,0,2,1,0,3
COBIJA,"anticoncepcion, prevencion de its y de cancer de cuello uterino",numero de mujeres con ivaa,2015-03-01,0,11,62,40,9,122
COCHABAMBA,"anticoncepcion, prevencion de its y de cancer de cuello uterino",numero de mujeres con ivaa,2015-03-01,3,76,139,859,52,1129
COMARAPA,"anticoncepcion, prevencion de its y de cancer de cuello uterino",numero de mujeres con ivaa,2015-03-01,0,0,16,6,5,27
CORQUE,"anticoncepcion, prevencion de its y de cancer de cuello uterino",numero de mujeres con ivaa,2015-03-01,0,0,1,2,1,4
CUATRO CAÑADAS,"anticoncepcion, prevencion de its y de cancer de cuello uterino",numero de mujeres con ivaa,2015-03-01,0,0,0,1,0,1
CULPINA,"anticoncepcion, prevencion de its y de cancer de cuello uterino",numero de mujeres con ivaa,2015-03-01,0,1,6,7,3,17
EL ALTO,"anticoncepcion, prevencion de its y de cancer de cuello uterino",numero de mujeres con ivaa,2015-03-01,0,30,27,41,7,105
EL PUENTE(TJA),"anticoncepcion, prevencion de its y de cancer de cuello uterino",numero de mujeres con ivaa,2015-03-01,0,0,1,5,0,6
GENERAL SAAVEDRA,"anticoncepcion, prevencion de its y de cancer de cuello uterino",numero de mujeres con ivaa,2015-03-01,1,0,2,0,1,4
GUAYARAMERIN,"anticoncepcion, prevencion de its y de cancer de cuello uterino",numero de mujeres con ivaa,2015-03-01,0,0,1,0,0,1
HUACARETA,"anticoncepcion, prevencion de its y de cancer de cuello uterino",numero de mujeres con ivaa,2015-03-01,0,0,5,12,1,18
HUACHACALLA,"anticoncepcion, prevencion de its y de cancer de cuello uterino",numero de mujeres con ivaa,2015-03-01,0,0,1,2,0,3
HUANUNI,"anticoncepcion, prevencion de its y de cancer de cuello uterino",numero de mujeres con ivaa,2015-03-01,0,1,7,9,2,19
HUAYLLAMARCA,"anticoncepcion, prevencion de its y de cancer de cuello uterino",numero de mujeres con ivaa,2015-03-01,0,0,1,0,2,3
ICLA,"anticoncepcion, prevencion de its y de cancer de cuello uterino",numero de mujeres con ivaa,2015-03-01,0,2,17,31,5,55
INCAHUASI,"anticoncepcion, prevencion de its y de cancer de cuello uterino",numero de mujeres con ivaa,2015-03-01,0,2,10,10,2,24
LA PAZ,"anticoncepcion, prevencion de its y de cancer de cuello uterino",numero de mujeres con ivaa,2015-03-01,0,15,60,55,9,139
MIZQUE,"anticoncepcion, prevencion de its y de cancer de cuello uterino",numero de mujeres con ivaa,2015-03-01,0,0,4,5,0,9
MOJOCOYA,"anticoncepcion, prevencion de its y de cancer de cuello uterino",numero de mujeres con ivaa,2015-03-01,0,0,1,1,1,3
MONTEAGUDO,"anticoncepcion, prevencion de its y de cancer de cuello uterino",numero de mujeres con ivaa,2015-03-01,1,12,5,14,5,37
MONTERO,"anticoncepcion, prevencion de its y de cancer de cuello uterino",numero de mujeres con ivaa,2015-03-01,0,4,59,29,10,102
ORURO,"anticoncepcion, prevencion de its y de cancer de cuello uterino",numero de mujeres con ivaa,2015-03-01,1,13,166,134,28,342
PADCAYA,"anticoncepcion, prevencion de its y de cancer de cuello uterino",numero de mujeres con ivaa,2015-03-01,0,0,10,7,0,17
PADILLA,"anticoncepcion, prevencion de its y de cancer de cuello uterino",numero de mujeres con ivaa,2015-03-01,0,2,9,12,2,25
POCONA,"anticoncepcion, prevencion de its y de cancer de cuello uterino",numero de mujeres con ivaa,2015-03-01,0,1,1,1,0,3
POOPO,"anticoncepcion, prevencion de its y de cancer de cuello uterino",numero de mujeres con ivaa,2015-03-01,0,0,6,1,0,7
POROMA,"anticoncepcion, prevencion de its y de cancer de cuello uterino",numero de mujeres con ivaa,2015-03-01,0,0,3,0,0,3
POTOSI,"anticoncepcion, prevencion de its y de cancer de cuello uterino",numero de mujeres con ivaa,2015-03-01,0,3,47,44,3,97
PUERTO GONZALO MORENO,"anticoncepcion, prevencion de its y de cancer de cuello uterino",numero de mujeres con ivaa,2015-03-01,0,1,4,3,1,9
PUERTO RICO,"anticoncepcion, prevencion de its y de cancer de cuello uterino",numero de mujeres con ivaa,2015-03-01,0,0,1,0,0,1
PUNATA,"anticoncepcion, prevencion de its y de cancer de cuello uterino",numero de mujeres con ivaa,2015-03-01,0,2,35,28,30,95
QUILLACOLLO,"anticoncepcion, prevencion de its y de cancer de cuello uterino",numero de mujeres con ivaa,2015-03-01,0,6,10,8,0,24
RIBERALTA,"anticoncepcion, prevencion de its y de cancer de cuello uterino",numero de mujeres con ivaa,2015-03-01,0,12,140,92,18,262
SACABA,"anticoncepcion, prevencion de its y de cancer de cuello uterino",numero de mujeres con ivaa,2015-03-01,0,1,9,6,2,18
SAN ANDRES,"anticoncepcion, prevencion de its y de cancer de cuello uterino",numero de mujeres con ivaa,2015-03-01,0,0,7,2,1,10
SAN IGNACIO,"anticoncepcion, prevencion de its y de cancer de cuello uterino",numero de mujeres con ivaa,2015-03-01,0,0,1,0,0,1
SAN IGNACIO DE VELASCO,"anticoncepcion, prevencion de its y de cancer de cuello uterino",numero de mujeres con ivaa,2015-03-01,0,2,0,0,0,2
SAN LUCAS,"anticoncepcion, prevencion de its y de cancer de cuello uterino",numero de mujeres con ivaa,2015-03-01,0,5,51,57,22,135
SANTA CRUZ DE LA SIERRA,"anticoncepcion, prevencion de its y de cancer de cuello uterino",numero de mujeres con ivaa,2015-03-01,0,4,49,91,10,154
SANTIAGO DE HUARI,"anticoncepcion, prevencion de its y de cancer de cuello uterino",numero de mujeres con ivaa,2015-03-01,0,0,3,0,0,3
SOPACHUY,"anticoncepcion, prevencion de its y de cancer de cuello uterino",numero de mujeres con ivaa,2015-03-01,0,0,1,0,0,1
SUCRE,"anticoncepcion, prevencion de its y de cancer de cuello uterino",numero de mujeres con ivaa,2015-03-01,0,19,175,99,15,308
TARIJA,"anticoncepcion, prevencion de its y de cancer de cuello uterino",numero de mujeres con ivaa,2015-03-01,0,2,46,65,15,128
TARVITA,"anticoncepcion, prevencion de its y de cancer de cuello uterino",numero de mujeres con ivaa,2015-03-01,0,7,25,50,5,87
TOLEDO,"anticoncepcion, prevencion de its y de cancer de cuello uterino",numero de mujeres con ivaa,2015-03-01,0,0,1,0,1,2
TOMINA,"anticoncepcion, prevencion de its y de cancer de cuello uterino",numero de mujeres con ivaa,2015-03-01,0,0,5,1,0,6
TOTORA(ORR),"anticoncepcion, prevencion de its y de cancer de cuello uterino",numero de mujeres con ivaa,2015-03-01,0,2,23,9,0,34
TRINIDAD,"anticoncepcion, prevencion de its y de cancer de cuello uterino",numero de mujeres con ivaa,2015-03-01,0,0,7,6,1,14
UNCIA,"anticoncepcion, prevencion de its y de cancer de cuello uterino",numero de mujeres con ivaa,2015-03-01,0,0,2,2,1,5
URIONDO (A. CONCEPCION),"anticoncepcion, prevencion de its y de cancer de cuello uterino",numero de mujeres con ivaa,2015-03-01,0,0,5,5,0,10
VILLA CHARCAS,"anticoncepcion, prevencion de its y de cancer de cuello uterino",numero de mujeres con ivaa,2015-03-01,0,3,18,14,4,39
VILLA MONTES,"anticoncepcion, prevencion de its y de cancer de cuello uterino",numero de mujeres con ivaa,2015-03-01,0,0,0,1,0,1
VILLA VACA GUZMAN (MUYUPAMPA),"anticoncepcion, prevencion de its y de cancer de cuello uterino",numero de mujeres con ivaa,2015-03-01,0,5,16,12,4,37
YAMPARAEZ,"anticoncepcion, prevencion de its y de cancer de cuello uterino",numero de mujeres con ivaa,2015-03-01,0,0,0,2,0,2
YAPACANI,"anticoncepcion, prevencion de its y de cancer de cuello uterino",numero de mujeres con ivaa,2015-03-01,0,13,48,23,1,85
ZUDAÑEZ,"anticoncepcion, prevencion de its y de cancer de cuello uterino",numero de mujeres con ivaa,2015-03-01,0,1,14,10,5,30
ACHACACHI,"anticoncepcion, prevencion de its y de cancer de cuello uterino",numero de mujeres con ivaa,2015-04-01,0,1,3,0,2,6
AIQUILE,"anticoncepcion, prevencion de its y de cancer de cuello uterino",numero de mujeres con ivaa,2015-04-01,0,2,14,8,2,26
ANCORAIMES,"anticoncepcion, prevencion de its y de cancer de cuello uterino",numero de mujeres con ivaa,2015-04-01,0,1,0,0,0,1
ANTEQUERA,"anticoncepcion, prevencion de its y de cancer de cuello uterino",numero de mujeres con ivaa,2015-04-01,0,0,0,1,0,1
AYOPAYA (V. DE INDEPENDENCIA),"anticoncepcion, prevencion de its y de cancer de cuello uterino",numero de mujeres con ivaa,2015-04-01,0,0,0,0,1,1
AZURDUY,"anticoncepcion, prevencion de its y de cancer de cuello uterino",numero de mujeres con ivaa,2015-04-01,0,1,0,1,0,2
BELLA FLOR,"anticoncepcion, prevencion de its y de cancer de cuello uterino",numero de mujeres con ivaa,2015-04-01,0,0,1,1,0,2
BERMEJO,"anticoncepcion, prevencion de its y de cancer de cuello uterino",numero de mujeres con ivaa,2015-04-01,0,0,1,1,0,2
BOYUIBE,"anticoncepcion, prevencion de its y de cancer de cuello uterino",numero de mujeres con ivaa,2015-04-01,0,0,0,1,0,1
CAMARGO,"anticoncepcion, prevencion de its y de cancer de cuello uterino",numero de mujeres con ivaa,2015-04-01,0,1,8,0,0,9
CAMATAQUI (C. VILLA ABECIA),"anticoncepcion, prevencion de its y de cancer de cuello uterino",numero de mujeres con ivaa,2015-04-01,0,0,5,5,2,12
CAMIRI,"anticoncepcion, prevencion de its y de cancer de cuello uterino",numero de mujeres con ivaa,2015-04-01,0,0,10,0,0,10
CAPINOTA,"anticoncepcion, prevencion de its y de cancer de cuello uterino",numero de mujeres con ivaa,2015-04-01,0,7,29,7,4,47
CLIZA,"anticoncepcion, prevencion de its y de cancer de cuello uterino",numero de mujeres con ivaa,2015-04-01,0,0,3,1,0,4
COBIJA,"anticoncepcion, prevencion de its y de cancer de cuello uterino",numero de mujeres con ivaa,2015-04-01,2,10,36,15,7,70
COCHABAMBA,"anticoncepcion, prevencion de its y de cancer de cuello uterino",numero de mujeres con ivaa,2015-04-01,0,69,121,715,33,938
CULPINA,"anticoncepcion, prevencion de its y de cancer de cuello uterino",numero de mujeres con ivaa,2015-04-01,0,2,9,3,3,17
EL ALTO,"anticoncepcion, prevencion de its y de cancer de cuello uterino",numero de mujeres con ivaa,2015-04-01,1,19,150,147,43,360
EL PUENTE(TJA),"anticoncepcion, prevencion de its y de cancer de cuello uterino",numero de mujeres con ivaa,2015-04-01,0,1,4,3,1,9
ENTRE RIOS TRJ,"anticoncepcion, prevencion de its y de cancer de cuello uterino",numero de mujeres con ivaa,2015-04-01,0,1,10,6,13,30
GENERAL SAAVEDRA,"anticoncepcion, prevencion de its y de cancer de cuello uterino",numero de mujeres con ivaa,2015-04-01,0,0,2,2,2,6
HUACARETA,"anticoncepcion, prevencion de its y de cancer de cuello uterino",numero de mujeres con ivaa,2015-04-01,0,0,10,7,3,20
HUANUNI,"anticoncepcion, prevencion de its y de cancer de cuello uterino",numero de mujeres con ivaa,2015-04-01,0,0,3,0,0,3
HUAYLLAMARCA,"anticoncepcion, prevencion de its y de cancer de cuello uterino",numero de mujeres con ivaa,2015-04-01,0,0,17,15,2,34
ICLA,"anticoncepcion, prevencion de its y de cancer de cuello uterino",numero de mujeres con ivaa,2015-04-01,0,1,19,33,18,71
INCAHUASI,"anticoncepcion, prevencion de its y de cancer de cuello uterino",numero de mujeres con ivaa,2015-04-01,0,2,15,21,5,43
LA PAZ,"anticoncepcion, prevencion de its y de cancer de cuello uterino",numero de mujeres con ivaa,2015-04-01,0,6,102,34,17,159
MIZQUE,"anticoncepcion, prevencion de its y de cancer de cuello uterino",numero de mujeres con ivaa,2015-04-01,0,0,5,2,0,7
MONTEAGUDO,"anticoncepcion, prevencion de its y de cancer de cuello uterino",numero de mujeres con ivaa,2015-04-01,1,1,15,15,0,32
MONTERO,"anticoncepcion, prevencion de its y de cancer de cuello uterino",numero de mujeres con ivaa,2015-04-01,0,9,45,35,5,94
ORURO,"anticoncepcion, prevencion de its y de cancer de cuello uterino",numero de mujeres con ivaa,2015-04-01,0,12,187,109,38,346
PADCAYA,"anticoncepcion, prevencion de its y de cancer de cuello uterino",numero de mujeres con ivaa,2015-04-01,0,0,3,7,2,12
PADILLA,"anticoncepcion, prevencion de its y de cancer de cuello uterino",numero de mujeres con ivaa,2015-04-01,0,1,8,12,4,25
POOPO,"anticoncepcion, prevencion de its y de cancer de cuello uterino",numero de mujeres con ivaa,2015-04-01,0,2,64,15,4,85
POTOSI,"anticoncepcion, prevencion de its y de cancer de cuello uterino",numero de mujeres con ivaa,2015-04-01,0,33,72,203,6,314
PUERTO GONZALO MORENO,"anticoncepcion, prevencion de its y de cancer de cuello uterino",numero de mujeres con ivaa,2015-04-01,1,1,19,4,5,30
PUERTO RICO,"anticoncepcion, prevencion de its y de cancer de cuello uterino",numero de mujeres con ivaa,2015-04-01,0,0,0,1,0,1
PUNATA,"anticoncepcion, prevencion de its y de cancer de cuello uterino",numero de mujeres con ivaa,2015-04-01,0,1,35,25,33,94
QUILLACOLLO,"anticoncepcion, prevencion de its y de cancer de cuello uterino",numero de mujeres con ivaa,2015-04-01,0,0,11,17,0,28
RIBERALTA,"anticoncepcion, prevencion de its y de cancer de cuello uterino",numero de mujeres con ivaa,2015-04-01,0,13,162,121,21,317
SABAYA,"anticoncepcion, prevencion de its y de cancer de cuello uterino",numero de mujeres con ivaa,2015-04-01,0,0,0,4,0,4
SACABA,"anticoncepcion, prevencion de its y de cancer de cuello uterino",numero de mujeres con ivaa,2015-04-01,0,2,17,9,2,30
SAN IGNACIO,"anticoncepcion, prevencion de its y de cancer de cuello uterino",numero de mujeres con ivaa,2015-04-01,0,0,2,1,2,5
SAN JUAN DE YAPACANI,"anticoncepcion, prevencion de its y de cancer de cuello uterino",numero de mujeres con ivaa,2015-04-01,0,0,2,0,3,5
SAN LORENZO(TJA),"anticoncepcion, prevencion de its y de cancer de cuello uterino",numero de mujeres con ivaa,2015-04-01,0,0,0,0,1,1
SAN LUCAS,"anticoncepcion, prevencion de its y de cancer de cuello uterino",numero de mujeres con ivaa,2015-04-01,0,7,41,39,7,94
SANTA CRUZ DE LA SIERRA,"anticoncepcion, prevencion de its y de cancer de cuello uterino",numero de mujeres con ivaa,2015-04-01,0,0,35,54,5,94
SICAYA,"anticoncepcion, prevencion de its y de cancer de cuello uterino",numero de mujeres con ivaa,2015-04-01,0,0,3,0,0,3
SOPACHUY,"anticoncepcion, prevencion de its y de cancer de cuello uterino",numero de mujeres con ivaa,2015-04-01,0,2,8,11,6,27
SORACACHI,"anticoncepcion, prevencion de its y de cancer de cuello uterino",numero de mujeres con ivaa,2015-04-01,0,1,6,0,1,8
SUCRE,"anticoncepcion, prevencion de its y de cancer de cuello uterino",numero de mujeres con ivaa,2015-04-01,4,15,103,79,15,216
TARIJA,"anticoncepcion, prevencion de its y de cancer de cuello uterino",numero de mujeres con ivaa,2015-04-01,0,1,55,35,22,113
TARVITA,"anticoncepcion, prevencion de its y de cancer de cuello uterino",numero de mujeres con ivaa,2015-04-01,0,7,32,24,6,69
TIRAQUE (CBBA),"anticoncepcion, prevencion de its y de cancer de cuello uterino",numero de mujeres con ivaa,2015-04-01,0,1,1,0,0,2
TOMINA,"anticoncepcion, prevencion de its y de cancer de cuello uterino",numero de mujeres con ivaa,2015-04-01,0,0,1,0,0,1
TOTORA(CBBA),"anticoncepcion, prevencion de its y de cancer de cuello uterino",numero de mujeres con ivaa,2015-04-01,0,1,7,0,0,8
TRINIDAD,"anticoncepcion, prevencion de its y de cancer de cuello uterino",numero de mujeres con ivaa,2015-04-01,0,1,18,19,3,41
URIONDO (A. CONCEPCION),"anticoncepcion, prevencion de its y de cancer de cuello uterino",numero de mujeres con ivaa,2015-04-01,0,1,4,5,0,10
VILLA CHARCAS,"anticoncepcion, prevencion de its y de cancer de cuello uterino",numero de mujeres con ivaa,2015-04-01,0,0,6,1,0,7
VILLA MONTES,"anticoncepcion, prevencion de its y de cancer de cuello uterino",numero de mujeres con ivaa,2015-04-01,0,0,6,0,0,6
VILLA SERRANO,"anticoncepcion, prevencion de its y de cancer de cuello uterino",numero de mujeres con ivaa,2015-04-01,0,1,2,0,0,3
VILLA VACA GUZMAN (MUYUPAMPA),"anticoncepcion, prevencion de its y de cancer de cuello uterino",numero de mujeres con ivaa,2015-04-01,0,2,10,11,1,24
YAMPARAEZ,"anticoncepcion, prevencion de its y de cancer de cuello uterino",numero de mujeres con ivaa,2015-04-01,1,0,6,9,1,17
YAPACANI,"anticoncepcion, prevencion de its y de cancer de cuello uterino",numero de mujeres con ivaa,2015-04-01,0,9,47,35,8,99
ZUDAÑEZ,"anticoncepcion, prevencion de its y de cancer de cuello uterino",numero de mujeres con ivaa,2015-04-01,0,0,0,4,0,4
ACHACACHI,"anticoncepcion, prevencion de its y de cancer de cuello uterino",numero de mujeres con ivaa,2015-05-01,0,1,2,1,3,7
AIQUILE,"anticoncepcion, prevencion de its y de cancer de cuello uterino",numero de mujeres con ivaa,2015-05-01,0,1,12,4,1,18
ANTEQUERA,"anticoncepcion, prevencion de its y de cancer de cuello uterino",numero de mujeres con ivaa,2015-05-01,0,0,1,0,0,1
AYOPAYA (V. DE INDEPENDENCIA),"anticoncepcion, prevencion de its y de cancer de cuello uterino",numero de mujeres con ivaa,2015-05-01,0,1,6,1,0,8
AZURDUY,"anticoncepcion, prevencion de its y de cancer de cuello uterino",numero de mujeres con ivaa,2015-05-01,0,0,7,6,1,14
BELLA FLOR,"anticoncepcion, prevencion de its y de cancer de cuello uterino",numero de mujeres con ivaa,2015-05-01,0,0,2,0,0,2
BERMEJO,"anticoncepcion, prevencion de its y de cancer de cuello uterino",numero de mujeres con ivaa,2015-05-01,0,2,30,22,6,60
BUENA VISTA,"anticoncepcion, prevencion de its y de cancer de cuello uterino",numero de mujeres con ivaa,2015-05-01,0,2,8,5,1,16
CAMARGO,"anticoncepcion, prevencion de its y de cancer de cuello uterino",numero de mujeres con ivaa,2015-05-01,0,0,1,0,0,1
CAMATAQUI (C. VILLA ABECIA),"anticoncepcion, prevencion de its y de cancer de cuello uterino",numero de mujeres con ivaa,2015-05-01,0,0,4,3,0,7
CAMIRI,"anticoncepcion, prevencion de its y de cancer de cuello uterino",numero de mujeres con ivaa,2015-05-01,0,0,3,9,2,14
CAPINOTA,"anticoncepcion, prevencion de its y de cancer de cuello uterino",numero de mujeres con ivaa,2015-05-01,0,9,46,15,0,70
CHALLAPATA,"anticoncepcion, prevencion de its y de cancer de cuello uterino",numero de mujeres con ivaa,2015-05-01,0,1,2,0,0,3
CHULUMANI (V. DE LA LIBERTAD),"anticoncepcion, prevencion de its y de cancer de cuello uterino",numero de mujeres con ivaa,2015-05-01,0,0,3,0,0,3
CLIZA,"anticoncepcion, prevencion de its y de cancer de cuello uterino",numero de mujeres con ivaa,2015-05-01,0,0,4,0,0,4
COBIJA,"anticoncepcion, prevencion de its y de cancer de cuello uterino",numero de mujeres con ivaa,2015-05-01,1,15,131,62,22,231
COCHABAMBA,"anticoncepcion, prevencion de its y de cancer de cuello uterino",numero de mujeres con ivaa,2015-05-01,1,59,149,935,65,1209
COMARAPA,"anticoncepcion, prevencion de its y de cancer de cuello uterino",numero de mujeres con ivaa,2015-05-01,0,0,21,16,15,52
CULPINA,"anticoncepcion, prevencion de its y de cancer de cuello uterino",numero de mujeres con ivaa,2015-05-01,0,6,17,19,4,46
CURAHUARA DE CARANGAS,"anticoncepcion, prevencion de its y de cancer de cuello uterino",numero de mujeres con ivaa,2015-05-01,0,0,0,1,3,4
EL ALTO,"anticoncepcion, prevencion de its y de cancer de cuello uterino",numero de mujeres con ivaa,2015-05-01,0,14,138,232,51,435
EL PUENTE(TJA),"anticoncepcion, prevencion de its y de cancer de cuello uterino",numero de mujeres con ivaa,2015-05-01,0,0,7,5,1,13
EL VILLAR,"anticoncepcion, prevencion de its y de cancer de cuello uterino",numero de mujeres con ivaa,2015-05-01,0,3,14,11,11,39
GENERAL SAAVEDRA,"anticoncepcion, prevencion de its y de cancer de cuello uterino",numero de mujeres con ivaa,2015-05-01,0,0,1,0,0,1
HUACARETA,"anticoncepcion, prevencion de its y de cancer de cuello uterino",numero de mujeres con ivaa,2015-05-01,0,0,2,0,2,4
HUANUNI,"anticoncepcion, prevencion de its y de cancer de cuello uterino",numero de mujeres con ivaa,2015-05-01,0,0,1,1,0,2
HUAYLLAMARCA,"anticoncepcion, prevencion de its y de cancer de cuello uterino",numero de mujeres con ivaa,2015-05-01,0,1,9,8,5,23
ICLA,"anticoncepcion, prevencion de its y de cancer de cuello uterino",numero de mujeres con ivaa,2015-05-01,0,4,36,66,32,138
INCAHUASI,"anticoncepcion, prevencion de its y de cancer de cuello uterino",numero de mujeres con ivaa,2015-05-01,0,0,6,4,1,11
JESUS DE MACHACA,"anticoncepcion, prevencion de its y de cancer de cuello uterino",numero de mujeres con ivaa,2015-05-01,0,0,1,0,0,1
LA PAZ,"anticoncepcion, prevencion de its y de cancer de cuello uterino",numero de mujeres con ivaa,2015-05-01,0,6,75,56,23,160
MOJOCOYA,"anticoncepcion, prevencion de its y de cancer de cuello uterino",numero de mujeres con ivaa,2015-05-01,0,0,1,1,0,2
MONTEAGUDO,"anticoncepcion, prevencion de its y de cancer de cuello uterino",numero de mujeres con ivaa,2015-05-01,0,2,16,11,4,33
MONTERO,"anticoncepcion, prevencion de its y de cancer de cuello uterino",numero de mujeres con ivaa,2015-05-01,0,1,22,10,6,39
ORURO,"anticoncepcion, prevencion de its y de cancer de cuello uterino",numero de mujeres con ivaa,2015-05-01,1,9,79,30,6,125
PADCAYA,"anticoncepcion, prevencion de its y de cancer de cuello uterino",numero de mujeres con ivaa,2015-05-01,0,1,5,4,1,11
PADILLA,"anticoncepcion, prevencion de its y de cancer de cuello uterino",numero de mujeres con ivaa,2015-05-01,0,0,5,5,5,15
PAZÑA,"anticoncepcion, prevencion de its y de cancer de cuello uterino",numero de mujeres con ivaa,2015-05-01,0,0,27,8,1,36
POOPO,"anticoncepcion, prevencion de its y de cancer de cuello uterino",numero de mujeres con ivaa,2015-05-01,0,1,83,27,7,118
PORVENIR,"anticoncepcion, prevencion de its y de cancer de cuello uterino",numero de mujeres con ivaa,2015-05-01,0,1,0,0,0,1
POTOSI,"anticoncepcion, prevencion de its y de cancer de cuello uterino",numero de mujeres con ivaa,2015-05-01,0,6,37,243,16,302
PUERTO GONZALO MORENO,"anticoncepcion, prevencion de its y de cancer de cuello uterino",numero de mujeres con ivaa,2015-05-01,0,3,13,6,1,23
PUERTO RICO,"anticoncepcion, prevencion de its y de cancer de cuello uterino",numero de mujeres con ivaa,2015-05-01,0,1,5,2,0,8
PUNATA,"anticoncepcion, prevencion de its y de cancer de cuello uterino",numero de mujeres con ivaa,2015-05-01,0,0,6,3,2,11
QUILLACOLLO,"anticoncepcion, prevencion de its y de cancer de cuello uterino",numero de mujeres con ivaa,2015-05-01,0,0,12,12,0,24
RIBERALTA,"anticoncepcion, prevencion de its y de cancer de cuello uterino",numero de mujeres con ivaa,2015-05-01,0,25,147,77,8,257
SACABA,"anticoncepcion, prevencion de its y de cancer de cuello uterino",numero de mujeres con ivaa,2015-05-01,0,2,42,28,2,74
SACACA,"anticoncepcion, prevencion de its y de cancer de cuello uterino",numero de mujeres con ivaa,2015-05-01,0,3,18,13,4,38
SAN LUCAS,"anticoncepcion, prevencion de its y de cancer de cuello uterino",numero de mujeres con ivaa,2015-05-01,0,11,43,42,6,102
SANTA CRUZ DE LA SIERRA,"anticoncepcion, prevencion de its y de cancer de cuello uterino",numero de mujeres con ivaa,2015-05-01,0,0,41,80,14,135
SORACACHI,"anticoncepcion, prevencion de its y de cancer de cuello uterino",numero de mujeres con ivaa,2015-05-01,0,0,2,0,0,2
SUCRE,"anticoncepcion, prevencion de its y de cancer de cuello uterino",numero de mujeres con ivaa,2015-05-01,1,11,106,85,17,220
TARIJA,"anticoncepcion, prevencion de its y de cancer de cuello uterino",numero de mujeres con ivaa,2015-05-01,0,1,71,68,33,173
TARVITA,"anticoncepcion, prevencion de its y de cancer de cuello uterino",numero de mujeres con ivaa,2015-05-01,0,5,52,47,7,111
TIRAQUE (CBBA),"anticoncepcion, prevencion de its y de cancer de cuello uterino",numero de mujeres con ivaa,2015-05-01,0,0,0,1,0,1
TOMINA,"anticoncepcion, prevencion de its y de cancer de cuello uterino",numero de mujeres con ivaa,2015-05-01,1,0,2,2,0,5
TOTORA(CBBA),"anticoncepcion, prevencion de its y de cancer de cuello uterino",numero de mujeres con ivaa,2015-05-01,0,0,6,10,0,16
TRINIDAD,"anticoncepcion, prevencion de its y de cancer de cuello uterino",numero de mujeres con ivaa,2015-05-01,0,0,15,5,1,21
URIONDO (A. CONCEPCION),"anticoncepcion, prevencion de its y de cancer de cuello uterino",numero de mujeres con ivaa,2015-05-01,0,1,4,3,1,9
VILLA CHARCAS,"anticoncepcion, prevencion de its y de cancer de cuello uterino",numero de mujeres con ivaa,2015-05-01,0,6,34,21,6,67
VILLA MONTES,"anticoncepcion, prevencion de its y de cancer de cuello uterino",numero de mujeres con ivaa,2015-05-01,1,11,95,62,17,186
VILLA VACA GUZMAN (MUYUPAMPA),"anticoncepcion, prevencion de its y de cancer de cuello uterino",numero de mujeres con ivaa,2015-05-01,0,2,2,5,0,9
VINTO,"anticoncepcion, prevencion de its y de cancer de cuello uterino",numero de mujeres con ivaa,2015-05-01,0,4,19,4,0,27
YACUIBA,"anticoncepcion, prevencion de its y de cancer de cuello uterino",numero de mujeres con ivaa,2015-05-01,0,0,1,5,0,6
YAMPARAEZ,"anticoncepcion, prevencion de its y de cancer de cuello uterino",numero de mujeres con ivaa,2015-05-01,0,0,3,13,2,18
YAPACANI,"anticoncepcion, prevencion de its y de cancer de cuello uterino",numero de mujeres con ivaa,2015-05-01,0,5,63,37,1,106
ACACIO,"anticoncepcion, prevencion de its y de cancer de cuello uterino",numero de mujeres con ivaa,2015-06-01,0,5,19,18,4,46
AIQUILE,"anticoncepcion, prevencion de its y de cancer de cuello uterino",numero de mujeres con ivaa,2015-06-01,0,0,11,7,0,18
ALCALA,"anticoncepcion, prevencion de its y de cancer de cuello uterino",numero de mujeres con ivaa,2015-06-01,0,0,9,21,12,42
ANTEQUERA,"anticoncepcion, prevencion de its y de cancer de cuello uterino",numero de mujeres con ivaa,2015-06-01,0,0,5,0,1,6
AZURDUY,"anticoncepcion, prevencion de its y de cancer de cuello uterino",numero de mujeres con ivaa,2015-06-01,0,1,14,9,0,24
BELLA FLOR,"anticoncepcion, prevencion de its y de cancer de cuello uterino",numero de mujeres con ivaa,2015-06-01,0,1,2,2,0,5
BERMEJO,"anticoncepcion, prevencion de its y de cancer de cuello uterino",numero de mujeres con ivaa,2015-06-01,0,1,6,9,3,19
BUENA VISTA,"anticoncepcion, prevencion de its y de cancer de cuello uterino",numero de mujeres con ivaa,2015-06-01,0,1,3,0,0,4
CAMARGO,"anticoncepcion, prevencion de its y de cancer de cuello uterino",numero de mujeres con ivaa,2015-06-01,0,2,2,1,0,5
CAMATAQUI (C. VILLA ABECIA),"anticoncepcion, prevencion de its y de cancer de cuello uterino",numero de mujeres con ivaa,2015-06-01,0,0,3,2,0,5
CAMIRI,"anticoncepcion, prevencion de its y de cancer de cuello uterino",numero de mujeres con ivaa,2015-06-01,0,0,4,6,1,11
CAPINOTA,"anticoncepcion, prevencion de its y de cancer de cuello uterino",numero de mujeres con ivaa,2015-06-01,0,6,22,17,4,49
CARIPUYO,"anticoncepcion, prevencion de its y de cancer de cuello uterino",numero de mujeres con ivaa,2015-06-01,0,3,24,26,5,58
COBIJA,"anticoncepcion, prevencion de its y de cancer de cuello uterino",numero de mujeres con ivaa,2015-06-01,0,18,85,47,19,169
COCHABAMBA,"anticoncepcion, prevencion de its y de cancer de cuello uterino",numero de mujeres con ivaa,2015-06-01,1,45,130,749,39,964
COLCAPIRHUA,"anticoncepcion, prevencion de its y de cancer de cuello uterino",numero de mujeres con ivaa,2015-06-01,0,0,3,0,0,3
COMARAPA,"anticoncepcion, prevencion de its y de cancer de cuello uterino",numero de mujeres con ivaa,2015-06-01,0,1,14,6,2,23
CULPINA,"anticoncepcion, prevencion de its y de cancer de cuello uterino",numero de mujeres con ivaa,2015-06-01,0,0,2,1,3,6
EL ALTO,"anticoncepcion, prevencion de its y de cancer de cuello uterino",numero de mujeres con ivaa,2015-06-01,0,13,180,300,39,532
EL PUENTE(TJA),"anticoncepcion, prevencion de its y de cancer de cuello uterino",numero de mujeres con ivaa,2015-06-01,0,2,20,12,4,38
EL VILLAR,"anticoncepcion, prevencion de its y de cancer de cuello uterino",numero de mujeres con ivaa,2015-06-01,0,0,3,4,3,10
ENTRE RIOS TRJ,"anticoncepcion, prevencion de its y de cancer de cuello uterino",numero de mujeres con ivaa,2015-06-01,0,0,0,1,0,1
GENERAL SAAVEDRA,"anticoncepcion, prevencion de its y de cancer de cuello uterino",numero de mujeres con ivaa,2015-06-01,0,3,1,0,0,4
HUACARETA,"anticoncepcion, prevencion de its y de cancer de cuello uterino",numero de mujeres con ivaa,2015-06-01,0,2,12,13,5,32
HUANUNI,"anticoncepcion, prevencion de its y de cancer de cuello uterino",numero de mujeres con ivaa,2015-06-01,0,1,1,0,0,2
HUAYLLAMARCA,"anticoncepcion, prevencion de its y de cancer de cuello uterino",numero de mujeres con ivaa,2015-06-01,0,3,19,11,3,36
ICLA,"anticoncepcion, prevencion de its y de cancer de cuello uterino",numero de mujeres con ivaa,2015-06-01,0,6,23,46,22,97
INCAHUASI,"anticoncepcion, prevencion de its y de cancer de cuello uterino",numero de mujeres con ivaa,2015-06-01,0,4,25,11,3,43
JESUS DE MACHACA,"anticoncepcion, prevencion de its y de cancer de cuello uterino",numero de mujeres con ivaa,2015-06-01,0,0,1,0,0,1
LA PAZ,"anticoncepcion, prevencion de its y de cancer de cuello uterino",numero de mujeres con ivaa,2015-06-01,1,5,52,39,17,114
MAIRANA,"anticoncepcion, prevencion de its y de cancer de cuello uterino",numero de mujeres con ivaa,2015-06-01,0,0,4,9,4,17
MONTEAGUDO,"anticoncepcion, prevencion de its y de cancer de cuello uterino",numero de mujeres con ivaa,2015-06-01,0,1,4,10,2,17
MONTERO,"anticoncepcion, prevencion de its y de cancer de cuello uterino",numero de mujeres con ivaa,2015-06-01,0,7,29,17,4,57
ORURO,"anticoncepcion, prevencion de its y de cancer de cuello uterino",numero de mujeres con ivaa,2015-06-01,0,10,87,43,2,142
PADCAYA,"anticoncepcion, prevencion de its y de cancer de cuello uterino",numero de mujeres con ivaa,2015-06-01,0,0,7,5,1,13
PAZÑA,"anticoncepcion, prevencion de its y de cancer de cuello uterino",numero de mujeres con ivaa,2015-06-01,0,1,4,2,0,7
POOPO,"anticoncepcion, prevencion de its y de cancer de cuello uterino",numero de mujeres con ivaa,2015-06-01,1,1,5,4,1,12
POTOSI,"anticoncepcion, prevencion de its y de cancer de cuello uterino",numero de mujeres con ivaa,2015-06-01,0,0,28,40,3,71
PRESTO,"anticoncepcion, prevencion de its y de cancer de cuello uterino",numero de mujeres con ivaa,2015-06-01,0,0,0,0,1,1
PUERTO GONZALO MORENO,"anticoncepcion, prevencion de its y de cancer de cuello uterino",numero de mujeres con ivaa,2015-06-01,0,1,11,3,0,15
PUERTO RICO,"anticoncepcion, prevencion de its y de cancer de cuello uterino",numero de mujeres con ivaa,2015-06-01,0,0,7,13,1,21
PUNA,"anticoncepcion, prevencion de its y de cancer de cuello uterino",numero de mujeres con ivaa,2015-06-01,0,0,4,3,0,7
PUNATA,"anticoncepcion, prevencion de its y de cancer de cuello uterino",numero de mujeres con ivaa,2015-06-01,0,1,10,4,4,19
QUILLACOLLO,"anticoncepcion, prevencion de its y de cancer de cuello uterino",numero de mujeres con ivaa,2015-06-01,0,0,14,18,0,32
RIBERALTA,"anticoncepcion, prevencion de its y de cancer de cuello uterino",numero de mujeres con ivaa,2015-06-01,0,5,182,172,40,399
SACABA,"anticoncepcion, prevencion de its y de cancer de cuello uterino",numero de mujeres con ivaa,2015-06-01,0,1,17,34,6,58
SACACA,"anticoncepcion, prevencion de its y de cancer de cuello uterino",numero de mujeres con ivaa,2015-06-01,0,6,93,55,15,169
SAN JOSE DE CHIQUITOS,"anticoncepcion, prevencion de its y de cancer de cuello uterino",numero de mujeres con ivaa,2015-06-01,0,0,1,0,0,1
SAN JUAN DE YAPACANI,"anticoncepcion, prevencion de its y de cancer de cuello uterino",numero de mujeres con ivaa,2015-06-01,0,0,0,3,1,4
SAN LUCAS,"anticoncepcion, prevencion de its y de cancer de cuello uterino",numero de mujeres con ivaa,2015-06-01,0,9,82,58,12,161
SAN PEDRO DE BUENA VISTA,"anticoncepcion, prevencion de its y de cancer de cuello uterino",numero de mujeres con ivaa,2015-06-01,0,10,71,24,8,113
SANTA CRUZ DE LA SIERRA,"anticoncepcion, prevencion de its y de cancer de cuello uterino",numero de mujeres con ivaa,2015-06-01,0,1,131,94,15,241
SANTA ROSA DEL SARA,"anticoncepcion, prevencion de its y de cancer de cuello uterino",numero de mujeres con ivaa,2015-06-01,0,0,2,7,0,9
SOPACHUY,"anticoncepcion, prevencion de its y de cancer de cuello uterino",numero de mujeres con ivaa,2015-06-01,1,0,3,3,2,9
SUCRE,"anticoncepcion, prevencion de its y de cancer de cuello uterino",numero de mujeres con ivaa,2015-06-01,0,11,211,174,93,489
TARABUCO,"anticoncepcion, prevencion de its y de cancer de cuello uterino",numero de mujeres con ivaa,2015-06-01,0,6,25,50,18,99
TARIJA,"anticoncepcion, prevencion de its y de cancer de cuello uterino",numero de mujeres con ivaa,2015-06-01,0,2,54,32,5,93
TARVITA,"anticoncepcion, prevencion de its y de cancer de cuello uterino",numero de mujeres con ivaa,2015-06-01,0,6,24,22,4,56
TIRAQUE (CBBA),"anticoncepcion, prevencion de its y de cancer de cuello uterino",numero de mujeres con ivaa,2015-06-01,0,0,0,2,0,2
TOMINA,"anticoncepcion, prevencion de its y de cancer de cuello uterino",numero de mujeres con ivaa,2015-06-01,0,1,0,2,0,3
TORO TORO,"anticoncepcion, prevencion de its y de cancer de cuello uterino",numero de mujeres con ivaa,2015-06-01,0,8,38,45,0,91
TOTORA(CBBA),"anticoncepcion, prevencion de its y de cancer de cuello uterino",numero de mujeres con ivaa,2015-06-01,0,0,1,0,0,1
TRINIDAD,"anticoncepcion, prevencion de its y de cancer de cuello uterino",numero de mujeres con ivaa,2015-06-01,0,2,14,11,0,27
VILLA CHARCAS,"anticoncepcion, prevencion de its y de cancer de cuello uterino",numero de mujeres con ivaa,2015-06-01,0,0,7,6,3,16
VILLA MONTES,"anticoncepcion, prevencion de its y de cancer de cuello uterino",numero de mujeres con ivaa,2015-06-01,0,3,15,7,0,25
VILLA VACA GUZMAN (MUYUPAMPA),"anticoncepcion, prevencion de its y de cancer de cuello uterino",numero de mujeres con ivaa,2015-06-01,0,0,10,11,2,23
YAMPARAEZ,"anticoncepcion, prevencion de its y de cancer de cuello uterino",numero de mujeres con ivaa,2015-06-01,0,1,4,5,3,13
YAPACANI,"anticoncepcion, prevencion de its y de cancer de cuello uterino",numero de mujeres con ivaa,2015-06-01,0,8,29,18,7,62
ZUDAÑEZ,"anticoncepcion, prevencion de its y de cancer de cuello uterino",numero de mujeres con ivaa,2015-06-01,0,19,94,36,6,155
ACACIO,"anticoncepcion, prevencion de its y de cancer de cuello uterino",numero de mujeres con ivaa,2015-07-01,0,5,26,39,4,74
AIQUILE,"anticoncepcion, prevencion de its y de cancer de cuello uterino",numero de mujeres con ivaa,2015-07-01,0,2,15,10,1,28
ANTEQUERA,"anticoncepcion, prevencion de its y de cancer de cuello uterino",numero de mujeres con ivaa,2015-07-01,0,0,0,22,0,22
AYOPAYA (V. DE INDEPENDENCIA),"anticoncepcion, prevencion de its y de cancer de cuello uterino",numero de mujeres con ivaa,2015-07-01,0,5,7,1,0,13
AZURDUY,"anticoncepcion, prevencion de its y de cancer de cuello uterino",numero de mujeres con ivaa,2015-07-01,0,1,8,0,0,9
BELLA FLOR,"anticoncepcion, prevencion de its y de cancer de cuello uterino",numero de mujeres con ivaa,2015-07-01,0,0,1,0,0,1
BERMEJO,"anticoncepcion, prevencion de its y de cancer de cuello uterino",numero de mujeres con ivaa,2015-07-01,0,0,18,14,9,41
BUENA VISTA,"anticoncepcion, prevencion de its y de cancer de cuello uterino",numero de mujeres con ivaa,2015-07-01,0,1,9,8,0,18
CAMARGO,"anticoncepcion, prevencion de its y de cancer de cuello uterino",numero de mujeres con ivaa,2015-07-01,0,4,6,3,0,13
CAMATAQUI (C. VILLA ABECIA),"anticoncepcion, prevencion de its y de cancer de cuello uterino",numero de mujeres con ivaa,2015-07-01,0,0,1,2,0,3
CAMIRI,"anticoncepcion, prevencion de its y de cancer de cuello uterino",numero de mujeres con ivaa,2015-07-01,0,0,12,5,0,17
CAPINOTA,"anticoncepcion, prevencion de its y de cancer de cuello uterino",numero de mujeres con ivaa,2015-07-01,0,5,35,9,1,50
CARIPUYO,"anticoncepcion, prevencion de its y de cancer de cuello uterino",numero de mujeres con ivaa,2015-07-01,0,3,5,3,1,12
CLIZA,"anticoncepcion, prevencion de its y de cancer de cuello uterino",numero de mujeres con ivaa,2015-07-01,0,2,0,4,0,6
COBIJA,"anticoncepcion, prevencion de its y de cancer de cuello uterino",numero de mujeres con ivaa,2015-07-01,4,18,118,50,15,205
COCHABAMBA,"anticoncepcion, prevencion de its y de cancer de cuello uterino",numero de mujeres con ivaa,2015-07-01,1,83,150,145,35,414
COMARAPA,"anticoncepcion, prevencion de its y de cancer de cuello uterino",numero de mujeres con ivaa,2015-07-01,0,1,15,7,4,27
CULPINA,"anticoncepcion, prevencion de its y de cancer de cuello uterino",numero de mujeres con ivaa,2015-07-01,0,0,1,1,0,2
CURAHUARA DE CARANGAS,"anticoncepcion, prevencion de its y de cancer de cuello uterino",numero de mujeres con ivaa,2015-07-01,0,0,8,3,8,19
EL ALTO,"anticoncepcion, prevencion de its y de cancer de cuello uterino",numero de mujeres con ivaa,2015-07-01,0,19,280,218,115,632
EL PUENTE(TJA),"anticoncepcion, prevencion de its y de cancer de cuello uterino",numero de mujeres con ivaa,2015-07-01,0,0,1,2,0,3
EUCALIPTUS,"anticoncepcion, prevencion de its y de cancer de cuello uterino",numero de mujeres con ivaa,2015-07-01,0,0,3,1,0,4
GENERAL SAAVEDRA,"anticoncepcion, prevencion de its y de cancer de cuello uterino",numero de mujeres con ivaa,2015-07-01,0,0,2,0,0,2
HUACARETA,"anticoncepcion, prevencion de its y de cancer de cuello uterino",numero de mujeres con ivaa,2015-07-01,0,4,18,15,3,40
HUACAYA (VILLA DE HUACAYA),"anticoncepcion, prevencion de its y de cancer de cuello uterino",numero de mujeres con ivaa,2015-07-01,0,0,4,2,0,6
HUANUNI,"anticoncepcion, prevencion de its y de cancer de cuello uterino",numero de mujeres con ivaa,2015-07-01,0,0,3,6,3,12
HUAYLLAMARCA,"anticoncepcion, prevencion de its y de cancer de cuello uterino",numero de mujeres con ivaa,2015-07-01,0,2,9,14,4,29
ICLA,"anticoncepcion, prevencion de its y de cancer de cuello uterino",numero de mujeres con ivaa,2015-07-01,0,4,9,10,1,24
LA PAZ,"anticoncepcion, prevencion de its y de cancer de cuello uterino",numero de mujeres con ivaa,2015-07-01,0,6,79,56,35,176
LLICA,"anticoncepcion, prevencion de its y de cancer de cuello uterino",numero de mujeres con ivaa,2015-07-01,0,2,9,2,2,15
MAIRANA,"anticoncepcion, prevencion de its y de cancer de cuello uterino",numero de mujeres con ivaa,2015-07-01,0,2,14,5,2,23
MIZQUE,"anticoncepcion, prevencion de its y de cancer de cuello uterino",numero de mujeres con ivaa,2015-07-01,0,0,12,3,0,15
MONTEAGUDO,"anticoncepcion, prevencion de its y de cancer de cuello uterino",numero de mujeres con ivaa,2015-07-01,0,1,17,20,3,41
MONTERO,"anticoncepcion, prevencion de its y de cancer de cuello uterino",numero de mujeres con ivaa,2015-07-01,0,6,23,21,2,52
ORURO,"anticoncepcion, prevencion de its y de cancer de cuello uterino",numero de mujeres con ivaa,2015-07-01,0,9,113,40,10,172
PADCAYA,"anticoncepcion, prevencion de its y de cancer de cuello uterino",numero de mujeres con ivaa,2015-07-01,0,0,6,5,0,11
PADILLA,"anticoncepcion, prevencion de its y de cancer de cuello uterino",numero de mujeres con ivaa,2015-07-01,0,3,23,15,3,44
PAZÑA,"anticoncepcion, prevencion de its y de cancer de cuello uterino",numero de mujeres con ivaa,2015-07-01,0,1,1,0,0,2
POROMA,"anticoncepcion, prevencion de its y de cancer de cuello uterino",numero de mujeres con ivaa,2015-07-01,0,3,26,25,0,54
PORVENIR,"anticoncepcion, prevencion de its y de cancer de cuello uterino",numero de mujeres con ivaa,2015-07-01,0,0,5,2,5,12
POTOSI,"anticoncepcion, prevencion de its y de cancer de cuello uterino",numero de mujeres con ivaa,2015-07-01,0,0,0,5,0,5
PUERTO GONZALO MORENO,"anticoncepcion, prevencion de its y de cancer de cuello uterino",numero de mujeres con ivaa,2015-07-01,0,0,9,11,2,22
PUERTO RICO,"anticoncepcion, prevencion de its y de cancer de cuello uterino",numero de mujeres con ivaa,2015-07-01,0,2,19,15,2,38
PUERTO VILLARROEL,"anticoncepcion, prevencion de its y de cancer de cuello uterino",numero de mujeres con ivaa,2015-07-01,0,1,0,0,0,1
PUNATA,"anticoncepcion, prevencion de its y de cancer de cuello uterino",numero de mujeres con ivaa,2015-07-01,0,1,9,9,4,23
QUILLACOLLO,"anticoncepcion, prevencion de its y de cancer de cuello uterino",numero de mujeres con ivaa,2015-07-01,0,0,10,10,0,20
RIBERALTA,"anticoncepcion, prevencion de its y de cancer de cuello uterino",numero de mujeres con ivaa,2015-07-01,0,5,111,106,19,241
SACABA,"anticoncepcion, prevencion de its y de cancer de cuello uterino",numero de mujeres con ivaa,2015-07-01,0,0,30,17,0,47
SACACA,"anticoncepcion, prevencion de its y de cancer de cuello uterino",numero de mujeres con ivaa,2015-07-01,0,3,30,35,5,73
SAN CARLOS,"anticoncepcion, prevencion de its y de cancer de cuello uterino",numero de mujeres con ivaa,2015-07-01,0,1,3,5,1,10
SAN LUCAS,"anticoncepcion, prevencion de its y de cancer de cuello uterino",numero de mujeres con ivaa,2015-07-01,0,1,16,22,6,45
SAN PEDRO DE BUENA VISTA,"anticoncepcion, prevencion de its y de cancer de cuello uterino",numero de mujeres con ivaa,2015-07-01,0,30,120,74,6,230
SAN RAMON SCZ,"anticoncepcion, prevencion de its y de cancer de cuello uterino",numero de mujeres con ivaa,2015-07-01,4,5,8,0,0,17
SANTA CRUZ DE LA SIERRA,"anticoncepcion, prevencion de its y de cancer de cuello uterino",numero de mujeres con ivaa,2015-07-01,0,1,42,65,6,114
SANTIAGO DE HUARI,"anticoncepcion, prevencion de its y de cancer de cuello uterino",numero de mujeres con ivaa,2015-07-01,0,0,1,1,0,2
SIPE SIPE,"anticoncepcion, prevencion de its y de cancer de cuello uterino",numero de mujeres con ivaa,2015-07-01,0,1,1,0,0,2
SORACACHI,"anticoncepcion, prevencion de its y de cancer de cuello uterino",numero de mujeres con ivaa,2015-07-01,0,0,0,3,0,3
SUCRE,"anticoncepcion, prevencion de its y de cancer de cuello uterino",numero de mujeres con ivaa,2015-07-01,0,6,39,23,2,70
TARABUCO,"anticoncepcion, prevencion de its y de cancer de cuello uterino",numero de mujeres con ivaa,2015-07-01,0,2,0,0,0,2
TARIJA,"anticoncepcion, prevencion de its y de cancer de cuello uterino",numero de mujeres con ivaa,2015-07-01,0,42,93,343,10,488
TARVITA,"anticoncepcion, prevencion de its y de cancer de cuello uterino",numero de mujeres con ivaa,2015-07-01,0,3,25,27,9,64
TIQUIPAYA,"anticoncepcion, prevencion de its y de cancer de cuello uterino",numero de mujeres con ivaa,2015-07-01,0,0,2,0,0,2
TIRAQUE (CBBA),"anticoncepcion, prevencion de its y de cancer de cuello uterino",numero de mujeres con ivaa,2015-07-01,0,0,0,2,0,2
TOMINA,"anticoncepcion, prevencion de its y de cancer de cuello uterino",numero de mujeres con ivaa,2015-07-01,0,2,2,0,1,5
TORO TORO,"anticoncepcion, prevencion de its y de cancer de cuello uterino",numero de mujeres con ivaa,2015-07-01,0,14,46,14,2,76
TRINIDAD,"anticoncepcion, prevencion de its y de cancer de cuello uterino",numero de mujeres con ivaa,2015-07-01,0,1,29,25,2,57
URIONDO (A. CONCEPCION),"anticoncepcion, prevencion de its y de cancer de cuello uterino",numero de mujeres con ivaa,2015-07-01,0,0,3,0,1,4
VILLA CHARCAS,"anticoncepcion, prevencion de its y de cancer de cuello uterino",numero de mujeres con ivaa,2015-07-01,0,2,6,2,0,10
VILLA MONTES,"anticoncepcion, prevencion de its y de cancer de cuello uterino",numero de mujeres con ivaa,2015-07-01,0,0,9,2,0,11
VILLA VACA GUZMAN (MUYUPAMPA),"anticoncepcion, prevencion de its y de cancer de cuello uterino",numero de mujeres con ivaa,2015-07-01,0,2,7,4,3,16
VINTO,"anticoncepcion, prevencion de its y de cancer de cuello uterino",numero de mujeres con ivaa,2015-07-01,0,0,11,8,0,19
YAMPARAEZ,"anticoncepcion, prevencion de its y de cancer de cuello uterino",numero de mujeres con ivaa,2015-07-01,0,0,0,2,2,4
YAPACANI,"anticoncepcion, prevencion de its y de cancer de cuello uterino",numero de mujeres con ivaa,2015-07-01,2,14,72,26,5,119
ZUDAÑEZ,"anticoncepcion, prevencion de its y de cancer de cuello uterino",numero de mujeres con ivaa,2015-07-01,0,0,3,2,1,6
ACACIO,"anticoncepcion, prevencion de its y de cancer de cuello uterino",numero de mujeres con ivaa,2015-08-01,0,9,33,38,27,107
AIQUILE,"anticoncepcion, prevencion de its y de cancer de cuello uterino",numero de mujeres con ivaa,2015-08-01,0,1,8,8,3,20
ANTEQUERA,"anticoncepcion, prevencion de its y de cancer de cuello uterino",numero de mujeres con ivaa,2015-08-01,0,0,3,1,0,4
AYOPAYA (V. DE INDEPENDENCIA),"anticoncepcion, prevencion de its y de cancer de cuello uterino",numero de mujeres con ivaa,2015-08-01,0,2,1,4,1,8
AZURDUY,"anticoncepcion, prevencion de its y de cancer de cuello uterino",numero de mujeres con ivaa,2015-08-01,0,1,0,0,0,1
BELLA FLOR,"anticoncepcion, prevencion de its y de cancer de cuello uterino",numero de mujeres con ivaa,2015-08-01,0,0,1,0,0,1
BERMEJO,"anticoncepcion, prevencion de its y de cancer de cuello uterino",numero de mujeres con ivaa,2015-08-01,0,3,2,4,0,9
BUENA VISTA,"anticoncepcion, prevencion de its y de cancer de cuello uterino",numero de mujeres con ivaa,2015-08-01,0,1,2,0,1,4
CAMARGO,"anticoncepcion, prevencion de its y de cancer de cuello uterino",numero de mujeres con ivaa,2015-08-01,0,2,11,7,2,22
CAMATAQUI (C. VILLA ABECIA),"anticoncepcion, prevencion de its y de cancer de cuello uterino",numero de mujeres con ivaa,2015-08-01,0,0,5,1,1,7
CAMIRI,"anticoncepcion, prevencion de its y de cancer de cuello uterino",numero de mujeres con ivaa,2015-08-01,0,0,11,5,1,17
CAPINOTA,"anticoncepcion, prevencion de its y de cancer de cuello uterino",numero de mujeres con ivaa,2015-08-01,1,8,29,6,0,44
CARACOLLO,"anticoncepcion, prevencion de its y de cancer de cuello uterino",numero de mujeres con ivaa,2015-08-01,0,0,0,1,0,1
CARIPUYO,"anticoncepcion, prevencion de its y de cancer de cuello uterino",numero de mujeres con ivaa,2015-08-01,0,1,6,6,1,14
CHAYANTA,"anticoncepcion, prevencion de its y de cancer de cuello uterino",numero de mujeres con ivaa,2015-08-01,0,2,4,4,0,10
CKOCHAS,"anticoncepcion, prevencion de its y de cancer de cuello uterino",numero de mujeres con ivaa,2015-08-01,0,0,4,3,0,7
CLIZA,"anticoncepcion, prevencion de its y de cancer de cuello uterino",numero de mujeres con ivaa,2015-08-01,0,1,1,0,0,2
COBIJA,"anticoncepcion, prevencion de its y de cancer de cuello uterino",numero de mujeres con ivaa,2015-08-01,2,13,81,47,9,152
COCHABAMBA,"anticoncepcion, prevencion de its y de cancer de cuello uterino",numero de mujeres con ivaa,2015-08-01,0,81,137,710,42,970
COMARAPA,"anticoncepcion, prevencion de its y de cancer de cuello uterino",numero de mujeres con ivaa,2015-08-01,0,2,9,10,4,25
CONCEPCION,"anticoncepcion, prevencion de its y de cancer de cuello uterino",numero de mujeres con ivaa,2015-08-01,0,0,3,3,1,7
CULPINA,"anticoncepcion, prevencion de its y de cancer de cuello uterino",numero de mujeres con ivaa,2015-08-01,0,1,10,14,2,27
CURAHUARA DE CARANGAS,"anticoncepcion, prevencion de its y de cancer de cuello uterino",numero de mujeres con ivaa,2015-08-01,0,0,1,0,0,1
EL ALTO,"anticoncepcion, prevencion de its y de cancer de cuello uterino",numero de mujeres con ivaa,2015-08-01,0,9,176,279,48,512
EL PUENTE(TJA),"anticoncepcion, prevencion de its y de cancer de cuello uterino",numero de mujeres con ivaa,2015-08-01,0,2,11,7,6,26
ENTRE RIOS CBBA,"anticoncepcion, prevencion de its y de cancer de cuello uterino",numero de mujeres con ivaa,2015-08-01,0,1,9,4,0,14
EUCALIPTUS,"anticoncepcion, prevencion de its y de cancer de cuello uterino",numero de mujeres con ivaa,2015-08-01,0,0,1,2,2,5
FILADELFIA,"anticoncepcion, prevencion de its y de cancer de cuello uterino",numero de mujeres con ivaa,2015-08-01,3,1,2,0,0,6
GENERAL SAAVEDRA,"anticoncepcion, prevencion de its y de cancer de cuello uterino",numero de mujeres con ivaa,2015-08-01,0,0,9,11,3,23
HUACARETA,"anticoncepcion, prevencion de its y de cancer de cuello uterino",numero de mujeres con ivaa,2015-08-01,0,2,18,30,11,61
HUACAYA (VILLA DE HUACAYA),"anticoncepcion, prevencion de its y de cancer de cuello uterino",numero de mujeres con ivaa,2015-08-01,0,1,12,11,6,30
HUANUNI,"anticoncepcion, prevencion de its y de cancer de cuello uterino",numero de mujeres con ivaa,2015-08-01,0,0,12,4,0,16
HUAYLLAMARCA,"anticoncepcion, prevencion de its y de cancer de cuello uterino",numero de mujeres con ivaa,2015-08-01,0,1,7,3,4,15
ICLA,"anticoncepcion, prevencion de its y de cancer de cuello uterino",numero de mujeres con ivaa,2015-08-01,0,0,36,51,12,99
LA PAZ,"anticoncepcion, prevencion de its y de cancer de cuello uterino",numero de mujeres con ivaa,2015-08-01,0,14,154,40,22,230
LLICA,"anticoncepcion, prevencion de its y de cancer de cuello uterino",numero de mujeres con ivaa,2015-08-01,0,0,1,2,1,4
MACHACAMARCA,"anticoncepcion, prevencion de its y de cancer de cuello uterino",numero de mujeres con ivaa,2015-08-01,0,0,1,0,0,1
MAIRANA,"anticoncepcion, prevencion de its y de cancer de cuello uterino",numero de mujeres con ivaa,2015-08-01,0,2,20,15,9,46
MIZQUE,"anticoncepcion, prevencion de its y de cancer de cuello uterino",numero de mujeres con ivaa,2015-08-01,0,10,23,5,2,40
MONTEAGUDO,"anticoncepcion, prevencion de its y de cancer de cuello uterino",numero de mujeres con ivaa,2015-08-01,0,1,3,11,2,17
MONTERO,"anticoncepcion, prevencion de its y de cancer de cuello uterino",numero de mujeres con ivaa,2015-08-01,0,0,17,11,5,33
ORURO,"anticoncepcion, prevencion de its y de cancer de cuello uterino",numero de mujeres con ivaa,2015-08-01,0,6,140,57,12,215
PADCAYA,"anticoncepcion, prevencion de its y de cancer de cuello uterino",numero de mujeres con ivaa,2015-08-01,0,0,10,6,1,17
PADILLA,"anticoncepcion, prevencion de its y de cancer de cuello uterino",numero de mujeres con ivaa,2015-08-01,0,0,14,15,5,34
PAZÑA,"anticoncepcion, prevencion de its y de cancer de cuello uterino",numero de mujeres con ivaa,2015-08-01,0,0,2,0,0,2
PORVENIR,"anticoncepcion, prevencion de its y de cancer de cuello uterino",numero de mujeres con ivaa,2015-08-01,0,0,5,0,0,5
POTOSI,"anticoncepcion, prevencion de its y de cancer de cuello uterino",numero de mujeres con ivaa,2015-08-01,0,0,9,17,2,28
PRESTO,"anticoncepcion, prevencion de its y de cancer de cuello uterino",numero de mujeres con ivaa,2015-08-01,0,0,2,0,2,4
PUERTO GONZALO MORENO,"anticoncepcion, prevencion de its y de cancer de cuello uterino",numero de mujeres con ivaa,2015-08-01,0,3,4,2,0,9
PUERTO RICO,"anticoncepcion, prevencion de its y de cancer de cuello uterino",numero de mujeres con ivaa,2015-08-01,0,1,8,8,0,17
PUNATA,"anticoncepcion, prevencion de its y de cancer de cuello uterino",numero de mujeres con ivaa,2015-08-01,0,1,6,2,2,11
QUILLACOLLO,"anticoncepcion, prevencion de its y de cancer de cuello uterino",numero de mujeres con ivaa,2015-08-01,0,0,4,8,0,12
RIBERALTA,"anticoncepcion, prevencion de its y de cancer de cuello uterino",numero de mujeres con ivaa,2015-08-01,2,14,69,28,5,118
SACABA,"anticoncepcion, prevencion de its y de cancer de cuello uterino",numero de mujeres con ivaa,2015-08-01,0,3,25,9,0,37
SACACA,"anticoncepcion, prevencion de its y de cancer de cuello uterino",numero de mujeres con ivaa,2015-08-01,0,1,9,8,2,20
SAN CARLOS,"anticoncepcion, prevencion de its y de cancer de cuello uterino",numero de mujeres con ivaa,2015-08-01,0,0,3,2,0,5
SAN LUCAS,"anticoncepcion, prevencion de its y de cancer de cuello uterino",numero de mujeres con ivaa,2015-08-01,0,33,94,47,3,177
SAN PEDRO DE BUENA VISTA,"anticoncepcion, prevencion de its y de cancer de cuello uterino",numero de mujeres con ivaa,2015-08-01,4,52,170,92,11,329
SAN RAMON SCZ,"anticoncepcion, prevencion de its y de cancer de cuello uterino",numero de mujeres con ivaa,2015-08-01,0,2,11,2,0,15
SANTA CRUZ DE LA SIERRA,"anticoncepcion, prevencion de its y de cancer de cuello uterino",numero de mujeres con ivaa,2015-08-01,0,6,29,16,2,53
SICAYA,"anticoncepcion, prevencion de its y de cancer de cuello uterino",numero de mujeres con ivaa,2015-08-01,0,1,2,0,0,3
SIPE SIPE,"anticoncepcion, prevencion de its y de cancer de cuello uterino",numero de mujeres con ivaa,2015-08-01,0,0,0,1,0,1
SOPACHUY,"anticoncepcion, prevencion de its y de cancer de cuello uterino",numero de mujeres con ivaa,2015-08-01,0,0,2,1,0,3
SORACACHI,"anticoncepcion, prevencion de its y de cancer de cuello uterino",numero de mujeres con ivaa,2015-08-01,0,0,2,1,0,3
SUCRE,"anticoncepcion, prevencion de its y de cancer de cuello uterino",numero de mujeres con ivaa,2015-08-01,0,8,71,41,7,127
TARABUCO,"anticoncepcion, prevencion de its y de cancer de cuello uterino",numero de mujeres con ivaa,2015-08-01,0,0,9,10,5,24
TARIJA,"anticoncepcion, prevencion de its y de cancer de cuello uterino",numero de mujeres con ivaa,2015-08-01,0,59,79,61,17,216
TARVITA,"anticoncepcion, prevencion de its y de cancer de cuello uterino",numero de mujeres con ivaa,2015-08-01,0,10,29,25,12,76
TIRAQUE (CBBA),"anticoncepcion, prevencion de its y de cancer de cuello uterino",numero de mujeres con ivaa,2015-08-01,0,0,1,3,0,4
TOMINA,"anticoncepcion, prevencion de its y de cancer de cuello uterino",numero de mujeres con ivaa,2015-08-01,0,2,5,0,4,11
TORO TORO,"anticoncepcion, prevencion de its y de cancer de cuello uterino",numero de mujeres con ivaa,2015-08-01,0,16,64,63,11,154
TRINIDAD,"anticoncepcion, prevencion de its y de cancer de cuello uterino",numero de mujeres con ivaa,2015-08-01,0,1,2,1,0,4
URIONDO (A. CONCEPCION),"anticoncepcion, prevencion de its y de cancer de cuello uterino",numero de mujeres con ivaa,2015-08-01,0,0,5,6,2,13
VALLEGRANDE,"anticoncepcion, prevencion de its y de cancer de cuello uterino",numero de mujeres con ivaa,2015-08-01,0,0,1,0,0,1
VILLA CHARCAS,"anticoncepcion, prevencion de its y de cancer de cuello uterino",numero de mujeres con ivaa,2015-08-01,0,0,6,9,0,15
VILLA MONTES,"anticoncepcion, prevencion de its y de cancer de cuello uterino",numero de mujeres con ivaa,2015-08-01,1,9,57,39,32,138
VILLA VACA GUZMAN (MUYUPAMPA),"anticoncepcion, prevencion de its y de cancer de cuello uterino",numero de mujeres con ivaa,2015-08-01,0,3,4,10,1,18
VINTO,"anticoncepcion, prevencion de its y de cancer de cuello uterino",numero de mujeres con ivaa,2015-08-01,0,0,16,8,0,24
YACUIBA,"anticoncepcion, prevencion de its y de cancer de cuello uterino",numero de mujeres con ivaa,2015-08-01,0,0,1,3,1,5
YAMPARAEZ,"anticoncepcion, prevencion de its y de cancer de cuello uterino",numero de mujeres con ivaa,2015-08-01,0,3,2,7,2,14
YAPACANI,"anticoncepcion, prevencion de its y de cancer de cuello uterino",numero de mujeres con ivaa,2015-08-01,7,31,70,20,7,135
YOCALLA,"anticoncepcion, prevencion de its y de cancer de cuello uterino",numero de mujeres con ivaa,2015-08-01,0,0,1,0,0,1
ZUDAÑEZ,"anticoncepcion, prevencion de its y de cancer de cuello uterino",numero de mujeres con ivaa,2015-08-01,0,0,2,2,2,6
ACACIO,"anticoncepcion, prevencion de its y de cancer de cuello uterino",numero de mujeres con ivaa,2015-09-01,0,0,7,9,7,23
AIQUILE,"anticoncepcion, prevencion de its y de cancer de cuello uterino",numero de mujeres con ivaa,2015-09-01,0,0,20,12,2,34
ANTEQUERA,"anticoncepcion, prevencion de its y de cancer de cuello uterino",numero de mujeres con ivaa,2015-09-01,0,0,1,1,0,2
ANZALDO,"anticoncepcion, prevencion de its y de cancer de cuello uterino",numero de mujeres con ivaa,2015-09-01,0,0,4,4,0,8
ARAMPAMPA,"anticoncepcion, prevencion de its y de cancer de cuello uterino",numero de mujeres con ivaa,2015-09-01,0,5,36,18,0,59
AYOPAYA (V. DE INDEPENDENCIA),"anticoncepcion, prevencion de its y de cancer de cuello uterino",numero de mujeres con ivaa,2015-09-01,0,0,1,4,0,5
AZURDUY,"anticoncepcion, prevencion de its y de cancer de cuello uterino",numero de mujeres con ivaa,2015-09-01,0,0,3,1,3,7
BELLA FLOR,"anticoncepcion, prevencion de its y de cancer de cuello uterino",numero de mujeres con ivaa,2015-09-01,0,3,12,11,3,29
BERMEJO,"anticoncepcion, prevencion de its y de cancer de cuello uterino",numero de mujeres con ivaa,2015-09-01,0,2,8,9,0,19
BUENA VISTA,"anticoncepcion, prevencion de its y de cancer de cuello uterino",numero de mujeres con ivaa,2015-09-01,0,0,8,2,3,13
CAMARGO,"anticoncepcion, prevencion de its y de cancer de cuello uterino",numero de mujeres con ivaa,2015-09-01,1,4,2,3,1,11
CAMATAQUI (C. VILLA ABECIA),"anticoncepcion, prevencion de its y de cancer de cuello uterino",numero de mujeres con ivaa,2015-09-01,0,2,8,6,4,20
CAMIRI,"anticoncepcion, prevencion de its y de cancer de cuello uterino",numero de mujeres con ivaa,2015-09-01,0,1,13,11,2,27
CAPINOTA,"anticoncepcion, prevencion de its y de cancer de cuello uterino",numero de mujeres con ivaa,2015-09-01,1,12,36,14,2,65
CARIPUYO,"anticoncepcion, prevencion de its y de cancer de cuello uterino",numero de mujeres con ivaa,2015-09-01,0,2,2,8,2,14
CHALLAPATA,"anticoncepcion, prevencion de its y de cancer de cuello uterino",numero de mujeres con ivaa,2015-09-01,0,1,6,0,0,7
CKOCHAS,"anticoncepcion, prevencion de its y de cancer de cuello uterino",numero de mujeres con ivaa,2015-09-01,0,2,28,36,7,73
CLIZA,"anticoncepcion, prevencion de its y de cancer de cuello uterino",numero de mujeres con ivaa,2015-09-01,0,0,3,2,0,5
COBIJA,"anticoncepcion, prevencion de its y de cancer de cuello uterino",numero de mujeres con ivaa,2015-09-01,1,18,118,48,11,196
COCHABAMBA,"anticoncepcion, prevencion de its y de cancer de cuello uterino",numero de mujeres con ivaa,2015-09-01,0,57,144,648,64,913
COMARAPA,"anticoncepcion, prevencion de its y de cancer de cuello uterino",numero de mujeres con ivaa,2015-09-01,0,1,14,10,3,28
CORQUE,"anticoncepcion, prevencion de its y de cancer de cuello uterino",numero de mujeres con ivaa,2015-09-01,0,2,7,7,0,16
CULPINA,"anticoncepcion, prevencion de its y de cancer de cuello uterino",numero de mujeres con ivaa,2015-09-01,0,1,2,2,0,5
CURAHUARA DE CARANGAS,"anticoncepcion, prevencion de its y de cancer de cuello uterino",numero de mujeres con ivaa,2015-09-01,0,0,9,6,9,24
EL ALTO,"anticoncepcion, prevencion de its y de cancer de cuello uterino",numero de mujeres con ivaa,2015-09-01,0,1,255,277,66,599
EL PUENTE(TJA),"anticoncepcion, prevencion de its y de cancer de cuello uterino",numero de mujeres con ivaa,2015-09-01,0,2,17,13,3,35
ENTRE RIOS CBBA,"anticoncepcion, prevencion de its y de cancer de cuello uterino",numero de mujeres con ivaa,2015-09-01,0,1,2,0,0,3
EUCALIPTUS,"anticoncepcion, prevencion de its y de cancer de cuello uterino",numero de mujeres con ivaa,2015-09-01,0,0,0,1,0,1
HUACARETA,"anticoncepcion, prevencion de its y de cancer de cuello uterino",numero de mujeres con ivaa,2015-09-01,0,3,5,6,3,17
HUACAYA (VILLA DE HUACAYA),"anticoncepcion, prevencion de its y de cancer de cuello uterino",numero de mujeres con ivaa,2015-09-01,0,3,15,14,3,35
HUANUNI,"anticoncepcion, prevencion de its y de cancer de cuello uterino",numero de mujeres con ivaa,2015-09-01,0,2,18,5,1,26
ICLA,"anticoncepcion, prevencion de its y de cancer de cuello uterino",numero de mujeres con ivaa,2015-09-01,0,6,26,23,7,62
LA PAZ,"anticoncepcion, prevencion de its y de cancer de cuello uterino",numero de mujeres con ivaa,2015-09-01,0,6,57,38,13,114
MACHACAMARCA,"anticoncepcion, prevencion de its y de cancer de cuello uterino",numero de mujeres con ivaa,2015-09-01,0,0,0,2,0,2
MAIRANA,"anticoncepcion, prevencion de its y de cancer de cuello uterino",numero de mujeres con ivaa,2015-09-01,0,1,17,8,4,30
MIZQUE,"anticoncepcion, prevencion de its y de cancer de cuello uterino",numero de mujeres con ivaa,2015-09-01,0,1,4,2,0,7
MOJOCOYA,"anticoncepcion, prevencion de its y de cancer de cuello uterino",numero de mujeres con ivaa,2015-09-01,0,2,9,9,0,20
MONTEAGUDO,"anticoncepcion, prevencion de its y de cancer de cuello uterino",numero de mujeres con ivaa,2015-09-01,0,0,5,0,0,5
MONTERO,"anticoncepcion, prevencion de its y de cancer de cuello uterino",numero de mujeres con ivaa,2015-09-01,1,3,21,9,5,39
ORURO,"anticoncepcion, prevencion de its y de cancer de cuello uterino",numero de mujeres con ivaa,2015-09-01,0,7,138,85,12,242
PADCAYA,"anticoncepcion, prevencion de its y de cancer de cuello uterino",numero de mujeres con ivaa,2015-09-01,0,0,3,1,0,4
PAZÑA,"anticoncepcion, prevencion de its y de cancer de cuello uterino",numero de mujeres con ivaa,2015-09-01,0,1,2,2,0,5
PORVENIR,"anticoncepcion, prevencion de its y de cancer de cuello uterino",numero de mujeres con ivaa,2015-09-01,0,1,6,3,2,12
POTOSI,"anticoncepcion, prevencion de its y de cancer de cuello uterino",numero de mujeres con ivaa,2015-09-01,0,0,5,26,0,31
PUERTO GONZALO MORENO,"anticoncepcion, prevencion de its y de cancer de cuello uterino",numero de mujeres con ivaa,2015-09-01,0,2,28,29,12,71
PUERTO RICO,"anticoncepcion, prevencion de its y de cancer de cuello uterino",numero de mujeres con ivaa,2015-09-01,0,0,5,4,1,10
PUERTO VILLARROEL,"anticoncepcion, prevencion de its y de cancer de cuello uterino",numero de mujeres con ivaa,2015-09-01,0,1,4,1,0,6
PUNATA,"anticoncepcion, prevencion de its y de cancer de cuello uterino",numero de mujeres con ivaa,2015-09-01,0,1,7,4,2,14
QUILLACOLLO,"anticoncepcion, prevencion de its y de cancer de cuello uterino",numero de mujeres con ivaa,2015-09-01,0,0,5,2,0,7
RIBERALTA,"anticoncepcion, prevencion de its y de cancer de cuello uterino",numero de mujeres con ivaa,2015-09-01,1,4,164,103,32,304
SACABA,"anticoncepcion, prevencion de its y de cancer de cuello uterino",numero de mujeres con ivaa,2015-09-01,0,1,15,45,0,61
SACACA,"anticoncepcion, prevencion de its y de cancer de cuello uterino",numero de mujeres con ivaa,2015-09-01,0,0,3,7,4,14
SAN CARLOS,"anticoncepcion, prevencion de its y de cancer de cuello uterino",numero de mujeres con ivaa,2015-09-01,0,3,3,1,0,7
SAN LUCAS,"anticoncepcion, prevencion de its y de cancer de cuello uterino",numero de mujeres con ivaa,2015-09-01,1,9,22,17,5,54
SAN PEDRO DE BUENA VISTA,"anticoncepcion, prevencion de its y de cancer de cuello uterino",numero de mujeres con ivaa,2015-09-01,3,19,78,60,14,174
SAN RAMON SCZ,"anticoncepcion, prevencion de its y de cancer de cuello uterino",numero de mujeres con ivaa,2015-09-01,0,8,16,7,4,35
SANTA CRUZ DE LA SIERRA,"anticoncepcion, prevencion de its y de cancer de cuello uterino",numero de mujeres con ivaa,2015-09-01,0,0,219,62,0,281
SHINAOTA,"anticoncepcion, prevencion de its y de cancer de cuello uterino",numero de mujeres con ivaa,2015-09-01,0,6,14,3,0,23
SIPE SIPE,"anticoncepcion, prevencion de its y de cancer de cuello uterino",numero de mujeres con ivaa,2015-09-01,0,14,25,11,0,50
SUCRE,"anticoncepcion, prevencion de its y de cancer de cuello uterino",numero de mujeres con ivaa,2015-09-01,1,14,98,55,15,183
TARABUCO,"anticoncepcion, prevencion de its y de cancer de cuello uterino",numero de mujeres con ivaa,2015-09-01,0,0,4,1,1,6
TARIJA,"anticoncepcion, prevencion de its y de cancer de cuello uterino",numero de mujeres con ivaa,2015-09-01,0,34,107,53,15,209
TARVITA,"anticoncepcion, prevencion de its y de cancer de cuello uterino",numero de mujeres con ivaa,2015-09-01,0,3,23,28,8,62
TIQUIPAYA,"anticoncepcion, prevencion de its y de cancer de cuello uterino",numero de mujeres con ivaa,2015-09-01,0,0,2,0,0,2
TIRAQUE (CBBA),"anticoncepcion, prevencion de its y de cancer de cuello uterino",numero de mujeres con ivaa,2015-09-01,0,0,1,2,0,3
TORO TORO,"anticoncepcion, prevencion de its y de cancer de cuello uterino",numero de mujeres con ivaa,2015-09-01,1,14,37,35,8,95
TRINIDAD,"anticoncepcion, prevencion de its y de cancer de cuello uterino",numero de mujeres con ivaa,2015-09-01,0,1,40,17,0,58
URIONDO (A. CONCEPCION),"anticoncepcion, prevencion de its y de cancer de cuello uterino",numero de mujeres con ivaa,2015-09-01,0,0,9,3,0,12
VILLA MONTES,"anticoncepcion, prevencion de its y de cancer de cuello uterino",numero de mujeres con ivaa,2015-09-01,0,11,83,43,25,162
VILLA TUNARI,"anticoncepcion, prevencion de its y de cancer de cuello uterino",numero de mujeres con ivaa,2015-09-01,0,0,2,3,1,6
VILLA VACA GUZMAN (MUYUPAMPA),"anticoncepcion, prevencion de its y de cancer de cuello uterino",numero de mujeres con ivaa,2015-09-01,0,2,12,2,1,17
YACUIBA,"anticoncepcion, prevencion de its y de cancer de cuello uterino",numero de mujeres con ivaa,2015-09-01,0,0,3,9,3,15
YAMPARAEZ,"anticoncepcion, prevencion de its y de cancer de cuello uterino",numero de mujeres con ivaa,2015-09-01,0,1,4,5,2,12
YAPACANI,"anticoncepcion, prevencion de its y de cancer de cuello uterino",numero de mujeres con ivaa,2015-09-01,2,42,138,45,12,239
ZUDAÑEZ,"anticoncepcion, prevencion de its y de cancer de cuello uterino",numero de mujeres con ivaa,2015-09-01,0,0,1,1,0,2
ACACIO,"anticoncepcion, prevencion de its y de cancer de cuello uterino",numero de mujeres con ivaa,2015-10-01,0,1,1,2,0,4
AIQUILE,"anticoncepcion, prevencion de its y de cancer de cuello uterino",numero de mujeres con ivaa,2015-10-01,0,1,24,18,2,45
ANTEQUERA,"anticoncepcion, prevencion de its y de cancer de cuello uterino",numero de mujeres con ivaa,2015-10-01,0,0,0,1,1,2
ARAMPAMPA,"anticoncepcion, prevencion de its y de cancer de cuello uterino",numero de mujeres con ivaa,2015-10-01,0,1,2,0,0,3
AYOPAYA (V. DE INDEPENDENCIA),"anticoncepcion, prevencion de its y de cancer de cuello uterino",numero de mujeres con ivaa,2015-10-01,0,2,4,2,1,9
AZURDUY,"anticoncepcion, prevencion de its y de cancer de cuello uterino",numero de mujeres con ivaa,2015-10-01,0,10,47,47,6,110
BELLA FLOR,"anticoncepcion, prevencion de its y de cancer de cuello uterino",numero de mujeres con ivaa,2015-10-01,1,0,3,11,3,18
BERMEJO,"anticoncepcion, prevencion de its y de cancer de cuello uterino",numero de mujeres con ivaa,2015-10-01,0,0,6,4,1,11
BUENA VISTA,"anticoncepcion, prevencion de its y de cancer de cuello uterino",numero de mujeres con ivaa,2015-10-01,0,0,2,1,0,3
CAMARGO,"anticoncepcion, prevencion de its y de cancer de cuello uterino",numero de mujeres con ivaa,2015-10-01,0,2,12,18,1,33
CAMATAQUI (C. VILLA ABECIA),"anticoncepcion, prevencion de its y de cancer de cuello uterino",numero de mujeres con ivaa,2015-10-01,0,0,4,4,5,13
CAMIRI,"anticoncepcion, prevencion de its y de cancer de cuello uterino",numero de mujeres con ivaa,2015-10-01,0,0,7,3,1,11
CAPINOTA,"anticoncepcion, prevencion de its y de cancer de cuello uterino",numero de mujeres con ivaa,2015-10-01,0,10,35,9,2,56
CARIPUYO,"anticoncepcion, prevencion de its y de cancer de cuello uterino",numero de mujeres con ivaa,2015-10-01,0,4,16,7,0,27
CKOCHAS,"anticoncepcion, prevencion de its y de cancer de cuello uterino",numero de mujeres con ivaa,2015-10-01,0,0,19,9,0,28
CLIZA,"anticoncepcion, prevencion de its y de cancer de cuello uterino",numero de mujeres con ivaa,2015-10-01,0,0,16,0,0,16
COBIJA,"anticoncepcion, prevencion de its y de cancer de cuello uterino",numero de mujeres con ivaa,2015-10-01,1,38,161,97,23,320
COCAPATA,"anticoncepcion, prevencion de its y de cancer de cuello uterino",numero de mujeres con ivaa,2015-10-01,0,0,6,3,0,9
COCHABAMBA,"anticoncepcion, prevencion de its y de cancer de cuello uterino",numero de mujeres con ivaa,2015-10-01,0,3,269,709,44,1025
COMARAPA,"anticoncepcion, prevencion de its y de cancer de cuello uterino",numero de mujeres con ivaa,2015-10-01,0,1,8,5,2,16
CULPINA,"anticoncepcion, prevencion de its y de cancer de cuello uterino",numero de mujeres con ivaa,2015-10-01,0,1,14,12,2,29
CURAHUARA DE CARANGAS,"anticoncepcion, prevencion de its y de cancer de cuello uterino",numero de mujeres con ivaa,2015-10-01,0,0,3,0,0,3
EL ALTO,"anticoncepcion, prevencion de its y de cancer de cuello uterino",numero de mujeres con ivaa,2015-10-01,0,25,366,281,103,775
EL PUENTE(TJA),"anticoncepcion, prevencion de its y de cancer de cuello uterino",numero de mujeres con ivaa,2015-10-01,0,4,32,6,0,42
ENTRE RIOS TRJ,"anticoncepcion, prevencion de its y de cancer de cuello uterino",numero de mujeres con ivaa,2015-10-01,0,2,8,7,3,20
ENTRE RIOS CBBA,"anticoncepcion, prevencion de its y de cancer de cuello uterino",numero de mujeres con ivaa,2015-10-01,0,1,5,4,1,11
EUCALIPTUS,"anticoncepcion, prevencion de its y de cancer de cuello uterino",numero de mujeres con ivaa,2015-10-01,0,0,1,1,1,3
HUACARETA,"anticoncepcion, prevencion de its y de cancer de cuello uterino",numero de mujeres con ivaa,2015-10-01,0,2,6,4,1,13
HUACAYA (VILLA DE HUACAYA),"anticoncepcion, prevencion de its y de cancer de cuello uterino",numero de mujeres con ivaa,2015-10-01,0,2,1,1,0,4
HUANUNI,"anticoncepcion, prevencion de its y de cancer de cuello uterino",numero de mujeres con ivaa,2015-10-01,0,1,17,6,7,31
HUAYLLAMARCA,"anticoncepcion, prevencion de its y de cancer de cuello uterino",numero de mujeres con ivaa,2015-10-01,0,0,1,4,0,5
ICLA,"anticoncepcion, prevencion de its y de cancer de cuello uterino",numero de mujeres con ivaa,2015-10-01,0,2,16,15,5,38
LA PAZ,"anticoncepcion, prevencion de its y de cancer de cuello uterino",numero de mujeres con ivaa,2015-10-01,0,6,66,55,18,145
LLALLAGUA,"anticoncepcion, prevencion de its y de cancer de cuello uterino",numero de mujeres con ivaa,2015-10-01,0,1,53,86,47,187
MACHACAMARCA,"anticoncepcion, prevencion de its y de cancer de cuello uterino",numero de mujeres con ivaa,2015-10-01,0,0,5,0,0,5
MACHARETI,"anticoncepcion, prevencion de its y de cancer de cuello uterino",numero de mujeres con ivaa,2015-10-01,0,0,3,4,3,10
MAIRANA,"anticoncepcion, prevencion de its y de cancer de cuello uterino",numero de mujeres con ivaa,2015-10-01,0,1,5,6,0,12
MIZQUE,"anticoncepcion, prevencion de its y de cancer de cuello uterino",numero de mujeres con ivaa,2015-10-01,0,5,18,7,1,31
MONTEAGUDO,"anticoncepcion, prevencion de its y de cancer de cuello uterino",numero de mujeres con ivaa,2015-10-01,0,2,20,6,5,33
MONTERO,"anticoncepcion, prevencion de its y de cancer de cuello uterino",numero de mujeres con ivaa,2015-10-01,0,1,23,10,3,37
ORURO,"anticoncepcion, prevencion de its y de cancer de cuello uterino",numero de mujeres con ivaa,2015-10-01,1,11,145,78,11,246
PADCAYA,"anticoncepcion, prevencion de its y de cancer de cuello uterino",numero de mujeres con ivaa,2015-10-01,0,0,1,0,2,3
PAILON,"anticoncepcion, prevencion de its y de cancer de cuello uterino",numero de mujeres con ivaa,2015-10-01,0,0,3,0,0,3
PORONGO,"anticoncepcion, prevencion de its y de cancer de cuello uterino",numero de mujeres con ivaa,2015-10-01,0,0,4,4,2,10
PORVENIR,"anticoncepcion, prevencion de its y de cancer de cuello uterino",numero de mujeres con ivaa,2015-10-01,0,1,2,2,0,5
POTOSI,"anticoncepcion, prevencion de its y de cancer de cuello uterino",numero de mujeres con ivaa,2015-10-01,0,1,45,48,18,112
PUERTO GONZALO MORENO,"anticoncepcion, prevencion de its y de cancer de cuello uterino",numero de mujeres con ivaa,2015-10-01,0,2,6,2,1,11
PUERTO VILLARROEL,"anticoncepcion, prevencion de its y de cancer de cuello uterino",numero de mujeres con ivaa,2015-10-01,0,1,9,1,0,11
PUNATA,"anticoncepcion, prevencion de its y de cancer de cuello uterino",numero de mujeres con ivaa,2015-10-01,0,2,14,3,2,21
QUILLACOLLO,"anticoncepcion, prevencion de its y de cancer de cuello uterino",numero de mujeres con ivaa,2015-10-01,0,0,6,4,0,10
RIBERALTA,"anticoncepcion, prevencion de its y de cancer de cuello uterino",numero de mujeres con ivaa,2015-10-01,5,29,140,103,7,284
SACABA,"anticoncepcion, prevencion de its y de cancer de cuello uterino",numero de mujeres con ivaa,2015-10-01,0,3,19,17,2,41
SACACA,"anticoncepcion, prevencion de its y de cancer de cuello uterino",numero de mujeres con ivaa,2015-10-01,0,3,14,2,3,22
SAN CARLOS,"anticoncepcion, prevencion de its y de cancer de cuello uterino",numero de mujeres con ivaa,2015-10-01,0,3,3,3,1,10
SAN IGNACIO,"anticoncepcion, prevencion de its y de cancer de cuello uterino",numero de mujeres con ivaa,2015-10-01,0,0,1,0,0,1
SAN LUCAS,"anticoncepcion, prevencion de its y de cancer de cuello uterino",numero de mujeres con ivaa,2015-10-01,1,14,43,22,5,85
SAN PEDRO DE BUENA VISTA,"anticoncepcion, prevencion de its y de cancer de cuello uterino",numero de mujeres con ivaa,2015-10-01,0,9,53,37,3,102
SAN RAMON SCZ,"anticoncepcion, prevencion de its y de cancer de cuello uterino",numero de mujeres con ivaa,2015-10-01,0,6,19,7,1,33
SANTA CRUZ DE LA SIERRA,"anticoncepcion, prevencion de its y de cancer de cuello uterino",numero de mujeres con ivaa,2015-10-01,0,0,213,82,8,303
SIPE SIPE,"anticoncepcion, prevencion de its y de cancer de cuello uterino",numero de mujeres con ivaa,2015-10-01,0,2,30,17,14,63
SORACACHI,"anticoncepcion, prevencion de its y de cancer de cuello uterino",numero de mujeres con ivaa,2015-10-01,0,0,1,0,0,1
SUCRE,"anticoncepcion, prevencion de its y de cancer de cuello uterino",numero de mujeres con ivaa,2015-10-01,1,8,88,58,16,171
TARABUCO,"anticoncepcion, prevencion de its y de cancer de cuello uterino",numero de mujeres con ivaa,2015-10-01,0,0,0,1,0,1
TARIJA,"anticoncepcion, prevencion de its y de cancer de cuello uterino",numero de mujeres con ivaa,2015-10-01,17,17,18,2,1,55
TARVITA,"anticoncepcion, prevencion de its y de cancer de cuello uterino",numero de mujeres con ivaa,2015-10-01,0,5,12,22,4,43
TIQUIPAYA,"anticoncepcion, prevencion de its y de cancer de cuello uterino",numero de mujeres con ivaa,2015-10-01,0,0,2,1,0,3
TIRAQUE (CBBA),"anticoncepcion, prevencion de its y de cancer de cuello uterino",numero de mujeres con ivaa,2015-10-01,0,1,5,2,0,8
TORO TORO,"anticoncepcion, prevencion de its y de cancer de cuello uterino",numero de mujeres con ivaa,2015-10-01,2,14,34,25,10,85
TOTORA(ORR),"anticoncepcion, prevencion de its y de cancer de cuello uterino",numero de mujeres con ivaa,2015-10-01,0,1,1,1,0,3
TRINIDAD,"anticoncepcion, prevencion de its y de cancer de cuello uterino",numero de mujeres con ivaa,2015-10-01,0,3,43,31,4,81
TURCO,"anticoncepcion, prevencion de its y de cancer de cuello uterino",numero de mujeres con ivaa,2015-10-01,0,0,2,2,2,6
URIONDO (A. CONCEPCION),"anticoncepcion, prevencion de its y de cancer de cuello uterino",numero de mujeres con ivaa,2015-10-01,0,3,10,14,4,31
VILLA CHARCAS,"anticoncepcion, prevencion de its y de cancer de cuello uterino",numero de mujeres con ivaa,2015-10-01,0,0,1,0,0,1
VILLA MONTES,"anticoncepcion, prevencion de its y de cancer de cuello uterino",numero de mujeres con ivaa,2015-10-01,1,7,49,30,13,100
VILLA TUNARI,"anticoncepcion, prevencion de its y de cancer de cuello uterino",numero de mujeres con ivaa,2015-10-01,0,0,1,0,0,1
VILLA VACA GUZMAN (MUYUPAMPA),"anticoncepcion, prevencion de its y de cancer de cuello uterino",numero de mujeres con ivaa,2015-10-01,0,1,3,6,1,11
VINTO,"anticoncepcion, prevencion de its y de cancer de cuello uterino",numero de mujeres con ivaa,2015-10-01,0,0,5,4,3,12
YAMPARAEZ,"anticoncepcion, prevencion de its y de cancer de cuello uterino",numero de mujeres con ivaa,2015-10-01,0,0,3,0,0,3
YAPACANI,"anticoncepcion, prevencion de its y de cancer de cuello uterino",numero de mujeres con ivaa,2015-10-01,3,38,123,27,10,201
ZUDAÑEZ,"anticoncepcion, prevencion de its y de cancer de cuello uterino",numero de mujeres con ivaa,2015-10-01,0,3,27,16,6,52
ACACIO,"anticoncepcion, prevencion de its y de cancer de cuello uterino",numero de mujeres con ivaa,2015-11-01,0,0,1,1,0,2
AIQUILE,"anticoncepcion, prevencion de its y de cancer de cuello uterino",numero de mujeres con ivaa,2015-11-01,0,5,13,7,5,30
ANTEQUERA,"anticoncepcion, prevencion de its y de cancer de cuello uterino",numero de mujeres con ivaa,2015-11-01,0,0,2,0,0,2
ARAMPAMPA,"anticoncepcion, prevencion de its y de cancer de cuello uterino",numero de mujeres con ivaa,2015-11-01,0,2,5,5,0,12
AYOPAYA (V. DE INDEPENDENCIA),"anticoncepcion, prevencion de its y de cancer de cuello uterino",numero de mujeres con ivaa,2015-11-01,0,1,10,4,2,17
AZURDUY,"anticoncepcion, prevencion de its y de cancer de cuello uterino",numero de mujeres con ivaa,2015-11-01,1,2,11,17,3,34
BELLA FLOR,"anticoncepcion, prevencion de its y de cancer de cuello uterino",numero de mujeres con ivaa,2015-11-01,2,4,12,2,0,20
BERMEJO,"anticoncepcion, prevencion de its y de cancer de cuello uterino",numero de mujeres con ivaa,2015-11-01,0,2,18,17,3,40
BOLPEBRA,"anticoncepcion, prevencion de its y de cancer de cuello uterino",numero de mujeres con ivaa,2015-11-01,0,1,19,3,0,23
CAMARGO,"anticoncepcion, prevencion de its y de cancer de cuello uterino",numero de mujeres con ivaa,2015-11-01,0,7,21,36,11,75
CAMIRI,"anticoncepcion, prevencion de its y de cancer de cuello uterino",numero de mujeres con ivaa,2015-11-01,0,4,8,7,7,26
CAPINOTA,"anticoncepcion, prevencion de its y de cancer de cuello uterino",numero de mujeres con ivaa,2015-11-01,2,5,26,10,0,43
CARIPUYO,"anticoncepcion, prevencion de its y de cancer de cuello uterino",numero de mujeres con ivaa,2015-11-01,1,10,38,54,4,107
COBIJA,"anticoncepcion, prevencion de its y de cancer de cuello uterino",numero de mujeres con ivaa,2015-11-01,0,18,80,41,12,151
COCAPATA,"anticoncepcion, prevencion de its y de cancer de cuello uterino",numero de mujeres con ivaa,2015-11-01,0,1,9,2,0,12
COCHABAMBA,"anticoncepcion, prevencion de its y de cancer de cuello uterino",numero de mujeres con ivaa,2015-11-01,0,50,99,482,34,665
COLOMI,"anticoncepcion, prevencion de its y de cancer de cuello uterino",numero de mujeres con ivaa,2015-11-01,0,0,0,1,0,1
COMARAPA,"anticoncepcion, prevencion de its y de cancer de cuello uterino",numero de mujeres con ivaa,2015-11-01,0,0,8,1,1,10
EL ALTO,"anticoncepcion, prevencion de its y de cancer de cuello uterino",numero de mujeres con ivaa,2015-11-01,0,18,229,255,56,558
EL PUENTE(TJA),"anticoncepcion, prevencion de its y de cancer de cuello uterino",numero de mujeres con ivaa,2015-11-01,0,8,30,18,2,58
ENTRE RIOS TRJ,"anticoncepcion, prevencion de its y de cancer de cuello uterino",numero de mujeres con ivaa,2015-11-01,0,1,12,5,1,19
ENTRE RIOS CBBA,"anticoncepcion, prevencion de its y de cancer de cuello uterino",numero de mujeres con ivaa,2015-11-01,0,1,8,3,0,12
EUCALIPTUS,"anticoncepcion, prevencion de its y de cancer de cuello uterino",numero de mujeres con ivaa,2015-11-01,0,1,3,1,1,6
HUACHACALLA,"anticoncepcion, prevencion de its y de cancer de cuello uterino",numero de mujeres con ivaa,2015-11-01,0,0,1,0,0,1
HUANUNI,"anticoncepcion, prevencion de its y de cancer de cuello uterino",numero de mujeres con ivaa,2015-11-01,0,3,19,7,3,32
HUAYLLAMARCA,"anticoncepcion, prevencion de its y de cancer de cuello uterino",numero de mujeres con ivaa,2015-11-01,0,1,0,2,1,4
ICLA,"anticoncepcion, prevencion de its y de cancer de cuello uterino",numero de mujeres con ivaa,2015-11-01,0,0,1,2,2,5
INCAHUASI,"anticoncepcion, prevencion de its y de cancer de cuello uterino",numero de mujeres con ivaa,2015-11-01,0,0,1,2,0,3
LA PAZ,"anticoncepcion, prevencion de its y de cancer de cuello uterino",numero de mujeres con ivaa,2015-11-01,1,32,78,34,23,168
MACHACAMARCA,"anticoncepcion, prevencion de its y de cancer de cuello uterino",numero de mujeres con ivaa,2015-11-01,0,0,1,2,0,3
MAIRANA,"anticoncepcion, prevencion de its y de cancer de cuello uterino",numero de mujeres con ivaa,2015-11-01,0,0,1,0,0,1
MIZQUE,"anticoncepcion, prevencion de its y de cancer de cuello uterino",numero de mujeres con ivaa,2015-11-01,0,3,11,3,0,17
MONTEAGUDO,"anticoncepcion, prevencion de its y de cancer de cuello uterino",numero de mujeres con ivaa,2015-11-01,0,0,21,15,5,41
MONTERO,"anticoncepcion, prevencion de its y de cancer de cuello uterino",numero de mujeres con ivaa,2015-11-01,0,12,45,33,16,106
ORURO,"anticoncepcion, prevencion de its y de cancer de cuello uterino",numero de mujeres con ivaa,2015-11-01,0,25,228,115,11,379
PADCAYA,"anticoncepcion, prevencion de its y de cancer de cuello uterino",numero de mujeres con ivaa,2015-11-01,0,0,2,2,0,4
PADILLA,"anticoncepcion, prevencion de its y de cancer de cuello uterino",numero de mujeres con ivaa,2015-11-01,0,1,13,6,1,21
PORVENIR,"anticoncepcion, prevencion de its y de cancer de cuello uterino",numero de mujeres con ivaa,2015-11-01,0,1,17,10,7,35
POTOSI,"anticoncepcion, prevencion de its y de cancer de cuello uterino",numero de mujeres con ivaa,2015-11-01,0,1,28,32,9,70
PUERTO GONZALO MORENO,"anticoncepcion, prevencion de its y de cancer de cuello uterino",numero de mujeres con ivaa,2015-11-01,0,0,8,2,1,11
PUERTO RICO,"anticoncepcion, prevencion de its y de cancer de cuello uterino",numero de mujeres con ivaa,2015-11-01,0,2,16,8,3,29
PUERTO VILLARROEL,"anticoncepcion, prevencion de its y de cancer de cuello uterino",numero de mujeres con ivaa,2015-11-01,0,2,3,1,0,6
PUNATA,"anticoncepcion, prevencion de its y de cancer de cuello uterino",numero de mujeres con ivaa,2015-11-01,0,0,4,4,2,10
QUILLACOLLO,"anticoncepcion, prevencion de its y de cancer de cuello uterino",numero de mujeres con ivaa,2015-11-01,0,0,5,2,0,7
RIBERALTA,"anticoncepcion, prevencion de its y de cancer de cuello uterino",numero de mujeres con ivaa,2015-11-01,0,13,49,19,34,115
SACABA,"anticoncepcion, prevencion de its y de cancer de cuello uterino",numero de mujeres con ivaa,2015-11-01,0,3,29,20,6,58
SACACA,"anticoncepcion, prevencion de its y de cancer de cuello uterino",numero de mujeres con ivaa,2015-11-01,0,2,6,5,1,14
SAN CARLOS,"anticoncepcion, prevencion de its y de cancer de cuello uterino",numero de mujeres con ivaa,2015-11-01,0,0,7,0,0,7
SAN LUCAS,"anticoncepcion, prevencion de its y de cancer de cuello uterino",numero de mujeres con ivaa,2015-11-01,1,22,52,45,12,132
SAN PEDRO DE BUENA VISTA,"anticoncepcion, prevencion de its y de cancer de cuello uterino",numero de mujeres con ivaa,2015-11-01,1,8,35,25,3,72
SAN RAMON SCZ,"anticoncepcion, prevencion de its y de cancer de cuello uterino",numero de mujeres con ivaa,2015-11-01,0,0,10,10,3,23
SANTA CRUZ DE LA SIERRA,"anticoncepcion, prevencion de its y de cancer de cuello uterino",numero de mujeres con ivaa,2015-11-01,0,21,21,17,7,66
SHINAOTA,"anticoncepcion, prevencion de its y de cancer de cuello uterino",numero de mujeres con ivaa,2015-11-01,0,3,11,1,0,15
SIPE SIPE,"anticoncepcion, prevencion de its y de cancer de cuello uterino",numero de mujeres con ivaa,2015-11-01,0,1,7,3,0,11
SOPACHUY,"anticoncepcion, prevencion de its y de cancer de cuello uterino",numero de mujeres con ivaa,2015-11-01,0,0,2,1,0,3
SORACACHI,"anticoncepcion, prevencion de its y de cancer de cuello uterino",numero de mujeres con ivaa,2015-11-01,0,0,2,1,1,4
SUCRE,"anticoncepcion, prevencion de its y de cancer de cuello uterino",numero de mujeres con ivaa,2015-11-01,1,5,99,34,7,146
TARIJA,"anticoncepcion, prevencion de its y de cancer de cuello uterino",numero de mujeres con ivaa,2015-11-01,0,6,47,16,4,73
TARVITA,"anticoncepcion, prevencion de its y de cancer de cuello uterino",numero de mujeres con ivaa,2015-11-01,0,21,40,51,2,114
TEOPONTE,"anticoncepcion, prevencion de its y de cancer de cuello uterino",numero de mujeres con ivaa,2015-11-01,0,0,1,0,0,1
TIRAQUE (CBBA),"anticoncepcion, prevencion de its y de cancer de cuello uterino",numero de mujeres con ivaa,2015-11-01,0,2,6,1,0,9
TORO TORO,"anticoncepcion, prevencion de its y de cancer de cuello uterino",numero de mujeres con ivaa,2015-11-01,0,15,47,31,14,107
TOTORA(CBBA),"anticoncepcion, prevencion de its y de cancer de cuello uterino",numero de mujeres con ivaa,2015-11-01,0,12,28,8,0,48
TRINIDAD,"anticoncepcion, prevencion de its y de cancer de cuello uterino",numero de mujeres con ivaa,2015-11-01,0,2,26,20,2,50
URIONDO (A. CONCEPCION),"anticoncepcion, prevencion de its y de cancer de cuello uterino",numero de mujeres con ivaa,2015-11-01,0,1,22,13,4,40
VILLA CHARCAS,"anticoncepcion, prevencion de its y de cancer de cuello uterino",numero de mujeres con ivaa,2015-11-01,0,2,13,4,1,20
VILLA MONTES,"anticoncepcion, prevencion de its y de cancer de cuello uterino",numero de mujeres con ivaa,2015-11-01,0,11,73,42,17,143
VILLA VACA GUZMAN (MUYUPAMPA),"anticoncepcion, prevencion de its y de cancer de cuello uterino",numero de mujeres con ivaa,2015-11-01,0,0,8,10,0,18
VINTO,"anticoncepcion, prevencion de its y de cancer de cuello uterino",numero de mujeres con ivaa,2015-11-01,0,2,30,7,0,39
YACUIBA,"anticoncepcion, prevencion de its y de cancer de cuello uterino",numero de mujeres con ivaa,2015-11-01,0,0,151,227,65,443
YAMPARAEZ,"anticoncepcion, prevencion de its y de cancer de cuello uterino",numero de mujeres con ivaa,2015-11-01,0,0,2,2,2,6
YAPACANI,"anticoncepcion, prevencion de its y de cancer de cuello uterino",numero de mujeres con ivaa,2015-11-01,2,27,89,41,4,163
ZUDAÑEZ,"anticoncepcion, prevencion de its y de cancer de cuello uterino",numero de mujeres con ivaa,2015-11-01,0,2,4,5,3,14
ACACIO,"anticoncepcion, prevencion de its y de cancer de cuello uterino",numero de mujeres con ivaa,2015-12-01,0,0,5,0,0,5
AIQUILE,"anticoncepcion, prevencion de its y de cancer de cuello uterino",numero de mujeres con ivaa,2015-12-01,0,0,11,6,3,20
ANTEQUERA,"anticoncepcion, prevencion de its y de cancer de cuello uterino",numero de mujeres con ivaa,2015-12-01,0,0,2,0,0,2
ARAMPAMPA,"anticoncepcion, prevencion de its y de cancer de cuello uterino",numero de mujeres con ivaa,2015-12-01,0,1,2,1,0,4
AYOPAYA (V. DE INDEPENDENCIA),"anticoncepcion, prevencion de its y de cancer de cuello uterino",numero de mujeres con ivaa,2015-12-01,0,4,9,6,1,20
AZURDUY,"anticoncepcion, prevencion de its y de cancer de cuello uterino",numero de mujeres con ivaa,2015-12-01,0,0,0,0,1,1
BELLA FLOR,"anticoncepcion, prevencion de its y de cancer de cuello uterino",numero de mujeres con ivaa,2015-12-01,0,0,4,2,1,7
BERMEJO,"anticoncepcion, prevencion de its y de cancer de cuello uterino",numero de mujeres con ivaa,2015-12-01,0,1,15,11,2,29
CALACOTO,"anticoncepcion, prevencion de its y de cancer de cuello uterino",numero de mujeres con ivaa,2015-12-01,0,0,1,0,1,2
CAPINOTA,"anticoncepcion, prevencion de its y de cancer de cuello uterino",numero de mujeres con ivaa,2015-12-01,0,7,31,10,1,49
CARIPUYO,"anticoncepcion, prevencion de its y de cancer de cuello uterino",numero de mujeres con ivaa,2015-12-01,0,0,12,3,0,15
CKOCHAS,"anticoncepcion, prevencion de its y de cancer de cuello uterino",numero de mujeres con ivaa,2015-12-01,0,1,3,2,3,9
COBIJA,"anticoncepcion, prevencion de its y de cancer de cuello uterino",numero de mujeres con ivaa,2015-12-01,0,25,111,47,14,197
COCAPATA,"anticoncepcion, prevencion de its y de cancer de cuello uterino",numero de mujeres con ivaa,2015-12-01,0,0,3,0,0,3
COCHABAMBA,"anticoncepcion, prevencion de its y de cancer de cuello uterino",numero de mujeres con ivaa,2015-12-01,0,50,103,630,37,820
COMARAPA,"anticoncepcion, prevencion de its y de cancer de cuello uterino",numero de mujeres con ivaa,2015-12-01,0,1,4,10,5,20
CURAHUARA DE CARANGAS,"anticoncepcion, prevencion de its y de cancer de cuello uterino",numero de mujeres con ivaa,2015-12-01,0,1,1,2,2,6
EL ALTO,"anticoncepcion, prevencion de its y de cancer de cuello uterino",numero de mujeres con ivaa,2015-12-01,1,15,236,174,51,477
EL PUENTE(TJA),"anticoncepcion, prevencion de its y de cancer de cuello uterino",numero de mujeres con ivaa,2015-12-01,0,2,13,10,3,28
EL TORNO,"anticoncepcion, prevencion de its y de cancer de cuello uterino",numero de mujeres con ivaa,2015-12-01,0,2,1,3,2,8
ENTRE RIOS CBBA,"anticoncepcion, prevencion de its y de cancer de cuello uterino",numero de mujeres con ivaa,2015-12-01,0,2,4,0,0,6
EUCALIPTUS,"anticoncepcion, prevencion de its y de cancer de cuello uterino",numero de mujeres con ivaa,2015-12-01,0,0,0,1,0,1
HUANUNI,"anticoncepcion, prevencion de its y de cancer de cuello uterino",numero de mujeres con ivaa,2015-12-01,0,2,5,4,0,11
ICLA,"anticoncepcion, prevencion de its y de cancer de cuello uterino",numero de mujeres con ivaa,2015-12-01,0,0,1,1,0,2
LA PAZ,"anticoncepcion, prevencion de its y de cancer de cuello uterino",numero de mujeres con ivaa,2015-12-01,0,3,33,36,10,82
LLICA,"anticoncepcion, prevencion de its y de cancer de cuello uterino",numero de mujeres con ivaa,2015-12-01,0,0,1,0,0,1
MACHACAMARCA,"anticoncepcion, prevencion de its y de cancer de cuello uterino",numero de mujeres con ivaa,2015-12-01,0,0,1,1,0,2
MAIRANA,"anticoncepcion, prevencion de its y de cancer de cuello uterino",numero de mujeres con ivaa,2015-12-01,0,0,2,2,0,4
MIZQUE,"anticoncepcion, prevencion de its y de cancer de cuello uterino",numero de mujeres con ivaa,2015-12-01,0,14,82,85,26,207
MONTEAGUDO,"anticoncepcion, prevencion de its y de cancer de cuello uterino",numero de mujeres con ivaa,2015-12-01,1,3,15,11,3,33
MONTERO,"anticoncepcion, prevencion de its y de cancer de cuello uterino",numero de mujeres con ivaa,2015-12-01,0,6,31,14,7,58
ORURO,"anticoncepcion, prevencion de its y de cancer de cuello uterino",numero de mujeres con ivaa,2015-12-01,0,16,145,66,10,237
PADCAYA,"anticoncepcion, prevencion de its y de cancer de cuello uterino",numero de mujeres con ivaa,2015-12-01,0,0,1,1,0,2
PORVENIR,"anticoncepcion, prevencion de its y de cancer de cuello uterino",numero de mujeres con ivaa,2015-12-01,0,0,1,0,0,1
POTOSI,"anticoncepcion, prevencion de its y de cancer de cuello uterino",numero de mujeres con ivaa,2015-12-01,0,1,33,109,12,155
PUERTO GONZALO MORENO,"anticoncepcion, prevencion de its y de cancer de cuello uterino",numero de mujeres con ivaa,2015-12-01,0,1,3,0,0,4
PUERTO RICO,"anticoncepcion, prevencion de its y de cancer de cuello uterino",numero de mujeres con ivaa,2015-12-01,0,1,7,1,2,11
PUERTO VILLARROEL,"anticoncepcion, prevencion de its y de cancer de cuello uterino",numero de mujeres con ivaa,2015-12-01,0,2,7,3,0,12
PUNATA,"anticoncepcion, prevencion de its y de cancer de cuello uterino",numero de mujeres con ivaa,2015-12-01,0,2,10,3,3,18
QUILLACOLLO,"anticoncepcion, prevencion de its y de cancer de cuello uterino",numero de mujeres con ivaa,2015-12-01,0,0,1,1,1,3
RIBERALTA,"anticoncepcion, prevencion de its y de cancer de cuello uterino",numero de mujeres con ivaa,2015-12-01,0,0,35,29,8,72
SACABA,"anticoncepcion, prevencion de its y de cancer de cuello uterino",numero de mujeres con ivaa,2015-12-01,0,0,20,11,3,34
SACACA,"anticoncepcion, prevencion de its y de cancer de cuello uterino",numero de mujeres con ivaa,2015-12-01,0,1,4,2,2,9
SALINAS DE GARCI MENDOZA,"anticoncepcion, prevencion de its y de cancer de cuello uterino",numero de mujeres con ivaa,2015-12-01,0,0,3,0,1,4
SAN CARLOS,"anticoncepcion, prevencion de its y de cancer de cuello uterino",numero de mujeres con ivaa,2015-12-01,0,2,6,2,1,11
SAN JULIAN,"anticoncepcion, prevencion de its y de cancer de cuello uterino",numero de mujeres con ivaa,2015-12-01,0,0,1,1,0,2
SAN LUCAS,"anticoncepcion, prevencion de its y de cancer de cuello uterino",numero de mujeres con ivaa,2015-12-01,0,3,23,12,3,41
SAN PEDRO DE BUENA VISTA,"anticoncepcion, prevencion de its y de cancer de cuello uterino",numero de mujeres con ivaa,2015-12-01,0,11,19,4,1,35
SAN RAMON SCZ,"anticoncepcion, prevencion de its y de cancer de cuello uterino",numero de mujeres con ivaa,2015-12-01,0,0,3,0,0,3
SANTA CRUZ DE LA SIERRA,"anticoncepcion, prevencion de its y de cancer de cuello uterino",numero de mujeres con ivaa,2015-12-01,1,20,39,166,9,235
SANTIAGO DE HUARI,"anticoncepcion, prevencion de its y de cancer de cuello uterino",numero de mujeres con ivaa,2015-12-01,0,10,39,9,7,65
SIPE SIPE,"anticoncepcion, prevencion de its y de cancer de cuello uterino",numero de mujeres con ivaa,2015-12-01,0,3,5,4,0,12
SOPACHUY,"anticoncepcion, prevencion de its y de cancer de cuello uterino",numero de mujeres con ivaa,2015-12-01,0,0,2,3,0,5
SUCRE,"anticoncepcion, prevencion de its y de cancer de cuello uterino",numero de mujeres con ivaa,2015-12-01,0,1,10,14,11,36
TARIJA,"anticoncepcion, prevencion de its y de cancer de cuello uterino",numero de mujeres con ivaa,2015-12-01,0,5,24,8,0,37
TARVITA,"anticoncepcion, prevencion de its y de cancer de cuello uterino",numero de mujeres con ivaa,2015-12-01,0,2,4,4,0,10
TIRAQUE (CBBA),"anticoncepcion, prevencion de its y de cancer de cuello uterino",numero de mujeres con ivaa,2015-12-01,0,2,4,2,0,8
TORO TORO,"anticoncepcion, prevencion de its y de cancer de cuello uterino",numero de mujeres con ivaa,2015-12-01,0,10,35,22,4,71
TOTORA(CBBA),"anticoncepcion, prevencion de its y de cancer de cuello uterino",numero de mujeres con ivaa,2015-12-01,0,6,12,2,0,20
TOTORA(ORR),"anticoncepcion, prevencion de its y de cancer de cuello uterino",numero de mujeres con ivaa,2015-12-01,0,0,3,1,1,5
TRINIDAD,"anticoncepcion, prevencion de its y de cancer de cuello uterino",numero de mujeres con ivaa,2015-12-01,0,0,1,0,0,1
URIONDO (A. CONCEPCION),"anticoncepcion, prevencion de its y de cancer de cuello uterino",numero de mujeres con ivaa,2015-12-01,0,0,4,1,0,5
VILLA MONTES,"anticoncepcion, prevencion de its y de cancer de cuello uterino",numero de mujeres con ivaa,2015-12-01,0,12,103,56,21,192
VILLA NUEVA (LOMA ALTA),"anticoncepcion, prevencion de its y de cancer de cuello uterino",numero de mujeres con ivaa,2015-12-01,0,15,19,12,0,46
VILLA VACA GUZMAN (MUYUPAMPA),"anticoncepcion, prevencion de its y de cancer de cuello uterino",numero de mujeres con ivaa,2015-12-01,0,1,6,3,0,10
VINTO,"anticoncepcion, prevencion de its y de cancer de cuello uterino",numero de mujeres con ivaa,2015-12-01,0,2,8,2,0,12
YACUIBA,"anticoncepcion, prevencion de its y de cancer de cuello uterino",numero de mujeres con ivaa,2015-12-01,0,0,2,11,2,15
YAMPARAEZ,"anticoncepcion, prevencion de its y de cancer de cuello uterino",numero de mujeres con ivaa,2015-12-01,0,1,0,1,0,2
YAPACANI,"anticoncepcion, prevencion de its y de cancer de cuello uterino",numero de mujeres con ivaa,2015-12-01,1,25,129,35,9,199
YUNCHARA,"anticoncepcion, prevencion de its y de cancer de cuello uterino",numero de mujeres con ivaa,2015-12-01,0,0,3,0,0,3
ZUDAÑEZ,"anticoncepcion, prevencion de its y de cancer de cuello uterino",numero de mujeres con ivaa,2015-12-01,0,3,2,4,7,16
