municipality,group,variable,month,Número de mujeres con IVAA positivos,Número de mujeres con IVAA positivos1,Número de mujeres con IVAA positivos2,Número de mujeres con IVAA positivos3,Número de mujeres con IVAA positivos4,TOTAL
BELLA FLOR,"anticoncepcion, prevencion de its y de cancer de cuello uterino",numero de mujeres con ivaa positivos,2015-01-01,0,2,0,0,0,2
CAMIRI,"anticoncepcion, prevencion de its y de cancer de cuello uterino",numero de mujeres con ivaa positivos,2015-01-01,0,0,1,1,0,2
CAPINOTA,"anticoncepcion, prevencion de its y de cancer de cuello uterino",numero de mujeres con ivaa positivos,2015-01-01,1,0,5,2,0,8
COBIJA,"anticoncepcion, prevencion de its y de cancer de cuello uterino",numero de mujeres con ivaa positivos,2015-01-01,0,0,1,0,0,1
COCHABAMBA,"anticoncepcion, prevencion de its y de cancer de cuello uterino",numero de mujeres con ivaa positivos,2015-01-01,0,2,11,72,3,88
COLCAPIRHUA,"anticoncepcion, prevencion de its y de cancer de cuello uterino",numero de mujeres con ivaa positivos,2015-01-01,0,0,1,0,0,1
EL ALTO,"anticoncepcion, prevencion de its y de cancer de cuello uterino",numero de mujeres con ivaa positivos,2015-01-01,0,1,5,7,9,22
HUACHACALLA,"anticoncepcion, prevencion de its y de cancer de cuello uterino",numero de mujeres con ivaa positivos,2015-01-01,0,0,1,0,0,1
LA PAZ,"anticoncepcion, prevencion de its y de cancer de cuello uterino",numero de mujeres con ivaa positivos,2015-01-01,0,3,15,5,0,23
MONTERO,"anticoncepcion, prevencion de its y de cancer de cuello uterino",numero de mujeres con ivaa positivos,2015-01-01,0,0,1,0,0,1
ORURO,"anticoncepcion, prevencion de its y de cancer de cuello uterino",numero de mujeres con ivaa positivos,2015-01-01,0,0,3,4,0,7
POTOSI,"anticoncepcion, prevencion de its y de cancer de cuello uterino",numero de mujeres con ivaa positivos,2015-01-01,0,0,3,2,0,5
RIBERALTA,"anticoncepcion, prevencion de its y de cancer de cuello uterino",numero de mujeres con ivaa positivos,2015-01-01,0,0,4,2,0,6
SAN LUCAS,"anticoncepcion, prevencion de its y de cancer de cuello uterino",numero de mujeres con ivaa positivos,2015-01-01,0,0,2,1,0,3
SANTA CRUZ DE LA SIERRA,"anticoncepcion, prevencion de its y de cancer de cuello uterino",numero de mujeres con ivaa positivos,2015-01-01,0,0,0,7,0,7
SUCRE,"anticoncepcion, prevencion de its y de cancer de cuello uterino",numero de mujeres con ivaa positivos,2015-01-01,0,2,3,1,0,6
TARIJA,"anticoncepcion, prevencion de its y de cancer de cuello uterino",numero de mujeres con ivaa positivos,2015-01-01,0,0,0,2,0,2
TRINIDAD,"anticoncepcion, prevencion de its y de cancer de cuello uterino",numero de mujeres con ivaa positivos,2015-01-01,0,0,0,1,0,1
UNCIA,"anticoncepcion, prevencion de its y de cancer de cuello uterino",numero de mujeres con ivaa positivos,2015-01-01,0,0,1,1,0,2
VILLA SERRANO,"anticoncepcion, prevencion de its y de cancer de cuello uterino",numero de mujeres con ivaa positivos,2015-01-01,0,0,2,1,0,3
YAPACANI,"anticoncepcion, prevencion de its y de cancer de cuello uterino",numero de mujeres con ivaa positivos,2015-01-01,0,0,1,0,0,1
CAMIRI,"anticoncepcion, prevencion de its y de cancer de cuello uterino",numero de mujeres con ivaa positivos,2015-02-01,0,0,2,4,3,9
CAPINOTA,"anticoncepcion, prevencion de its y de cancer de cuello uterino",numero de mujeres con ivaa positivos,2015-02-01,0,3,12,0,0,15
EL ALTO,"anticoncepcion, prevencion de its y de cancer de cuello uterino",numero de mujeres con ivaa positivos,2015-02-01,0,0,5,2,1,8
ICLA,"anticoncepcion, prevencion de its y de cancer de cuello uterino",numero de mujeres con ivaa positivos,2015-02-01,0,0,3,3,0,6
LA PAZ,"anticoncepcion, prevencion de its y de cancer de cuello uterino",numero de mujeres con ivaa positivos,2015-02-01,0,0,6,4,0,10
MIZQUE,"anticoncepcion, prevencion de its y de cancer de cuello uterino",numero de mujeres con ivaa positivos,2015-02-01,0,3,6,3,0,12
MONTERO,"anticoncepcion, prevencion de its y de cancer de cuello uterino",numero de mujeres con ivaa positivos,2015-02-01,0,0,3,0,0,3
ORURO,"anticoncepcion, prevencion de its y de cancer de cuello uterino",numero de mujeres con ivaa positivos,2015-02-01,0,0,5,2,0,7
POTOSI,"anticoncepcion, prevencion de its y de cancer de cuello uterino",numero de mujeres con ivaa positivos,2015-02-01,0,0,1,3,0,4
RIBERALTA,"anticoncepcion, prevencion de its y de cancer de cuello uterino",numero de mujeres con ivaa positivos,2015-02-01,0,0,5,4,0,9
SACABA,"anticoncepcion, prevencion de its y de cancer de cuello uterino",numero de mujeres con ivaa positivos,2015-02-01,0,0,0,1,0,1
SAN IGNACIO DE VELASCO,"anticoncepcion, prevencion de its y de cancer de cuello uterino",numero de mujeres con ivaa positivos,2015-02-01,0,0,1,0,0,1
SANTA CRUZ DE LA SIERRA,"anticoncepcion, prevencion de its y de cancer de cuello uterino",numero de mujeres con ivaa positivos,2015-02-01,0,0,2,2,0,4
TARIJA,"anticoncepcion, prevencion de its y de cancer de cuello uterino",numero de mujeres con ivaa positivos,2015-02-01,0,0,18,5,1,24
VILLA SERRANO,"anticoncepcion, prevencion de its y de cancer de cuello uterino",numero de mujeres con ivaa positivos,2015-02-01,0,0,1,0,0,1
ACHACACHI,"anticoncepcion, prevencion de its y de cancer de cuello uterino",numero de mujeres con ivaa positivos,2015-03-01,0,1,0,0,0,1
ALCALA,"anticoncepcion, prevencion de its y de cancer de cuello uterino",numero de mujeres con ivaa positivos,2015-03-01,0,0,4,5,0,9
AYOPAYA (V. DE INDEPENDENCIA),"anticoncepcion, prevencion de its y de cancer de cuello uterino",numero de mujeres con ivaa positivos,2015-03-01,0,0,0,0,2,2
CAMIRI,"anticoncepcion, prevencion de its y de cancer de cuello uterino",numero de mujeres con ivaa positivos,2015-03-01,0,0,1,0,0,1
CAPINOTA,"anticoncepcion, prevencion de its y de cancer de cuello uterino",numero de mujeres con ivaa positivos,2015-03-01,0,3,10,2,0,15
COBIJA,"anticoncepcion, prevencion de its y de cancer de cuello uterino",numero de mujeres con ivaa positivos,2015-03-01,0,0,1,0,0,1
COCHABAMBA,"anticoncepcion, prevencion de its y de cancer de cuello uterino",numero de mujeres con ivaa positivos,2015-03-01,0,9,22,104,2,137
EL ALTO,"anticoncepcion, prevencion de its y de cancer de cuello uterino",numero de mujeres con ivaa positivos,2015-03-01,0,3,2,2,3,10
ICLA,"anticoncepcion, prevencion de its y de cancer de cuello uterino",numero de mujeres con ivaa positivos,2015-03-01,0,0,2,0,0,2
LA PAZ,"anticoncepcion, prevencion de its y de cancer de cuello uterino",numero de mujeres con ivaa positivos,2015-03-01,0,5,28,18,4,55
MIZQUE,"anticoncepcion, prevencion de its y de cancer de cuello uterino",numero de mujeres con ivaa positivos,2015-03-01,0,0,0,1,1,2
MONTERO,"anticoncepcion, prevencion de its y de cancer de cuello uterino",numero de mujeres con ivaa positivos,2015-03-01,0,0,0,1,0,1
ORURO,"anticoncepcion, prevencion de its y de cancer de cuello uterino",numero de mujeres con ivaa positivos,2015-03-01,0,0,7,5,1,13
POTOSI,"anticoncepcion, prevencion de its y de cancer de cuello uterino",numero de mujeres con ivaa positivos,2015-03-01,0,0,2,4,0,6
PUERTO GONZALO MORENO,"anticoncepcion, prevencion de its y de cancer de cuello uterino",numero de mujeres con ivaa positivos,2015-03-01,0,0,1,2,0,3
RIBERALTA,"anticoncepcion, prevencion de its y de cancer de cuello uterino",numero de mujeres con ivaa positivos,2015-03-01,0,1,10,1,1,13
SAN CARLOS,"anticoncepcion, prevencion de its y de cancer de cuello uterino",numero de mujeres con ivaa positivos,2015-03-01,0,0,0,2,0,2
SUCRE,"anticoncepcion, prevencion de its y de cancer de cuello uterino",numero de mujeres con ivaa positivos,2015-03-01,0,0,1,2,0,3
TARIJA,"anticoncepcion, prevencion de its y de cancer de cuello uterino",numero de mujeres con ivaa positivos,2015-03-01,0,1,8,1,1,11
TRINIDAD,"anticoncepcion, prevencion de its y de cancer de cuello uterino",numero de mujeres con ivaa positivos,2015-03-01,0,0,1,1,1,3
UNCIA,"anticoncepcion, prevencion de its y de cancer de cuello uterino",numero de mujeres con ivaa positivos,2015-03-01,0,0,0,1,1,2
VILLA MONTES,"anticoncepcion, prevencion de its y de cancer de cuello uterino",numero de mujeres con ivaa positivos,2015-03-01,0,0,0,1,0,1
YAMPARAEZ,"anticoncepcion, prevencion de its y de cancer de cuello uterino",numero de mujeres con ivaa positivos,2015-03-01,0,2,7,3,0,12
ZUDAÑEZ,"anticoncepcion, prevencion de its y de cancer de cuello uterino",numero de mujeres con ivaa positivos,2015-03-01,0,0,1,1,0,2
AYOPAYA (V. DE INDEPENDENCIA),"anticoncepcion, prevencion de its y de cancer de cuello uterino",numero de mujeres con ivaa positivos,2015-04-01,0,0,0,0,1,1
BATALLAS,"anticoncepcion, prevencion de its y de cancer de cuello uterino",numero de mujeres con ivaa positivos,2015-04-01,0,0,0,0,1,1
CAMIRI,"anticoncepcion, prevencion de its y de cancer de cuello uterino",numero de mujeres con ivaa positivos,2015-04-01,0,0,0,0,1,1
CAPINOTA,"anticoncepcion, prevencion de its y de cancer de cuello uterino",numero de mujeres con ivaa positivos,2015-04-01,0,0,2,0,0,2
COCHABAMBA,"anticoncepcion, prevencion de its y de cancer de cuello uterino",numero de mujeres con ivaa positivos,2015-04-01,0,7,15,91,4,117
COLCAPIRHUA,"anticoncepcion, prevencion de its y de cancer de cuello uterino",numero de mujeres con ivaa positivos,2015-04-01,0,0,1,0,0,1
EL ALTO,"anticoncepcion, prevencion de its y de cancer de cuello uterino",numero de mujeres con ivaa positivos,2015-04-01,0,1,0,1,0,2
EL TORNO,"anticoncepcion, prevencion de its y de cancer de cuello uterino",numero de mujeres con ivaa positivos,2015-04-01,0,4,23,18,9,54
ENTRE RIOS TRJ,"anticoncepcion, prevencion de its y de cancer de cuello uterino",numero de mujeres con ivaa positivos,2015-04-01,0,0,1,0,2,3
ICLA,"anticoncepcion, prevencion de its y de cancer de cuello uterino",numero de mujeres con ivaa positivos,2015-04-01,0,0,0,2,1,3
LA PAZ,"anticoncepcion, prevencion de its y de cancer de cuello uterino",numero de mujeres con ivaa positivos,2015-04-01,0,0,2,2,0,4
MONTERO,"anticoncepcion, prevencion de its y de cancer de cuello uterino",numero de mujeres con ivaa positivos,2015-04-01,0,0,1,0,0,1
ORURO,"anticoncepcion, prevencion de its y de cancer de cuello uterino",numero de mujeres con ivaa positivos,2015-04-01,0,0,7,2,0,9
POTOSI,"anticoncepcion, prevencion de its y de cancer de cuello uterino",numero de mujeres con ivaa positivos,2015-04-01,0,0,8,2,1,11
PUERTO GONZALO MORENO,"anticoncepcion, prevencion de its y de cancer de cuello uterino",numero de mujeres con ivaa positivos,2015-04-01,0,0,1,0,1,2
RIBERALTA,"anticoncepcion, prevencion de its y de cancer de cuello uterino",numero de mujeres con ivaa positivos,2015-04-01,0,0,13,6,0,19
SAN IGNACIO,"anticoncepcion, prevencion de its y de cancer de cuello uterino",numero de mujeres con ivaa positivos,2015-04-01,0,0,0,0,2,2
SAN LUCAS,"anticoncepcion, prevencion de its y de cancer de cuello uterino",numero de mujeres con ivaa positivos,2015-04-01,0,0,0,1,0,1
SANTA CRUZ DE LA SIERRA,"anticoncepcion, prevencion de its y de cancer de cuello uterino",numero de mujeres con ivaa positivos,2015-04-01,0,0,1,1,0,2
TARIJA,"anticoncepcion, prevencion de its y de cancer de cuello uterino",numero de mujeres con ivaa positivos,2015-04-01,0,48,106,78,16,248
TIQUIPAYA,"anticoncepcion, prevencion de its y de cancer de cuello uterino",numero de mujeres con ivaa positivos,2015-04-01,0,0,3,1,0,4
TRINIDAD,"anticoncepcion, prevencion de its y de cancer de cuello uterino",numero de mujeres con ivaa positivos,2015-04-01,0,0,1,1,2,4
VILLA MONTES,"anticoncepcion, prevencion de its y de cancer de cuello uterino",numero de mujeres con ivaa positivos,2015-04-01,0,0,2,0,0,2
YAPACANI,"anticoncepcion, prevencion de its y de cancer de cuello uterino",numero de mujeres con ivaa positivos,2015-04-01,0,0,0,4,0,4
ZUDAÑEZ,"anticoncepcion, prevencion de its y de cancer de cuello uterino",numero de mujeres con ivaa positivos,2015-04-01,0,0,0,1,0,1
AYOPAYA (V. DE INDEPENDENCIA),"anticoncepcion, prevencion de its y de cancer de cuello uterino",numero de mujeres con ivaa positivos,2015-05-01,0,0,1,0,0,1
CABEZAS,"anticoncepcion, prevencion de its y de cancer de cuello uterino",numero de mujeres con ivaa positivos,2015-05-01,0,6,0,0,0,6
CAMIRI,"anticoncepcion, prevencion de its y de cancer de cuello uterino",numero de mujeres con ivaa positivos,2015-05-01,0,0,0,0,1,1
CAPINOTA,"anticoncepcion, prevencion de its y de cancer de cuello uterino",numero de mujeres con ivaa positivos,2015-05-01,0,2,0,2,0,4
COBIJA,"anticoncepcion, prevencion de its y de cancer de cuello uterino",numero de mujeres con ivaa positivos,2015-05-01,0,0,9,2,1,12
COCHABAMBA,"anticoncepcion, prevencion de its y de cancer de cuello uterino",numero de mujeres con ivaa positivos,2015-05-01,0,6,30,252,11,299
EL ALTO,"anticoncepcion, prevencion de its y de cancer de cuello uterino",numero de mujeres con ivaa positivos,2015-05-01,0,2,8,7,1,18
EL TORNO,"anticoncepcion, prevencion de its y de cancer de cuello uterino",numero de mujeres con ivaa positivos,2015-05-01,0,0,5,0,1,6
ICLA,"anticoncepcion, prevencion de its y de cancer de cuello uterino",numero de mujeres con ivaa positivos,2015-05-01,0,0,2,2,0,4
LA PAZ,"anticoncepcion, prevencion de its y de cancer de cuello uterino",numero de mujeres con ivaa positivos,2015-05-01,0,4,5,2,0,11
ORURO,"anticoncepcion, prevencion de its y de cancer de cuello uterino",numero de mujeres con ivaa positivos,2015-05-01,0,0,2,0,0,2
POTOSI,"anticoncepcion, prevencion de its y de cancer de cuello uterino",numero de mujeres con ivaa positivos,2015-05-01,0,0,3,6,0,9
QUILLACOLLO,"anticoncepcion, prevencion de its y de cancer de cuello uterino",numero de mujeres con ivaa positivos,2015-05-01,0,0,1,0,0,1
RIBERALTA,"anticoncepcion, prevencion de its y de cancer de cuello uterino",numero de mujeres con ivaa positivos,2015-05-01,0,1,5,1,0,7
SACACA,"anticoncepcion, prevencion de its y de cancer de cuello uterino",numero de mujeres con ivaa positivos,2015-05-01,0,1,4,1,1,7
SUCRE,"anticoncepcion, prevencion de its y de cancer de cuello uterino",numero de mujeres con ivaa positivos,2015-05-01,0,0,0,1,0,1
TARIJA,"anticoncepcion, prevencion de its y de cancer de cuello uterino",numero de mujeres con ivaa positivos,2015-05-01,0,8,30,27,1,66
TRINIDAD,"anticoncepcion, prevencion de its y de cancer de cuello uterino",numero de mujeres con ivaa positivos,2015-05-01,0,0,1,1,0,2
VILLA MONTES,"anticoncepcion, prevencion de its y de cancer de cuello uterino",numero de mujeres con ivaa positivos,2015-05-01,0,0,56,1,0,57
YACUIBA,"anticoncepcion, prevencion de its y de cancer de cuello uterino",numero de mujeres con ivaa positivos,2015-05-01,0,0,0,2,3,5
YAMPARAEZ,"anticoncepcion, prevencion de its y de cancer de cuello uterino",numero de mujeres con ivaa positivos,2015-05-01,0,0,1,1,0,2
YAPACANI,"anticoncepcion, prevencion de its y de cancer de cuello uterino",numero de mujeres con ivaa positivos,2015-05-01,0,0,4,5,0,9
YUNCHARA,"anticoncepcion, prevencion de its y de cancer de cuello uterino",numero de mujeres con ivaa positivos,2015-05-01,0,1,0,0,0,1
AIQUILE,"anticoncepcion, prevencion de its y de cancer de cuello uterino",numero de mujeres con ivaa positivos,2015-06-01,0,0,1,1,0,2
AZURDUY,"anticoncepcion, prevencion de its y de cancer de cuello uterino",numero de mujeres con ivaa positivos,2015-06-01,1,0,6,4,0,11
BUENA VISTA,"anticoncepcion, prevencion de its y de cancer de cuello uterino",numero de mujeres con ivaa positivos,2015-06-01,0,0,1,0,0,1
CAMARGO,"anticoncepcion, prevencion de its y de cancer de cuello uterino",numero de mujeres con ivaa positivos,2015-06-01,0,1,0,0,0,1
CAMIRI,"anticoncepcion, prevencion de its y de cancer de cuello uterino",numero de mujeres con ivaa positivos,2015-06-01,0,0,0,6,1,7
CAPINOTA,"anticoncepcion, prevencion de its y de cancer de cuello uterino",numero de mujeres con ivaa positivos,2015-06-01,0,0,1,0,0,1
COCHABAMBA,"anticoncepcion, prevencion de its y de cancer de cuello uterino",numero de mujeres con ivaa positivos,2015-06-01,0,7,23,110,6,146
EL ALTO,"anticoncepcion, prevencion de its y de cancer de cuello uterino",numero de mujeres con ivaa positivos,2015-06-01,0,1,16,18,2,37
ICLA,"anticoncepcion, prevencion de its y de cancer de cuello uterino",numero de mujeres con ivaa positivos,2015-06-01,0,0,0,2,0,2
LA PAZ,"anticoncepcion, prevencion de its y de cancer de cuello uterino",numero de mujeres con ivaa positivos,2015-06-01,0,1,4,2,0,7
MAIRANA,"anticoncepcion, prevencion de its y de cancer de cuello uterino",numero de mujeres con ivaa positivos,2015-06-01,0,0,0,3,1,4
MONTEAGUDO,"anticoncepcion, prevencion de its y de cancer de cuello uterino",numero de mujeres con ivaa positivos,2015-06-01,0,0,1,0,0,1
MONTERO,"anticoncepcion, prevencion de its y de cancer de cuello uterino",numero de mujeres con ivaa positivos,2015-06-01,0,0,2,1,1,4
ORURO,"anticoncepcion, prevencion de its y de cancer de cuello uterino",numero de mujeres con ivaa positivos,2015-06-01,0,0,5,1,0,6
POTOSI,"anticoncepcion, prevencion de its y de cancer de cuello uterino",numero de mujeres con ivaa positivos,2015-06-01,0,0,3,9,1,13
PUERTO GONZALO MORENO,"anticoncepcion, prevencion de its y de cancer de cuello uterino",numero de mujeres con ivaa positivos,2015-06-01,0,0,0,1,0,1
RIBERALTA,"anticoncepcion, prevencion de its y de cancer de cuello uterino",numero de mujeres con ivaa positivos,2015-06-01,0,2,13,4,3,22
SACACA,"anticoncepcion, prevencion de its y de cancer de cuello uterino",numero de mujeres con ivaa positivos,2015-06-01,0,0,3,2,4,9
SANTA CRUZ DE LA SIERRA,"anticoncepcion, prevencion de its y de cancer de cuello uterino",numero de mujeres con ivaa positivos,2015-06-01,0,0,0,1,0,1
SUCRE,"anticoncepcion, prevencion de its y de cancer de cuello uterino",numero de mujeres con ivaa positivos,2015-06-01,28,0,2,5,0,35
TARABUCO,"anticoncepcion, prevencion de its y de cancer de cuello uterino",numero de mujeres con ivaa positivos,2015-06-01,0,0,0,0,1,1
TARIJA,"anticoncepcion, prevencion de its y de cancer de cuello uterino",numero de mujeres con ivaa positivos,2015-06-01,0,2,27,9,3,41
TIRAQUE (CBBA),"anticoncepcion, prevencion de its y de cancer de cuello uterino",numero de mujeres con ivaa positivos,2015-06-01,0,0,0,1,0,1
TRINIDAD,"anticoncepcion, prevencion de its y de cancer de cuello uterino",numero de mujeres con ivaa positivos,2015-06-01,0,0,0,2,0,2
VIACHA,"anticoncepcion, prevencion de its y de cancer de cuello uterino",numero de mujeres con ivaa positivos,2015-06-01,0,0,0,1,1,2
ZUDAÑEZ,"anticoncepcion, prevencion de its y de cancer de cuello uterino",numero de mujeres con ivaa positivos,2015-06-01,0,1,2,0,0,3
AIQUILE,"anticoncepcion, prevencion de its y de cancer de cuello uterino",numero de mujeres con ivaa positivos,2015-07-01,0,0,1,1,0,2
ANTEQUERA,"anticoncepcion, prevencion de its y de cancer de cuello uterino",numero de mujeres con ivaa positivos,2015-07-01,0,0,0,1,0,1
AZURDUY,"anticoncepcion, prevencion de its y de cancer de cuello uterino",numero de mujeres con ivaa positivos,2015-07-01,0,0,1,0,0,1
BERMEJO,"anticoncepcion, prevencion de its y de cancer de cuello uterino",numero de mujeres con ivaa positivos,2015-07-01,0,0,2,1,0,3
BUENA VISTA,"anticoncepcion, prevencion de its y de cancer de cuello uterino",numero de mujeres con ivaa positivos,2015-07-01,0,0,0,1,0,1
CAMARGO,"anticoncepcion, prevencion de its y de cancer de cuello uterino",numero de mujeres con ivaa positivos,2015-07-01,0,2,1,0,0,3
CAMIRI,"anticoncepcion, prevencion de its y de cancer de cuello uterino",numero de mujeres con ivaa positivos,2015-07-01,0,0,2,0,0,2
CAPINOTA,"anticoncepcion, prevencion de its y de cancer de cuello uterino",numero de mujeres con ivaa positivos,2015-07-01,0,0,1,0,0,1
COBIJA,"anticoncepcion, prevencion de its y de cancer de cuello uterino",numero de mujeres con ivaa positivos,2015-07-01,0,1,2,2,0,5
COCHABAMBA,"anticoncepcion, prevencion de its y de cancer de cuello uterino",numero de mujeres con ivaa positivos,2015-07-01,1,6,18,5,3,33
EL ALTO,"anticoncepcion, prevencion de its y de cancer de cuello uterino",numero de mujeres con ivaa positivos,2015-07-01,0,0,133,116,0,249
LA PAZ,"anticoncepcion, prevencion de its y de cancer de cuello uterino",numero de mujeres con ivaa positivos,2015-07-01,0,0,0,2,0,2
MAIRANA,"anticoncepcion, prevencion de its y de cancer de cuello uterino",numero de mujeres con ivaa positivos,2015-07-01,0,0,1,0,0,1
MONTERO,"anticoncepcion, prevencion de its y de cancer de cuello uterino",numero de mujeres con ivaa positivos,2015-07-01,0,0,2,2,0,4
ORURO,"anticoncepcion, prevencion de its y de cancer de cuello uterino",numero de mujeres con ivaa positivos,2015-07-01,0,0,3,1,0,4
POROMA,"anticoncepcion, prevencion de its y de cancer de cuello uterino",numero de mujeres con ivaa positivos,2015-07-01,0,0,2,1,0,3
PUERTO GONZALO MORENO,"anticoncepcion, prevencion de its y de cancer de cuello uterino",numero de mujeres con ivaa positivos,2015-07-01,0,0,0,2,0,2
QUILLACOLLO,"anticoncepcion, prevencion de its y de cancer de cuello uterino",numero de mujeres con ivaa positivos,2015-07-01,0,0,0,1,0,1
RIBERALTA,"anticoncepcion, prevencion de its y de cancer de cuello uterino",numero de mujeres con ivaa positivos,2015-07-01,0,0,2,0,0,2
RURRENABAQUE,"anticoncepcion, prevencion de its y de cancer de cuello uterino",numero de mujeres con ivaa positivos,2015-07-01,0,0,1,0,0,1
SACABA,"anticoncepcion, prevencion de its y de cancer de cuello uterino",numero de mujeres con ivaa positivos,2015-07-01,0,0,1,0,0,1
SACACA,"anticoncepcion, prevencion de its y de cancer de cuello uterino",numero de mujeres con ivaa positivos,2015-07-01,0,0,0,1,0,1
SAN CARLOS,"anticoncepcion, prevencion de its y de cancer de cuello uterino",numero de mujeres con ivaa positivos,2015-07-01,0,0,1,0,0,1
SAN PEDRO DE BUENA VISTA,"anticoncepcion, prevencion de its y de cancer de cuello uterino",numero de mujeres con ivaa positivos,2015-07-01,0,0,2,0,0,2
SANTA CRUZ DE LA SIERRA,"anticoncepcion, prevencion de its y de cancer de cuello uterino",numero de mujeres con ivaa positivos,2015-07-01,0,0,3,1,0,4
SIPE SIPE,"anticoncepcion, prevencion de its y de cancer de cuello uterino",numero de mujeres con ivaa positivos,2015-07-01,0,1,1,0,0,2
SUCRE,"anticoncepcion, prevencion de its y de cancer de cuello uterino",numero de mujeres con ivaa positivos,2015-07-01,0,0,4,2,1,7
TARABUCO,"anticoncepcion, prevencion de its y de cancer de cuello uterino",numero de mujeres con ivaa positivos,2015-07-01,0,0,0,1,0,1
TARIJA,"anticoncepcion, prevencion de its y de cancer de cuello uterino",numero de mujeres con ivaa positivos,2015-07-01,0,0,3,4,0,7
TARVITA,"anticoncepcion, prevencion de its y de cancer de cuello uterino",numero de mujeres con ivaa positivos,2015-07-01,0,1,5,9,1,16
TRINIDAD,"anticoncepcion, prevencion de its y de cancer de cuello uterino",numero de mujeres con ivaa positivos,2015-07-01,0,0,1,1,0,2
VILLA MONTES,"anticoncepcion, prevencion de its y de cancer de cuello uterino",numero de mujeres con ivaa positivos,2015-07-01,0,0,2,0,0,2
AIQUILE,"anticoncepcion, prevencion de its y de cancer de cuello uterino",numero de mujeres con ivaa positivos,2015-08-01,0,0,1,0,1,2
AYOPAYA (V. DE INDEPENDENCIA),"anticoncepcion, prevencion de its y de cancer de cuello uterino",numero de mujeres con ivaa positivos,2015-08-01,0,0,1,1,1,3
CAMARGO,"anticoncepcion, prevencion de its y de cancer de cuello uterino",numero de mujeres con ivaa positivos,2015-08-01,0,2,1,0,0,3
CAMATAQUI (C. VILLA ABECIA),"anticoncepcion, prevencion de its y de cancer de cuello uterino",numero de mujeres con ivaa positivos,2015-08-01,0,0,1,0,0,1
CAMIRI,"anticoncepcion, prevencion de its y de cancer de cuello uterino",numero de mujeres con ivaa positivos,2015-08-01,0,0,0,1,0,1
CAPINOTA,"anticoncepcion, prevencion de its y de cancer de cuello uterino",numero de mujeres con ivaa positivos,2015-08-01,0,0,1,0,0,1
CARIPUYO,"anticoncepcion, prevencion de its y de cancer de cuello uterino",numero de mujeres con ivaa positivos,2015-08-01,0,0,0,0,1,1
COBIJA,"anticoncepcion, prevencion de its y de cancer de cuello uterino",numero de mujeres con ivaa positivos,2015-08-01,0,0,0,1,0,1
COCHABAMBA,"anticoncepcion, prevencion de its y de cancer de cuello uterino",numero de mujeres con ivaa positivos,2015-08-01,0,11,16,116,2,145
EL ALTO,"anticoncepcion, prevencion de its y de cancer de cuello uterino",numero de mujeres con ivaa positivos,2015-08-01,0,1,4,4,2,11
LA PAZ,"anticoncepcion, prevencion de its y de cancer de cuello uterino",numero de mujeres con ivaa positivos,2015-08-01,0,0,3,3,1,7
MAIRANA,"anticoncepcion, prevencion de its y de cancer de cuello uterino",numero de mujeres con ivaa positivos,2015-08-01,0,0,2,1,0,3
MONTERO,"anticoncepcion, prevencion de its y de cancer de cuello uterino",numero de mujeres con ivaa positivos,2015-08-01,0,0,1,0,0,1
ORURO,"anticoncepcion, prevencion de its y de cancer de cuello uterino",numero de mujeres con ivaa positivos,2015-08-01,0,0,2,1,0,3
POTOSI,"anticoncepcion, prevencion de its y de cancer de cuello uterino",numero de mujeres con ivaa positivos,2015-08-01,0,0,2,1,0,3
PRESTO,"anticoncepcion, prevencion de its y de cancer de cuello uterino",numero de mujeres con ivaa positivos,2015-08-01,0,0,0,0,2,2
RIBERALTA,"anticoncepcion, prevencion de its y de cancer de cuello uterino",numero de mujeres con ivaa positivos,2015-08-01,0,1,0,0,0,1
SACACA,"anticoncepcion, prevencion de its y de cancer de cuello uterino",numero de mujeres con ivaa positivos,2015-08-01,0,0,1,0,0,1
SAN CARLOS,"anticoncepcion, prevencion de its y de cancer de cuello uterino",numero de mujeres con ivaa positivos,2015-08-01,0,0,5,1,0,6
SAN LUCAS,"anticoncepcion, prevencion de its y de cancer de cuello uterino",numero de mujeres con ivaa positivos,2015-08-01,0,0,1,1,0,2
SAN PEDRO DE BUENA VISTA,"anticoncepcion, prevencion de its y de cancer de cuello uterino",numero de mujeres con ivaa positivos,2015-08-01,0,0,3,2,1,6
SANTA CRUZ DE LA SIERRA,"anticoncepcion, prevencion de its y de cancer de cuello uterino",numero de mujeres con ivaa positivos,2015-08-01,0,2,0,0,0,2
SIPE SIPE,"anticoncepcion, prevencion de its y de cancer de cuello uterino",numero de mujeres con ivaa positivos,2015-08-01,0,0,0,1,0,1
SUCRE,"anticoncepcion, prevencion de its y de cancer de cuello uterino",numero de mujeres con ivaa positivos,2015-08-01,0,0,5,5,0,10
TARIJA,"anticoncepcion, prevencion de its y de cancer de cuello uterino",numero de mujeres con ivaa positivos,2015-08-01,0,0,5,8,1,14
TARVITA,"anticoncepcion, prevencion de its y de cancer de cuello uterino",numero de mujeres con ivaa positivos,2015-08-01,0,0,0,1,2,3
TRINIDAD,"anticoncepcion, prevencion de its y de cancer de cuello uterino",numero de mujeres con ivaa positivos,2015-08-01,0,0,30,19,1,50
VILLA MONTES,"anticoncepcion, prevencion de its y de cancer de cuello uterino",numero de mujeres con ivaa positivos,2015-08-01,0,2,8,0,1,11
YAPACANI,"anticoncepcion, prevencion de its y de cancer de cuello uterino",numero de mujeres con ivaa positivos,2015-08-01,0,0,1,0,0,1
AIQUILE,"anticoncepcion, prevencion de its y de cancer de cuello uterino",numero de mujeres con ivaa positivos,2015-09-01,0,0,0,1,0,1
ANZALDO,"anticoncepcion, prevencion de its y de cancer de cuello uterino",numero de mujeres con ivaa positivos,2015-09-01,0,0,1,2,0,3
ARAMPAMPA,"anticoncepcion, prevencion de its y de cancer de cuello uterino",numero de mujeres con ivaa positivos,2015-09-01,0,0,1,2,0,3
AYOPAYA (V. DE INDEPENDENCIA),"anticoncepcion, prevencion de its y de cancer de cuello uterino",numero de mujeres con ivaa positivos,2015-09-01,1,1,15,6,3,26
CAMARGO,"anticoncepcion, prevencion de its y de cancer de cuello uterino",numero de mujeres con ivaa positivos,2015-09-01,0,1,0,0,0,1
CAMIRI,"anticoncepcion, prevencion de its y de cancer de cuello uterino",numero de mujeres con ivaa positivos,2015-09-01,0,0,0,2,0,2
CAPINOTA,"anticoncepcion, prevencion de its y de cancer de cuello uterino",numero de mujeres con ivaa positivos,2015-09-01,0,2,1,0,0,3
COBIJA,"anticoncepcion, prevencion de its y de cancer de cuello uterino",numero de mujeres con ivaa positivos,2015-09-01,0,0,1,0,0,1
COCHABAMBA,"anticoncepcion, prevencion de its y de cancer de cuello uterino",numero de mujeres con ivaa positivos,2015-09-01,0,9,28,104,5,146
CULPINA,"anticoncepcion, prevencion de its y de cancer de cuello uterino",numero de mujeres con ivaa positivos,2015-09-01,0,0,0,3,0,3
CURAHUARA DE CARANGAS,"anticoncepcion, prevencion de its y de cancer de cuello uterino",numero de mujeres con ivaa positivos,2015-09-01,0,0,0,1,0,1
EL ALTO,"anticoncepcion, prevencion de its y de cancer de cuello uterino",numero de mujeres con ivaa positivos,2015-09-01,0,0,3,3,6,12
EL PUENTE(TJA),"anticoncepcion, prevencion de its y de cancer de cuello uterino",numero de mujeres con ivaa positivos,2015-09-01,0,0,1,0,0,1
HUACAYA (VILLA DE HUACAYA),"anticoncepcion, prevencion de its y de cancer de cuello uterino",numero de mujeres con ivaa positivos,2015-09-01,0,0,1,0,0,1
ICLA,"anticoncepcion, prevencion de its y de cancer de cuello uterino",numero de mujeres con ivaa positivos,2015-09-01,0,0,3,1,0,4
LA PAZ,"anticoncepcion, prevencion de its y de cancer de cuello uterino",numero de mujeres con ivaa positivos,2015-09-01,0,0,4,5,0,9
MAIRANA,"anticoncepcion, prevencion de its y de cancer de cuello uterino",numero de mujeres con ivaa positivos,2015-09-01,0,0,1,0,0,1
MONTERO,"anticoncepcion, prevencion de its y de cancer de cuello uterino",numero de mujeres con ivaa positivos,2015-09-01,1,1,5,0,0,7
ORURO,"anticoncepcion, prevencion de its y de cancer de cuello uterino",numero de mujeres con ivaa positivos,2015-09-01,0,1,2,1,0,4
PUERTO GONZALO MORENO,"anticoncepcion, prevencion de its y de cancer de cuello uterino",numero de mujeres con ivaa positivos,2015-09-01,0,0,2,1,0,3
PUERTO RICO,"anticoncepcion, prevencion de its y de cancer de cuello uterino",numero de mujeres con ivaa positivos,2015-09-01,0,0,1,0,0,1
PUERTO VILLARROEL,"anticoncepcion, prevencion de its y de cancer de cuello uterino",numero de mujeres con ivaa positivos,2015-09-01,0,0,1,0,0,1
RIBERALTA,"anticoncepcion, prevencion de its y de cancer de cuello uterino",numero de mujeres con ivaa positivos,2015-09-01,0,2,6,4,0,12
SAN CARLOS,"anticoncepcion, prevencion de its y de cancer de cuello uterino",numero de mujeres con ivaa positivos,2015-09-01,0,0,2,1,0,3
SAN LUCAS,"anticoncepcion, prevencion de its y de cancer de cuello uterino",numero de mujeres con ivaa positivos,2015-09-01,0,0,0,1,0,1
SAN PEDRO DE BUENA VISTA,"anticoncepcion, prevencion de its y de cancer de cuello uterino",numero de mujeres con ivaa positivos,2015-09-01,0,0,1,0,1,2
SANTA CRUZ DE LA SIERRA,"anticoncepcion, prevencion de its y de cancer de cuello uterino",numero de mujeres con ivaa positivos,2015-09-01,0,0,0,1,0,1
SUCRE,"anticoncepcion, prevencion de its y de cancer de cuello uterino",numero de mujeres con ivaa positivos,2015-09-01,0,1,10,7,6,24
TARIJA,"anticoncepcion, prevencion de its y de cancer de cuello uterino",numero de mujeres con ivaa positivos,2015-09-01,0,1,0,1,0,2
TORO TORO,"anticoncepcion, prevencion de its y de cancer de cuello uterino",numero de mujeres con ivaa positivos,2015-09-01,0,0,1,1,0,2
TRINIDAD,"anticoncepcion, prevencion de its y de cancer de cuello uterino",numero de mujeres con ivaa positivos,2015-09-01,0,0,2,2,0,4
VILLA MONTES,"anticoncepcion, prevencion de its y de cancer de cuello uterino",numero de mujeres con ivaa positivos,2015-09-01,0,0,3,2,0,5
VILLA TUNARI,"anticoncepcion, prevencion de its y de cancer de cuello uterino",numero de mujeres con ivaa positivos,2015-09-01,0,0,3,5,4,12
YAPACANI,"anticoncepcion, prevencion de its y de cancer de cuello uterino",numero de mujeres con ivaa positivos,2015-09-01,0,0,2,0,0,2
AIQUILE,"anticoncepcion, prevencion de its y de cancer de cuello uterino",numero de mujeres con ivaa positivos,2015-10-01,0,0,1,0,1,2
CAMIRI,"anticoncepcion, prevencion de its y de cancer de cuello uterino",numero de mujeres con ivaa positivos,2015-10-01,0,0,0,0,1,1
CAPINOTA,"anticoncepcion, prevencion de its y de cancer de cuello uterino",numero de mujeres con ivaa positivos,2015-10-01,0,2,3,0,0,5
CLIZA,"anticoncepcion, prevencion de its y de cancer de cuello uterino",numero de mujeres con ivaa positivos,2015-10-01,0,0,0,1,0,1
COBIJA,"anticoncepcion, prevencion de its y de cancer de cuello uterino",numero de mujeres con ivaa positivos,2015-10-01,0,0,1,2,1,4
COCHABAMBA,"anticoncepcion, prevencion de its y de cancer de cuello uterino",numero de mujeres con ivaa positivos,2015-10-01,0,7,27,103,4,141
EL ALTO,"anticoncepcion, prevencion de its y de cancer de cuello uterino",numero de mujeres con ivaa positivos,2015-10-01,0,4,35,18,2,59
LA GUARDIA,"anticoncepcion, prevencion de its y de cancer de cuello uterino",numero de mujeres con ivaa positivos,2015-10-01,0,0,4,0,1,5
LA PAZ,"anticoncepcion, prevencion de its y de cancer de cuello uterino",numero de mujeres con ivaa positivos,2015-10-01,0,0,1,5,1,7
MONTERO,"anticoncepcion, prevencion de its y de cancer de cuello uterino",numero de mujeres con ivaa positivos,2015-10-01,0,0,1,0,0,1
PALOS BLANCOS,"anticoncepcion, prevencion de its y de cancer de cuello uterino",numero de mujeres con ivaa positivos,2015-10-01,0,0,1,0,0,1
POTOSI,"anticoncepcion, prevencion de its y de cancer de cuello uterino",numero de mujeres con ivaa positivos,2015-10-01,0,2,8,4,0,14
PUERTO GONZALO MORENO,"anticoncepcion, prevencion de its y de cancer de cuello uterino",numero de mujeres con ivaa positivos,2015-10-01,0,0,2,0,0,2
RIBERALTA,"anticoncepcion, prevencion de its y de cancer de cuello uterino",numero de mujeres con ivaa positivos,2015-10-01,0,0,1,0,0,1
SAN PEDRO DE BUENA VISTA,"anticoncepcion, prevencion de its y de cancer de cuello uterino",numero de mujeres con ivaa positivos,2015-10-01,0,0,1,0,0,1
SANTA CRUZ DE LA SIERRA,"anticoncepcion, prevencion de its y de cancer de cuello uterino",numero de mujeres con ivaa positivos,2015-10-01,0,0,4,2,0,6
SIPE SIPE,"anticoncepcion, prevencion de its y de cancer de cuello uterino",numero de mujeres con ivaa positivos,2015-10-01,1,0,0,0,1,2
SUCRE,"anticoncepcion, prevencion de its y de cancer de cuello uterino",numero de mujeres con ivaa positivos,2015-10-01,1,1,10,12,6,30
TARIJA,"anticoncepcion, prevencion de its y de cancer de cuello uterino",numero de mujeres con ivaa positivos,2015-10-01,0,0,14,12,0,26
TARVITA,"anticoncepcion, prevencion de its y de cancer de cuello uterino",numero de mujeres con ivaa positivos,2015-10-01,0,0,0,1,1,2
TRINIDAD,"anticoncepcion, prevencion de its y de cancer de cuello uterino",numero de mujeres con ivaa positivos,2015-10-01,0,0,1,3,1,5
URIONDO (A. CONCEPCION),"anticoncepcion, prevencion de its y de cancer de cuello uterino",numero de mujeres con ivaa positivos,2015-10-01,0,0,6,1,0,7
VILLA MONTES,"anticoncepcion, prevencion de its y de cancer de cuello uterino",numero de mujeres con ivaa positivos,2015-10-01,0,1,0,0,0,1
ZUDAÑEZ,"anticoncepcion, prevencion de its y de cancer de cuello uterino",numero de mujeres con ivaa positivos,2015-10-01,0,1,1,1,1,4
AYOPAYA (V. DE INDEPENDENCIA),"anticoncepcion, prevencion de its y de cancer de cuello uterino",numero de mujeres con ivaa positivos,2015-11-01,0,0,2,0,2,4
BERMEJO,"anticoncepcion, prevencion de its y de cancer de cuello uterino",numero de mujeres con ivaa positivos,2015-11-01,0,0,1,0,0,1
CAMARGO,"anticoncepcion, prevencion de its y de cancer de cuello uterino",numero de mujeres con ivaa positivos,2015-11-01,0,0,1,0,0,1
CAMIRI,"anticoncepcion, prevencion de its y de cancer de cuello uterino",numero de mujeres con ivaa positivos,2015-11-01,0,0,0,1,0,1
CAPINOTA,"anticoncepcion, prevencion de its y de cancer de cuello uterino",numero de mujeres con ivaa positivos,2015-11-01,0,3,5,2,0,10
COCHABAMBA,"anticoncepcion, prevencion de its y de cancer de cuello uterino",numero de mujeres con ivaa positivos,2015-11-01,0,4,17,79,4,104
EL ALTO,"anticoncepcion, prevencion de its y de cancer de cuello uterino",numero de mujeres con ivaa positivos,2015-11-01,0,0,28,18,0,46
EL PUENTE(TJA),"anticoncepcion, prevencion de its y de cancer de cuello uterino",numero de mujeres con ivaa positivos,2015-11-01,0,0,1,0,0,1
ENTRE RIOS CBBA,"anticoncepcion, prevencion de its y de cancer de cuello uterino",numero de mujeres con ivaa positivos,2015-11-01,0,2,3,3,0,8
LA PAZ,"anticoncepcion, prevencion de its y de cancer de cuello uterino",numero de mujeres con ivaa positivos,2015-11-01,0,1,3,3,1,8
MONTERO,"anticoncepcion, prevencion de its y de cancer de cuello uterino",numero de mujeres con ivaa positivos,2015-11-01,0,0,0,1,0,1
ORURO,"anticoncepcion, prevencion de its y de cancer de cuello uterino",numero de mujeres con ivaa positivos,2015-11-01,0,0,2,1,0,3
POTOSI,"anticoncepcion, prevencion de its y de cancer de cuello uterino",numero de mujeres con ivaa positivos,2015-11-01,0,0,4,1,1,6
PUERTO GONZALO MORENO,"anticoncepcion, prevencion de its y de cancer de cuello uterino",numero de mujeres con ivaa positivos,2015-11-01,0,0,0,1,0,1
SACABA,"anticoncepcion, prevencion de its y de cancer de cuello uterino",numero de mujeres con ivaa positivos,2015-11-01,0,0,0,0,1,1
SACACA,"anticoncepcion, prevencion de its y de cancer de cuello uterino",numero de mujeres con ivaa positivos,2015-11-01,0,0,1,0,0,1
SAN CARLOS,"anticoncepcion, prevencion de its y de cancer de cuello uterino",numero de mujeres con ivaa positivos,2015-11-01,0,0,4,0,0,4
SAN RAMON SCZ,"anticoncepcion, prevencion de its y de cancer de cuello uterino",numero de mujeres con ivaa positivos,2015-11-01,0,0,1,0,0,1
SANTA CRUZ DE LA SIERRA,"anticoncepcion, prevencion de its y de cancer de cuello uterino",numero de mujeres con ivaa positivos,2015-11-01,0,0,0,2,0,2
SORATA,"anticoncepcion, prevencion de its y de cancer de cuello uterino",numero de mujeres con ivaa positivos,2015-11-01,0,0,1,0,0,1
SUCRE,"anticoncepcion, prevencion de its y de cancer de cuello uterino",numero de mujeres con ivaa positivos,2015-11-01,1,1,10,9,0,21
TARIJA,"anticoncepcion, prevencion de its y de cancer de cuello uterino",numero de mujeres con ivaa positivos,2015-11-01,0,0,2,3,1,6
TORO TORO,"anticoncepcion, prevencion de its y de cancer de cuello uterino",numero de mujeres con ivaa positivos,2015-11-01,0,0,0,0,1,1
YACUIBA,"anticoncepcion, prevencion de its y de cancer de cuello uterino",numero de mujeres con ivaa positivos,2015-11-01,0,0,13,13,11,37
YAPACANI,"anticoncepcion, prevencion de its y de cancer de cuello uterino",numero de mujeres con ivaa positivos,2015-11-01,0,2,0,0,0,2
AIQUILE,"anticoncepcion, prevencion de its y de cancer de cuello uterino",numero de mujeres con ivaa positivos,2015-12-01,0,0,1,0,0,1
CAPINOTA,"anticoncepcion, prevencion de its y de cancer de cuello uterino",numero de mujeres con ivaa positivos,2015-12-01,0,0,1,0,0,1
COBIJA,"anticoncepcion, prevencion de its y de cancer de cuello uterino",numero de mujeres con ivaa positivos,2015-12-01,0,0,1,1,0,2
COCHABAMBA,"anticoncepcion, prevencion de its y de cancer de cuello uterino",numero de mujeres con ivaa positivos,2015-12-01,0,8,16,107,5,136
EL ALTO,"anticoncepcion, prevencion de its y de cancer de cuello uterino",numero de mujeres con ivaa positivos,2015-12-01,0,0,24,12,3,39
LA ASUNTA,"anticoncepcion, prevencion de its y de cancer de cuello uterino",numero de mujeres con ivaa positivos,2015-12-01,0,0,1,0,0,1
LA PAZ,"anticoncepcion, prevencion de its y de cancer de cuello uterino",numero de mujeres con ivaa positivos,2015-12-01,0,1,1,5,1,8
MAIRANA,"anticoncepcion, prevencion de its y de cancer de cuello uterino",numero de mujeres con ivaa positivos,2015-12-01,0,0,0,1,0,1
MIZQUE,"anticoncepcion, prevencion de its y de cancer de cuello uterino",numero de mujeres con ivaa positivos,2015-12-01,0,0,2,0,0,2
ORURO,"anticoncepcion, prevencion de its y de cancer de cuello uterino",numero de mujeres con ivaa positivos,2015-12-01,0,0,1,0,0,1
POTOSI,"anticoncepcion, prevencion de its y de cancer de cuello uterino",numero de mujeres con ivaa positivos,2015-12-01,0,0,4,3,0,7
SOPACHUY,"anticoncepcion, prevencion de its y de cancer de cuello uterino",numero de mujeres con ivaa positivos,2015-12-01,0,0,2,2,0,4
SUCRE,"anticoncepcion, prevencion de its y de cancer de cuello uterino",numero de mujeres con ivaa positivos,2015-12-01,0,0,5,6,8,19
TARIJA,"anticoncepcion, prevencion de its y de cancer de cuello uterino",numero de mujeres con ivaa positivos,2015-12-01,0,0,2,4,0,6
TIRAQUE (CBBA),"anticoncepcion, prevencion de its y de cancer de cuello uterino",numero de mujeres con ivaa positivos,2015-12-01,0,0,1,0,0,1
VILLA MONTES,"anticoncepcion, prevencion de its y de cancer de cuello uterino",numero de mujeres con ivaa positivos,2015-12-01,0,0,0,2,0,2
VINTO,"anticoncepcion, prevencion de its y de cancer de cuello uterino",numero de mujeres con ivaa positivos,2015-12-01,0,1,1,1,0,3
YAPACANI,"anticoncepcion, prevencion de its y de cancer de cuello uterino",numero de mujeres con ivaa positivos,2015-12-01,0,1,4,1,0,6
ZUDAÑEZ,"anticoncepcion, prevencion de its y de cancer de cuello uterino",numero de mujeres con ivaa positivos,2015-12-01,0,0,0,0,1,1
