municipality,group,variable,month,Píldora: Usuarias Continuas,Píldora: Usuarias Continuas1,Píldora: Usuarias Continuas2,Píldora: Usuarias Continuas3,Píldora: Usuarias Continuas4,TOTAL
ACACIO,"anticoncepcion, prevencion de its y de cancer de cuello uterino",pildora: usuarias continuas,2015-01-01,0,0,0,1,0,1
ACHACACHI,"anticoncepcion, prevencion de its y de cancer de cuello uterino",pildora: usuarias continuas,2015-01-01,0,2,4,0,0,6
ACHOCALLA,"anticoncepcion, prevencion de its y de cancer de cuello uterino",pildora: usuarias continuas,2015-01-01,1,2,2,2,0,7
ALCALA,"anticoncepcion, prevencion de its y de cancer de cuello uterino",pildora: usuarias continuas,2015-01-01,0,0,2,2,0,4
ALTO BENI,"anticoncepcion, prevencion de its y de cancer de cuello uterino",pildora: usuarias continuas,2015-01-01,0,0,7,3,0,10
ANCORAIMES,"anticoncepcion, prevencion de its y de cancer de cuello uterino",pildora: usuarias continuas,2015-01-01,0,0,0,1,0,1
APOLO,"anticoncepcion, prevencion de its y de cancer de cuello uterino",pildora: usuarias continuas,2015-01-01,0,0,5,2,0,7
ARAMPAMPA,"anticoncepcion, prevencion de its y de cancer de cuello uterino",pildora: usuarias continuas,2015-01-01,0,0,1,1,0,2
ARANI,"anticoncepcion, prevencion de its y de cancer de cuello uterino",pildora: usuarias continuas,2015-01-01,0,0,0,1,0,1
ARBIETO,"anticoncepcion, prevencion de its y de cancer de cuello uterino",pildora: usuarias continuas,2015-01-01,0,0,2,0,0,2
ARQUE,"anticoncepcion, prevencion de its y de cancer de cuello uterino",pildora: usuarias continuas,2015-01-01,0,0,2,1,0,3
ASCENCION DE GUARAYOS,"anticoncepcion, prevencion de its y de cancer de cuello uterino",pildora: usuarias continuas,2015-01-01,0,3,4,1,0,8
ATOCHA,"anticoncepcion, prevencion de its y de cancer de cuello uterino",pildora: usuarias continuas,2015-01-01,0,0,7,2,0,9
AUCAPATA,"anticoncepcion, prevencion de its y de cancer de cuello uterino",pildora: usuarias continuas,2015-01-01,0,0,3,1,0,4
AYATA,"anticoncepcion, prevencion de its y de cancer de cuello uterino",pildora: usuarias continuas,2015-01-01,0,1,1,1,0,3
AYOPAYA (V. DE INDEPENDENCIA),"anticoncepcion, prevencion de its y de cancer de cuello uterino",pildora: usuarias continuas,2015-01-01,0,2,7,2,0,11
BATALLAS,"anticoncepcion, prevencion de its y de cancer de cuello uterino",pildora: usuarias continuas,2015-01-01,0,1,4,3,0,8
BAURES,"anticoncepcion, prevencion de its y de cancer de cuello uterino",pildora: usuarias continuas,2015-01-01,0,0,9,1,0,10
BELLA FLOR,"anticoncepcion, prevencion de its y de cancer de cuello uterino",pildora: usuarias continuas,2015-01-01,0,1,9,0,0,10
BERMEJO,"anticoncepcion, prevencion de its y de cancer de cuello uterino",pildora: usuarias continuas,2015-01-01,0,0,3,2,0,5
BETANZOS,"anticoncepcion, prevencion de its y de cancer de cuello uterino",pildora: usuarias continuas,2015-01-01,0,1,5,3,0,9
BOLPEBRA,"anticoncepcion, prevencion de its y de cancer de cuello uterino",pildora: usuarias continuas,2015-01-01,0,0,3,0,0,3
BOYUIBE,"anticoncepcion, prevencion de its y de cancer de cuello uterino",pildora: usuarias continuas,2015-01-01,0,0,3,0,0,3
BUENA VISTA,"anticoncepcion, prevencion de its y de cancer de cuello uterino",pildora: usuarias continuas,2015-01-01,0,2,31,8,0,41
CABEZAS,"anticoncepcion, prevencion de its y de cancer de cuello uterino",pildora: usuarias continuas,2015-01-01,0,1,35,7,0,43
CAIROMA,"anticoncepcion, prevencion de its y de cancer de cuello uterino",pildora: usuarias continuas,2015-01-01,0,0,0,1,0,1
"CAIZA ""D""","anticoncepcion, prevencion de its y de cancer de cuello uterino",pildora: usuarias continuas,2015-01-01,0,0,4,0,0,4
CAJUATA,"anticoncepcion, prevencion de its y de cancer de cuello uterino",pildora: usuarias continuas,2015-01-01,0,0,1,1,0,2
CALAMARCA,"anticoncepcion, prevencion de its y de cancer de cuello uterino",pildora: usuarias continuas,2015-01-01,0,0,5,1,0,6
CAMARGO,"anticoncepcion, prevencion de its y de cancer de cuello uterino",pildora: usuarias continuas,2015-01-01,0,0,2,0,0,2
CAMATAQUI (C. VILLA ABECIA),"anticoncepcion, prevencion de its y de cancer de cuello uterino",pildora: usuarias continuas,2015-01-01,0,0,2,0,0,2
CAMIRI,"anticoncepcion, prevencion de its y de cancer de cuello uterino",pildora: usuarias continuas,2015-01-01,0,0,4,5,0,9
CAPINOTA,"anticoncepcion, prevencion de its y de cancer de cuello uterino",pildora: usuarias continuas,2015-01-01,0,0,4,1,0,5
CAQUIAVIRI,"anticoncepcion, prevencion de its y de cancer de cuello uterino",pildora: usuarias continuas,2015-01-01,0,0,2,0,0,2
CARACOLLO,"anticoncepcion, prevencion de its y de cancer de cuello uterino",pildora: usuarias continuas,2015-01-01,0,0,1,0,0,1
CARANAVI,"anticoncepcion, prevencion de its y de cancer de cuello uterino",pildora: usuarias continuas,2015-01-01,0,0,7,9,1,17
CARAPARI,"anticoncepcion, prevencion de its y de cancer de cuello uterino",pildora: usuarias continuas,2015-01-01,0,4,29,4,0,37
CARIPUYO,"anticoncepcion, prevencion de its y de cancer de cuello uterino",pildora: usuarias continuas,2015-01-01,0,0,12,0,0,12
CARMEN RIVERO TORREZ,"anticoncepcion, prevencion de its y de cancer de cuello uterino",pildora: usuarias continuas,2015-01-01,0,0,3,0,0,3
CATACORA,"anticoncepcion, prevencion de its y de cancer de cuello uterino",pildora: usuarias continuas,2015-01-01,0,0,3,1,0,4
CHALLAPATA,"anticoncepcion, prevencion de its y de cancer de cuello uterino",pildora: usuarias continuas,2015-01-01,0,0,0,1,0,1
CHARAGUA,"anticoncepcion, prevencion de its y de cancer de cuello uterino",pildora: usuarias continuas,2015-01-01,0,5,21,9,0,35
CHIMORE,"anticoncepcion, prevencion de its y de cancer de cuello uterino",pildora: usuarias continuas,2015-01-01,0,1,14,6,0,21
CHULUMANI (V. DE LA LIBERTAD),"anticoncepcion, prevencion de its y de cancer de cuello uterino",pildora: usuarias continuas,2015-01-01,0,0,4,0,0,4
CHUMA,"anticoncepcion, prevencion de its y de cancer de cuello uterino",pildora: usuarias continuas,2015-01-01,0,1,1,1,0,3
CHUQUIHUTA AYLLU JUCUMANI,"anticoncepcion, prevencion de its y de cancer de cuello uterino",pildora: usuarias continuas,2015-01-01,0,0,1,0,0,1
CKOCHAS,"anticoncepcion, prevencion de its y de cancer de cuello uterino",pildora: usuarias continuas,2015-01-01,0,0,0,1,0,1
CLIZA,"anticoncepcion, prevencion de its y de cancer de cuello uterino",pildora: usuarias continuas,2015-01-01,0,0,6,0,0,6
COBIJA,"anticoncepcion, prevencion de its y de cancer de cuello uterino",pildora: usuarias continuas,2015-01-01,0,8,55,7,0,70
COCAPATA,"anticoncepcion, prevencion de its y de cancer de cuello uterino",pildora: usuarias continuas,2015-01-01,0,0,4,2,0,6
COCHABAMBA,"anticoncepcion, prevencion de its y de cancer de cuello uterino",pildora: usuarias continuas,2015-01-01,2,20,102,31,0,155
COLCAPIRHUA,"anticoncepcion, prevencion de its y de cancer de cuello uterino",pildora: usuarias continuas,2015-01-01,0,1,7,0,0,8
"COLCHA ""K""","anticoncepcion, prevencion de its y de cancer de cuello uterino",pildora: usuarias continuas,2015-01-01,0,1,7,2,0,10
COLOMI,"anticoncepcion, prevencion de its y de cancer de cuello uterino",pildora: usuarias continuas,2015-01-01,0,2,3,2,0,7
COLPA BELGICA,"anticoncepcion, prevencion de its y de cancer de cuello uterino",pildora: usuarias continuas,2015-01-01,0,2,13,4,0,19
COLQUENCHA,"anticoncepcion, prevencion de its y de cancer de cuello uterino",pildora: usuarias continuas,2015-01-01,0,1,1,1,0,3
COLQUIRI,"anticoncepcion, prevencion de its y de cancer de cuello uterino",pildora: usuarias continuas,2015-01-01,0,1,0,0,0,1
COMARAPA,"anticoncepcion, prevencion de its y de cancer de cuello uterino",pildora: usuarias continuas,2015-01-01,0,0,5,1,0,6
CONCEPCION,"anticoncepcion, prevencion de its y de cancer de cuello uterino",pildora: usuarias continuas,2015-01-01,0,0,16,1,0,17
COPACABANA,"anticoncepcion, prevencion de its y de cancer de cuello uterino",pildora: usuarias continuas,2015-01-01,0,0,4,2,0,6
CORIPATA,"anticoncepcion, prevencion de its y de cancer de cuello uterino",pildora: usuarias continuas,2015-01-01,0,0,0,2,0,2
CORQUE,"anticoncepcion, prevencion de its y de cancer de cuello uterino",pildora: usuarias continuas,2015-01-01,0,0,1,0,0,1
COTAGAITA,"anticoncepcion, prevencion de its y de cancer de cuello uterino",pildora: usuarias continuas,2015-01-01,0,0,5,1,0,6
COTOCA,"anticoncepcion, prevencion de its y de cancer de cuello uterino",pildora: usuarias continuas,2015-01-01,0,8,39,13,0,60
CUATRO CAÑADAS,"anticoncepcion, prevencion de its y de cancer de cuello uterino",pildora: usuarias continuas,2015-01-01,0,3,10,0,1,14
CUEVO,"anticoncepcion, prevencion de its y de cancer de cuello uterino",pildora: usuarias continuas,2015-01-01,0,0,1,0,0,1
CULPINA,"anticoncepcion, prevencion de its y de cancer de cuello uterino",pildora: usuarias continuas,2015-01-01,0,0,6,4,0,10
CURAHUARA DE CARANGAS,"anticoncepcion, prevencion de its y de cancer de cuello uterino",pildora: usuarias continuas,2015-01-01,0,0,1,0,0,1
CURVA,"anticoncepcion, prevencion de its y de cancer de cuello uterino",pildora: usuarias continuas,2015-01-01,0,0,1,0,0,1
DESAGUADERO,"anticoncepcion, prevencion de its y de cancer de cuello uterino",pildora: usuarias continuas,2015-01-01,0,0,1,0,0,1
EL ALTO,"anticoncepcion, prevencion de its y de cancer de cuello uterino",pildora: usuarias continuas,2015-01-01,0,13,141,38,0,192
EL PUENTE(STC),"anticoncepcion, prevencion de its y de cancer de cuello uterino",pildora: usuarias continuas,2015-01-01,0,0,6,0,0,6
EL PUENTE(TJA),"anticoncepcion, prevencion de its y de cancer de cuello uterino",pildora: usuarias continuas,2015-01-01,0,0,12,8,0,20
EL TORNO,"anticoncepcion, prevencion de its y de cancer de cuello uterino",pildora: usuarias continuas,2015-01-01,1,11,38,22,0,72
EL VILLAR,"anticoncepcion, prevencion de its y de cancer de cuello uterino",pildora: usuarias continuas,2015-01-01,0,1,6,1,0,8
ENTRE RIOS TRJ,"anticoncepcion, prevencion de its y de cancer de cuello uterino",pildora: usuarias continuas,2015-01-01,0,4,20,8,0,32
ENTRE RIOS CBBA,"anticoncepcion, prevencion de its y de cancer de cuello uterino",pildora: usuarias continuas,2015-01-01,0,0,10,3,0,13
EUREKA (SANTOS MERCADO),"anticoncepcion, prevencion de its y de cancer de cuello uterino",pildora: usuarias continuas,2015-01-01,0,1,5,0,0,6
EXALTACION,"anticoncepcion, prevencion de its y de cancer de cuello uterino",pildora: usuarias continuas,2015-01-01,0,0,0,2,0,2
FERNANDEZ ALONSO,"anticoncepcion, prevencion de its y de cancer de cuello uterino",pildora: usuarias continuas,2015-01-01,0,1,9,1,0,11
FILADELFIA,"anticoncepcion, prevencion de its y de cancer de cuello uterino",pildora: usuarias continuas,2015-01-01,0,0,13,3,0,16
GENERAL SAAVEDRA,"anticoncepcion, prevencion de its y de cancer de cuello uterino",pildora: usuarias continuas,2015-01-01,0,4,22,16,0,42
GRAL. J.J. PEREZ (CHARAZANI),"anticoncepcion, prevencion de its y de cancer de cuello uterino",pildora: usuarias continuas,2015-01-01,0,0,0,1,0,1
GUAQUI,"anticoncepcion, prevencion de its y de cancer de cuello uterino",pildora: usuarias continuas,2015-01-01,0,0,1,0,0,1
GUAYARAMERIN,"anticoncepcion, prevencion de its y de cancer de cuello uterino",pildora: usuarias continuas,2015-01-01,0,1,1,0,0,2
GUTIERREZ,"anticoncepcion, prevencion de its y de cancer de cuello uterino",pildora: usuarias continuas,2015-01-01,0,0,7,10,0,17
HUACARETA,"anticoncepcion, prevencion de its y de cancer de cuello uterino",pildora: usuarias continuas,2015-01-01,0,0,7,1,0,8
HUANUNI,"anticoncepcion, prevencion de its y de cancer de cuello uterino",pildora: usuarias continuas,2015-01-01,0,0,3,0,0,3
HUARACAJE,"anticoncepcion, prevencion de its y de cancer de cuello uterino",pildora: usuarias continuas,2015-01-01,0,3,15,4,0,22
HUATAJATA,"anticoncepcion, prevencion de its y de cancer de cuello uterino",pildora: usuarias continuas,2015-01-01,0,0,1,0,0,1
HUAYLLAMARCA,"anticoncepcion, prevencion de its y de cancer de cuello uterino",pildora: usuarias continuas,2015-01-01,0,0,1,0,0,1
ICLA,"anticoncepcion, prevencion de its y de cancer de cuello uterino",pildora: usuarias continuas,2015-01-01,0,0,4,1,0,5
INCAHUASI,"anticoncepcion, prevencion de its y de cancer de cuello uterino",pildora: usuarias continuas,2015-01-01,0,1,4,3,0,8
INGAVI (HUMAITA),"anticoncepcion, prevencion de its y de cancer de cuello uterino",pildora: usuarias continuas,2015-01-01,0,1,1,0,0,2
INQUISIVI,"anticoncepcion, prevencion de its y de cancer de cuello uterino",pildora: usuarias continuas,2015-01-01,0,0,0,1,0,1
IRUPANA (VILLA DE LANZA),"anticoncepcion, prevencion de its y de cancer de cuello uterino",pildora: usuarias continuas,2015-01-01,0,1,5,2,0,8
IXIAMAS,"anticoncepcion, prevencion de its y de cancer de cuello uterino",pildora: usuarias continuas,2015-01-01,0,1,8,1,0,10
JESUS DE MACHACA,"anticoncepcion, prevencion de its y de cancer de cuello uterino",pildora: usuarias continuas,2015-01-01,0,0,1,0,0,1
LA ASUNTA,"anticoncepcion, prevencion de its y de cancer de cuello uterino",pildora: usuarias continuas,2015-01-01,0,2,23,5,0,30
LA GUARDIA,"anticoncepcion, prevencion de its y de cancer de cuello uterino",pildora: usuarias continuas,2015-01-01,0,4,37,8,0,49
LA PAZ,"anticoncepcion, prevencion de its y de cancer de cuello uterino",pildora: usuarias continuas,2015-01-01,0,6,138,21,0,165
LAGUNILLAS,"anticoncepcion, prevencion de its y de cancer de cuello uterino",pildora: usuarias continuas,2015-01-01,0,0,12,2,0,14
LAJA,"anticoncepcion, prevencion de its y de cancer de cuello uterino",pildora: usuarias continuas,2015-01-01,0,0,13,5,1,19
LAS CARRERAS,"anticoncepcion, prevencion de its y de cancer de cuello uterino",pildora: usuarias continuas,2015-01-01,0,0,1,1,0,2
LLALLAGUA,"anticoncepcion, prevencion de its y de cancer de cuello uterino",pildora: usuarias continuas,2015-01-01,0,0,10,1,0,11
LLICA,"anticoncepcion, prevencion de its y de cancer de cuello uterino",pildora: usuarias continuas,2015-01-01,0,0,4,0,0,4
LORETO,"anticoncepcion, prevencion de its y de cancer de cuello uterino",pildora: usuarias continuas,2015-01-01,0,0,0,2,0,2
LURIBAY,"anticoncepcion, prevencion de its y de cancer de cuello uterino",pildora: usuarias continuas,2015-01-01,0,0,1,1,0,2
MACHARETI,"anticoncepcion, prevencion de its y de cancer de cuello uterino",pildora: usuarias continuas,2015-01-01,0,2,7,3,0,12
MAGDALENA,"anticoncepcion, prevencion de its y de cancer de cuello uterino",pildora: usuarias continuas,2015-01-01,0,3,53,14,0,70
MAIRANA,"anticoncepcion, prevencion de its y de cancer de cuello uterino",pildora: usuarias continuas,2015-01-01,0,0,8,0,0,8
MAPIRI,"anticoncepcion, prevencion de its y de cancer de cuello uterino",pildora: usuarias continuas,2015-01-01,0,0,3,0,0,3
MECAPACA,"anticoncepcion, prevencion de its y de cancer de cuello uterino",pildora: usuarias continuas,2015-01-01,0,0,3,3,0,6
MINEROS,"anticoncepcion, prevencion de its y de cancer de cuello uterino",pildora: usuarias continuas,2015-01-01,0,2,16,3,0,21
MIZQUE,"anticoncepcion, prevencion de its y de cancer de cuello uterino",pildora: usuarias continuas,2015-01-01,0,0,3,1,0,4
MOCOMOCO,"anticoncepcion, prevencion de its y de cancer de cuello uterino",pildora: usuarias continuas,2015-01-01,0,0,2,1,0,3
MOJOCOYA,"anticoncepcion, prevencion de its y de cancer de cuello uterino",pildora: usuarias continuas,2015-01-01,0,0,2,2,0,4
MONTEAGUDO,"anticoncepcion, prevencion de its y de cancer de cuello uterino",pildora: usuarias continuas,2015-01-01,0,3,7,5,0,15
MONTERO,"anticoncepcion, prevencion de its y de cancer de cuello uterino",pildora: usuarias continuas,2015-01-01,0,9,45,11,0,65
MORO MORO,"anticoncepcion, prevencion de its y de cancer de cuello uterino",pildora: usuarias continuas,2015-01-01,0,0,6,0,0,6
MOROCHATA,"anticoncepcion, prevencion de its y de cancer de cuello uterino",pildora: usuarias continuas,2015-01-01,0,1,3,3,0,7
NACEBE (SANTA ROSA DEL ABUNA),"anticoncepcion, prevencion de its y de cancer de cuello uterino",pildora: usuarias continuas,2015-01-01,0,0,5,0,0,5
OCURI,"anticoncepcion, prevencion de its y de cancer de cuello uterino",pildora: usuarias continuas,2015-01-01,0,0,3,0,0,3
OKINAWA,"anticoncepcion, prevencion de its y de cancer de cuello uterino",pildora: usuarias continuas,2015-01-01,0,1,14,8,0,23
OMEREQUE,"anticoncepcion, prevencion de its y de cancer de cuello uterino",pildora: usuarias continuas,2015-01-01,0,0,4,1,0,5
ORURO,"anticoncepcion, prevencion de its y de cancer de cuello uterino",pildora: usuarias continuas,2015-01-01,0,7,47,17,1,72
PADCAYA,"anticoncepcion, prevencion de its y de cancer de cuello uterino",pildora: usuarias continuas,2015-01-01,0,2,18,9,1,30
PADILLA,"anticoncepcion, prevencion de its y de cancer de cuello uterino",pildora: usuarias continuas,2015-01-01,0,1,16,1,0,18
PAILON,"anticoncepcion, prevencion de its y de cancer de cuello uterino",pildora: usuarias continuas,2015-01-01,0,2,6,2,0,10
PALOS BLANCOS,"anticoncepcion, prevencion de its y de cancer de cuello uterino",pildora: usuarias continuas,2015-01-01,0,1,32,9,1,43
PAMPA AULLAGAS,"anticoncepcion, prevencion de its y de cancer de cuello uterino",pildora: usuarias continuas,2015-01-01,0,0,1,1,0,2
PAMPA GRANDE,"anticoncepcion, prevencion de its y de cancer de cuello uterino",pildora: usuarias continuas,2015-01-01,0,0,7,2,0,9
PAPEL PAMPA,"anticoncepcion, prevencion de its y de cancer de cuello uterino",pildora: usuarias continuas,2015-01-01,0,0,2,2,0,4
PASORAPA,"anticoncepcion, prevencion de its y de cancer de cuello uterino",pildora: usuarias continuas,2015-01-01,0,0,5,0,0,5
PAZÑA,"anticoncepcion, prevencion de its y de cancer de cuello uterino",pildora: usuarias continuas,2015-01-01,0,0,1,0,0,1
PELECHUCO,"anticoncepcion, prevencion de its y de cancer de cuello uterino",pildora: usuarias continuas,2015-01-01,0,1,5,3,0,9
POCOATA,"anticoncepcion, prevencion de its y de cancer de cuello uterino",pildora: usuarias continuas,2015-01-01,0,0,1,1,0,2
POCONA,"anticoncepcion, prevencion de its y de cancer de cuello uterino",pildora: usuarias continuas,2015-01-01,0,1,6,5,0,12
POJO (CBBA),"anticoncepcion, prevencion de its y de cancer de cuello uterino",pildora: usuarias continuas,2015-01-01,0,0,3,0,0,3
POOPO,"anticoncepcion, prevencion de its y de cancer de cuello uterino",pildora: usuarias continuas,2015-01-01,0,0,2,0,0,2
PORCO,"anticoncepcion, prevencion de its y de cancer de cuello uterino",pildora: usuarias continuas,2015-01-01,0,0,1,0,0,1
POROMA,"anticoncepcion, prevencion de its y de cancer de cuello uterino",pildora: usuarias continuas,2015-01-01,0,0,4,0,0,4
PORONGO,"anticoncepcion, prevencion de its y de cancer de cuello uterino",pildora: usuarias continuas,2015-01-01,0,2,9,5,0,16
PORTACHUELO,"anticoncepcion, prevencion de its y de cancer de cuello uterino",pildora: usuarias continuas,2015-01-01,0,1,9,5,0,15
PORVENIR,"anticoncepcion, prevencion de its y de cancer de cuello uterino",pildora: usuarias continuas,2015-01-01,0,0,8,0,0,8
POSTRER VALLE,"anticoncepcion, prevencion de its y de cancer de cuello uterino",pildora: usuarias continuas,2015-01-01,0,0,1,2,0,3
POTOSI,"anticoncepcion, prevencion de its y de cancer de cuello uterino",pildora: usuarias continuas,2015-01-01,0,13,69,15,0,97
PRESTO,"anticoncepcion, prevencion de its y de cancer de cuello uterino",pildora: usuarias continuas,2015-01-01,0,0,5,0,1,6
PUCARA,"anticoncepcion, prevencion de its y de cancer de cuello uterino",pildora: usuarias continuas,2015-01-01,0,0,1,0,0,1
PUCARANI,"anticoncepcion, prevencion de its y de cancer de cuello uterino",pildora: usuarias continuas,2015-01-01,0,0,4,1,0,5
PUERTO CARABUCO,"anticoncepcion, prevencion de its y de cancer de cuello uterino",pildora: usuarias continuas,2015-01-01,0,0,1,0,0,1
PUERTO GONZALO MORENO,"anticoncepcion, prevencion de its y de cancer de cuello uterino",pildora: usuarias continuas,2015-01-01,0,0,2,1,0,3
PUERTO QUIJARRO,"anticoncepcion, prevencion de its y de cancer de cuello uterino",pildora: usuarias continuas,2015-01-01,0,0,7,7,0,14
PUERTO RICO,"anticoncepcion, prevencion de its y de cancer de cuello uterino",pildora: usuarias continuas,2015-01-01,0,3,14,1,0,18
PUERTO SILES,"anticoncepcion, prevencion de its y de cancer de cuello uterino",pildora: usuarias continuas,2015-01-01,0,0,3,0,0,3
PUERTO SUAREZ,"anticoncepcion, prevencion de its y de cancer de cuello uterino",pildora: usuarias continuas,2015-01-01,0,0,2,0,0,2
PUERTO VILLARROEL,"anticoncepcion, prevencion de its y de cancer de cuello uterino",pildora: usuarias continuas,2015-01-01,0,4,15,12,0,31
PUNA,"anticoncepcion, prevencion de its y de cancer de cuello uterino",pildora: usuarias continuas,2015-01-01,2,0,5,2,0,9
PUNATA,"anticoncepcion, prevencion de its y de cancer de cuello uterino",pildora: usuarias continuas,2015-01-01,0,0,2,0,0,2
QUILLACOLLO,"anticoncepcion, prevencion de its y de cancer de cuello uterino",pildora: usuarias continuas,2015-01-01,0,0,17,1,0,18
QUIME,"anticoncepcion, prevencion de its y de cancer de cuello uterino",pildora: usuarias continuas,2015-01-01,0,0,7,2,0,9
QUIRUSILLAS,"anticoncepcion, prevencion de its y de cancer de cuello uterino",pildora: usuarias continuas,2015-01-01,0,0,5,0,0,5
REYES,"anticoncepcion, prevencion de its y de cancer de cuello uterino",pildora: usuarias continuas,2015-01-01,0,0,8,1,0,9
RIBERALTA,"anticoncepcion, prevencion de its y de cancer de cuello uterino",pildora: usuarias continuas,2015-01-01,5,5,41,12,0,63
ROBORE,"anticoncepcion, prevencion de its y de cancer de cuello uterino",pildora: usuarias continuas,2015-01-01,0,0,12,3,1,16
RURRENABAQUE,"anticoncepcion, prevencion de its y de cancer de cuello uterino",pildora: usuarias continuas,2015-01-01,0,1,6,0,0,7
SABAYA,"anticoncepcion, prevencion de its y de cancer de cuello uterino",pildora: usuarias continuas,2015-01-01,0,0,2,0,0,2
SACABA,"anticoncepcion, prevencion de its y de cancer de cuello uterino",pildora: usuarias continuas,2015-01-01,0,3,17,6,0,26
SACABAMBA,"anticoncepcion, prevencion de its y de cancer de cuello uterino",pildora: usuarias continuas,2015-01-01,0,0,1,0,0,1
SACACA,"anticoncepcion, prevencion de its y de cancer de cuello uterino",pildora: usuarias continuas,2015-01-01,0,2,3,0,0,5
SAIPINA,"anticoncepcion, prevencion de its y de cancer de cuello uterino",pildora: usuarias continuas,2015-01-01,0,0,0,3,0,3
SAMAIPATA,"anticoncepcion, prevencion de its y de cancer de cuello uterino",pildora: usuarias continuas,2015-01-01,0,0,13,2,0,15
SAN AGUSTIN,"anticoncepcion, prevencion de its y de cancer de cuello uterino",pildora: usuarias continuas,2015-01-01,0,0,1,1,0,2
SAN ANDRES,"anticoncepcion, prevencion de its y de cancer de cuello uterino",pildora: usuarias continuas,2015-01-01,0,3,21,4,0,28
SAN ANTONIO DE LOMERIO,"anticoncepcion, prevencion de its y de cancer de cuello uterino",pildora: usuarias continuas,2015-01-01,0,0,19,8,0,27
SAN BENITO,"anticoncepcion, prevencion de its y de cancer de cuello uterino",pildora: usuarias continuas,2015-01-01,0,0,0,2,0,2
SAN BORJA,"anticoncepcion, prevencion de its y de cancer de cuello uterino",pildora: usuarias continuas,2015-01-01,0,4,45,9,2,60
SAN BUENA VENTURA,"anticoncepcion, prevencion de its y de cancer de cuello uterino",pildora: usuarias continuas,2015-01-01,0,2,1,1,0,4
SAN CARLOS,"anticoncepcion, prevencion de its y de cancer de cuello uterino",pildora: usuarias continuas,2015-01-01,0,6,24,9,0,39
SAN IGNACIO,"anticoncepcion, prevencion de its y de cancer de cuello uterino",pildora: usuarias continuas,2015-01-01,0,5,78,58,0,141
SAN IGNACIO DE VELASCO,"anticoncepcion, prevencion de its y de cancer de cuello uterino",pildora: usuarias continuas,2015-01-01,0,10,82,19,0,111
SAN JAVIER(BNI),"anticoncepcion, prevencion de its y de cancer de cuello uterino",pildora: usuarias continuas,2015-01-01,0,3,4,3,0,10
SAN JAVIER(STC),"anticoncepcion, prevencion de its y de cancer de cuello uterino",pildora: usuarias continuas,2015-01-01,0,4,15,8,0,27
SAN JOSE DE CHIQUITOS,"anticoncepcion, prevencion de its y de cancer de cuello uterino",pildora: usuarias continuas,2015-01-01,0,3,7,7,1,18
SAN JUAN DE YAPACANI,"anticoncepcion, prevencion de its y de cancer de cuello uterino",pildora: usuarias continuas,2015-01-01,0,0,6,2,0,8
SAN JULIAN,"anticoncepcion, prevencion de its y de cancer de cuello uterino",pildora: usuarias continuas,2015-01-01,0,0,8,1,0,9
SAN LORENZO(PND),"anticoncepcion, prevencion de its y de cancer de cuello uterino",pildora: usuarias continuas,2015-01-01,0,0,3,3,0,6
SAN LORENZO(TJA),"anticoncepcion, prevencion de its y de cancer de cuello uterino",pildora: usuarias continuas,2015-01-01,0,1,12,4,0,17
SAN LUCAS,"anticoncepcion, prevencion de its y de cancer de cuello uterino",pildora: usuarias continuas,2015-01-01,0,0,8,0,1,9
SAN MATIAS,"anticoncepcion, prevencion de its y de cancer de cuello uterino",pildora: usuarias continuas,2015-01-01,1,2,24,6,0,33
SAN MIGUEL DE VELASCO,"anticoncepcion, prevencion de its y de cancer de cuello uterino",pildora: usuarias continuas,2015-01-01,0,1,30,14,0,45
SAN PABLO DE LIPEZ,"anticoncepcion, prevencion de its y de cancer de cuello uterino",pildora: usuarias continuas,2015-01-01,0,0,1,0,0,1
SAN PEDRO,"anticoncepcion, prevencion de its y de cancer de cuello uterino",pildora: usuarias continuas,2015-01-01,0,0,10,2,0,12
SAN PEDRO DE BUENA VISTA,"anticoncepcion, prevencion de its y de cancer de cuello uterino",pildora: usuarias continuas,2015-01-01,0,0,8,5,0,13
SAN PEDRO DE CURAHUARA,"anticoncepcion, prevencion de its y de cancer de cuello uterino",pildora: usuarias continuas,2015-01-01,0,0,2,0,0,2
SAN PEDRO DE QUEMES,"anticoncepcion, prevencion de its y de cancer de cuello uterino",pildora: usuarias continuas,2015-01-01,0,1,0,1,0,2
SAN PEDRO DE TIQUINA,"anticoncepcion, prevencion de its y de cancer de cuello uterino",pildora: usuarias continuas,2015-01-01,0,0,1,0,0,1
SAN RAFAEL,"anticoncepcion, prevencion de its y de cancer de cuello uterino",pildora: usuarias continuas,2015-01-01,0,3,18,5,0,26
SAN RAMON BENI,"anticoncepcion, prevencion de its y de cancer de cuello uterino",pildora: usuarias continuas,2015-01-01,0,2,9,1,0,12
SAN RAMON SCZ,"anticoncepcion, prevencion de its y de cancer de cuello uterino",pildora: usuarias continuas,2015-01-01,0,3,4,0,0,7
SANTA ANA,"anticoncepcion, prevencion de its y de cancer de cuello uterino",pildora: usuarias continuas,2015-01-01,0,5,21,13,0,39
SANTA CRUZ DE LA SIERRA,"anticoncepcion, prevencion de its y de cancer de cuello uterino",pildora: usuarias continuas,2015-01-01,1,12,135,63,17,228
SANTA ROSA,"anticoncepcion, prevencion de its y de cancer de cuello uterino",pildora: usuarias continuas,2015-01-01,0,0,12,3,0,15
SANTA ROSA DEL SARA,"anticoncepcion, prevencion de its y de cancer de cuello uterino",pildora: usuarias continuas,2015-01-01,0,6,22,20,0,48
SANTIAGO DE HUARI,"anticoncepcion, prevencion de its y de cancer de cuello uterino",pildora: usuarias continuas,2015-01-01,0,0,1,0,0,1
SANTIAGO DE HUATA,"anticoncepcion, prevencion de its y de cancer de cuello uterino",pildora: usuarias continuas,2015-01-01,0,0,1,1,0,2
SANTIVAÑES,"anticoncepcion, prevencion de its y de cancer de cuello uterino",pildora: usuarias continuas,2015-01-01,0,0,1,1,0,2
SANTUARIO DE QUILLACAS,"anticoncepcion, prevencion de its y de cancer de cuello uterino",pildora: usuarias continuas,2015-01-01,0,0,2,1,0,3
SAPAHAQUI,"anticoncepcion, prevencion de its y de cancer de cuello uterino",pildora: usuarias continuas,2015-01-01,0,0,1,0,0,1
SHINAOTA,"anticoncepcion, prevencion de its y de cancer de cuello uterino",pildora: usuarias continuas,2015-01-01,0,1,1,0,0,2
SICA SICA (VILLA AROMA),"anticoncepcion, prevencion de its y de cancer de cuello uterino",pildora: usuarias continuas,2015-01-01,0,0,3,1,0,4
SIPE SIPE,"anticoncepcion, prevencion de its y de cancer de cuello uterino",pildora: usuarias continuas,2015-01-01,0,1,16,1,0,18
SOPACHUY,"anticoncepcion, prevencion de its y de cancer de cuello uterino",pildora: usuarias continuas,2015-01-01,0,0,0,1,0,1
SORACACHI,"anticoncepcion, prevencion de its y de cancer de cuello uterino",pildora: usuarias continuas,2015-01-01,0,0,3,1,0,4
SORATA,"anticoncepcion, prevencion de its y de cancer de cuello uterino",pildora: usuarias continuas,2015-01-01,0,0,0,1,0,1
SUCRE,"anticoncepcion, prevencion de its y de cancer de cuello uterino",pildora: usuarias continuas,2015-01-01,0,8,70,17,0,95
TACACOMA,"anticoncepcion, prevencion de its y de cancer de cuello uterino",pildora: usuarias continuas,2015-01-01,0,0,5,1,0,6
TARABUCO,"anticoncepcion, prevencion de its y de cancer de cuello uterino",pildora: usuarias continuas,2015-01-01,0,0,1,0,0,1
TARACO,"anticoncepcion, prevencion de its y de cancer de cuello uterino",pildora: usuarias continuas,2015-01-01,0,0,1,1,0,2
TARIJA,"anticoncepcion, prevencion de its y de cancer de cuello uterino",pildora: usuarias continuas,2015-01-01,0,7,46,12,1,66
TARVITA,"anticoncepcion, prevencion de its y de cancer de cuello uterino",pildora: usuarias continuas,2015-01-01,0,0,2,4,0,6
TEOPONTE,"anticoncepcion, prevencion de its y de cancer de cuello uterino",pildora: usuarias continuas,2015-01-01,0,1,1,3,0,5
TIAWANACU,"anticoncepcion, prevencion de its y de cancer de cuello uterino",pildora: usuarias continuas,2015-01-01,0,0,5,2,0,7
TIPUANI,"anticoncepcion, prevencion de its y de cancer de cuello uterino",pildora: usuarias continuas,2015-01-01,0,1,4,3,0,8
TIQUIPAYA,"anticoncepcion, prevencion de its y de cancer de cuello uterino",pildora: usuarias continuas,2015-01-01,0,2,11,3,0,16
TIRAQUE (CBBA),"anticoncepcion, prevencion de its y de cancer de cuello uterino",pildora: usuarias continuas,2015-01-01,0,0,7,5,0,12
TOLATA,"anticoncepcion, prevencion de its y de cancer de cuello uterino",pildora: usuarias continuas,2015-01-01,0,0,4,0,0,4
TOLEDO,"anticoncepcion, prevencion de its y de cancer de cuello uterino",pildora: usuarias continuas,2015-01-01,0,0,1,0,0,1
TOMAVE,"anticoncepcion, prevencion de its y de cancer de cuello uterino",pildora: usuarias continuas,2015-01-01,0,0,1,0,0,1
TOMINA,"anticoncepcion, prevencion de its y de cancer de cuello uterino",pildora: usuarias continuas,2015-01-01,0,0,4,0,0,4
TRIGAL,"anticoncepcion, prevencion de its y de cancer de cuello uterino",pildora: usuarias continuas,2015-01-01,0,1,0,1,0,2
TRINIDAD,"anticoncepcion, prevencion de its y de cancer de cuello uterino",pildora: usuarias continuas,2015-01-01,0,0,62,17,1,80
TUPIZA,"anticoncepcion, prevencion de its y de cancer de cuello uterino",pildora: usuarias continuas,2015-01-01,0,0,10,2,0,12
TURCO,"anticoncepcion, prevencion de its y de cancer de cuello uterino",pildora: usuarias continuas,2015-01-01,0,0,0,1,0,1
UMALA,"anticoncepcion, prevencion de its y de cancer de cuello uterino",pildora: usuarias continuas,2015-01-01,0,0,1,1,0,2
UNCIA,"anticoncepcion, prevencion de its y de cancer de cuello uterino",pildora: usuarias continuas,2015-01-01,0,0,0,2,0,2
URIONDO (A. CONCEPCION),"anticoncepcion, prevencion de its y de cancer de cuello uterino",pildora: usuarias continuas,2015-01-01,0,1,17,8,0,26
URUBICHA,"anticoncepcion, prevencion de its y de cancer de cuello uterino",pildora: usuarias continuas,2015-01-01,0,1,6,1,0,8
UYUNI,"anticoncepcion, prevencion de its y de cancer de cuello uterino",pildora: usuarias continuas,2015-01-01,0,1,8,1,0,10
VALLEGRANDE,"anticoncepcion, prevencion de its y de cancer de cuello uterino",pildora: usuarias continuas,2015-01-01,0,2,3,1,0,6
VIACHA,"anticoncepcion, prevencion de its y de cancer de cuello uterino",pildora: usuarias continuas,2015-01-01,0,0,1,4,0,5
VILLA CHARCAS,"anticoncepcion, prevencion de its y de cancer de cuello uterino",pildora: usuarias continuas,2015-01-01,0,1,5,3,0,9
VILLA MONTES,"anticoncepcion, prevencion de its y de cancer de cuello uterino",pildora: usuarias continuas,2015-01-01,0,4,19,6,0,29
VILLA NUEVA (LOMA ALTA),"anticoncepcion, prevencion de its y de cancer de cuello uterino",pildora: usuarias continuas,2015-01-01,0,0,3,1,0,4
VILLA RIVERO,"anticoncepcion, prevencion de its y de cancer de cuello uterino",pildora: usuarias continuas,2015-01-01,0,0,2,0,0,2
VILLA SERRANO,"anticoncepcion, prevencion de its y de cancer de cuello uterino",pildora: usuarias continuas,2015-01-01,0,0,1,1,0,2
VILLA TUNARI,"anticoncepcion, prevencion de its y de cancer de cuello uterino",pildora: usuarias continuas,2015-01-01,0,2,28,8,0,38
VILLA VACA GUZMAN (MUYUPAMPA),"anticoncepcion, prevencion de its y de cancer de cuello uterino",pildora: usuarias continuas,2015-01-01,0,0,17,2,0,19
VILLAZON,"anticoncepcion, prevencion de its y de cancer de cuello uterino",pildora: usuarias continuas,2015-01-01,0,0,13,4,0,17
VINTO,"anticoncepcion, prevencion de its y de cancer de cuello uterino",pildora: usuarias continuas,2015-01-01,0,0,5,1,0,6
VITICHI,"anticoncepcion, prevencion de its y de cancer de cuello uterino",pildora: usuarias continuas,2015-01-01,0,0,2,0,0,2
WARNES,"anticoncepcion, prevencion de its y de cancer de cuello uterino",pildora: usuarias continuas,2015-01-01,0,10,75,21,0,106
YACUIBA,"anticoncepcion, prevencion de its y de cancer de cuello uterino",pildora: usuarias continuas,2015-01-01,0,5,14,14,0,33
YANACACHI,"anticoncepcion, prevencion de its y de cancer de cuello uterino",pildora: usuarias continuas,2015-01-01,0,0,1,0,0,1
YAPACANI,"anticoncepcion, prevencion de its y de cancer de cuello uterino",pildora: usuarias continuas,2015-01-01,0,2,24,4,0,30
YOCALLA,"anticoncepcion, prevencion de its y de cancer de cuello uterino",pildora: usuarias continuas,2015-01-01,0,2,2,0,0,4
YOTALA,"anticoncepcion, prevencion de its y de cancer de cuello uterino",pildora: usuarias continuas,2015-01-01,0,0,1,0,0,1
YUNCHARA,"anticoncepcion, prevencion de its y de cancer de cuello uterino",pildora: usuarias continuas,2015-01-01,0,2,4,2,0,8
ZUDAÑEZ,"anticoncepcion, prevencion de its y de cancer de cuello uterino",pildora: usuarias continuas,2015-01-01,0,0,2,0,0,2
ACACIO,"anticoncepcion, prevencion de its y de cancer de cuello uterino",pildora: usuarias continuas,2015-02-01,0,0,1,0,0,1
ACHACACHI,"anticoncepcion, prevencion de its y de cancer de cuello uterino",pildora: usuarias continuas,2015-02-01,0,0,2,0,0,2
ACHOCALLA,"anticoncepcion, prevencion de its y de cancer de cuello uterino",pildora: usuarias continuas,2015-02-01,0,0,7,5,0,12
AIQUILE,"anticoncepcion, prevencion de its y de cancer de cuello uterino",pildora: usuarias continuas,2015-02-01,0,0,1,0,0,1
ALCALA,"anticoncepcion, prevencion de its y de cancer de cuello uterino",pildora: usuarias continuas,2015-02-01,0,0,0,1,0,1
ALTO BENI,"anticoncepcion, prevencion de its y de cancer de cuello uterino",pildora: usuarias continuas,2015-02-01,0,1,6,2,0,9
ANCORAIMES,"anticoncepcion, prevencion de its y de cancer de cuello uterino",pildora: usuarias continuas,2015-02-01,0,0,2,1,0,3
ANDAMARCA,"anticoncepcion, prevencion de its y de cancer de cuello uterino",pildora: usuarias continuas,2015-02-01,0,0,1,0,0,1
APOLO,"anticoncepcion, prevencion de its y de cancer de cuello uterino",pildora: usuarias continuas,2015-02-01,0,0,6,0,0,6
ARAMPAMPA,"anticoncepcion, prevencion de its y de cancer de cuello uterino",pildora: usuarias continuas,2015-02-01,0,0,0,1,0,1
ARANI,"anticoncepcion, prevencion de its y de cancer de cuello uterino",pildora: usuarias continuas,2015-02-01,0,0,2,5,0,7
ARBIETO,"anticoncepcion, prevencion de its y de cancer de cuello uterino",pildora: usuarias continuas,2015-02-01,0,0,5,2,0,7
ARQUE,"anticoncepcion, prevencion de its y de cancer de cuello uterino",pildora: usuarias continuas,2015-02-01,0,1,1,1,0,3
ASCENCION DE GUARAYOS,"anticoncepcion, prevencion de its y de cancer de cuello uterino",pildora: usuarias continuas,2015-02-01,0,2,10,1,0,13
ATOCHA,"anticoncepcion, prevencion de its y de cancer de cuello uterino",pildora: usuarias continuas,2015-02-01,0,0,7,2,0,9
AUCAPATA,"anticoncepcion, prevencion de its y de cancer de cuello uterino",pildora: usuarias continuas,2015-02-01,0,0,1,0,0,1
AYATA,"anticoncepcion, prevencion de its y de cancer de cuello uterino",pildora: usuarias continuas,2015-02-01,0,0,3,2,0,5
AYOPAYA (V. DE INDEPENDENCIA),"anticoncepcion, prevencion de its y de cancer de cuello uterino",pildora: usuarias continuas,2015-02-01,0,2,11,5,0,18
AZURDUY,"anticoncepcion, prevencion de its y de cancer de cuello uterino",pildora: usuarias continuas,2015-02-01,1,0,0,1,0,2
BATALLAS,"anticoncepcion, prevencion de its y de cancer de cuello uterino",pildora: usuarias continuas,2015-02-01,0,0,5,2,0,7
BAURES,"anticoncepcion, prevencion de its y de cancer de cuello uterino",pildora: usuarias continuas,2015-02-01,0,0,11,4,0,15
BELLA FLOR,"anticoncepcion, prevencion de its y de cancer de cuello uterino",pildora: usuarias continuas,2015-02-01,0,3,4,1,0,8
BERMEJO,"anticoncepcion, prevencion de its y de cancer de cuello uterino",pildora: usuarias continuas,2015-02-01,0,0,4,1,0,5
BETANZOS,"anticoncepcion, prevencion de its y de cancer de cuello uterino",pildora: usuarias continuas,2015-02-01,0,0,3,2,0,5
BOLIVAR,"anticoncepcion, prevencion de its y de cancer de cuello uterino",pildora: usuarias continuas,2015-02-01,0,0,1,0,0,1
BOLPEBRA,"anticoncepcion, prevencion de its y de cancer de cuello uterino",pildora: usuarias continuas,2015-02-01,0,0,2,0,0,2
BOYUIBE,"anticoncepcion, prevencion de its y de cancer de cuello uterino",pildora: usuarias continuas,2015-02-01,0,0,1,1,0,2
BUENA VISTA,"anticoncepcion, prevencion de its y de cancer de cuello uterino",pildora: usuarias continuas,2015-02-01,0,1,14,7,1,23
CABEZAS,"anticoncepcion, prevencion de its y de cancer de cuello uterino",pildora: usuarias continuas,2015-02-01,1,4,15,9,0,29
"CAIZA ""D""","anticoncepcion, prevencion de its y de cancer de cuello uterino",pildora: usuarias continuas,2015-02-01,0,0,3,0,0,3
CAJUATA,"anticoncepcion, prevencion de its y de cancer de cuello uterino",pildora: usuarias continuas,2015-02-01,0,0,2,0,0,2
CALAMARCA,"anticoncepcion, prevencion de its y de cancer de cuello uterino",pildora: usuarias continuas,2015-02-01,0,0,6,3,0,9
CAMARGO,"anticoncepcion, prevencion de its y de cancer de cuello uterino",pildora: usuarias continuas,2015-02-01,0,0,2,0,1,3
CAMATAQUI (C. VILLA ABECIA),"anticoncepcion, prevencion de its y de cancer de cuello uterino",pildora: usuarias continuas,2015-02-01,0,0,0,1,0,1
CAMIRI,"anticoncepcion, prevencion de its y de cancer de cuello uterino",pildora: usuarias continuas,2015-02-01,0,0,7,1,0,8
CAPINOTA,"anticoncepcion, prevencion de its y de cancer de cuello uterino",pildora: usuarias continuas,2015-02-01,0,0,6,1,0,7
CARACOLLO,"anticoncepcion, prevencion de its y de cancer de cuello uterino",pildora: usuarias continuas,2015-02-01,0,0,6,0,0,6
CARANAVI,"anticoncepcion, prevencion de its y de cancer de cuello uterino",pildora: usuarias continuas,2015-02-01,0,1,8,3,0,12
CARANGAS,"anticoncepcion, prevencion de its y de cancer de cuello uterino",pildora: usuarias continuas,2015-02-01,0,0,1,0,0,1
CARAPARI,"anticoncepcion, prevencion de its y de cancer de cuello uterino",pildora: usuarias continuas,2015-02-01,0,0,17,2,0,19
CARIPUYO,"anticoncepcion, prevencion de its y de cancer de cuello uterino",pildora: usuarias continuas,2015-02-01,0,0,1,0,0,1
CATACORA,"anticoncepcion, prevencion de its y de cancer de cuello uterino",pildora: usuarias continuas,2015-02-01,0,0,1,0,0,1
CHACARILLA,"anticoncepcion, prevencion de its y de cancer de cuello uterino",pildora: usuarias continuas,2015-02-01,0,0,0,0,1,1
CHAQUI,"anticoncepcion, prevencion de its y de cancer de cuello uterino",pildora: usuarias continuas,2015-02-01,0,0,0,1,0,1
CHARAGUA,"anticoncepcion, prevencion de its y de cancer de cuello uterino",pildora: usuarias continuas,2015-02-01,0,0,12,4,0,16
CHAYANTA,"anticoncepcion, prevencion de its y de cancer de cuello uterino",pildora: usuarias continuas,2015-02-01,0,0,1,0,0,1
CHIMORE,"anticoncepcion, prevencion de its y de cancer de cuello uterino",pildora: usuarias continuas,2015-02-01,0,2,6,3,0,11
CHUA COCANI,"anticoncepcion, prevencion de its y de cancer de cuello uterino",pildora: usuarias continuas,2015-02-01,0,0,1,0,0,1
CHULUMANI (V. DE LA LIBERTAD),"anticoncepcion, prevencion de its y de cancer de cuello uterino",pildora: usuarias continuas,2015-02-01,0,1,3,0,0,4
CHUMA,"anticoncepcion, prevencion de its y de cancer de cuello uterino",pildora: usuarias continuas,2015-02-01,0,2,1,5,0,8
CHUQUIHUTA AYLLU JUCUMANI,"anticoncepcion, prevencion de its y de cancer de cuello uterino",pildora: usuarias continuas,2015-02-01,0,0,4,2,0,6
CKOCHAS,"anticoncepcion, prevencion de its y de cancer de cuello uterino",pildora: usuarias continuas,2015-02-01,0,0,0,1,0,1
CLIZA,"anticoncepcion, prevencion de its y de cancer de cuello uterino",pildora: usuarias continuas,2015-02-01,0,0,7,2,0,9
COBIJA,"anticoncepcion, prevencion de its y de cancer de cuello uterino",pildora: usuarias continuas,2015-02-01,0,3,39,6,0,48
COCAPATA,"anticoncepcion, prevencion de its y de cancer de cuello uterino",pildora: usuarias continuas,2015-02-01,0,1,1,0,0,2
COCHABAMBA,"anticoncepcion, prevencion de its y de cancer de cuello uterino",pildora: usuarias continuas,2015-02-01,0,5,77,29,0,111
COIPASA,"anticoncepcion, prevencion de its y de cancer de cuello uterino",pildora: usuarias continuas,2015-02-01,0,0,2,0,0,2
COLCAPIRHUA,"anticoncepcion, prevencion de its y de cancer de cuello uterino",pildora: usuarias continuas,2015-02-01,0,1,3,4,1,9
"COLCHA ""K""","anticoncepcion, prevencion de its y de cancer de cuello uterino",pildora: usuarias continuas,2015-02-01,0,0,1,0,0,1
COLLANA,"anticoncepcion, prevencion de its y de cancer de cuello uterino",pildora: usuarias continuas,2015-02-01,0,0,1,0,0,1
COLOMI,"anticoncepcion, prevencion de its y de cancer de cuello uterino",pildora: usuarias continuas,2015-02-01,0,1,6,1,0,8
COLPA BELGICA,"anticoncepcion, prevencion de its y de cancer de cuello uterino",pildora: usuarias continuas,2015-02-01,0,0,10,2,0,12
COLQUECHACA,"anticoncepcion, prevencion de its y de cancer de cuello uterino",pildora: usuarias continuas,2015-02-01,0,0,1,0,0,1
COLQUENCHA,"anticoncepcion, prevencion de its y de cancer de cuello uterino",pildora: usuarias continuas,2015-02-01,0,0,1,2,1,4
COMANCHE,"anticoncepcion, prevencion de its y de cancer de cuello uterino",pildora: usuarias continuas,2015-02-01,0,0,1,0,0,1
COMARAPA,"anticoncepcion, prevencion de its y de cancer de cuello uterino",pildora: usuarias continuas,2015-02-01,0,1,4,2,0,7
CONCEPCION,"anticoncepcion, prevencion de its y de cancer de cuello uterino",pildora: usuarias continuas,2015-02-01,0,0,3,4,0,7
COPACABANA,"anticoncepcion, prevencion de its y de cancer de cuello uterino",pildora: usuarias continuas,2015-02-01,0,0,1,1,0,2
CORO CORO,"anticoncepcion, prevencion de its y de cancer de cuello uterino",pildora: usuarias continuas,2015-02-01,0,0,3,0,0,3
COROICO,"anticoncepcion, prevencion de its y de cancer de cuello uterino",pildora: usuarias continuas,2015-02-01,0,0,2,5,0,7
COTAGAITA,"anticoncepcion, prevencion de its y de cancer de cuello uterino",pildora: usuarias continuas,2015-02-01,0,0,1,2,0,3
COTOCA,"anticoncepcion, prevencion de its y de cancer de cuello uterino",pildora: usuarias continuas,2015-02-01,0,1,20,4,0,25
CUATRO CAÑADAS,"anticoncepcion, prevencion de its y de cancer de cuello uterino",pildora: usuarias continuas,2015-02-01,0,0,16,0,0,16
CUEVO,"anticoncepcion, prevencion de its y de cancer de cuello uterino",pildora: usuarias continuas,2015-02-01,0,1,7,2,0,10
CULPINA,"anticoncepcion, prevencion de its y de cancer de cuello uterino",pildora: usuarias continuas,2015-02-01,0,0,6,1,0,7
DESAGUADERO,"anticoncepcion, prevencion de its y de cancer de cuello uterino",pildora: usuarias continuas,2015-02-01,0,0,2,0,0,2
EL ALTO,"anticoncepcion, prevencion de its y de cancer de cuello uterino",pildora: usuarias continuas,2015-02-01,0,10,149,45,1,205
EL PUENTE(STC),"anticoncepcion, prevencion de its y de cancer de cuello uterino",pildora: usuarias continuas,2015-02-01,0,2,16,6,0,24
EL PUENTE(TJA),"anticoncepcion, prevencion de its y de cancer de cuello uterino",pildora: usuarias continuas,2015-02-01,0,0,14,3,0,17
EL TORNO,"anticoncepcion, prevencion de its y de cancer de cuello uterino",pildora: usuarias continuas,2015-02-01,1,6,44,9,0,60
EL VILLAR,"anticoncepcion, prevencion de its y de cancer de cuello uterino",pildora: usuarias continuas,2015-02-01,0,0,4,1,0,5
ENTRE RIOS TRJ,"anticoncepcion, prevencion de its y de cancer de cuello uterino",pildora: usuarias continuas,2015-02-01,0,3,20,4,0,27
ENTRE RIOS CBBA,"anticoncepcion, prevencion de its y de cancer de cuello uterino",pildora: usuarias continuas,2015-02-01,0,0,16,5,0,21
EUREKA (SANTOS MERCADO),"anticoncepcion, prevencion de its y de cancer de cuello uterino",pildora: usuarias continuas,2015-02-01,0,0,2,0,0,2
EXALTACION,"anticoncepcion, prevencion de its y de cancer de cuello uterino",pildora: usuarias continuas,2015-02-01,0,1,2,0,0,3
FERNANDEZ ALONSO,"anticoncepcion, prevencion de its y de cancer de cuello uterino",pildora: usuarias continuas,2015-02-01,0,1,35,2,0,38
FILADELFIA,"anticoncepcion, prevencion de its y de cancer de cuello uterino",pildora: usuarias continuas,2015-02-01,0,3,10,3,0,16
GENERAL SAAVEDRA,"anticoncepcion, prevencion de its y de cancer de cuello uterino",pildora: usuarias continuas,2015-02-01,0,0,18,5,0,23
GUANAY,"anticoncepcion, prevencion de its y de cancer de cuello uterino",pildora: usuarias continuas,2015-02-01,0,0,0,1,0,1
GUAQUI,"anticoncepcion, prevencion de its y de cancer de cuello uterino",pildora: usuarias continuas,2015-02-01,0,0,0,1,0,1
GUAYARAMERIN,"anticoncepcion, prevencion de its y de cancer de cuello uterino",pildora: usuarias continuas,2015-02-01,0,0,2,0,0,2
GUTIERREZ,"anticoncepcion, prevencion de its y de cancer de cuello uterino",pildora: usuarias continuas,2015-02-01,0,0,1,1,0,2
HUACARETA,"anticoncepcion, prevencion de its y de cancer de cuello uterino",pildora: usuarias continuas,2015-02-01,0,2,8,9,1,20
HUACAYA (VILLA DE HUACAYA),"anticoncepcion, prevencion de its y de cancer de cuello uterino",pildora: usuarias continuas,2015-02-01,0,1,0,0,0,1
HUACHACALLA,"anticoncepcion, prevencion de its y de cancer de cuello uterino",pildora: usuarias continuas,2015-02-01,0,0,1,0,0,1
HUANUNI,"anticoncepcion, prevencion de its y de cancer de cuello uterino",pildora: usuarias continuas,2015-02-01,0,0,1,1,0,2
HUARACAJE,"anticoncepcion, prevencion de its y de cancer de cuello uterino",pildora: usuarias continuas,2015-02-01,0,0,22,2,0,24
HUARINA,"anticoncepcion, prevencion de its y de cancer de cuello uterino",pildora: usuarias continuas,2015-02-01,0,0,0,1,0,1
HUATAJATA,"anticoncepcion, prevencion de its y de cancer de cuello uterino",pildora: usuarias continuas,2015-02-01,0,0,1,1,0,2
HUAYLLAMARCA,"anticoncepcion, prevencion de its y de cancer de cuello uterino",pildora: usuarias continuas,2015-02-01,0,0,1,0,0,1
HUMANATA,"anticoncepcion, prevencion de its y de cancer de cuello uterino",pildora: usuarias continuas,2015-02-01,0,0,3,0,0,3
ICLA,"anticoncepcion, prevencion de its y de cancer de cuello uterino",pildora: usuarias continuas,2015-02-01,0,0,1,4,0,5
INCAHUASI,"anticoncepcion, prevencion de its y de cancer de cuello uterino",pildora: usuarias continuas,2015-02-01,0,0,2,3,0,5
INGAVI (HUMAITA),"anticoncepcion, prevencion de its y de cancer de cuello uterino",pildora: usuarias continuas,2015-02-01,0,1,2,1,0,4
INQUISIVI,"anticoncepcion, prevencion de its y de cancer de cuello uterino",pildora: usuarias continuas,2015-02-01,0,0,0,1,0,1
IRUPANA (VILLA DE LANZA),"anticoncepcion, prevencion de its y de cancer de cuello uterino",pildora: usuarias continuas,2015-02-01,0,1,11,6,0,18
IXIAMAS,"anticoncepcion, prevencion de its y de cancer de cuello uterino",pildora: usuarias continuas,2015-02-01,0,6,14,1,0,21
JESUS DE MACHACA,"anticoncepcion, prevencion de its y de cancer de cuello uterino",pildora: usuarias continuas,2015-02-01,0,0,1,1,0,2
LA ASUNTA,"anticoncepcion, prevencion de its y de cancer de cuello uterino",pildora: usuarias continuas,2015-02-01,0,5,15,3,0,23
LA GUARDIA,"anticoncepcion, prevencion de its y de cancer de cuello uterino",pildora: usuarias continuas,2015-02-01,0,2,21,11,0,34
LA PAZ,"anticoncepcion, prevencion de its y de cancer de cuello uterino",pildora: usuarias continuas,2015-02-01,0,1,126,23,0,150
LAGUNILLAS,"anticoncepcion, prevencion de its y de cancer de cuello uterino",pildora: usuarias continuas,2015-02-01,0,0,7,0,0,7
LAJA,"anticoncepcion, prevencion de its y de cancer de cuello uterino",pildora: usuarias continuas,2015-02-01,0,0,11,1,0,12
LICOMA PAMPA,"anticoncepcion, prevencion de its y de cancer de cuello uterino",pildora: usuarias continuas,2015-02-01,0,0,2,1,0,3
LLALLAGUA,"anticoncepcion, prevencion de its y de cancer de cuello uterino",pildora: usuarias continuas,2015-02-01,0,0,3,1,0,4
LLICA,"anticoncepcion, prevencion de its y de cancer de cuello uterino",pildora: usuarias continuas,2015-02-01,0,3,4,2,0,9
LORETO,"anticoncepcion, prevencion de its y de cancer de cuello uterino",pildora: usuarias continuas,2015-02-01,0,1,2,20,0,23
LURIBAY,"anticoncepcion, prevencion de its y de cancer de cuello uterino",pildora: usuarias continuas,2015-02-01,0,0,1,0,0,1
MACHARETI,"anticoncepcion, prevencion de its y de cancer de cuello uterino",pildora: usuarias continuas,2015-02-01,0,3,9,4,0,16
MAGDALENA,"anticoncepcion, prevencion de its y de cancer de cuello uterino",pildora: usuarias continuas,2015-02-01,0,6,38,13,1,58
MAIRANA,"anticoncepcion, prevencion de its y de cancer de cuello uterino",pildora: usuarias continuas,2015-02-01,0,3,0,1,0,4
MECAPACA,"anticoncepcion, prevencion de its y de cancer de cuello uterino",pildora: usuarias continuas,2015-02-01,0,0,3,2,0,5
MINEROS,"anticoncepcion, prevencion de its y de cancer de cuello uterino",pildora: usuarias continuas,2015-02-01,0,0,14,7,0,21
MIZQUE,"anticoncepcion, prevencion de its y de cancer de cuello uterino",pildora: usuarias continuas,2015-02-01,0,0,5,4,0,9
MOCOMOCO,"anticoncepcion, prevencion de its y de cancer de cuello uterino",pildora: usuarias continuas,2015-02-01,0,1,3,0,0,4
MOJINETE,"anticoncepcion, prevencion de its y de cancer de cuello uterino",pildora: usuarias continuas,2015-02-01,0,0,1,0,0,1
MOJOCOYA,"anticoncepcion, prevencion de its y de cancer de cuello uterino",pildora: usuarias continuas,2015-02-01,0,0,3,1,0,4
MONTEAGUDO,"anticoncepcion, prevencion de its y de cancer de cuello uterino",pildora: usuarias continuas,2015-02-01,0,2,11,2,0,15
MONTERO,"anticoncepcion, prevencion de its y de cancer de cuello uterino",pildora: usuarias continuas,2015-02-01,2,6,27,20,0,55
MORO MORO,"anticoncepcion, prevencion de its y de cancer de cuello uterino",pildora: usuarias continuas,2015-02-01,0,1,1,1,0,3
MOROCHATA,"anticoncepcion, prevencion de its y de cancer de cuello uterino",pildora: usuarias continuas,2015-02-01,0,0,3,0,0,3
NACEBE (SANTA ROSA DEL ABUNA),"anticoncepcion, prevencion de its y de cancer de cuello uterino",pildora: usuarias continuas,2015-02-01,0,0,1,2,0,3
OCURI,"anticoncepcion, prevencion de its y de cancer de cuello uterino",pildora: usuarias continuas,2015-02-01,0,0,1,0,0,1
OKINAWA,"anticoncepcion, prevencion de its y de cancer de cuello uterino",pildora: usuarias continuas,2015-02-01,0,0,14,4,0,18
OMEREQUE,"anticoncepcion, prevencion de its y de cancer de cuello uterino",pildora: usuarias continuas,2015-02-01,0,0,4,1,0,5
ORURO,"anticoncepcion, prevencion de its y de cancer de cuello uterino",pildora: usuarias continuas,2015-02-01,0,6,63,9,0,78
PADCAYA,"anticoncepcion, prevencion de its y de cancer de cuello uterino",pildora: usuarias continuas,2015-02-01,0,3,18,7,0,28
PADILLA,"anticoncepcion, prevencion de its y de cancer de cuello uterino",pildora: usuarias continuas,2015-02-01,0,1,10,3,0,14
PAILON,"anticoncepcion, prevencion de its y de cancer de cuello uterino",pildora: usuarias continuas,2015-02-01,0,1,12,0,0,13
PALOS BLANCOS,"anticoncepcion, prevencion de its y de cancer de cuello uterino",pildora: usuarias continuas,2015-02-01,0,1,12,4,0,17
PAMPA GRANDE,"anticoncepcion, prevencion de its y de cancer de cuello uterino",pildora: usuarias continuas,2015-02-01,0,0,4,2,1,7
PASORAPA,"anticoncepcion, prevencion de its y de cancer de cuello uterino",pildora: usuarias continuas,2015-02-01,0,0,1,0,0,1
PAZÑA,"anticoncepcion, prevencion de its y de cancer de cuello uterino",pildora: usuarias continuas,2015-02-01,0,0,2,0,0,2
PELECHUCO,"anticoncepcion, prevencion de its y de cancer de cuello uterino",pildora: usuarias continuas,2015-02-01,0,1,6,1,0,8
POCOATA,"anticoncepcion, prevencion de its y de cancer de cuello uterino",pildora: usuarias continuas,2015-02-01,0,0,5,1,0,6
POCONA,"anticoncepcion, prevencion de its y de cancer de cuello uterino",pildora: usuarias continuas,2015-02-01,0,0,3,2,0,5
POJO (CBBA),"anticoncepcion, prevencion de its y de cancer de cuello uterino",pildora: usuarias continuas,2015-02-01,0,2,3,2,0,7
POOPO,"anticoncepcion, prevencion de its y de cancer de cuello uterino",pildora: usuarias continuas,2015-02-01,0,0,1,0,0,1
PORCO,"anticoncepcion, prevencion de its y de cancer de cuello uterino",pildora: usuarias continuas,2015-02-01,0,0,3,0,0,3
POROMA,"anticoncepcion, prevencion de its y de cancer de cuello uterino",pildora: usuarias continuas,2015-02-01,0,0,2,3,0,5
PORONGO,"anticoncepcion, prevencion de its y de cancer de cuello uterino",pildora: usuarias continuas,2015-02-01,0,3,12,9,0,24
PORTACHUELO,"anticoncepcion, prevencion de its y de cancer de cuello uterino",pildora: usuarias continuas,2015-02-01,0,9,19,19,0,47
PORVENIR,"anticoncepcion, prevencion de its y de cancer de cuello uterino",pildora: usuarias continuas,2015-02-01,1,1,11,1,0,14
POSTRER VALLE,"anticoncepcion, prevencion de its y de cancer de cuello uterino",pildora: usuarias continuas,2015-02-01,0,0,4,0,0,4
POTOSI,"anticoncepcion, prevencion de its y de cancer de cuello uterino",pildora: usuarias continuas,2015-02-01,0,13,75,16,0,104
PRESTO,"anticoncepcion, prevencion de its y de cancer de cuello uterino",pildora: usuarias continuas,2015-02-01,0,0,1,1,0,2
PUCARA,"anticoncepcion, prevencion de its y de cancer de cuello uterino",pildora: usuarias continuas,2015-02-01,0,0,1,0,0,1
PUCARANI,"anticoncepcion, prevencion de its y de cancer de cuello uterino",pildora: usuarias continuas,2015-02-01,0,0,2,0,0,2
PUERTO CARABUCO,"anticoncepcion, prevencion de its y de cancer de cuello uterino",pildora: usuarias continuas,2015-02-01,0,0,0,2,0,2
PUERTO GONZALO MORENO,"anticoncepcion, prevencion de its y de cancer de cuello uterino",pildora: usuarias continuas,2015-02-01,0,1,3,2,0,6
PUERTO QUIJARRO,"anticoncepcion, prevencion de its y de cancer de cuello uterino",pildora: usuarias continuas,2015-02-01,0,0,6,1,0,7
PUERTO RICO,"anticoncepcion, prevencion de its y de cancer de cuello uterino",pildora: usuarias continuas,2015-02-01,0,2,7,4,0,13
PUERTO SILES,"anticoncepcion, prevencion de its y de cancer de cuello uterino",pildora: usuarias continuas,2015-02-01,0,3,3,1,0,7
PUERTO SUAREZ,"anticoncepcion, prevencion de its y de cancer de cuello uterino",pildora: usuarias continuas,2015-02-01,0,3,5,2,0,10
PUERTO VILLARROEL,"anticoncepcion, prevencion de its y de cancer de cuello uterino",pildora: usuarias continuas,2015-02-01,0,0,8,3,0,11
PUNA,"anticoncepcion, prevencion de its y de cancer de cuello uterino",pildora: usuarias continuas,2015-02-01,0,0,6,2,0,8
PUNATA,"anticoncepcion, prevencion de its y de cancer de cuello uterino",pildora: usuarias continuas,2015-02-01,0,0,3,1,0,4
QUIABAYA,"anticoncepcion, prevencion de its y de cancer de cuello uterino",pildora: usuarias continuas,2015-02-01,0,0,0,1,0,1
QUILLACOLLO,"anticoncepcion, prevencion de its y de cancer de cuello uterino",pildora: usuarias continuas,2015-02-01,0,0,8,1,0,9
QUIME,"anticoncepcion, prevencion de its y de cancer de cuello uterino",pildora: usuarias continuas,2015-02-01,0,1,9,4,0,14
QUIRUSILLAS,"anticoncepcion, prevencion de its y de cancer de cuello uterino",pildora: usuarias continuas,2015-02-01,0,0,2,1,0,3
RAVELO,"anticoncepcion, prevencion de its y de cancer de cuello uterino",pildora: usuarias continuas,2015-02-01,0,0,0,1,0,1
REYES,"anticoncepcion, prevencion de its y de cancer de cuello uterino",pildora: usuarias continuas,2015-02-01,0,2,13,2,0,17
RIBERALTA,"anticoncepcion, prevencion de its y de cancer de cuello uterino",pildora: usuarias continuas,2015-02-01,0,5,25,3,0,33
ROBORE,"anticoncepcion, prevencion de its y de cancer de cuello uterino",pildora: usuarias continuas,2015-02-01,0,0,11,9,0,20
RURRENABAQUE,"anticoncepcion, prevencion de its y de cancer de cuello uterino",pildora: usuarias continuas,2015-02-01,0,1,9,6,0,16
SACABA,"anticoncepcion, prevencion de its y de cancer de cuello uterino",pildora: usuarias continuas,2015-02-01,0,3,16,2,0,21
SAIPINA,"anticoncepcion, prevencion de its y de cancer de cuello uterino",pildora: usuarias continuas,2015-02-01,0,3,0,0,0,3
SALINAS DE GARCI MENDOZA,"anticoncepcion, prevencion de its y de cancer de cuello uterino",pildora: usuarias continuas,2015-02-01,0,0,4,0,0,4
SAMAIPATA,"anticoncepcion, prevencion de its y de cancer de cuello uterino",pildora: usuarias continuas,2015-02-01,0,1,3,6,0,10
SAN ANDRES,"anticoncepcion, prevencion de its y de cancer de cuello uterino",pildora: usuarias continuas,2015-02-01,0,1,22,3,0,26
SAN ANTONIO DE LOMERIO,"anticoncepcion, prevencion de its y de cancer de cuello uterino",pildora: usuarias continuas,2015-02-01,0,0,10,7,0,17
SAN BORJA,"anticoncepcion, prevencion de its y de cancer de cuello uterino",pildora: usuarias continuas,2015-02-01,0,5,34,23,0,62
SAN BUENA VENTURA,"anticoncepcion, prevencion de its y de cancer de cuello uterino",pildora: usuarias continuas,2015-02-01,0,0,5,0,0,5
SAN CARLOS,"anticoncepcion, prevencion de its y de cancer de cuello uterino",pildora: usuarias continuas,2015-02-01,0,4,18,5,0,27
SAN IGNACIO,"anticoncepcion, prevencion de its y de cancer de cuello uterino",pildora: usuarias continuas,2015-02-01,4,7,78,34,0,123
SAN IGNACIO DE VELASCO,"anticoncepcion, prevencion de its y de cancer de cuello uterino",pildora: usuarias continuas,2015-02-01,1,5,46,21,0,73
SAN JAVIER(BNI),"anticoncepcion, prevencion de its y de cancer de cuello uterino",pildora: usuarias continuas,2015-02-01,0,0,1,0,0,1
SAN JAVIER(STC),"anticoncepcion, prevencion de its y de cancer de cuello uterino",pildora: usuarias continuas,2015-02-01,0,1,12,7,0,20
SAN JOSE DE CHIQUITOS,"anticoncepcion, prevencion de its y de cancer de cuello uterino",pildora: usuarias continuas,2015-02-01,0,1,10,8,1,20
SAN JUAN DE YAPACANI,"anticoncepcion, prevencion de its y de cancer de cuello uterino",pildora: usuarias continuas,2015-02-01,0,6,7,0,0,13
SAN JULIAN,"anticoncepcion, prevencion de its y de cancer de cuello uterino",pildora: usuarias continuas,2015-02-01,2,3,14,6,1,26
SAN LORENZO(PND),"anticoncepcion, prevencion de its y de cancer de cuello uterino",pildora: usuarias continuas,2015-02-01,0,0,3,1,0,4
SAN LORENZO(TJA),"anticoncepcion, prevencion de its y de cancer de cuello uterino",pildora: usuarias continuas,2015-02-01,0,2,16,2,0,20
SAN LUCAS,"anticoncepcion, prevencion de its y de cancer de cuello uterino",pildora: usuarias continuas,2015-02-01,0,0,1,4,0,5
SAN MATIAS,"anticoncepcion, prevencion de its y de cancer de cuello uterino",pildora: usuarias continuas,2015-02-01,0,1,15,6,0,22
SAN MIGUEL DE VELASCO,"anticoncepcion, prevencion de its y de cancer de cuello uterino",pildora: usuarias continuas,2015-02-01,0,2,16,12,0,30
SAN PEDRO,"anticoncepcion, prevencion de its y de cancer de cuello uterino",pildora: usuarias continuas,2015-02-01,0,2,7,1,0,10
SAN PEDRO DE BUENA VISTA,"anticoncepcion, prevencion de its y de cancer de cuello uterino",pildora: usuarias continuas,2015-02-01,0,0,6,5,0,11
SAN PEDRO DE CURAHUARA,"anticoncepcion, prevencion de its y de cancer de cuello uterino",pildora: usuarias continuas,2015-02-01,0,0,3,3,0,6
SAN PEDRO DE QUEMES,"anticoncepcion, prevencion de its y de cancer de cuello uterino",pildora: usuarias continuas,2015-02-01,0,0,1,1,0,2
SAN PEDRO DE TIQUINA,"anticoncepcion, prevencion de its y de cancer de cuello uterino",pildora: usuarias continuas,2015-02-01,0,0,1,0,0,1
SAN RAFAEL,"anticoncepcion, prevencion de its y de cancer de cuello uterino",pildora: usuarias continuas,2015-02-01,1,3,18,10,0,32
SAN RAMON BENI,"anticoncepcion, prevencion de its y de cancer de cuello uterino",pildora: usuarias continuas,2015-02-01,0,1,9,2,0,12
SAN RAMON SCZ,"anticoncepcion, prevencion de its y de cancer de cuello uterino",pildora: usuarias continuas,2015-02-01,0,0,2,3,0,5
SANTA ANA,"anticoncepcion, prevencion de its y de cancer de cuello uterino",pildora: usuarias continuas,2015-02-01,0,1,17,10,0,28
SANTA CRUZ DE LA SIERRA,"anticoncepcion, prevencion de its y de cancer de cuello uterino",pildora: usuarias continuas,2015-02-01,1,76,201,37,0,315
SANTA ROSA,"anticoncepcion, prevencion de its y de cancer de cuello uterino",pildora: usuarias continuas,2015-02-01,0,0,3,1,0,4
SANTA ROSA DEL SARA,"anticoncepcion, prevencion de its y de cancer de cuello uterino",pildora: usuarias continuas,2015-02-01,0,3,24,4,0,31
SANTIAGO DE HUARI,"anticoncepcion, prevencion de its y de cancer de cuello uterino",pildora: usuarias continuas,2015-02-01,0,0,1,1,0,2
SANTIAGO DE HUATA,"anticoncepcion, prevencion de its y de cancer de cuello uterino",pildora: usuarias continuas,2015-02-01,0,0,0,1,0,1
SANTIVAÑES,"anticoncepcion, prevencion de its y de cancer de cuello uterino",pildora: usuarias continuas,2015-02-01,0,0,2,2,0,4
SANTUARIO DE QUILLACAS,"anticoncepcion, prevencion de its y de cancer de cuello uterino",pildora: usuarias continuas,2015-02-01,0,0,1,0,0,1
SAPAHAQUI,"anticoncepcion, prevencion de its y de cancer de cuello uterino",pildora: usuarias continuas,2015-02-01,0,0,4,1,0,5
SENA,"anticoncepcion, prevencion de its y de cancer de cuello uterino",pildora: usuarias continuas,2015-02-01,0,0,1,1,0,2
SHINAOTA,"anticoncepcion, prevencion de its y de cancer de cuello uterino",pildora: usuarias continuas,2015-02-01,0,1,1,1,0,3
SICA SICA (VILLA AROMA),"anticoncepcion, prevencion de its y de cancer de cuello uterino",pildora: usuarias continuas,2015-02-01,0,5,4,1,0,10
SIPE SIPE,"anticoncepcion, prevencion de its y de cancer de cuello uterino",pildora: usuarias continuas,2015-02-01,0,0,6,3,0,9
SOPACHUY,"anticoncepcion, prevencion de its y de cancer de cuello uterino",pildora: usuarias continuas,2015-02-01,0,1,3,1,0,5
SORACACHI,"anticoncepcion, prevencion de its y de cancer de cuello uterino",pildora: usuarias continuas,2015-02-01,0,0,0,1,0,1
SORATA,"anticoncepcion, prevencion de its y de cancer de cuello uterino",pildora: usuarias continuas,2015-02-01,0,1,6,1,0,8
SUCRE,"anticoncepcion, prevencion de its y de cancer de cuello uterino",pildora: usuarias continuas,2015-02-01,0,8,90,20,0,118
TACACOMA,"anticoncepcion, prevencion de its y de cancer de cuello uterino",pildora: usuarias continuas,2015-02-01,0,0,3,1,0,4
TACOPAYA,"anticoncepcion, prevencion de its y de cancer de cuello uterino",pildora: usuarias continuas,2015-02-01,0,0,0,1,0,1
TAHUA,"anticoncepcion, prevencion de its y de cancer de cuello uterino",pildora: usuarias continuas,2015-02-01,0,1,2,2,0,5
TARABUCO,"anticoncepcion, prevencion de its y de cancer de cuello uterino",pildora: usuarias continuas,2015-02-01,0,0,0,1,0,1
TARACO,"anticoncepcion, prevencion de its y de cancer de cuello uterino",pildora: usuarias continuas,2015-02-01,0,1,0,1,0,2
TARATA,"anticoncepcion, prevencion de its y de cancer de cuello uterino",pildora: usuarias continuas,2015-02-01,0,0,2,0,0,2
TARIJA,"anticoncepcion, prevencion de its y de cancer de cuello uterino",pildora: usuarias continuas,2015-02-01,0,8,44,19,1,72
TARVITA,"anticoncepcion, prevencion de its y de cancer de cuello uterino",pildora: usuarias continuas,2015-02-01,0,3,3,2,0,8
TEOPONTE,"anticoncepcion, prevencion de its y de cancer de cuello uterino",pildora: usuarias continuas,2015-02-01,0,0,2,0,0,2
TIAWANACU,"anticoncepcion, prevencion de its y de cancer de cuello uterino",pildora: usuarias continuas,2015-02-01,0,0,7,2,0,9
TIPUANI,"anticoncepcion, prevencion de its y de cancer de cuello uterino",pildora: usuarias continuas,2015-02-01,0,0,4,3,0,7
TIQUIPAYA,"anticoncepcion, prevencion de its y de cancer de cuello uterino",pildora: usuarias continuas,2015-02-01,0,2,10,3,0,15
TIRAQUE (CBBA),"anticoncepcion, prevencion de its y de cancer de cuello uterino",pildora: usuarias continuas,2015-02-01,0,0,1,0,0,1
TOCO,"anticoncepcion, prevencion de its y de cancer de cuello uterino",pildora: usuarias continuas,2015-02-01,0,0,1,0,0,1
TOLATA,"anticoncepcion, prevencion de its y de cancer de cuello uterino",pildora: usuarias continuas,2015-02-01,0,0,1,1,0,2
TOLEDO,"anticoncepcion, prevencion de its y de cancer de cuello uterino",pildora: usuarias continuas,2015-02-01,0,0,2,0,0,2
TOMAVE,"anticoncepcion, prevencion de its y de cancer de cuello uterino",pildora: usuarias continuas,2015-02-01,0,0,0,2,0,2
TOMINA,"anticoncepcion, prevencion de its y de cancer de cuello uterino",pildora: usuarias continuas,2015-02-01,0,3,1,0,0,4
TORO TORO,"anticoncepcion, prevencion de its y de cancer de cuello uterino",pildora: usuarias continuas,2015-02-01,0,0,7,0,0,7
TOTORA(ORR),"anticoncepcion, prevencion de its y de cancer de cuello uterino",pildora: usuarias continuas,2015-02-01,0,1,1,0,0,2
TRIGAL,"anticoncepcion, prevencion de its y de cancer de cuello uterino",pildora: usuarias continuas,2015-02-01,0,1,4,0,0,5
TRINIDAD,"anticoncepcion, prevencion de its y de cancer de cuello uterino",pildora: usuarias continuas,2015-02-01,0,4,37,8,0,49
TUPIZA,"anticoncepcion, prevencion de its y de cancer de cuello uterino",pildora: usuarias continuas,2015-02-01,0,0,14,1,0,15
UNCIA,"anticoncepcion, prevencion de its y de cancer de cuello uterino",pildora: usuarias continuas,2015-02-01,0,0,2,0,0,2
URIONDO (A. CONCEPCION),"anticoncepcion, prevencion de its y de cancer de cuello uterino",pildora: usuarias continuas,2015-02-01,0,2,6,6,1,15
URUBICHA,"anticoncepcion, prevencion de its y de cancer de cuello uterino",pildora: usuarias continuas,2015-02-01,0,0,8,1,0,9
UYUNI,"anticoncepcion, prevencion de its y de cancer de cuello uterino",pildora: usuarias continuas,2015-02-01,0,0,2,2,0,4
VALLEGRANDE,"anticoncepcion, prevencion de its y de cancer de cuello uterino",pildora: usuarias continuas,2015-02-01,0,1,5,1,0,7
VIACHA,"anticoncepcion, prevencion de its y de cancer de cuello uterino",pildora: usuarias continuas,2015-02-01,0,1,5,1,0,7
VILLA CHARCAS,"anticoncepcion, prevencion de its y de cancer de cuello uterino",pildora: usuarias continuas,2015-02-01,0,2,7,2,0,11
VILLA MONTES,"anticoncepcion, prevencion de its y de cancer de cuello uterino",pildora: usuarias continuas,2015-02-01,0,3,14,6,0,23
VILLA NUEVA (LOMA ALTA),"anticoncepcion, prevencion de its y de cancer de cuello uterino",pildora: usuarias continuas,2015-02-01,0,0,3,0,0,3
VILLA SERRANO,"anticoncepcion, prevencion de its y de cancer de cuello uterino",pildora: usuarias continuas,2015-02-01,0,0,5,7,0,12
VILLA TUNARI,"anticoncepcion, prevencion de its y de cancer de cuello uterino",pildora: usuarias continuas,2015-02-01,0,3,24,8,0,35
VILLA VACA GUZMAN (MUYUPAMPA),"anticoncepcion, prevencion de its y de cancer de cuello uterino",pildora: usuarias continuas,2015-02-01,0,4,16,2,0,22
VILLAZON,"anticoncepcion, prevencion de its y de cancer de cuello uterino",pildora: usuarias continuas,2015-02-01,0,1,20,5,0,26
VINTO,"anticoncepcion, prevencion de its y de cancer de cuello uterino",pildora: usuarias continuas,2015-02-01,0,3,0,3,0,6
VITICHI,"anticoncepcion, prevencion de its y de cancer de cuello uterino",pildora: usuarias continuas,2015-02-01,0,0,1,1,0,2
WALDO BALLIVIAN,"anticoncepcion, prevencion de its y de cancer de cuello uterino",pildora: usuarias continuas,2015-02-01,0,0,1,1,0,2
WARNES,"anticoncepcion, prevencion de its y de cancer de cuello uterino",pildora: usuarias continuas,2015-02-01,0,11,52,12,0,75
YACUIBA,"anticoncepcion, prevencion de its y de cancer de cuello uterino",pildora: usuarias continuas,2015-02-01,0,1,14,8,0,23
YANACACHI,"anticoncepcion, prevencion de its y de cancer de cuello uterino",pildora: usuarias continuas,2015-02-01,0,1,4,0,0,5
YAPACANI,"anticoncepcion, prevencion de its y de cancer de cuello uterino",pildora: usuarias continuas,2015-02-01,0,0,13,4,1,18
YOCALLA,"anticoncepcion, prevencion de its y de cancer de cuello uterino",pildora: usuarias continuas,2015-02-01,0,0,2,0,0,2
YUNCHARA,"anticoncepcion, prevencion de its y de cancer de cuello uterino",pildora: usuarias continuas,2015-02-01,0,0,5,3,0,8
ZUDAÑEZ,"anticoncepcion, prevencion de its y de cancer de cuello uterino",pildora: usuarias continuas,2015-02-01,0,1,6,2,1,10
ACACIO,"anticoncepcion, prevencion de its y de cancer de cuello uterino",pildora: usuarias continuas,2015-03-01,0,0,0,1,0,1
ACHACACHI,"anticoncepcion, prevencion de its y de cancer de cuello uterino",pildora: usuarias continuas,2015-03-01,0,0,3,1,0,4
ACHOCALLA,"anticoncepcion, prevencion de its y de cancer de cuello uterino",pildora: usuarias continuas,2015-03-01,0,1,3,1,0,5
AIQUILE,"anticoncepcion, prevencion de its y de cancer de cuello uterino",pildora: usuarias continuas,2015-03-01,0,1,1,1,0,3
ALCALA,"anticoncepcion, prevencion de its y de cancer de cuello uterino",pildora: usuarias continuas,2015-03-01,0,0,3,2,0,5
ALTO BENI,"anticoncepcion, prevencion de its y de cancer de cuello uterino",pildora: usuarias continuas,2015-03-01,0,0,6,0,0,6
ANCORAIMES,"anticoncepcion, prevencion de its y de cancer de cuello uterino",pildora: usuarias continuas,2015-03-01,0,0,3,0,0,3
ANTEQUERA,"anticoncepcion, prevencion de its y de cancer de cuello uterino",pildora: usuarias continuas,2015-03-01,0,0,1,0,0,1
APOLO,"anticoncepcion, prevencion de its y de cancer de cuello uterino",pildora: usuarias continuas,2015-03-01,0,0,6,0,0,6
ARBIETO,"anticoncepcion, prevencion de its y de cancer de cuello uterino",pildora: usuarias continuas,2015-03-01,0,0,2,3,0,5
ARQUE,"anticoncepcion, prevencion de its y de cancer de cuello uterino",pildora: usuarias continuas,2015-03-01,0,0,1,0,0,1
ASCENCION DE GUARAYOS,"anticoncepcion, prevencion de its y de cancer de cuello uterino",pildora: usuarias continuas,2015-03-01,0,2,13,2,0,17
ATOCHA,"anticoncepcion, prevencion de its y de cancer de cuello uterino",pildora: usuarias continuas,2015-03-01,0,3,24,9,0,36
AUCAPATA,"anticoncepcion, prevencion de its y de cancer de cuello uterino",pildora: usuarias continuas,2015-03-01,0,0,2,1,0,3
AYATA,"anticoncepcion, prevencion de its y de cancer de cuello uterino",pildora: usuarias continuas,2015-03-01,0,0,4,2,0,6
AYOPAYA (V. DE INDEPENDENCIA),"anticoncepcion, prevencion de its y de cancer de cuello uterino",pildora: usuarias continuas,2015-03-01,0,0,8,4,0,12
AZURDUY,"anticoncepcion, prevencion de its y de cancer de cuello uterino",pildora: usuarias continuas,2015-03-01,0,0,3,0,0,3
BATALLAS,"anticoncepcion, prevencion de its y de cancer de cuello uterino",pildora: usuarias continuas,2015-03-01,0,0,2,2,0,4
BAURES,"anticoncepcion, prevencion de its y de cancer de cuello uterino",pildora: usuarias continuas,2015-03-01,0,1,13,5,0,19
BELLA FLOR,"anticoncepcion, prevencion de its y de cancer de cuello uterino",pildora: usuarias continuas,2015-03-01,0,4,8,2,0,14
BERMEJO,"anticoncepcion, prevencion de its y de cancer de cuello uterino",pildora: usuarias continuas,2015-03-01,0,1,17,4,0,22
BETANZOS,"anticoncepcion, prevencion de its y de cancer de cuello uterino",pildora: usuarias continuas,2015-03-01,0,1,2,0,0,3
BOLPEBRA,"anticoncepcion, prevencion de its y de cancer de cuello uterino",pildora: usuarias continuas,2015-03-01,0,1,1,1,0,3
BOYUIBE,"anticoncepcion, prevencion de its y de cancer de cuello uterino",pildora: usuarias continuas,2015-03-01,0,0,1,0,0,1
BUENA VISTA,"anticoncepcion, prevencion de its y de cancer de cuello uterino",pildora: usuarias continuas,2015-03-01,0,5,21,7,0,33
CABEZAS,"anticoncepcion, prevencion de its y de cancer de cuello uterino",pildora: usuarias continuas,2015-03-01,0,8,26,8,0,42
CAIROMA,"anticoncepcion, prevencion de its y de cancer de cuello uterino",pildora: usuarias continuas,2015-03-01,0,0,0,1,0,1
"CAIZA ""D""","anticoncepcion, prevencion de its y de cancer de cuello uterino",pildora: usuarias continuas,2015-03-01,0,0,4,2,0,6
CAJUATA,"anticoncepcion, prevencion de its y de cancer de cuello uterino",pildora: usuarias continuas,2015-03-01,0,0,3,0,0,3
CALAMARCA,"anticoncepcion, prevencion de its y de cancer de cuello uterino",pildora: usuarias continuas,2015-03-01,0,0,0,1,0,1
CAMARGO,"anticoncepcion, prevencion de its y de cancer de cuello uterino",pildora: usuarias continuas,2015-03-01,0,1,2,0,0,3
CAMATAQUI (C. VILLA ABECIA),"anticoncepcion, prevencion de its y de cancer de cuello uterino",pildora: usuarias continuas,2015-03-01,0,0,0,1,0,1
CAMIRI,"anticoncepcion, prevencion de its y de cancer de cuello uterino",pildora: usuarias continuas,2015-03-01,0,0,5,4,0,9
CAPINOTA,"anticoncepcion, prevencion de its y de cancer de cuello uterino",pildora: usuarias continuas,2015-03-01,0,0,2,1,0,3
CARACOLLO,"anticoncepcion, prevencion de its y de cancer de cuello uterino",pildora: usuarias continuas,2015-03-01,0,1,6,1,0,8
CARANAVI,"anticoncepcion, prevencion de its y de cancer de cuello uterino",pildora: usuarias continuas,2015-03-01,0,2,5,3,0,10
CARAPARI,"anticoncepcion, prevencion de its y de cancer de cuello uterino",pildora: usuarias continuas,2015-03-01,0,1,24,4,0,29
CARMEN RIVERO TORREZ,"anticoncepcion, prevencion de its y de cancer de cuello uterino",pildora: usuarias continuas,2015-03-01,0,0,8,2,0,10
CATACORA,"anticoncepcion, prevencion de its y de cancer de cuello uterino",pildora: usuarias continuas,2015-03-01,0,0,2,0,0,2
CHALLAPATA,"anticoncepcion, prevencion de its y de cancer de cuello uterino",pildora: usuarias continuas,2015-03-01,0,1,3,0,0,4
CHARAGUA,"anticoncepcion, prevencion de its y de cancer de cuello uterino",pildora: usuarias continuas,2015-03-01,0,2,14,10,0,26
CHIMORE,"anticoncepcion, prevencion de its y de cancer de cuello uterino",pildora: usuarias continuas,2015-03-01,0,1,15,7,0,23
CHULUMANI (V. DE LA LIBERTAD),"anticoncepcion, prevencion de its y de cancer de cuello uterino",pildora: usuarias continuas,2015-03-01,0,1,3,1,0,5
CHUMA,"anticoncepcion, prevencion de its y de cancer de cuello uterino",pildora: usuarias continuas,2015-03-01,0,0,1,5,0,6
CLIZA,"anticoncepcion, prevencion de its y de cancer de cuello uterino",pildora: usuarias continuas,2015-03-01,0,6,7,1,0,14
COBIJA,"anticoncepcion, prevencion de its y de cancer de cuello uterino",pildora: usuarias continuas,2015-03-01,0,16,30,12,0,58
COCAPATA,"anticoncepcion, prevencion de its y de cancer de cuello uterino",pildora: usuarias continuas,2015-03-01,0,9,9,1,0,19
COCHABAMBA,"anticoncepcion, prevencion de its y de cancer de cuello uterino",pildora: usuarias continuas,2015-03-01,3,17,100,31,0,151
COIPASA,"anticoncepcion, prevencion de its y de cancer de cuello uterino",pildora: usuarias continuas,2015-03-01,0,0,2,0,0,2
COLCAPIRHUA,"anticoncepcion, prevencion de its y de cancer de cuello uterino",pildora: usuarias continuas,2015-03-01,0,2,5,0,0,7
"COLCHA ""K""","anticoncepcion, prevencion de its y de cancer de cuello uterino",pildora: usuarias continuas,2015-03-01,0,0,2,1,0,3
COLOMI,"anticoncepcion, prevencion de its y de cancer de cuello uterino",pildora: usuarias continuas,2015-03-01,0,1,5,0,0,6
COLPA BELGICA,"anticoncepcion, prevencion de its y de cancer de cuello uterino",pildora: usuarias continuas,2015-03-01,0,1,7,5,0,13
COLQUECHACA,"anticoncepcion, prevencion de its y de cancer de cuello uterino",pildora: usuarias continuas,2015-03-01,0,1,1,1,0,3
COLQUENCHA,"anticoncepcion, prevencion de its y de cancer de cuello uterino",pildora: usuarias continuas,2015-03-01,0,0,2,2,1,5
COLQUIRI,"anticoncepcion, prevencion de its y de cancer de cuello uterino",pildora: usuarias continuas,2015-03-01,0,0,1,0,0,1
COMARAPA,"anticoncepcion, prevencion de its y de cancer de cuello uterino",pildora: usuarias continuas,2015-03-01,0,0,7,1,0,8
CONCEPCION,"anticoncepcion, prevencion de its y de cancer de cuello uterino",pildora: usuarias continuas,2015-03-01,0,0,10,1,0,11
COPACABANA,"anticoncepcion, prevencion de its y de cancer de cuello uterino",pildora: usuarias continuas,2015-03-01,0,0,1,1,0,2
CORIPATA,"anticoncepcion, prevencion de its y de cancer de cuello uterino",pildora: usuarias continuas,2015-03-01,0,0,1,0,0,1
COROICO,"anticoncepcion, prevencion de its y de cancer de cuello uterino",pildora: usuarias continuas,2015-03-01,0,0,1,1,0,2
CORQUE,"anticoncepcion, prevencion de its y de cancer de cuello uterino",pildora: usuarias continuas,2015-03-01,0,0,0,2,0,2
COTAGAITA,"anticoncepcion, prevencion de its y de cancer de cuello uterino",pildora: usuarias continuas,2015-03-01,0,0,8,5,0,13
COTOCA,"anticoncepcion, prevencion de its y de cancer de cuello uterino",pildora: usuarias continuas,2015-03-01,0,3,30,3,0,36
CUATRO CAÑADAS,"anticoncepcion, prevencion de its y de cancer de cuello uterino",pildora: usuarias continuas,2015-03-01,0,1,9,1,0,11
CUCHUMUELA (V. G. VILLARROEL),"anticoncepcion, prevencion de its y de cancer de cuello uterino",pildora: usuarias continuas,2015-03-01,0,0,3,0,0,3
CUEVO,"anticoncepcion, prevencion de its y de cancer de cuello uterino",pildora: usuarias continuas,2015-03-01,0,0,1,0,0,1
CULPINA,"anticoncepcion, prevencion de its y de cancer de cuello uterino",pildora: usuarias continuas,2015-03-01,0,1,3,2,1,7
CURAHUARA DE CARANGAS,"anticoncepcion, prevencion de its y de cancer de cuello uterino",pildora: usuarias continuas,2015-03-01,0,0,2,1,0,3
EL ALTO,"anticoncepcion, prevencion de its y de cancer de cuello uterino",pildora: usuarias continuas,2015-03-01,0,10,153,48,0,211
EL CHORO,"anticoncepcion, prevencion de its y de cancer de cuello uterino",pildora: usuarias continuas,2015-03-01,0,0,1,0,0,1
EL PUENTE(STC),"anticoncepcion, prevencion de its y de cancer de cuello uterino",pildora: usuarias continuas,2015-03-01,0,2,3,3,0,8
EL PUENTE(TJA),"anticoncepcion, prevencion de its y de cancer de cuello uterino",pildora: usuarias continuas,2015-03-01,0,0,4,3,0,7
EL TORNO,"anticoncepcion, prevencion de its y de cancer de cuello uterino",pildora: usuarias continuas,2015-03-01,5,6,31,18,0,60
EL VILLAR,"anticoncepcion, prevencion de its y de cancer de cuello uterino",pildora: usuarias continuas,2015-03-01,0,2,4,2,1,9
ENTRE RIOS TRJ,"anticoncepcion, prevencion de its y de cancer de cuello uterino",pildora: usuarias continuas,2015-03-01,0,7,27,11,0,45
ENTRE RIOS CBBA,"anticoncepcion, prevencion de its y de cancer de cuello uterino",pildora: usuarias continuas,2015-03-01,0,0,15,2,0,17
ESCARA,"anticoncepcion, prevencion de its y de cancer de cuello uterino",pildora: usuarias continuas,2015-03-01,0,1,0,0,0,1
EUCALIPTUS,"anticoncepcion, prevencion de its y de cancer de cuello uterino",pildora: usuarias continuas,2015-03-01,0,0,1,0,0,1
EUREKA (SANTOS MERCADO),"anticoncepcion, prevencion de its y de cancer de cuello uterino",pildora: usuarias continuas,2015-03-01,0,0,3,0,0,3
FERNANDEZ ALONSO,"anticoncepcion, prevencion de its y de cancer de cuello uterino",pildora: usuarias continuas,2015-03-01,0,0,15,2,0,17
FILADELFIA,"anticoncepcion, prevencion de its y de cancer de cuello uterino",pildora: usuarias continuas,2015-03-01,1,3,18,3,0,25
GENERAL SAAVEDRA,"anticoncepcion, prevencion de its y de cancer de cuello uterino",pildora: usuarias continuas,2015-03-01,0,1,15,7,0,23
GRAL. J.J. PEREZ (CHARAZANI),"anticoncepcion, prevencion de its y de cancer de cuello uterino",pildora: usuarias continuas,2015-03-01,0,0,1,0,0,1
GUANAY,"anticoncepcion, prevencion de its y de cancer de cuello uterino",pildora: usuarias continuas,2015-03-01,0,0,1,0,0,1
GUAQUI,"anticoncepcion, prevencion de its y de cancer de cuello uterino",pildora: usuarias continuas,2015-03-01,0,0,1,0,0,1
GUAYARAMERIN,"anticoncepcion, prevencion de its y de cancer de cuello uterino",pildora: usuarias continuas,2015-03-01,0,2,3,0,0,5
GUTIERREZ,"anticoncepcion, prevencion de its y de cancer de cuello uterino",pildora: usuarias continuas,2015-03-01,0,2,7,3,0,12
HUACARETA,"anticoncepcion, prevencion de its y de cancer de cuello uterino",pildora: usuarias continuas,2015-03-01,0,2,28,2,1,33
HUACHACALLA,"anticoncepcion, prevencion de its y de cancer de cuello uterino",pildora: usuarias continuas,2015-03-01,0,0,1,0,0,1
HUANUNI,"anticoncepcion, prevencion de its y de cancer de cuello uterino",pildora: usuarias continuas,2015-03-01,0,0,2,0,0,2
HUARACAJE,"anticoncepcion, prevencion de its y de cancer de cuello uterino",pildora: usuarias continuas,2015-03-01,0,5,16,9,0,30
HUMANATA,"anticoncepcion, prevencion de its y de cancer de cuello uterino",pildora: usuarias continuas,2015-03-01,0,0,0,1,0,1
ICLA,"anticoncepcion, prevencion de its y de cancer de cuello uterino",pildora: usuarias continuas,2015-03-01,0,0,4,2,0,6
INCAHUASI,"anticoncepcion, prevencion de its y de cancer de cuello uterino",pildora: usuarias continuas,2015-03-01,0,3,1,1,0,5
INQUISIVI,"anticoncepcion, prevencion de its y de cancer de cuello uterino",pildora: usuarias continuas,2015-03-01,0,0,1,1,0,2
IRUPANA (VILLA DE LANZA),"anticoncepcion, prevencion de its y de cancer de cuello uterino",pildora: usuarias continuas,2015-03-01,0,0,5,2,0,7
IXIAMAS,"anticoncepcion, prevencion de its y de cancer de cuello uterino",pildora: usuarias continuas,2015-03-01,0,1,6,1,0,8
JESUS DE MACHACA,"anticoncepcion, prevencion de its y de cancer de cuello uterino",pildora: usuarias continuas,2015-03-01,0,1,2,0,0,3
LA ASUNTA,"anticoncepcion, prevencion de its y de cancer de cuello uterino",pildora: usuarias continuas,2015-03-01,0,1,20,10,0,31
LA GUARDIA,"anticoncepcion, prevencion de its y de cancer de cuello uterino",pildora: usuarias continuas,2015-03-01,0,3,23,11,0,37
LA PAZ,"anticoncepcion, prevencion de its y de cancer de cuello uterino",pildora: usuarias continuas,2015-03-01,0,13,111,34,0,158
LA RIVERA,"anticoncepcion, prevencion de its y de cancer de cuello uterino",pildora: usuarias continuas,2015-03-01,0,0,1,0,0,1
LAJA,"anticoncepcion, prevencion de its y de cancer de cuello uterino",pildora: usuarias continuas,2015-03-01,0,2,7,2,0,11
LAS CARRERAS,"anticoncepcion, prevencion de its y de cancer de cuello uterino",pildora: usuarias continuas,2015-03-01,0,0,0,1,0,1
LLALLAGUA,"anticoncepcion, prevencion de its y de cancer de cuello uterino",pildora: usuarias continuas,2015-03-01,0,0,3,2,0,5
LLICA,"anticoncepcion, prevencion de its y de cancer de cuello uterino",pildora: usuarias continuas,2015-03-01,0,1,4,0,0,5
LORETO,"anticoncepcion, prevencion de its y de cancer de cuello uterino",pildora: usuarias continuas,2015-03-01,0,0,5,3,0,8
LURIBAY,"anticoncepcion, prevencion de its y de cancer de cuello uterino",pildora: usuarias continuas,2015-03-01,0,0,0,3,0,3
MACHARETI,"anticoncepcion, prevencion de its y de cancer de cuello uterino",pildora: usuarias continuas,2015-03-01,0,1,5,8,0,14
MAGDALENA,"anticoncepcion, prevencion de its y de cancer de cuello uterino",pildora: usuarias continuas,2015-03-01,0,4,39,12,1,56
MAIRANA,"anticoncepcion, prevencion de its y de cancer de cuello uterino",pildora: usuarias continuas,2015-03-01,0,1,5,0,0,6
MECAPACA,"anticoncepcion, prevencion de its y de cancer de cuello uterino",pildora: usuarias continuas,2015-03-01,0,0,6,1,0,7
MINEROS,"anticoncepcion, prevencion de its y de cancer de cuello uterino",pildora: usuarias continuas,2015-03-01,0,2,26,10,0,38
MIZQUE,"anticoncepcion, prevencion de its y de cancer de cuello uterino",pildora: usuarias continuas,2015-03-01,0,0,2,0,0,2
MOJOCOYA,"anticoncepcion, prevencion de its y de cancer de cuello uterino",pildora: usuarias continuas,2015-03-01,0,0,3,3,0,6
MONTEAGUDO,"anticoncepcion, prevencion de its y de cancer de cuello uterino",pildora: usuarias continuas,2015-03-01,0,0,23,3,0,26
MONTERO,"anticoncepcion, prevencion de its y de cancer de cuello uterino",pildora: usuarias continuas,2015-03-01,0,6,37,12,1,56
MORO MORO,"anticoncepcion, prevencion de its y de cancer de cuello uterino",pildora: usuarias continuas,2015-03-01,1,1,5,2,0,9
MOROCHATA,"anticoncepcion, prevencion de its y de cancer de cuello uterino",pildora: usuarias continuas,2015-03-01,0,0,1,1,0,2
NACEBE (SANTA ROSA DEL ABUNA),"anticoncepcion, prevencion de its y de cancer de cuello uterino",pildora: usuarias continuas,2015-03-01,0,0,0,2,0,2
OCURI,"anticoncepcion, prevencion de its y de cancer de cuello uterino",pildora: usuarias continuas,2015-03-01,0,0,4,4,0,8
OKINAWA,"anticoncepcion, prevencion de its y de cancer de cuello uterino",pildora: usuarias continuas,2015-03-01,0,4,16,9,0,29
OMEREQUE,"anticoncepcion, prevencion de its y de cancer de cuello uterino",pildora: usuarias continuas,2015-03-01,0,0,4,2,0,6
ORURO,"anticoncepcion, prevencion de its y de cancer de cuello uterino",pildora: usuarias continuas,2015-03-01,0,14,54,25,0,93
PADCAYA,"anticoncepcion, prevencion de its y de cancer de cuello uterino",pildora: usuarias continuas,2015-03-01,1,1,18,13,0,33
PADILLA,"anticoncepcion, prevencion de its y de cancer de cuello uterino",pildora: usuarias continuas,2015-03-01,0,0,23,2,0,25
PAILON,"anticoncepcion, prevencion de its y de cancer de cuello uterino",pildora: usuarias continuas,2015-03-01,0,4,11,8,0,23
PALOS BLANCOS,"anticoncepcion, prevencion de its y de cancer de cuello uterino",pildora: usuarias continuas,2015-03-01,0,0,18,6,0,24
PAMPA GRANDE,"anticoncepcion, prevencion de its y de cancer de cuello uterino",pildora: usuarias continuas,2015-03-01,0,1,8,4,0,13
PAPEL PAMPA,"anticoncepcion, prevencion de its y de cancer de cuello uterino",pildora: usuarias continuas,2015-03-01,0,0,2,3,0,5
PASORAPA,"anticoncepcion, prevencion de its y de cancer de cuello uterino",pildora: usuarias continuas,2015-03-01,0,0,2,0,0,2
PAZÑA,"anticoncepcion, prevencion de its y de cancer de cuello uterino",pildora: usuarias continuas,2015-03-01,0,0,2,1,0,3
PELECHUCO,"anticoncepcion, prevencion de its y de cancer de cuello uterino",pildora: usuarias continuas,2015-03-01,0,0,5,0,0,5
POCOATA,"anticoncepcion, prevencion de its y de cancer de cuello uterino",pildora: usuarias continuas,2015-03-01,0,0,1,0,0,1
POCONA,"anticoncepcion, prevencion de its y de cancer de cuello uterino",pildora: usuarias continuas,2015-03-01,0,1,6,2,0,9
POJO (CBBA),"anticoncepcion, prevencion de its y de cancer de cuello uterino",pildora: usuarias continuas,2015-03-01,0,0,4,4,0,8
POOPO,"anticoncepcion, prevencion de its y de cancer de cuello uterino",pildora: usuarias continuas,2015-03-01,0,0,2,0,0,2
PORCO,"anticoncepcion, prevencion de its y de cancer de cuello uterino",pildora: usuarias continuas,2015-03-01,0,0,2,1,0,3
POROMA,"anticoncepcion, prevencion de its y de cancer de cuello uterino",pildora: usuarias continuas,2015-03-01,0,0,4,3,0,7
PORONGO,"anticoncepcion, prevencion de its y de cancer de cuello uterino",pildora: usuarias continuas,2015-03-01,0,0,10,4,1,15
PORTACHUELO,"anticoncepcion, prevencion de its y de cancer de cuello uterino",pildora: usuarias continuas,2015-03-01,0,1,25,6,0,32
PORVENIR,"anticoncepcion, prevencion de its y de cancer de cuello uterino",pildora: usuarias continuas,2015-03-01,0,4,14,3,0,21
POSTRER VALLE,"anticoncepcion, prevencion de its y de cancer de cuello uterino",pildora: usuarias continuas,2015-03-01,0,0,2,1,0,3
POTOSI,"anticoncepcion, prevencion de its y de cancer de cuello uterino",pildora: usuarias continuas,2015-03-01,0,10,108,21,0,139
PRESTO,"anticoncepcion, prevencion de its y de cancer de cuello uterino",pildora: usuarias continuas,2015-03-01,0,1,6,1,0,8
PUCARA,"anticoncepcion, prevencion de its y de cancer de cuello uterino",pildora: usuarias continuas,2015-03-01,0,1,2,0,0,3
PUCARANI,"anticoncepcion, prevencion de its y de cancer de cuello uterino",pildora: usuarias continuas,2015-03-01,0,0,1,0,0,1
PUERTO ACOSTA,"anticoncepcion, prevencion de its y de cancer de cuello uterino",pildora: usuarias continuas,2015-03-01,0,0,0,1,0,1
PUERTO CARABUCO,"anticoncepcion, prevencion de its y de cancer de cuello uterino",pildora: usuarias continuas,2015-03-01,0,0,1,0,0,1
PUERTO GONZALO MORENO,"anticoncepcion, prevencion de its y de cancer de cuello uterino",pildora: usuarias continuas,2015-03-01,0,2,8,5,0,15
PUERTO QUIJARRO,"anticoncepcion, prevencion de its y de cancer de cuello uterino",pildora: usuarias continuas,2015-03-01,0,2,3,5,0,10
PUERTO RICO,"anticoncepcion, prevencion de its y de cancer de cuello uterino",pildora: usuarias continuas,2015-03-01,0,1,13,3,1,18
PUERTO SILES,"anticoncepcion, prevencion de its y de cancer de cuello uterino",pildora: usuarias continuas,2015-03-01,0,1,4,1,0,6
PUERTO SUAREZ,"anticoncepcion, prevencion de its y de cancer de cuello uterino",pildora: usuarias continuas,2015-03-01,0,1,6,1,0,8
PUERTO VILLARROEL,"anticoncepcion, prevencion de its y de cancer de cuello uterino",pildora: usuarias continuas,2015-03-01,0,1,10,6,0,17
PUNA,"anticoncepcion, prevencion de its y de cancer de cuello uterino",pildora: usuarias continuas,2015-03-01,0,0,13,2,0,15
PUNATA,"anticoncepcion, prevencion de its y de cancer de cuello uterino",pildora: usuarias continuas,2015-03-01,0,0,1,0,0,1
QUIABAYA,"anticoncepcion, prevencion de its y de cancer de cuello uterino",pildora: usuarias continuas,2015-03-01,0,0,1,0,0,1
QUILLACOLLO,"anticoncepcion, prevencion de its y de cancer de cuello uterino",pildora: usuarias continuas,2015-03-01,0,1,12,5,0,18
QUIME,"anticoncepcion, prevencion de its y de cancer de cuello uterino",pildora: usuarias continuas,2015-03-01,0,2,8,2,0,12
QUIRUSILLAS,"anticoncepcion, prevencion de its y de cancer de cuello uterino",pildora: usuarias continuas,2015-03-01,0,1,4,3,0,8
RAVELO,"anticoncepcion, prevencion de its y de cancer de cuello uterino",pildora: usuarias continuas,2015-03-01,0,0,0,1,0,1
REYES,"anticoncepcion, prevencion de its y de cancer de cuello uterino",pildora: usuarias continuas,2015-03-01,0,4,11,6,0,21
RIBERALTA,"anticoncepcion, prevencion de its y de cancer de cuello uterino",pildora: usuarias continuas,2015-03-01,0,6,54,18,0,78
ROBORE,"anticoncepcion, prevencion de its y de cancer de cuello uterino",pildora: usuarias continuas,2015-03-01,0,4,14,5,0,23
RURRENABAQUE,"anticoncepcion, prevencion de its y de cancer de cuello uterino",pildora: usuarias continuas,2015-03-01,0,2,7,1,0,10
SABAYA,"anticoncepcion, prevencion de its y de cancer de cuello uterino",pildora: usuarias continuas,2015-03-01,0,0,1,0,0,1
SACABA,"anticoncepcion, prevencion de its y de cancer de cuello uterino",pildora: usuarias continuas,2015-03-01,0,3,18,6,0,27
SACABAMBA,"anticoncepcion, prevencion de its y de cancer de cuello uterino",pildora: usuarias continuas,2015-03-01,0,0,1,0,0,1
SACACA,"anticoncepcion, prevencion de its y de cancer de cuello uterino",pildora: usuarias continuas,2015-03-01,0,1,6,4,0,11
SAIPINA,"anticoncepcion, prevencion de its y de cancer de cuello uterino",pildora: usuarias continuas,2015-03-01,0,1,1,0,0,2
SALINAS DE GARCI MENDOZA,"anticoncepcion, prevencion de its y de cancer de cuello uterino",pildora: usuarias continuas,2015-03-01,0,0,2,2,0,4
SAMAIPATA,"anticoncepcion, prevencion de its y de cancer de cuello uterino",pildora: usuarias continuas,2015-03-01,0,2,9,2,0,13
SAN AGUSTIN,"anticoncepcion, prevencion de its y de cancer de cuello uterino",pildora: usuarias continuas,2015-03-01,0,0,1,3,0,4
SAN ANDRES,"anticoncepcion, prevencion de its y de cancer de cuello uterino",pildora: usuarias continuas,2015-03-01,0,4,27,12,1,44
SAN ANTONIO DE LOMERIO,"anticoncepcion, prevencion de its y de cancer de cuello uterino",pildora: usuarias continuas,2015-03-01,0,2,12,10,0,24
SAN BORJA,"anticoncepcion, prevencion de its y de cancer de cuello uterino",pildora: usuarias continuas,2015-03-01,0,5,38,13,0,56
SAN BUENA VENTURA,"anticoncepcion, prevencion de its y de cancer de cuello uterino",pildora: usuarias continuas,2015-03-01,0,0,1,0,0,1
SAN CARLOS,"anticoncepcion, prevencion de its y de cancer de cuello uterino",pildora: usuarias continuas,2015-03-01,0,2,14,7,0,23
SAN IGNACIO,"anticoncepcion, prevencion de its y de cancer de cuello uterino",pildora: usuarias continuas,2015-03-01,0,10,90,57,3,160
SAN IGNACIO DE VELASCO,"anticoncepcion, prevencion de its y de cancer de cuello uterino",pildora: usuarias continuas,2015-03-01,1,9,54,19,0,83
SAN JAVIER(BNI),"anticoncepcion, prevencion de its y de cancer de cuello uterino",pildora: usuarias continuas,2015-03-01,0,1,4,1,0,6
SAN JAVIER(STC),"anticoncepcion, prevencion de its y de cancer de cuello uterino",pildora: usuarias continuas,2015-03-01,0,4,20,7,0,31
SAN JOAQUIN,"anticoncepcion, prevencion de its y de cancer de cuello uterino",pildora: usuarias continuas,2015-03-01,0,1,0,0,0,1
SAN JOSE DE CHIQUITOS,"anticoncepcion, prevencion de its y de cancer de cuello uterino",pildora: usuarias continuas,2015-03-01,0,1,8,6,1,16
SAN JUAN DE YAPACANI,"anticoncepcion, prevencion de its y de cancer de cuello uterino",pildora: usuarias continuas,2015-03-01,0,1,18,3,0,22
SAN JULIAN,"anticoncepcion, prevencion de its y de cancer de cuello uterino",pildora: usuarias continuas,2015-03-01,0,1,9,4,0,14
SAN LORENZO(PND),"anticoncepcion, prevencion de its y de cancer de cuello uterino",pildora: usuarias continuas,2015-03-01,0,0,2,0,0,2
SAN LORENZO(TJA),"anticoncepcion, prevencion de its y de cancer de cuello uterino",pildora: usuarias continuas,2015-03-01,0,2,20,1,1,24
SAN LUCAS,"anticoncepcion, prevencion de its y de cancer de cuello uterino",pildora: usuarias continuas,2015-03-01,0,0,9,4,0,13
SAN MATIAS,"anticoncepcion, prevencion de its y de cancer de cuello uterino",pildora: usuarias continuas,2015-03-01,0,2,14,1,0,17
SAN MIGUEL DE VELASCO,"anticoncepcion, prevencion de its y de cancer de cuello uterino",pildora: usuarias continuas,2015-03-01,0,4,29,19,1,53
SAN PEDRO,"anticoncepcion, prevencion de its y de cancer de cuello uterino",pildora: usuarias continuas,2015-03-01,0,1,19,4,0,24
SAN PEDRO DE BUENA VISTA,"anticoncepcion, prevencion de its y de cancer de cuello uterino",pildora: usuarias continuas,2015-03-01,0,0,2,3,0,5
SAN PEDRO DE CURAHUARA,"anticoncepcion, prevencion de its y de cancer de cuello uterino",pildora: usuarias continuas,2015-03-01,0,0,0,1,0,1
SAN PEDRO DE TIQUINA,"anticoncepcion, prevencion de its y de cancer de cuello uterino",pildora: usuarias continuas,2015-03-01,0,0,0,1,0,1
SAN PEDRO(PND),"anticoncepcion, prevencion de its y de cancer de cuello uterino",pildora: usuarias continuas,2015-03-01,0,0,2,1,0,3
SAN RAFAEL,"anticoncepcion, prevencion de its y de cancer de cuello uterino",pildora: usuarias continuas,2015-03-01,0,4,21,8,0,33
SAN RAMON BENI,"anticoncepcion, prevencion de its y de cancer de cuello uterino",pildora: usuarias continuas,2015-03-01,0,0,3,0,0,3
SAN RAMON SCZ,"anticoncepcion, prevencion de its y de cancer de cuello uterino",pildora: usuarias continuas,2015-03-01,0,5,4,1,0,10
SANTA ANA,"anticoncepcion, prevencion de its y de cancer de cuello uterino",pildora: usuarias continuas,2015-03-01,0,4,18,4,0,26
SANTA CRUZ DE LA SIERRA,"anticoncepcion, prevencion de its y de cancer de cuello uterino",pildora: usuarias continuas,2015-03-01,1,46,197,73,1,318
SANTA ROSA,"anticoncepcion, prevencion de its y de cancer de cuello uterino",pildora: usuarias continuas,2015-03-01,0,0,5,0,0,5
SANTA ROSA DEL SARA,"anticoncepcion, prevencion de its y de cancer de cuello uterino",pildora: usuarias continuas,2015-03-01,0,2,21,9,1,33
SANTIAGO DE HUATA,"anticoncepcion, prevencion de its y de cancer de cuello uterino",pildora: usuarias continuas,2015-03-01,0,1,0,2,0,3
SANTIVAÑES,"anticoncepcion, prevencion de its y de cancer de cuello uterino",pildora: usuarias continuas,2015-03-01,0,0,3,1,0,4
SANTUARIO DE QUILLACAS,"anticoncepcion, prevencion de its y de cancer de cuello uterino",pildora: usuarias continuas,2015-03-01,0,0,2,2,0,4
SAPAHAQUI,"anticoncepcion, prevencion de its y de cancer de cuello uterino",pildora: usuarias continuas,2015-03-01,0,0,0,2,0,2
SENA,"anticoncepcion, prevencion de its y de cancer de cuello uterino",pildora: usuarias continuas,2015-03-01,0,1,3,0,0,4
SHINAOTA,"anticoncepcion, prevencion de its y de cancer de cuello uterino",pildora: usuarias continuas,2015-03-01,0,0,2,3,0,5
SICA SICA (VILLA AROMA),"anticoncepcion, prevencion de its y de cancer de cuello uterino",pildora: usuarias continuas,2015-03-01,0,0,4,3,0,7
SIPE SIPE,"anticoncepcion, prevencion de its y de cancer de cuello uterino",pildora: usuarias continuas,2015-03-01,0,0,8,1,0,9
SOPACHUY,"anticoncepcion, prevencion de its y de cancer de cuello uterino",pildora: usuarias continuas,2015-03-01,0,3,3,0,0,6
SORACACHI,"anticoncepcion, prevencion de its y de cancer de cuello uterino",pildora: usuarias continuas,2015-03-01,0,0,1,2,0,3
SORATA,"anticoncepcion, prevencion de its y de cancer de cuello uterino",pildora: usuarias continuas,2015-03-01,0,2,3,1,0,6
SUCRE,"anticoncepcion, prevencion de its y de cancer de cuello uterino",pildora: usuarias continuas,2015-03-01,0,11,99,24,1,135
TACACOMA,"anticoncepcion, prevencion de its y de cancer de cuello uterino",pildora: usuarias continuas,2015-03-01,0,0,6,1,0,7
TARABUCO,"anticoncepcion, prevencion de its y de cancer de cuello uterino",pildora: usuarias continuas,2015-03-01,0,0,1,0,0,1
TARACO,"anticoncepcion, prevencion de its y de cancer de cuello uterino",pildora: usuarias continuas,2015-03-01,0,0,1,0,0,1
TARIJA,"anticoncepcion, prevencion de its y de cancer de cuello uterino",pildora: usuarias continuas,2015-03-01,0,7,62,30,0,99
TARVITA,"anticoncepcion, prevencion de its y de cancer de cuello uterino",pildora: usuarias continuas,2015-03-01,0,0,4,3,0,7
TEOPONTE,"anticoncepcion, prevencion de its y de cancer de cuello uterino",pildora: usuarias continuas,2015-03-01,0,0,1,0,0,1
TIAWANACU,"anticoncepcion, prevencion de its y de cancer de cuello uterino",pildora: usuarias continuas,2015-03-01,0,0,0,3,0,3
TINGUIPAYA,"anticoncepcion, prevencion de its y de cancer de cuello uterino",pildora: usuarias continuas,2015-03-01,0,0,1,0,0,1
TIPUANI,"anticoncepcion, prevencion de its y de cancer de cuello uterino",pildora: usuarias continuas,2015-03-01,0,0,4,6,0,10
TIQUIPAYA,"anticoncepcion, prevencion de its y de cancer de cuello uterino",pildora: usuarias continuas,2015-03-01,0,3,13,2,0,18
TIRAQUE (CBBA),"anticoncepcion, prevencion de its y de cancer de cuello uterino",pildora: usuarias continuas,2015-03-01,0,0,4,0,0,4
TOLATA,"anticoncepcion, prevencion de its y de cancer de cuello uterino",pildora: usuarias continuas,2015-03-01,0,0,3,1,0,4
TOLEDO,"anticoncepcion, prevencion de its y de cancer de cuello uterino",pildora: usuarias continuas,2015-03-01,0,0,0,1,0,1
TOMAVE,"anticoncepcion, prevencion de its y de cancer de cuello uterino",pildora: usuarias continuas,2015-03-01,0,0,4,0,0,4
TOMINA,"anticoncepcion, prevencion de its y de cancer de cuello uterino",pildora: usuarias continuas,2015-03-01,0,0,7,0,0,7
TOTORA(ORR),"anticoncepcion, prevencion de its y de cancer de cuello uterino",pildora: usuarias continuas,2015-03-01,0,0,2,0,0,2
TRIGAL,"anticoncepcion, prevencion de its y de cancer de cuello uterino",pildora: usuarias continuas,2015-03-01,0,0,3,2,0,5
TRINIDAD,"anticoncepcion, prevencion de its y de cancer de cuello uterino",pildora: usuarias continuas,2015-03-01,0,6,47,17,0,70
TUPIZA,"anticoncepcion, prevencion de its y de cancer de cuello uterino",pildora: usuarias continuas,2015-03-01,0,0,11,2,0,13
TURCO,"anticoncepcion, prevencion de its y de cancer de cuello uterino",pildora: usuarias continuas,2015-03-01,0,0,3,1,0,4
UNCIA,"anticoncepcion, prevencion de its y de cancer de cuello uterino",pildora: usuarias continuas,2015-03-01,0,0,4,0,0,4
URIONDO (A. CONCEPCION),"anticoncepcion, prevencion de its y de cancer de cuello uterino",pildora: usuarias continuas,2015-03-01,0,2,16,4,0,22
URUBICHA,"anticoncepcion, prevencion de its y de cancer de cuello uterino",pildora: usuarias continuas,2015-03-01,0,0,12,0,0,12
UYUNI,"anticoncepcion, prevencion de its y de cancer de cuello uterino",pildora: usuarias continuas,2015-03-01,0,0,3,1,0,4
VALLEGRANDE,"anticoncepcion, prevencion de its y de cancer de cuello uterino",pildora: usuarias continuas,2015-03-01,0,1,4,2,0,7
VIACHA,"anticoncepcion, prevencion de its y de cancer de cuello uterino",pildora: usuarias continuas,2015-03-01,0,0,10,4,0,14
VILLA CHARCAS,"anticoncepcion, prevencion de its y de cancer de cuello uterino",pildora: usuarias continuas,2015-03-01,0,0,3,1,0,4
VILLA MONTES,"anticoncepcion, prevencion de its y de cancer de cuello uterino",pildora: usuarias continuas,2015-03-01,0,5,24,2,1,32
VILLA NUEVA (LOMA ALTA),"anticoncepcion, prevencion de its y de cancer de cuello uterino",pildora: usuarias continuas,2015-03-01,0,0,2,0,0,2
VILLA RIVERO,"anticoncepcion, prevencion de its y de cancer de cuello uterino",pildora: usuarias continuas,2015-03-01,0,0,1,0,0,1
VILLA SERRANO,"anticoncepcion, prevencion de its y de cancer de cuello uterino",pildora: usuarias continuas,2015-03-01,0,0,5,1,0,6
VILLA TUNARI,"anticoncepcion, prevencion de its y de cancer de cuello uterino",pildora: usuarias continuas,2015-03-01,0,4,28,4,0,36
VILLA VACA GUZMAN (MUYUPAMPA),"anticoncepcion, prevencion de its y de cancer de cuello uterino",pildora: usuarias continuas,2015-03-01,0,1,3,1,0,5
VILLAZON,"anticoncepcion, prevencion de its y de cancer de cuello uterino",pildora: usuarias continuas,2015-03-01,0,2,18,8,0,28
VINTO,"anticoncepcion, prevencion de its y de cancer de cuello uterino",pildora: usuarias continuas,2015-03-01,0,0,5,0,0,5
VITICHI,"anticoncepcion, prevencion de its y de cancer de cuello uterino",pildora: usuarias continuas,2015-03-01,0,0,1,3,0,4
WARNES,"anticoncepcion, prevencion de its y de cancer de cuello uterino",pildora: usuarias continuas,2015-03-01,0,9,45,15,0,69
YACUIBA,"anticoncepcion, prevencion de its y de cancer de cuello uterino",pildora: usuarias continuas,2015-03-01,0,3,30,16,0,49
YANACACHI,"anticoncepcion, prevencion de its y de cancer de cuello uterino",pildora: usuarias continuas,2015-03-01,0,0,4,0,0,4
YAPACANI,"anticoncepcion, prevencion de its y de cancer de cuello uterino",pildora: usuarias continuas,2015-03-01,0,1,6,2,0,9
YOCALLA,"anticoncepcion, prevencion de its y de cancer de cuello uterino",pildora: usuarias continuas,2015-03-01,0,1,0,0,0,1
YOTALA,"anticoncepcion, prevencion de its y de cancer de cuello uterino",pildora: usuarias continuas,2015-03-01,0,0,1,1,0,2
YUNCHARA,"anticoncepcion, prevencion de its y de cancer de cuello uterino",pildora: usuarias continuas,2015-03-01,0,2,3,1,0,6
ZUDAÑEZ,"anticoncepcion, prevencion de its y de cancer de cuello uterino",pildora: usuarias continuas,2015-03-01,0,0,3,0,0,3
ACHACACHI,"anticoncepcion, prevencion de its y de cancer de cuello uterino",pildora: usuarias continuas,2015-04-01,0,0,3,0,0,3
ACHOCALLA,"anticoncepcion, prevencion de its y de cancer de cuello uterino",pildora: usuarias continuas,2015-04-01,0,0,7,3,0,10
AIQUILE,"anticoncepcion, prevencion de its y de cancer de cuello uterino",pildora: usuarias continuas,2015-04-01,0,0,2,0,0,2
ALCALA,"anticoncepcion, prevencion de its y de cancer de cuello uterino",pildora: usuarias continuas,2015-04-01,0,0,1,1,0,2
ALTO BENI,"anticoncepcion, prevencion de its y de cancer de cuello uterino",pildora: usuarias continuas,2015-04-01,0,1,7,0,0,8
ANCORAIMES,"anticoncepcion, prevencion de its y de cancer de cuello uterino",pildora: usuarias continuas,2015-04-01,0,1,0,1,0,2
ANTEQUERA,"anticoncepcion, prevencion de its y de cancer de cuello uterino",pildora: usuarias continuas,2015-04-01,0,0,3,0,0,3
APOLO,"anticoncepcion, prevencion de its y de cancer de cuello uterino",pildora: usuarias continuas,2015-04-01,0,1,11,5,0,17
ARAMPAMPA,"anticoncepcion, prevencion de its y de cancer de cuello uterino",pildora: usuarias continuas,2015-04-01,0,0,2,2,0,4
ARANI,"anticoncepcion, prevencion de its y de cancer de cuello uterino",pildora: usuarias continuas,2015-04-01,0,0,0,2,0,2
ARBIETO,"anticoncepcion, prevencion de its y de cancer de cuello uterino",pildora: usuarias continuas,2015-04-01,0,0,5,1,0,6
ARQUE,"anticoncepcion, prevencion de its y de cancer de cuello uterino",pildora: usuarias continuas,2015-04-01,0,0,3,0,0,3
ASCENCION DE GUARAYOS,"anticoncepcion, prevencion de its y de cancer de cuello uterino",pildora: usuarias continuas,2015-04-01,0,1,11,4,0,16
ATOCHA,"anticoncepcion, prevencion de its y de cancer de cuello uterino",pildora: usuarias continuas,2015-04-01,0,0,6,0,0,6
AUCAPATA,"anticoncepcion, prevencion de its y de cancer de cuello uterino",pildora: usuarias continuas,2015-04-01,0,0,2,2,0,4
AYATA,"anticoncepcion, prevencion de its y de cancer de cuello uterino",pildora: usuarias continuas,2015-04-01,0,0,6,2,0,8
AYO AYO,"anticoncepcion, prevencion de its y de cancer de cuello uterino",pildora: usuarias continuas,2015-04-01,0,1,0,0,0,1
AYOPAYA (V. DE INDEPENDENCIA),"anticoncepcion, prevencion de its y de cancer de cuello uterino",pildora: usuarias continuas,2015-04-01,0,2,11,3,0,16
AZURDUY,"anticoncepcion, prevencion de its y de cancer de cuello uterino",pildora: usuarias continuas,2015-04-01,0,0,2,1,0,3
BATALLAS,"anticoncepcion, prevencion de its y de cancer de cuello uterino",pildora: usuarias continuas,2015-04-01,0,4,0,0,0,4
BAURES,"anticoncepcion, prevencion de its y de cancer de cuello uterino",pildora: usuarias continuas,2015-04-01,0,1,13,2,0,16
BELLA FLOR,"anticoncepcion, prevencion de its y de cancer de cuello uterino",pildora: usuarias continuas,2015-04-01,0,2,3,2,0,7
BERMEJO,"anticoncepcion, prevencion de its y de cancer de cuello uterino",pildora: usuarias continuas,2015-04-01,0,0,8,2,0,10
BETANZOS,"anticoncepcion, prevencion de its y de cancer de cuello uterino",pildora: usuarias continuas,2015-04-01,0,1,4,1,0,6
BOLPEBRA,"anticoncepcion, prevencion de its y de cancer de cuello uterino",pildora: usuarias continuas,2015-04-01,0,0,7,0,0,7
BOYUIBE,"anticoncepcion, prevencion de its y de cancer de cuello uterino",pildora: usuarias continuas,2015-04-01,0,0,0,1,0,1
BUENA VISTA,"anticoncepcion, prevencion de its y de cancer de cuello uterino",pildora: usuarias continuas,2015-04-01,0,1,16,7,0,24
CABEZAS,"anticoncepcion, prevencion de its y de cancer de cuello uterino",pildora: usuarias continuas,2015-04-01,0,5,25,4,0,34
"CAIZA ""D""","anticoncepcion, prevencion de its y de cancer de cuello uterino",pildora: usuarias continuas,2015-04-01,0,0,4,1,0,5
CAJUATA,"anticoncepcion, prevencion de its y de cancer de cuello uterino",pildora: usuarias continuas,2015-04-01,0,0,1,0,0,1
CALAMARCA,"anticoncepcion, prevencion de its y de cancer de cuello uterino",pildora: usuarias continuas,2015-04-01,0,0,5,2,0,7
CAMARGO,"anticoncepcion, prevencion de its y de cancer de cuello uterino",pildora: usuarias continuas,2015-04-01,0,0,2,0,0,2
CAMATAQUI (C. VILLA ABECIA),"anticoncepcion, prevencion de its y de cancer de cuello uterino",pildora: usuarias continuas,2015-04-01,0,0,2,1,0,3
CAMIRI,"anticoncepcion, prevencion de its y de cancer de cuello uterino",pildora: usuarias continuas,2015-04-01,0,0,7,0,0,7
CAPINOTA,"anticoncepcion, prevencion de its y de cancer de cuello uterino",pildora: usuarias continuas,2015-04-01,0,0,5,1,0,6
CARACOLLO,"anticoncepcion, prevencion de its y de cancer de cuello uterino",pildora: usuarias continuas,2015-04-01,0,1,1,0,0,2
CARANAVI,"anticoncepcion, prevencion de its y de cancer de cuello uterino",pildora: usuarias continuas,2015-04-01,0,0,9,4,0,13
CARANGAS,"anticoncepcion, prevencion de its y de cancer de cuello uterino",pildora: usuarias continuas,2015-04-01,0,0,3,0,0,3
CARAPARI,"anticoncepcion, prevencion de its y de cancer de cuello uterino",pildora: usuarias continuas,2015-04-01,0,5,25,3,1,34
CARIPUYO,"anticoncepcion, prevencion de its y de cancer de cuello uterino",pildora: usuarias continuas,2015-04-01,0,1,0,0,0,1
CATACORA,"anticoncepcion, prevencion de its y de cancer de cuello uterino",pildora: usuarias continuas,2015-04-01,0,0,2,0,0,2
CHALLAPATA,"anticoncepcion, prevencion de its y de cancer de cuello uterino",pildora: usuarias continuas,2015-04-01,0,0,2,2,0,4
CHAQUI,"anticoncepcion, prevencion de its y de cancer de cuello uterino",pildora: usuarias continuas,2015-04-01,0,0,1,1,0,2
CHARAGUA,"anticoncepcion, prevencion de its y de cancer de cuello uterino",pildora: usuarias continuas,2015-04-01,0,2,18,1,0,21
CHAYANTA,"anticoncepcion, prevencion de its y de cancer de cuello uterino",pildora: usuarias continuas,2015-04-01,0,0,1,1,0,2
CHIMORE,"anticoncepcion, prevencion de its y de cancer de cuello uterino",pildora: usuarias continuas,2015-04-01,1,2,5,6,0,14
CHULUMANI (V. DE LA LIBERTAD),"anticoncepcion, prevencion de its y de cancer de cuello uterino",pildora: usuarias continuas,2015-04-01,0,0,3,0,0,3
CHUMA,"anticoncepcion, prevencion de its y de cancer de cuello uterino",pildora: usuarias continuas,2015-04-01,0,0,1,2,0,3
CHUQUIHUTA AYLLU JUCUMANI,"anticoncepcion, prevencion de its y de cancer de cuello uterino",pildora: usuarias continuas,2015-04-01,0,0,2,1,0,3
CKOCHAS,"anticoncepcion, prevencion de its y de cancer de cuello uterino",pildora: usuarias continuas,2015-04-01,0,0,1,0,0,1
CLIZA,"anticoncepcion, prevencion de its y de cancer de cuello uterino",pildora: usuarias continuas,2015-04-01,0,2,6,1,0,9
COBIJA,"anticoncepcion, prevencion de its y de cancer de cuello uterino",pildora: usuarias continuas,2015-04-01,0,11,36,3,0,50
COCAPATA,"anticoncepcion, prevencion de its y de cancer de cuello uterino",pildora: usuarias continuas,2015-04-01,0,0,7,1,0,8
COCHABAMBA,"anticoncepcion, prevencion de its y de cancer de cuello uterino",pildora: usuarias continuas,2015-04-01,0,15,110,8,0,133
COIPASA,"anticoncepcion, prevencion de its y de cancer de cuello uterino",pildora: usuarias continuas,2015-04-01,0,0,1,1,0,2
COLCAPIRHUA,"anticoncepcion, prevencion de its y de cancer de cuello uterino",pildora: usuarias continuas,2015-04-01,0,0,10,2,0,12
"COLCHA ""K""","anticoncepcion, prevencion de its y de cancer de cuello uterino",pildora: usuarias continuas,2015-04-01,0,0,1,2,0,3
COLOMI,"anticoncepcion, prevencion de its y de cancer de cuello uterino",pildora: usuarias continuas,2015-04-01,0,0,2,5,0,7
COLPA BELGICA,"anticoncepcion, prevencion de its y de cancer de cuello uterino",pildora: usuarias continuas,2015-04-01,1,1,9,4,0,15
COLQUECHACA,"anticoncepcion, prevencion de its y de cancer de cuello uterino",pildora: usuarias continuas,2015-04-01,0,0,6,1,0,7
COLQUIRI,"anticoncepcion, prevencion de its y de cancer de cuello uterino",pildora: usuarias continuas,2015-04-01,1,0,1,1,0,3
COMARAPA,"anticoncepcion, prevencion de its y de cancer de cuello uterino",pildora: usuarias continuas,2015-04-01,0,0,3,2,0,5
CONCEPCION,"anticoncepcion, prevencion de its y de cancer de cuello uterino",pildora: usuarias continuas,2015-04-01,0,1,11,3,0,15
COPACABANA,"anticoncepcion, prevencion de its y de cancer de cuello uterino",pildora: usuarias continuas,2015-04-01,0,0,1,0,0,1
CORIPATA,"anticoncepcion, prevencion de its y de cancer de cuello uterino",pildora: usuarias continuas,2015-04-01,0,0,0,1,0,1
CORQUE,"anticoncepcion, prevencion de its y de cancer de cuello uterino",pildora: usuarias continuas,2015-04-01,0,0,0,1,0,1
COTAGAITA,"anticoncepcion, prevencion de its y de cancer de cuello uterino",pildora: usuarias continuas,2015-04-01,0,0,7,6,0,13
COTOCA,"anticoncepcion, prevencion de its y de cancer de cuello uterino",pildora: usuarias continuas,2015-04-01,0,3,32,11,1,47
CUATRO CAÑADAS,"anticoncepcion, prevencion de its y de cancer de cuello uterino",pildora: usuarias continuas,2015-04-01,0,3,11,1,0,15
CUEVO,"anticoncepcion, prevencion de its y de cancer de cuello uterino",pildora: usuarias continuas,2015-04-01,0,1,2,0,0,3
CULPINA,"anticoncepcion, prevencion de its y de cancer de cuello uterino",pildora: usuarias continuas,2015-04-01,0,0,10,2,0,12
CURAHUARA DE CARANGAS,"anticoncepcion, prevencion de its y de cancer de cuello uterino",pildora: usuarias continuas,2015-04-01,0,0,2,0,0,2
CURVA,"anticoncepcion, prevencion de its y de cancer de cuello uterino",pildora: usuarias continuas,2015-04-01,0,0,1,0,0,1
DESAGUADERO,"anticoncepcion, prevencion de its y de cancer de cuello uterino",pildora: usuarias continuas,2015-04-01,0,0,2,1,0,3
EL ALTO,"anticoncepcion, prevencion de its y de cancer de cuello uterino",pildora: usuarias continuas,2015-04-01,0,10,145,51,0,206
EL CHORO,"anticoncepcion, prevencion de its y de cancer de cuello uterino",pildora: usuarias continuas,2015-04-01,0,0,1,0,0,1
EL PUENTE(STC),"anticoncepcion, prevencion de its y de cancer de cuello uterino",pildora: usuarias continuas,2015-04-01,0,0,18,1,0,19
EL PUENTE(TJA),"anticoncepcion, prevencion de its y de cancer de cuello uterino",pildora: usuarias continuas,2015-04-01,0,1,5,5,0,11
EL TORNO,"anticoncepcion, prevencion de its y de cancer de cuello uterino",pildora: usuarias continuas,2015-04-01,2,7,38,9,1,57
EL VILLAR,"anticoncepcion, prevencion de its y de cancer de cuello uterino",pildora: usuarias continuas,2015-04-01,0,0,3,1,0,4
ENTRE RIOS TRJ,"anticoncepcion, prevencion de its y de cancer de cuello uterino",pildora: usuarias continuas,2015-04-01,0,2,25,7,0,34
ENTRE RIOS CBBA,"anticoncepcion, prevencion de its y de cancer de cuello uterino",pildora: usuarias continuas,2015-04-01,0,0,4,3,0,7
EUREKA (SANTOS MERCADO),"anticoncepcion, prevencion de its y de cancer de cuello uterino",pildora: usuarias continuas,2015-04-01,0,0,5,1,0,6
EXALTACION,"anticoncepcion, prevencion de its y de cancer de cuello uterino",pildora: usuarias continuas,2015-04-01,0,0,1,0,0,1
FERNANDEZ ALONSO,"anticoncepcion, prevencion de its y de cancer de cuello uterino",pildora: usuarias continuas,2015-04-01,0,3,11,3,0,17
FILADELFIA,"anticoncepcion, prevencion de its y de cancer de cuello uterino",pildora: usuarias continuas,2015-04-01,0,7,8,4,0,19
GENERAL SAAVEDRA,"anticoncepcion, prevencion de its y de cancer de cuello uterino",pildora: usuarias continuas,2015-04-01,0,0,24,4,0,28
GRAL. J.J. PEREZ (CHARAZANI),"anticoncepcion, prevencion de its y de cancer de cuello uterino",pildora: usuarias continuas,2015-04-01,0,0,1,0,0,1
GUANAY,"anticoncepcion, prevencion de its y de cancer de cuello uterino",pildora: usuarias continuas,2015-04-01,0,1,1,0,0,2
GUAYARAMERIN,"anticoncepcion, prevencion de its y de cancer de cuello uterino",pildora: usuarias continuas,2015-04-01,0,0,3,0,0,3
GUTIERREZ,"anticoncepcion, prevencion de its y de cancer de cuello uterino",pildora: usuarias continuas,2015-04-01,0,0,2,3,0,5
HUACARETA,"anticoncepcion, prevencion de its y de cancer de cuello uterino",pildora: usuarias continuas,2015-04-01,0,0,1,4,0,5
HUACAYA (VILLA DE HUACAYA),"anticoncepcion, prevencion de its y de cancer de cuello uterino",pildora: usuarias continuas,2015-04-01,0,1,0,0,0,1
HUANUNI,"anticoncepcion, prevencion de its y de cancer de cuello uterino",pildora: usuarias continuas,2015-04-01,0,0,3,0,0,3
HUARACAJE,"anticoncepcion, prevencion de its y de cancer de cuello uterino",pildora: usuarias continuas,2015-04-01,0,3,15,10,0,28
HUARINA,"anticoncepcion, prevencion de its y de cancer de cuello uterino",pildora: usuarias continuas,2015-04-01,0,0,0,1,0,1
HUATAJATA,"anticoncepcion, prevencion de its y de cancer de cuello uterino",pildora: usuarias continuas,2015-04-01,0,0,0,1,0,1
HUAYLLAMARCA,"anticoncepcion, prevencion de its y de cancer de cuello uterino",pildora: usuarias continuas,2015-04-01,0,0,2,0,0,2
ICLA,"anticoncepcion, prevencion de its y de cancer de cuello uterino",pildora: usuarias continuas,2015-04-01,0,0,5,2,0,7
INCAHUASI,"anticoncepcion, prevencion de its y de cancer de cuello uterino",pildora: usuarias continuas,2015-04-01,0,1,3,2,0,6
INGAVI (HUMAITA),"anticoncepcion, prevencion de its y de cancer de cuello uterino",pildora: usuarias continuas,2015-04-01,0,0,3,0,0,3
INQUISIVI,"anticoncepcion, prevencion de its y de cancer de cuello uterino",pildora: usuarias continuas,2015-04-01,0,0,1,1,0,2
IRUPANA (VILLA DE LANZA),"anticoncepcion, prevencion de its y de cancer de cuello uterino",pildora: usuarias continuas,2015-04-01,0,1,7,2,0,10
IXIAMAS,"anticoncepcion, prevencion de its y de cancer de cuello uterino",pildora: usuarias continuas,2015-04-01,0,0,11,1,0,12
JESUS DE MACHACA,"anticoncepcion, prevencion de its y de cancer de cuello uterino",pildora: usuarias continuas,2015-04-01,0,0,3,0,0,3
LA ASUNTA,"anticoncepcion, prevencion de its y de cancer de cuello uterino",pildora: usuarias continuas,2015-04-01,0,1,14,6,0,21
LA GUARDIA,"anticoncepcion, prevencion de its y de cancer de cuello uterino",pildora: usuarias continuas,2015-04-01,0,3,37,7,0,47
LA PAZ,"anticoncepcion, prevencion de its y de cancer de cuello uterino",pildora: usuarias continuas,2015-04-01,0,6,98,29,0,133
LAJA,"anticoncepcion, prevencion de its y de cancer de cuello uterino",pildora: usuarias continuas,2015-04-01,0,0,7,5,0,12
LAS CARRERAS,"anticoncepcion, prevencion de its y de cancer de cuello uterino",pildora: usuarias continuas,2015-04-01,0,0,1,0,0,1
LICOMA PAMPA,"anticoncepcion, prevencion de its y de cancer de cuello uterino",pildora: usuarias continuas,2015-04-01,0,0,2,0,0,2
LLALLAGUA,"anticoncepcion, prevencion de its y de cancer de cuello uterino",pildora: usuarias continuas,2015-04-01,0,0,11,0,0,11
LLICA,"anticoncepcion, prevencion de its y de cancer de cuello uterino",pildora: usuarias continuas,2015-04-01,0,1,5,3,0,9
LORETO,"anticoncepcion, prevencion de its y de cancer de cuello uterino",pildora: usuarias continuas,2015-04-01,0,1,8,0,0,9
MACHARETI,"anticoncepcion, prevencion de its y de cancer de cuello uterino",pildora: usuarias continuas,2015-04-01,1,0,13,4,0,18
MAGDALENA,"anticoncepcion, prevencion de its y de cancer de cuello uterino",pildora: usuarias continuas,2015-04-01,0,3,24,6,0,33
MAIRANA,"anticoncepcion, prevencion de its y de cancer de cuello uterino",pildora: usuarias continuas,2015-04-01,0,0,8,0,0,8
MAPIRI,"anticoncepcion, prevencion de its y de cancer de cuello uterino",pildora: usuarias continuas,2015-04-01,0,0,2,0,0,2
MECAPACA,"anticoncepcion, prevencion de its y de cancer de cuello uterino",pildora: usuarias continuas,2015-04-01,0,0,2,3,0,5
MINEROS,"anticoncepcion, prevencion de its y de cancer de cuello uterino",pildora: usuarias continuas,2015-04-01,0,5,14,4,0,23
MIZQUE,"anticoncepcion, prevencion de its y de cancer de cuello uterino",pildora: usuarias continuas,2015-04-01,0,0,4,2,0,6
MOCOMOCO,"anticoncepcion, prevencion de its y de cancer de cuello uterino",pildora: usuarias continuas,2015-04-01,0,0,2,1,0,3
MOJINETE,"anticoncepcion, prevencion de its y de cancer de cuello uterino",pildora: usuarias continuas,2015-04-01,0,0,1,0,0,1
MOJOCOYA,"anticoncepcion, prevencion de its y de cancer de cuello uterino",pildora: usuarias continuas,2015-04-01,0,0,3,2,0,5
MONTEAGUDO,"anticoncepcion, prevencion de its y de cancer de cuello uterino",pildora: usuarias continuas,2015-04-01,0,0,5,3,0,8
MONTERO,"anticoncepcion, prevencion de its y de cancer de cuello uterino",pildora: usuarias continuas,2015-04-01,5,10,42,30,2,89
MORO MORO,"anticoncepcion, prevencion de its y de cancer de cuello uterino",pildora: usuarias continuas,2015-04-01,0,0,5,1,0,6
MOROCHATA,"anticoncepcion, prevencion de its y de cancer de cuello uterino",pildora: usuarias continuas,2015-04-01,0,0,2,3,0,5
NACEBE (SANTA ROSA DEL ABUNA),"anticoncepcion, prevencion de its y de cancer de cuello uterino",pildora: usuarias continuas,2015-04-01,0,2,2,0,0,4
OCURI,"anticoncepcion, prevencion de its y de cancer de cuello uterino",pildora: usuarias continuas,2015-04-01,0,0,3,0,0,3
OKINAWA,"anticoncepcion, prevencion de its y de cancer de cuello uterino",pildora: usuarias continuas,2015-04-01,0,0,17,9,0,26
OMEREQUE,"anticoncepcion, prevencion de its y de cancer de cuello uterino",pildora: usuarias continuas,2015-04-01,0,0,5,1,0,6
ORURO,"anticoncepcion, prevencion de its y de cancer de cuello uterino",pildora: usuarias continuas,2015-04-01,0,13,54,27,0,94
PADCAYA,"anticoncepcion, prevencion de its y de cancer de cuello uterino",pildora: usuarias continuas,2015-04-01,0,2,22,9,0,33
PADILLA,"anticoncepcion, prevencion de its y de cancer de cuello uterino",pildora: usuarias continuas,2015-04-01,0,1,8,6,0,15
PAILON,"anticoncepcion, prevencion de its y de cancer de cuello uterino",pildora: usuarias continuas,2015-04-01,0,1,9,4,1,15
PALOS BLANCOS,"anticoncepcion, prevencion de its y de cancer de cuello uterino",pildora: usuarias continuas,2015-04-01,0,1,24,15,0,40
PAMPA AULLAGAS,"anticoncepcion, prevencion de its y de cancer de cuello uterino",pildora: usuarias continuas,2015-04-01,0,0,0,1,0,1
PAMPA GRANDE,"anticoncepcion, prevencion de its y de cancer de cuello uterino",pildora: usuarias continuas,2015-04-01,0,0,2,4,0,6
PAPEL PAMPA,"anticoncepcion, prevencion de its y de cancer de cuello uterino",pildora: usuarias continuas,2015-04-01,0,0,4,0,0,4
PASORAPA,"anticoncepcion, prevencion de its y de cancer de cuello uterino",pildora: usuarias continuas,2015-04-01,0,0,3,0,0,3
PATACAMAYA,"anticoncepcion, prevencion de its y de cancer de cuello uterino",pildora: usuarias continuas,2015-04-01,0,2,2,0,0,4
PAZÑA,"anticoncepcion, prevencion de its y de cancer de cuello uterino",pildora: usuarias continuas,2015-04-01,0,0,1,3,0,4
PELECHUCO,"anticoncepcion, prevencion de its y de cancer de cuello uterino",pildora: usuarias continuas,2015-04-01,0,0,8,2,0,10
POCOATA,"anticoncepcion, prevencion de its y de cancer de cuello uterino",pildora: usuarias continuas,2015-04-01,0,0,1,1,0,2
POCONA,"anticoncepcion, prevencion de its y de cancer de cuello uterino",pildora: usuarias continuas,2015-04-01,0,0,3,6,0,9
POJO (CBBA),"anticoncepcion, prevencion de its y de cancer de cuello uterino",pildora: usuarias continuas,2015-04-01,0,1,5,4,0,10
POOPO,"anticoncepcion, prevencion de its y de cancer de cuello uterino",pildora: usuarias continuas,2015-04-01,0,0,1,0,0,1
PORCO,"anticoncepcion, prevencion de its y de cancer de cuello uterino",pildora: usuarias continuas,2015-04-01,0,0,10,0,0,10
PORONGO,"anticoncepcion, prevencion de its y de cancer de cuello uterino",pildora: usuarias continuas,2015-04-01,0,0,7,2,0,9
PORTACHUELO,"anticoncepcion, prevencion de its y de cancer de cuello uterino",pildora: usuarias continuas,2015-04-01,0,0,17,7,1,25
PORVENIR,"anticoncepcion, prevencion de its y de cancer de cuello uterino",pildora: usuarias continuas,2015-04-01,0,0,10,1,0,11
POSTRER VALLE,"anticoncepcion, prevencion de its y de cancer de cuello uterino",pildora: usuarias continuas,2015-04-01,0,0,2,1,0,3
POTOSI,"anticoncepcion, prevencion de its y de cancer de cuello uterino",pildora: usuarias continuas,2015-04-01,0,4,75,10,0,89
PRESTO,"anticoncepcion, prevencion de its y de cancer de cuello uterino",pildora: usuarias continuas,2015-04-01,0,0,4,1,0,5
PUCARA,"anticoncepcion, prevencion de its y de cancer de cuello uterino",pildora: usuarias continuas,2015-04-01,0,0,1,0,0,1
PUCARANI,"anticoncepcion, prevencion de its y de cancer de cuello uterino",pildora: usuarias continuas,2015-04-01,0,0,0,1,0,1
PUERTO GONZALO MORENO,"anticoncepcion, prevencion de its y de cancer de cuello uterino",pildora: usuarias continuas,2015-04-01,0,2,4,1,1,8
PUERTO QUIJARRO,"anticoncepcion, prevencion de its y de cancer de cuello uterino",pildora: usuarias continuas,2015-04-01,0,0,15,7,0,22
PUERTO RICO,"anticoncepcion, prevencion de its y de cancer de cuello uterino",pildora: usuarias continuas,2015-04-01,0,0,10,1,0,11
PUERTO SILES,"anticoncepcion, prevencion de its y de cancer de cuello uterino",pildora: usuarias continuas,2015-04-01,0,0,5,0,0,5
PUERTO SUAREZ,"anticoncepcion, prevencion de its y de cancer de cuello uterino",pildora: usuarias continuas,2015-04-01,0,0,11,3,0,14
PUERTO VILLARROEL,"anticoncepcion, prevencion de its y de cancer de cuello uterino",pildora: usuarias continuas,2015-04-01,1,4,9,6,0,20
PUNA,"anticoncepcion, prevencion de its y de cancer de cuello uterino",pildora: usuarias continuas,2015-04-01,0,1,6,4,0,11
PUNATA,"anticoncepcion, prevencion de its y de cancer de cuello uterino",pildora: usuarias continuas,2015-04-01,0,0,2,1,0,3
QUIABAYA,"anticoncepcion, prevencion de its y de cancer de cuello uterino",pildora: usuarias continuas,2015-04-01,0,0,2,0,0,2
QUILLACOLLO,"anticoncepcion, prevencion de its y de cancer de cuello uterino",pildora: usuarias continuas,2015-04-01,0,1,25,4,0,30
QUIME,"anticoncepcion, prevencion de its y de cancer de cuello uterino",pildora: usuarias continuas,2015-04-01,0,0,8,0,0,8
QUIRUSILLAS,"anticoncepcion, prevencion de its y de cancer de cuello uterino",pildora: usuarias continuas,2015-04-01,0,3,6,0,0,9
REYES,"anticoncepcion, prevencion de its y de cancer de cuello uterino",pildora: usuarias continuas,2015-04-01,0,7,20,9,0,36
RIBERALTA,"anticoncepcion, prevencion de its y de cancer de cuello uterino",pildora: usuarias continuas,2015-04-01,2,5,26,3,0,36
ROBORE,"anticoncepcion, prevencion de its y de cancer de cuello uterino",pildora: usuarias continuas,2015-04-01,0,2,11,8,1,22
RURRENABAQUE,"anticoncepcion, prevencion de its y de cancer de cuello uterino",pildora: usuarias continuas,2015-04-01,0,1,5,4,0,10
SABAYA,"anticoncepcion, prevencion de its y de cancer de cuello uterino",pildora: usuarias continuas,2015-04-01,0,0,2,0,0,2
SACABA,"anticoncepcion, prevencion de its y de cancer de cuello uterino",pildora: usuarias continuas,2015-04-01,0,5,19,6,0,30
SACACA,"anticoncepcion, prevencion de its y de cancer de cuello uterino",pildora: usuarias continuas,2015-04-01,0,0,5,1,0,6
SAIPINA,"anticoncepcion, prevencion de its y de cancer de cuello uterino",pildora: usuarias continuas,2015-04-01,0,1,1,1,0,3
SALINAS DE GARCI MENDOZA,"anticoncepcion, prevencion de its y de cancer de cuello uterino",pildora: usuarias continuas,2015-04-01,0,0,1,0,0,1
SAMAIPATA,"anticoncepcion, prevencion de its y de cancer de cuello uterino",pildora: usuarias continuas,2015-04-01,0,1,16,2,0,19
SAN AGUSTIN,"anticoncepcion, prevencion de its y de cancer de cuello uterino",pildora: usuarias continuas,2015-04-01,0,0,1,1,0,2
SAN ANDRES,"anticoncepcion, prevencion de its y de cancer de cuello uterino",pildora: usuarias continuas,2015-04-01,1,9,26,4,0,40
SAN ANTONIO DE ESMORUCO,"anticoncepcion, prevencion de its y de cancer de cuello uterino",pildora: usuarias continuas,2015-04-01,0,0,1,0,0,1
SAN ANTONIO DE LOMERIO,"anticoncepcion, prevencion de its y de cancer de cuello uterino",pildora: usuarias continuas,2015-04-01,0,2,8,5,0,15
SAN BORJA,"anticoncepcion, prevencion de its y de cancer de cuello uterino",pildora: usuarias continuas,2015-04-01,0,5,49,14,2,70
SAN BUENA VENTURA,"anticoncepcion, prevencion de its y de cancer de cuello uterino",pildora: usuarias continuas,2015-04-01,0,0,3,0,0,3
SAN CARLOS,"anticoncepcion, prevencion de its y de cancer de cuello uterino",pildora: usuarias continuas,2015-04-01,0,1,25,5,0,31
SAN IGNACIO,"anticoncepcion, prevencion de its y de cancer de cuello uterino",pildora: usuarias continuas,2015-04-01,0,7,59,36,0,102
SAN IGNACIO DE VELASCO,"anticoncepcion, prevencion de its y de cancer de cuello uterino",pildora: usuarias continuas,2015-04-01,1,6,64,16,0,87
SAN JAVIER(BNI),"anticoncepcion, prevencion de its y de cancer de cuello uterino",pildora: usuarias continuas,2015-04-01,0,0,3,1,0,4
SAN JAVIER(STC),"anticoncepcion, prevencion de its y de cancer de cuello uterino",pildora: usuarias continuas,2015-04-01,0,1,13,3,0,17
SAN JOAQUIN,"anticoncepcion, prevencion de its y de cancer de cuello uterino",pildora: usuarias continuas,2015-04-01,0,2,1,2,0,5
SAN JOSE DE CHIQUITOS,"anticoncepcion, prevencion de its y de cancer de cuello uterino",pildora: usuarias continuas,2015-04-01,0,1,7,16,4,28
SAN JUAN DE YAPACANI,"anticoncepcion, prevencion de its y de cancer de cuello uterino",pildora: usuarias continuas,2015-04-01,0,0,11,1,0,12
SAN JULIAN,"anticoncepcion, prevencion de its y de cancer de cuello uterino",pildora: usuarias continuas,2015-04-01,0,1,6,2,0,9
SAN LORENZO(PND),"anticoncepcion, prevencion de its y de cancer de cuello uterino",pildora: usuarias continuas,2015-04-01,0,1,6,0,0,7
SAN LORENZO(TJA),"anticoncepcion, prevencion de its y de cancer de cuello uterino",pildora: usuarias continuas,2015-04-01,0,2,13,10,1,26
SAN LUCAS,"anticoncepcion, prevencion de its y de cancer de cuello uterino",pildora: usuarias continuas,2015-04-01,0,0,1,2,0,3
SAN MATIAS,"anticoncepcion, prevencion de its y de cancer de cuello uterino",pildora: usuarias continuas,2015-04-01,1,1,13,3,0,18
SAN MIGUEL DE VELASCO,"anticoncepcion, prevencion de its y de cancer de cuello uterino",pildora: usuarias continuas,2015-04-01,0,2,36,13,1,52
SAN PEDRO,"anticoncepcion, prevencion de its y de cancer de cuello uterino",pildora: usuarias continuas,2015-04-01,0,1,6,5,0,12
SAN PEDRO DE BUENA VISTA,"anticoncepcion, prevencion de its y de cancer de cuello uterino",pildora: usuarias continuas,2015-04-01,0,0,5,1,0,6
SAN PEDRO DE CURAHUARA,"anticoncepcion, prevencion de its y de cancer de cuello uterino",pildora: usuarias continuas,2015-04-01,0,0,1,0,0,1
SAN PEDRO DE QUEMES,"anticoncepcion, prevencion de its y de cancer de cuello uterino",pildora: usuarias continuas,2015-04-01,0,0,0,1,0,1
SAN PEDRO DE TIQUINA,"anticoncepcion, prevencion de its y de cancer de cuello uterino",pildora: usuarias continuas,2015-04-01,0,0,1,0,0,1
SAN PEDRO(PND),"anticoncepcion, prevencion de its y de cancer de cuello uterino",pildora: usuarias continuas,2015-04-01,0,0,3,0,0,3
SAN RAFAEL,"anticoncepcion, prevencion de its y de cancer de cuello uterino",pildora: usuarias continuas,2015-04-01,0,1,15,8,0,24
SAN RAMON BENI,"anticoncepcion, prevencion de its y de cancer de cuello uterino",pildora: usuarias continuas,2015-04-01,0,1,9,2,0,12
SAN RAMON SCZ,"anticoncepcion, prevencion de its y de cancer de cuello uterino",pildora: usuarias continuas,2015-04-01,0,0,4,3,0,7
SANTA ANA,"anticoncepcion, prevencion de its y de cancer de cuello uterino",pildora: usuarias continuas,2015-04-01,0,10,27,13,0,50
SANTA CRUZ DE LA SIERRA,"anticoncepcion, prevencion de its y de cancer de cuello uterino",pildora: usuarias continuas,2015-04-01,0,52,145,58,1,256
SANTA ROSA,"anticoncepcion, prevencion de its y de cancer de cuello uterino",pildora: usuarias continuas,2015-04-01,0,1,3,2,0,6
SANTA ROSA DEL SARA,"anticoncepcion, prevencion de its y de cancer de cuello uterino",pildora: usuarias continuas,2015-04-01,0,5,24,9,0,38
SANTIAGO DE HUATA,"anticoncepcion, prevencion de its y de cancer de cuello uterino",pildora: usuarias continuas,2015-04-01,0,0,3,1,0,4
SANTIVAÑES,"anticoncepcion, prevencion de its y de cancer de cuello uterino",pildora: usuarias continuas,2015-04-01,0,3,2,0,0,5
SANTUARIO DE QUILLACAS,"anticoncepcion, prevencion de its y de cancer de cuello uterino",pildora: usuarias continuas,2015-04-01,0,0,2,0,0,2
SAPAHAQUI,"anticoncepcion, prevencion de its y de cancer de cuello uterino",pildora: usuarias continuas,2015-04-01,0,0,2,0,0,2
SENA,"anticoncepcion, prevencion de its y de cancer de cuello uterino",pildora: usuarias continuas,2015-04-01,0,0,3,0,0,3
SHINAOTA,"anticoncepcion, prevencion de its y de cancer de cuello uterino",pildora: usuarias continuas,2015-04-01,0,1,2,0,0,3
SICAYA,"anticoncepcion, prevencion de its y de cancer de cuello uterino",pildora: usuarias continuas,2015-04-01,0,0,0,1,0,1
SIPE SIPE,"anticoncepcion, prevencion de its y de cancer de cuello uterino",pildora: usuarias continuas,2015-04-01,0,0,10,0,0,10
SOPACHUY,"anticoncepcion, prevencion de its y de cancer de cuello uterino",pildora: usuarias continuas,2015-04-01,0,0,2,1,0,3
SORATA,"anticoncepcion, prevencion de its y de cancer de cuello uterino",pildora: usuarias continuas,2015-04-01,0,0,1,2,0,3
SUCRE,"anticoncepcion, prevencion de its y de cancer de cuello uterino",pildora: usuarias continuas,2015-04-01,0,13,77,16,0,106
TACACOMA,"anticoncepcion, prevencion de its y de cancer de cuello uterino",pildora: usuarias continuas,2015-04-01,0,0,2,1,0,3
TARABUCO,"anticoncepcion, prevencion de its y de cancer de cuello uterino",pildora: usuarias continuas,2015-04-01,0,0,6,1,0,7
TARACO,"anticoncepcion, prevencion de its y de cancer de cuello uterino",pildora: usuarias continuas,2015-04-01,0,0,0,2,0,2
TARATA,"anticoncepcion, prevencion de its y de cancer de cuello uterino",pildora: usuarias continuas,2015-04-01,0,0,2,0,0,2
TARIJA,"anticoncepcion, prevencion de its y de cancer de cuello uterino",pildora: usuarias continuas,2015-04-01,0,10,58,19,1,88
TARVITA,"anticoncepcion, prevencion de its y de cancer de cuello uterino",pildora: usuarias continuas,2015-04-01,0,1,2,6,0,9
TEOPONTE,"anticoncepcion, prevencion de its y de cancer de cuello uterino",pildora: usuarias continuas,2015-04-01,0,0,2,2,0,4
TIAWANACU,"anticoncepcion, prevencion de its y de cancer de cuello uterino",pildora: usuarias continuas,2015-04-01,0,0,2,6,0,8
TIPUANI,"anticoncepcion, prevencion de its y de cancer de cuello uterino",pildora: usuarias continuas,2015-04-01,0,0,4,0,0,4
TIQUIPAYA,"anticoncepcion, prevencion de its y de cancer de cuello uterino",pildora: usuarias continuas,2015-04-01,0,2,12,1,0,15
TIRAQUE (CBBA),"anticoncepcion, prevencion de its y de cancer de cuello uterino",pildora: usuarias continuas,2015-04-01,0,0,2,1,0,3
TOLATA,"anticoncepcion, prevencion de its y de cancer de cuello uterino",pildora: usuarias continuas,2015-04-01,0,0,0,2,0,2
TOLEDO,"anticoncepcion, prevencion de its y de cancer de cuello uterino",pildora: usuarias continuas,2015-04-01,0,0,1,0,0,1
TOMAVE,"anticoncepcion, prevencion de its y de cancer de cuello uterino",pildora: usuarias continuas,2015-04-01,0,0,8,2,0,10
TOMINA,"anticoncepcion, prevencion de its y de cancer de cuello uterino",pildora: usuarias continuas,2015-04-01,0,0,6,3,0,9
TORO TORO,"anticoncepcion, prevencion de its y de cancer de cuello uterino",pildora: usuarias continuas,2015-04-01,0,0,3,0,0,3
TOTORA(CBBA),"anticoncepcion, prevencion de its y de cancer de cuello uterino",pildora: usuarias continuas,2015-04-01,0,0,3,0,0,3
TRIGAL,"anticoncepcion, prevencion de its y de cancer de cuello uterino",pildora: usuarias continuas,2015-04-01,0,0,1,0,0,1
TRINIDAD,"anticoncepcion, prevencion de its y de cancer de cuello uterino",pildora: usuarias continuas,2015-04-01,0,1,19,7,0,27
TUPIZA,"anticoncepcion, prevencion de its y de cancer de cuello uterino",pildora: usuarias continuas,2015-04-01,0,1,4,1,0,6
TURCO,"anticoncepcion, prevencion de its y de cancer de cuello uterino",pildora: usuarias continuas,2015-04-01,0,0,1,0,0,1
UNCIA,"anticoncepcion, prevencion de its y de cancer de cuello uterino",pildora: usuarias continuas,2015-04-01,0,0,4,1,0,5
URIONDO (A. CONCEPCION),"anticoncepcion, prevencion de its y de cancer de cuello uterino",pildora: usuarias continuas,2015-04-01,0,1,18,2,0,21
URUBICHA,"anticoncepcion, prevencion de its y de cancer de cuello uterino",pildora: usuarias continuas,2015-04-01,0,2,6,1,0,9
UYUNI,"anticoncepcion, prevencion de its y de cancer de cuello uterino",pildora: usuarias continuas,2015-04-01,0,3,5,1,0,9
VACAS,"anticoncepcion, prevencion de its y de cancer de cuello uterino",pildora: usuarias continuas,2015-04-01,0,0,2,2,0,4
VALLEGRANDE,"anticoncepcion, prevencion de its y de cancer de cuello uterino",pildora: usuarias continuas,2015-04-01,1,0,6,0,0,7
VIACHA,"anticoncepcion, prevencion de its y de cancer de cuello uterino",pildora: usuarias continuas,2015-04-01,0,1,13,9,0,23
VILA VILA,"anticoncepcion, prevencion de its y de cancer de cuello uterino",pildora: usuarias continuas,2015-04-01,0,0,1,0,0,1
VILLA CHARCAS,"anticoncepcion, prevencion de its y de cancer de cuello uterino",pildora: usuarias continuas,2015-04-01,0,0,2,1,0,3
VILLA MONTES,"anticoncepcion, prevencion de its y de cancer de cuello uterino",pildora: usuarias continuas,2015-04-01,0,2,29,6,3,40
VILLA NUEVA (LOMA ALTA),"anticoncepcion, prevencion de its y de cancer de cuello uterino",pildora: usuarias continuas,2015-04-01,0,0,3,0,0,3
VILLA SERRANO,"anticoncepcion, prevencion de its y de cancer de cuello uterino",pildora: usuarias continuas,2015-04-01,0,1,5,2,0,8
VILLA TUNARI,"anticoncepcion, prevencion de its y de cancer de cuello uterino",pildora: usuarias continuas,2015-04-01,0,10,49,17,0,76
VILLA VACA GUZMAN (MUYUPAMPA),"anticoncepcion, prevencion de its y de cancer de cuello uterino",pildora: usuarias continuas,2015-04-01,0,3,9,2,0,14
VILLAZON,"anticoncepcion, prevencion de its y de cancer de cuello uterino",pildora: usuarias continuas,2015-04-01,0,1,14,4,0,19
VINTO,"anticoncepcion, prevencion de its y de cancer de cuello uterino",pildora: usuarias continuas,2015-04-01,0,0,9,0,0,9
VITICHI,"anticoncepcion, prevencion de its y de cancer de cuello uterino",pildora: usuarias continuas,2015-04-01,0,0,1,0,0,1
WARNES,"anticoncepcion, prevencion de its y de cancer de cuello uterino",pildora: usuarias continuas,2015-04-01,0,9,56,16,0,81
YACO,"anticoncepcion, prevencion de its y de cancer de cuello uterino",pildora: usuarias continuas,2015-04-01,0,0,1,0,0,1
YACUIBA,"anticoncepcion, prevencion de its y de cancer de cuello uterino",pildora: usuarias continuas,2015-04-01,0,2,14,10,0,26
YAMPARAEZ,"anticoncepcion, prevencion de its y de cancer de cuello uterino",pildora: usuarias continuas,2015-04-01,0,0,0,1,0,1
YANACACHI,"anticoncepcion, prevencion de its y de cancer de cuello uterino",pildora: usuarias continuas,2015-04-01,0,0,3,0,0,3
YAPACANI,"anticoncepcion, prevencion de its y de cancer de cuello uterino",pildora: usuarias continuas,2015-04-01,0,3,28,2,0,33
YOTALA,"anticoncepcion, prevencion de its y de cancer de cuello uterino",pildora: usuarias continuas,2015-04-01,0,0,0,1,0,1
YUNCHARA,"anticoncepcion, prevencion de its y de cancer de cuello uterino",pildora: usuarias continuas,2015-04-01,0,0,6,3,0,9
ZUDAÑEZ,"anticoncepcion, prevencion de its y de cancer de cuello uterino",pildora: usuarias continuas,2015-04-01,0,1,3,1,0,5
ACHACACHI,"anticoncepcion, prevencion de its y de cancer de cuello uterino",pildora: usuarias continuas,2015-05-01,0,0,5,1,0,6
ACHOCALLA,"anticoncepcion, prevencion de its y de cancer de cuello uterino",pildora: usuarias continuas,2015-05-01,0,0,4,4,0,8
AIQUILE,"anticoncepcion, prevencion de its y de cancer de cuello uterino",pildora: usuarias continuas,2015-05-01,0,0,2,0,0,2
ALCALA,"anticoncepcion, prevencion de its y de cancer de cuello uterino",pildora: usuarias continuas,2015-05-01,0,0,2,2,0,4
ALTO BENI,"anticoncepcion, prevencion de its y de cancer de cuello uterino",pildora: usuarias continuas,2015-05-01,0,3,5,4,0,12
ANCORAIMES,"anticoncepcion, prevencion de its y de cancer de cuello uterino",pildora: usuarias continuas,2015-05-01,0,0,3,3,0,6
APOLO,"anticoncepcion, prevencion de its y de cancer de cuello uterino",pildora: usuarias continuas,2015-05-01,0,0,0,1,0,1
ARAMPAMPA,"anticoncepcion, prevencion de its y de cancer de cuello uterino",pildora: usuarias continuas,2015-05-01,0,0,0,2,0,2
ARANI,"anticoncepcion, prevencion de its y de cancer de cuello uterino",pildora: usuarias continuas,2015-05-01,0,1,1,1,0,3
ARBIETO,"anticoncepcion, prevencion de its y de cancer de cuello uterino",pildora: usuarias continuas,2015-05-01,0,0,5,1,0,6
ARQUE,"anticoncepcion, prevencion de its y de cancer de cuello uterino",pildora: usuarias continuas,2015-05-01,0,0,3,2,0,5
ASCENCION DE GUARAYOS,"anticoncepcion, prevencion de its y de cancer de cuello uterino",pildora: usuarias continuas,2015-05-01,0,2,5,1,0,8
ATOCHA,"anticoncepcion, prevencion de its y de cancer de cuello uterino",pildora: usuarias continuas,2015-05-01,0,0,8,3,0,11
AUCAPATA,"anticoncepcion, prevencion de its y de cancer de cuello uterino",pildora: usuarias continuas,2015-05-01,0,0,2,0,0,2
AYATA,"anticoncepcion, prevencion de its y de cancer de cuello uterino",pildora: usuarias continuas,2015-05-01,0,0,3,3,0,6
AYOPAYA (V. DE INDEPENDENCIA),"anticoncepcion, prevencion de its y de cancer de cuello uterino",pildora: usuarias continuas,2015-05-01,0,2,7,9,0,18
BATALLAS,"anticoncepcion, prevencion de its y de cancer de cuello uterino",pildora: usuarias continuas,2015-05-01,0,0,2,2,0,4
BAURES,"anticoncepcion, prevencion de its y de cancer de cuello uterino",pildora: usuarias continuas,2015-05-01,0,0,15,5,0,20
BELLA FLOR,"anticoncepcion, prevencion de its y de cancer de cuello uterino",pildora: usuarias continuas,2015-05-01,0,0,5,1,0,6
BERMEJO,"anticoncepcion, prevencion de its y de cancer de cuello uterino",pildora: usuarias continuas,2015-05-01,0,4,12,5,0,21
BETANZOS,"anticoncepcion, prevencion de its y de cancer de cuello uterino",pildora: usuarias continuas,2015-05-01,0,0,2,0,0,2
BOLIVAR,"anticoncepcion, prevencion de its y de cancer de cuello uterino",pildora: usuarias continuas,2015-05-01,0,0,1,0,0,1
BOLPEBRA,"anticoncepcion, prevencion de its y de cancer de cuello uterino",pildora: usuarias continuas,2015-05-01,0,2,2,0,0,4
BOYUIBE,"anticoncepcion, prevencion de its y de cancer de cuello uterino",pildora: usuarias continuas,2015-05-01,0,0,0,1,0,1
BUENA VISTA,"anticoncepcion, prevencion de its y de cancer de cuello uterino",pildora: usuarias continuas,2015-05-01,0,7,22,7,0,36
CABEZAS,"anticoncepcion, prevencion de its y de cancer de cuello uterino",pildora: usuarias continuas,2015-05-01,0,3,24,8,0,35
CAIROMA,"anticoncepcion, prevencion de its y de cancer de cuello uterino",pildora: usuarias continuas,2015-05-01,0,0,0,2,0,2
"CAIZA ""D""","anticoncepcion, prevencion de its y de cancer de cuello uterino",pildora: usuarias continuas,2015-05-01,0,0,4,1,0,5
CALAMARCA,"anticoncepcion, prevencion de its y de cancer de cuello uterino",pildora: usuarias continuas,2015-05-01,0,0,2,2,0,4
CAMIRI,"anticoncepcion, prevencion de its y de cancer de cuello uterino",pildora: usuarias continuas,2015-05-01,0,0,8,2,0,10
CAPINOTA,"anticoncepcion, prevencion de its y de cancer de cuello uterino",pildora: usuarias continuas,2015-05-01,0,0,4,1,0,5
CARACOLLO,"anticoncepcion, prevencion de its y de cancer de cuello uterino",pildora: usuarias continuas,2015-05-01,0,0,5,2,0,7
CARANAVI,"anticoncepcion, prevencion de its y de cancer de cuello uterino",pildora: usuarias continuas,2015-05-01,0,1,6,3,0,10
CARAPARI,"anticoncepcion, prevencion de its y de cancer de cuello uterino",pildora: usuarias continuas,2015-05-01,0,0,11,9,0,20
CARMEN RIVERO TORREZ,"anticoncepcion, prevencion de its y de cancer de cuello uterino",pildora: usuarias continuas,2015-05-01,0,0,2,0,0,2
CATACORA,"anticoncepcion, prevencion de its y de cancer de cuello uterino",pildora: usuarias continuas,2015-05-01,0,1,0,0,0,1
CHACARILLA,"anticoncepcion, prevencion de its y de cancer de cuello uterino",pildora: usuarias continuas,2015-05-01,0,0,1,0,0,1
CHALLAPATA,"anticoncepcion, prevencion de its y de cancer de cuello uterino",pildora: usuarias continuas,2015-05-01,0,1,0,0,0,1
CHAQUI,"anticoncepcion, prevencion de its y de cancer de cuello uterino",pildora: usuarias continuas,2015-05-01,0,0,0,2,0,2
CHARAGUA,"anticoncepcion, prevencion de its y de cancer de cuello uterino",pildora: usuarias continuas,2015-05-01,0,3,10,7,0,20
CHIMORE,"anticoncepcion, prevencion de its y de cancer de cuello uterino",pildora: usuarias continuas,2015-05-01,0,2,11,3,0,16
CHIPAYA,"anticoncepcion, prevencion de its y de cancer de cuello uterino",pildora: usuarias continuas,2015-05-01,0,1,2,0,0,3
CHUA COCANI,"anticoncepcion, prevencion de its y de cancer de cuello uterino",pildora: usuarias continuas,2015-05-01,0,0,2,0,0,2
CHULUMANI (V. DE LA LIBERTAD),"anticoncepcion, prevencion de its y de cancer de cuello uterino",pildora: usuarias continuas,2015-05-01,0,1,0,1,0,2
CHUMA,"anticoncepcion, prevencion de its y de cancer de cuello uterino",pildora: usuarias continuas,2015-05-01,0,0,1,1,0,2
CHUQUIHUTA AYLLU JUCUMANI,"anticoncepcion, prevencion de its y de cancer de cuello uterino",pildora: usuarias continuas,2015-05-01,0,1,5,0,0,6
CKOCHAS,"anticoncepcion, prevencion de its y de cancer de cuello uterino",pildora: usuarias continuas,2015-05-01,0,0,1,0,0,1
CLIZA,"anticoncepcion, prevencion de its y de cancer de cuello uterino",pildora: usuarias continuas,2015-05-01,0,0,6,2,0,8
COBIJA,"anticoncepcion, prevencion de its y de cancer de cuello uterino",pildora: usuarias continuas,2015-05-01,0,7,35,9,0,51
COCHABAMBA,"anticoncepcion, prevencion de its y de cancer de cuello uterino",pildora: usuarias continuas,2015-05-01,1,9,105,36,0,151
COIPASA,"anticoncepcion, prevencion de its y de cancer de cuello uterino",pildora: usuarias continuas,2015-05-01,0,0,1,0,0,1
COLCAPIRHUA,"anticoncepcion, prevencion de its y de cancer de cuello uterino",pildora: usuarias continuas,2015-05-01,0,1,5,0,0,6
COLOMI,"anticoncepcion, prevencion de its y de cancer de cuello uterino",pildora: usuarias continuas,2015-05-01,0,0,4,2,0,6
COLPA BELGICA,"anticoncepcion, prevencion de its y de cancer de cuello uterino",pildora: usuarias continuas,2015-05-01,0,4,8,2,0,14
COLQUECHACA,"anticoncepcion, prevencion de its y de cancer de cuello uterino",pildora: usuarias continuas,2015-05-01,0,1,9,2,0,12
COLQUENCHA,"anticoncepcion, prevencion de its y de cancer de cuello uterino",pildora: usuarias continuas,2015-05-01,0,0,2,2,1,5
COMARAPA,"anticoncepcion, prevencion de its y de cancer de cuello uterino",pildora: usuarias continuas,2015-05-01,0,0,7,2,0,9
CONCEPCION,"anticoncepcion, prevencion de its y de cancer de cuello uterino",pildora: usuarias continuas,2015-05-01,0,1,8,3,0,12
COPACABANA,"anticoncepcion, prevencion de its y de cancer de cuello uterino",pildora: usuarias continuas,2015-05-01,0,0,2,1,0,3
CORIPATA,"anticoncepcion, prevencion de its y de cancer de cuello uterino",pildora: usuarias continuas,2015-05-01,0,0,4,0,0,4
CORO CORO,"anticoncepcion, prevencion de its y de cancer de cuello uterino",pildora: usuarias continuas,2015-05-01,0,0,1,0,0,1
COROICO,"anticoncepcion, prevencion de its y de cancer de cuello uterino",pildora: usuarias continuas,2015-05-01,0,0,0,4,0,4
CORQUE,"anticoncepcion, prevencion de its y de cancer de cuello uterino",pildora: usuarias continuas,2015-05-01,0,0,0,1,0,1
COTAGAITA,"anticoncepcion, prevencion de its y de cancer de cuello uterino",pildora: usuarias continuas,2015-05-01,0,1,5,1,0,7
COTOCA,"anticoncepcion, prevencion de its y de cancer de cuello uterino",pildora: usuarias continuas,2015-05-01,0,6,32,7,1,46
CUATRO CAÑADAS,"anticoncepcion, prevencion de its y de cancer de cuello uterino",pildora: usuarias continuas,2015-05-01,0,4,3,2,0,9
CUEVO,"anticoncepcion, prevencion de its y de cancer de cuello uterino",pildora: usuarias continuas,2015-05-01,0,0,2,0,0,2
CULPINA,"anticoncepcion, prevencion de its y de cancer de cuello uterino",pildora: usuarias continuas,2015-05-01,0,0,3,1,0,4
CURVA,"anticoncepcion, prevencion de its y de cancer de cuello uterino",pildora: usuarias continuas,2015-05-01,0,0,2,0,0,2
DESAGUADERO,"anticoncepcion, prevencion de its y de cancer de cuello uterino",pildora: usuarias continuas,2015-05-01,0,1,1,0,0,2
EL ALTO,"anticoncepcion, prevencion de its y de cancer de cuello uterino",pildora: usuarias continuas,2015-05-01,0,14,178,42,0,234
EL PUENTE(STC),"anticoncepcion, prevencion de its y de cancer de cuello uterino",pildora: usuarias continuas,2015-05-01,0,3,7,5,0,15
EL PUENTE(TJA),"anticoncepcion, prevencion de its y de cancer de cuello uterino",pildora: usuarias continuas,2015-05-01,0,0,8,4,0,12
EL TORNO,"anticoncepcion, prevencion de its y de cancer de cuello uterino",pildora: usuarias continuas,2015-05-01,1,5,30,10,1,47
EL VILLAR,"anticoncepcion, prevencion de its y de cancer de cuello uterino",pildora: usuarias continuas,2015-05-01,0,0,3,2,0,5
ENTRE RIOS TRJ,"anticoncepcion, prevencion de its y de cancer de cuello uterino",pildora: usuarias continuas,2015-05-01,1,9,17,7,0,34
ENTRE RIOS CBBA,"anticoncepcion, prevencion de its y de cancer de cuello uterino",pildora: usuarias continuas,2015-05-01,0,0,17,4,0,21
ESCARA,"anticoncepcion, prevencion de its y de cancer de cuello uterino",pildora: usuarias continuas,2015-05-01,0,0,0,1,0,1
EUCALIPTUS,"anticoncepcion, prevencion de its y de cancer de cuello uterino",pildora: usuarias continuas,2015-05-01,0,0,0,2,0,2
EUREKA (SANTOS MERCADO),"anticoncepcion, prevencion de its y de cancer de cuello uterino",pildora: usuarias continuas,2015-05-01,0,0,2,0,0,2
EXALTACION,"anticoncepcion, prevencion de its y de cancer de cuello uterino",pildora: usuarias continuas,2015-05-01,0,0,2,0,0,2
FERNANDEZ ALONSO,"anticoncepcion, prevencion de its y de cancer de cuello uterino",pildora: usuarias continuas,2015-05-01,0,0,8,2,0,10
FILADELFIA,"anticoncepcion, prevencion de its y de cancer de cuello uterino",pildora: usuarias continuas,2015-05-01,0,0,18,6,0,24
GENERAL SAAVEDRA,"anticoncepcion, prevencion de its y de cancer de cuello uterino",pildora: usuarias continuas,2015-05-01,0,0,16,4,0,20
GRAL. J.J. PEREZ (CHARAZANI),"anticoncepcion, prevencion de its y de cancer de cuello uterino",pildora: usuarias continuas,2015-05-01,0,0,0,1,0,1
GUANAY,"anticoncepcion, prevencion de its y de cancer de cuello uterino",pildora: usuarias continuas,2015-05-01,0,0,1,0,0,1
GUAQUI,"anticoncepcion, prevencion de its y de cancer de cuello uterino",pildora: usuarias continuas,2015-05-01,0,0,0,1,0,1
GUAYARAMERIN,"anticoncepcion, prevencion de its y de cancer de cuello uterino",pildora: usuarias continuas,2015-05-01,1,1,2,1,0,5
GUTIERREZ,"anticoncepcion, prevencion de its y de cancer de cuello uterino",pildora: usuarias continuas,2015-05-01,0,0,2,0,0,2
HUACARETA,"anticoncepcion, prevencion de its y de cancer de cuello uterino",pildora: usuarias continuas,2015-05-01,0,0,9,4,0,13
HUACAYA (VILLA DE HUACAYA),"anticoncepcion, prevencion de its y de cancer de cuello uterino",pildora: usuarias continuas,2015-05-01,0,0,0,1,0,1
HUANUNI,"anticoncepcion, prevencion de its y de cancer de cuello uterino",pildora: usuarias continuas,2015-05-01,0,0,3,1,0,4
HUARACAJE,"anticoncepcion, prevencion de its y de cancer de cuello uterino",pildora: usuarias continuas,2015-05-01,0,5,17,8,0,30
HUAYLLAMARCA,"anticoncepcion, prevencion de its y de cancer de cuello uterino",pildora: usuarias continuas,2015-05-01,0,0,0,1,0,1
HUMANATA,"anticoncepcion, prevencion de its y de cancer de cuello uterino",pildora: usuarias continuas,2015-05-01,0,0,1,0,0,1
ICLA,"anticoncepcion, prevencion de its y de cancer de cuello uterino",pildora: usuarias continuas,2015-05-01,0,0,1,0,0,1
INCAHUASI,"anticoncepcion, prevencion de its y de cancer de cuello uterino",pildora: usuarias continuas,2015-05-01,0,0,4,1,1,6
INGAVI (HUMAITA),"anticoncepcion, prevencion de its y de cancer de cuello uterino",pildora: usuarias continuas,2015-05-01,0,0,2,0,0,2
INQUISIVI,"anticoncepcion, prevencion de its y de cancer de cuello uterino",pildora: usuarias continuas,2015-05-01,0,0,1,2,0,3
IRUPANA (VILLA DE LANZA),"anticoncepcion, prevencion de its y de cancer de cuello uterino",pildora: usuarias continuas,2015-05-01,0,0,9,3,0,12
IXIAMAS,"anticoncepcion, prevencion de its y de cancer de cuello uterino",pildora: usuarias continuas,2015-05-01,0,0,5,0,0,5
JESUS DE MACHACA,"anticoncepcion, prevencion de its y de cancer de cuello uterino",pildora: usuarias continuas,2015-05-01,0,0,3,4,0,7
LA ASUNTA,"anticoncepcion, prevencion de its y de cancer de cuello uterino",pildora: usuarias continuas,2015-05-01,0,2,17,7,0,26
LA GUARDIA,"anticoncepcion, prevencion de its y de cancer de cuello uterino",pildora: usuarias continuas,2015-05-01,0,3,26,9,0,38
LA PAZ,"anticoncepcion, prevencion de its y de cancer de cuello uterino",pildora: usuarias continuas,2015-05-01,0,4,88,23,0,115
LAJA,"anticoncepcion, prevencion de its y de cancer de cuello uterino",pildora: usuarias continuas,2015-05-01,0,0,5,3,0,8
LAS CARRERAS,"anticoncepcion, prevencion de its y de cancer de cuello uterino",pildora: usuarias continuas,2015-05-01,0,0,1,1,0,2
LLALLAGUA,"anticoncepcion, prevencion de its y de cancer de cuello uterino",pildora: usuarias continuas,2015-05-01,0,0,2,0,0,2
LLICA,"anticoncepcion, prevencion de its y de cancer de cuello uterino",pildora: usuarias continuas,2015-05-01,0,0,5,1,0,6
LORETO,"anticoncepcion, prevencion de its y de cancer de cuello uterino",pildora: usuarias continuas,2015-05-01,0,1,1,2,0,4
LURIBAY,"anticoncepcion, prevencion de its y de cancer de cuello uterino",pildora: usuarias continuas,2015-05-01,0,0,2,1,0,3
MACHARETI,"anticoncepcion, prevencion de its y de cancer de cuello uterino",pildora: usuarias continuas,2015-05-01,0,2,9,3,0,14
MAGDALENA,"anticoncepcion, prevencion de its y de cancer de cuello uterino",pildora: usuarias continuas,2015-05-01,0,7,37,13,0,57
MAIRANA,"anticoncepcion, prevencion de its y de cancer de cuello uterino",pildora: usuarias continuas,2015-05-01,0,1,4,0,0,5
MECAPACA,"anticoncepcion, prevencion de its y de cancer de cuello uterino",pildora: usuarias continuas,2015-05-01,0,0,1,2,0,3
MINEROS,"anticoncepcion, prevencion de its y de cancer de cuello uterino",pildora: usuarias continuas,2015-05-01,0,1,11,6,0,18
MIZQUE,"anticoncepcion, prevencion de its y de cancer de cuello uterino",pildora: usuarias continuas,2015-05-01,1,0,3,2,0,6
MOCOMOCO,"anticoncepcion, prevencion de its y de cancer de cuello uterino",pildora: usuarias continuas,2015-05-01,0,0,2,0,0,2
MOJINETE,"anticoncepcion, prevencion de its y de cancer de cuello uterino",pildora: usuarias continuas,2015-05-01,0,0,0,1,0,1
MOJOCOYA,"anticoncepcion, prevencion de its y de cancer de cuello uterino",pildora: usuarias continuas,2015-05-01,0,0,4,2,0,6
MONTEAGUDO,"anticoncepcion, prevencion de its y de cancer de cuello uterino",pildora: usuarias continuas,2015-05-01,0,1,12,5,0,18
MONTERO,"anticoncepcion, prevencion de its y de cancer de cuello uterino",pildora: usuarias continuas,2015-05-01,4,10,36,13,3,66
MORO MORO,"anticoncepcion, prevencion de its y de cancer de cuello uterino",pildora: usuarias continuas,2015-05-01,0,0,2,0,0,2
MOROCHATA,"anticoncepcion, prevencion de its y de cancer de cuello uterino",pildora: usuarias continuas,2015-05-01,0,0,1,0,0,1
OCURI,"anticoncepcion, prevencion de its y de cancer de cuello uterino",pildora: usuarias continuas,2015-05-01,0,0,3,0,0,3
OKINAWA,"anticoncepcion, prevencion de its y de cancer de cuello uterino",pildora: usuarias continuas,2015-05-01,0,2,26,9,0,37
OMEREQUE,"anticoncepcion, prevencion de its y de cancer de cuello uterino",pildora: usuarias continuas,2015-05-01,0,2,5,7,0,14
ORURO,"anticoncepcion, prevencion de its y de cancer de cuello uterino",pildora: usuarias continuas,2015-05-01,0,7,69,22,0,98
PADCAYA,"anticoncepcion, prevencion de its y de cancer de cuello uterino",pildora: usuarias continuas,2015-05-01,0,2,22,10,0,34
PADILLA,"anticoncepcion, prevencion de its y de cancer de cuello uterino",pildora: usuarias continuas,2015-05-01,0,0,9,2,0,11
PAILON,"anticoncepcion, prevencion de its y de cancer de cuello uterino",pildora: usuarias continuas,2015-05-01,0,0,7,1,0,8
PALOS BLANCOS,"anticoncepcion, prevencion de its y de cancer de cuello uterino",pildora: usuarias continuas,2015-05-01,0,0,13,1,0,14
PAMPA GRANDE,"anticoncepcion, prevencion de its y de cancer de cuello uterino",pildora: usuarias continuas,2015-05-01,0,1,9,3,0,13
PAPEL PAMPA,"anticoncepcion, prevencion de its y de cancer de cuello uterino",pildora: usuarias continuas,2015-05-01,0,0,1,2,0,3
PASORAPA,"anticoncepcion, prevencion de its y de cancer de cuello uterino",pildora: usuarias continuas,2015-05-01,0,0,2,0,0,2
PATACAMAYA,"anticoncepcion, prevencion de its y de cancer de cuello uterino",pildora: usuarias continuas,2015-05-01,0,0,1,0,0,1
PAZÑA,"anticoncepcion, prevencion de its y de cancer de cuello uterino",pildora: usuarias continuas,2015-05-01,0,0,1,0,0,1
PELECHUCO,"anticoncepcion, prevencion de its y de cancer de cuello uterino",pildora: usuarias continuas,2015-05-01,0,0,2,3,0,5
POCOATA,"anticoncepcion, prevencion de its y de cancer de cuello uterino",pildora: usuarias continuas,2015-05-01,0,0,3,1,0,4
POCONA,"anticoncepcion, prevencion de its y de cancer de cuello uterino",pildora: usuarias continuas,2015-05-01,0,0,5,2,0,7
POJO (CBBA),"anticoncepcion, prevencion de its y de cancer de cuello uterino",pildora: usuarias continuas,2015-05-01,0,0,5,0,0,5
PORCO,"anticoncepcion, prevencion de its y de cancer de cuello uterino",pildora: usuarias continuas,2015-05-01,0,0,2,0,0,2
POROMA,"anticoncepcion, prevencion de its y de cancer de cuello uterino",pildora: usuarias continuas,2015-05-01,0,0,4,2,0,6
PORONGO,"anticoncepcion, prevencion de its y de cancer de cuello uterino",pildora: usuarias continuas,2015-05-01,0,4,15,3,1,23
PORTACHUELO,"anticoncepcion, prevencion de its y de cancer de cuello uterino",pildora: usuarias continuas,2015-05-01,0,2,27,9,2,40
PORVENIR,"anticoncepcion, prevencion de its y de cancer de cuello uterino",pildora: usuarias continuas,2015-05-01,0,3,12,4,0,19
POSTRER VALLE,"anticoncepcion, prevencion de its y de cancer de cuello uterino",pildora: usuarias continuas,2015-05-01,0,1,2,0,0,3
POTOSI,"anticoncepcion, prevencion de its y de cancer de cuello uterino",pildora: usuarias continuas,2015-05-01,0,8,82,22,1,113
PRESTO,"anticoncepcion, prevencion de its y de cancer de cuello uterino",pildora: usuarias continuas,2015-05-01,0,0,4,1,0,5
PUCARA,"anticoncepcion, prevencion de its y de cancer de cuello uterino",pildora: usuarias continuas,2015-05-01,0,0,1,0,0,1
PUCARANI,"anticoncepcion, prevencion de its y de cancer de cuello uterino",pildora: usuarias continuas,2015-05-01,0,0,5,3,0,8
PUERTO ACOSTA,"anticoncepcion, prevencion de its y de cancer de cuello uterino",pildora: usuarias continuas,2015-05-01,0,0,0,2,0,2
PUERTO CARABUCO,"anticoncepcion, prevencion de its y de cancer de cuello uterino",pildora: usuarias continuas,2015-05-01,0,0,1,1,0,2
PUERTO GONZALO MORENO,"anticoncepcion, prevencion de its y de cancer de cuello uterino",pildora: usuarias continuas,2015-05-01,0,0,5,2,0,7
PUERTO QUIJARRO,"anticoncepcion, prevencion de its y de cancer de cuello uterino",pildora: usuarias continuas,2015-05-01,0,2,7,2,0,11
PUERTO RICO,"anticoncepcion, prevencion de its y de cancer de cuello uterino",pildora: usuarias continuas,2015-05-01,0,0,7,3,0,10
PUERTO SILES,"anticoncepcion, prevencion de its y de cancer de cuello uterino",pildora: usuarias continuas,2015-05-01,0,0,4,1,0,5
PUERTO SUAREZ,"anticoncepcion, prevencion de its y de cancer de cuello uterino",pildora: usuarias continuas,2015-05-01,0,1,3,0,0,4
PUERTO VILLARROEL,"anticoncepcion, prevencion de its y de cancer de cuello uterino",pildora: usuarias continuas,2015-05-01,0,2,13,1,0,16
PUNA,"anticoncepcion, prevencion de its y de cancer de cuello uterino",pildora: usuarias continuas,2015-05-01,0,0,5,4,0,9
PUNATA,"anticoncepcion, prevencion de its y de cancer de cuello uterino",pildora: usuarias continuas,2015-05-01,0,0,2,2,0,4
QUIABAYA,"anticoncepcion, prevencion de its y de cancer de cuello uterino",pildora: usuarias continuas,2015-05-01,0,0,1,0,0,1
QUILLACOLLO,"anticoncepcion, prevencion de its y de cancer de cuello uterino",pildora: usuarias continuas,2015-05-01,0,3,16,8,0,27
QUIME,"anticoncepcion, prevencion de its y de cancer de cuello uterino",pildora: usuarias continuas,2015-05-01,0,0,5,1,0,6
QUIRUSILLAS,"anticoncepcion, prevencion de its y de cancer de cuello uterino",pildora: usuarias continuas,2015-05-01,0,0,2,2,0,4
RAVELO,"anticoncepcion, prevencion de its y de cancer de cuello uterino",pildora: usuarias continuas,2015-05-01,0,0,1,0,0,1
REYES,"anticoncepcion, prevencion de its y de cancer de cuello uterino",pildora: usuarias continuas,2015-05-01,0,7,6,6,0,19
RIBERALTA,"anticoncepcion, prevencion de its y de cancer de cuello uterino",pildora: usuarias continuas,2015-05-01,1,6,27,6,0,40
ROBORE,"anticoncepcion, prevencion de its y de cancer de cuello uterino",pildora: usuarias continuas,2015-05-01,0,0,13,5,0,18
RURRENABAQUE,"anticoncepcion, prevencion de its y de cancer de cuello uterino",pildora: usuarias continuas,2015-05-01,0,0,8,6,0,14
SABAYA,"anticoncepcion, prevencion de its y de cancer de cuello uterino",pildora: usuarias continuas,2015-05-01,0,0,1,0,0,1
SACABA,"anticoncepcion, prevencion de its y de cancer de cuello uterino",pildora: usuarias continuas,2015-05-01,0,2,10,3,0,15
SACACA,"anticoncepcion, prevencion de its y de cancer de cuello uterino",pildora: usuarias continuas,2015-05-01,0,0,3,2,0,5
SAIPINA,"anticoncepcion, prevencion de its y de cancer de cuello uterino",pildora: usuarias continuas,2015-05-01,0,0,2,0,0,2
SALINAS DE GARCI MENDOZA,"anticoncepcion, prevencion de its y de cancer de cuello uterino",pildora: usuarias continuas,2015-05-01,0,0,3,0,0,3
SAMAIPATA,"anticoncepcion, prevencion de its y de cancer de cuello uterino",pildora: usuarias continuas,2015-05-01,0,2,2,0,0,4
SAN AGUSTIN,"anticoncepcion, prevencion de its y de cancer de cuello uterino",pildora: usuarias continuas,2015-05-01,0,0,3,2,0,5
SAN ANDRES,"anticoncepcion, prevencion de its y de cancer de cuello uterino",pildora: usuarias continuas,2015-05-01,0,3,33,8,0,44
SAN ANDRES DE MACHACA,"anticoncepcion, prevencion de its y de cancer de cuello uterino",pildora: usuarias continuas,2015-05-01,0,0,2,1,0,3
SAN ANTONIO DE LOMERIO,"anticoncepcion, prevencion de its y de cancer de cuello uterino",pildora: usuarias continuas,2015-05-01,0,2,12,10,0,24
SAN BORJA,"anticoncepcion, prevencion de its y de cancer de cuello uterino",pildora: usuarias continuas,2015-05-01,0,4,33,17,1,55
SAN BUENA VENTURA,"anticoncepcion, prevencion de its y de cancer de cuello uterino",pildora: usuarias continuas,2015-05-01,0,0,2,0,0,2
SAN CARLOS,"anticoncepcion, prevencion de its y de cancer de cuello uterino",pildora: usuarias continuas,2015-05-01,0,2,9,0,0,11
SAN IGNACIO,"anticoncepcion, prevencion de its y de cancer de cuello uterino",pildora: usuarias continuas,2015-05-01,1,13,87,51,1,153
SAN IGNACIO DE VELASCO,"anticoncepcion, prevencion de its y de cancer de cuello uterino",pildora: usuarias continuas,2015-05-01,0,8,52,14,0,74
SAN JAVIER(BNI),"anticoncepcion, prevencion de its y de cancer de cuello uterino",pildora: usuarias continuas,2015-05-01,0,0,1,1,0,2
SAN JAVIER(STC),"anticoncepcion, prevencion de its y de cancer de cuello uterino",pildora: usuarias continuas,2015-05-01,0,2,24,11,0,37
SAN JOSE DE CHIQUITOS,"anticoncepcion, prevencion de its y de cancer de cuello uterino",pildora: usuarias continuas,2015-05-01,0,2,5,7,0,14
SAN JUAN DE YAPACANI,"anticoncepcion, prevencion de its y de cancer de cuello uterino",pildora: usuarias continuas,2015-05-01,0,0,14,2,0,16
SAN JULIAN,"anticoncepcion, prevencion de its y de cancer de cuello uterino",pildora: usuarias continuas,2015-05-01,0,0,19,7,0,26
SAN LORENZO(PND),"anticoncepcion, prevencion de its y de cancer de cuello uterino",pildora: usuarias continuas,2015-05-01,0,1,0,0,0,1
SAN LORENZO(TJA),"anticoncepcion, prevencion de its y de cancer de cuello uterino",pildora: usuarias continuas,2015-05-01,0,2,16,2,0,20
SAN LUCAS,"anticoncepcion, prevencion de its y de cancer de cuello uterino",pildora: usuarias continuas,2015-05-01,0,0,2,3,0,5
SAN MATIAS,"anticoncepcion, prevencion de its y de cancer de cuello uterino",pildora: usuarias continuas,2015-05-01,0,1,14,3,0,18
SAN MIGUEL DE VELASCO,"anticoncepcion, prevencion de its y de cancer de cuello uterino",pildora: usuarias continuas,2015-05-01,0,0,14,15,0,29
SAN PEDRO,"anticoncepcion, prevencion de its y de cancer de cuello uterino",pildora: usuarias continuas,2015-05-01,0,2,20,3,1,26
SAN PEDRO DE BUENA VISTA,"anticoncepcion, prevencion de its y de cancer de cuello uterino",pildora: usuarias continuas,2015-05-01,0,2,5,3,0,10
SAN PEDRO DE CURAHUARA,"anticoncepcion, prevencion de its y de cancer de cuello uterino",pildora: usuarias continuas,2015-05-01,0,0,1,2,0,3
SAN PEDRO DE QUEMES,"anticoncepcion, prevencion de its y de cancer de cuello uterino",pildora: usuarias continuas,2015-05-01,0,0,1,0,0,1
SAN PEDRO DE TIQUINA,"anticoncepcion, prevencion de its y de cancer de cuello uterino",pildora: usuarias continuas,2015-05-01,0,0,1,0,0,1
SAN PEDRO(PND),"anticoncepcion, prevencion de its y de cancer de cuello uterino",pildora: usuarias continuas,2015-05-01,0,0,3,3,0,6
SAN RAFAEL,"anticoncepcion, prevencion de its y de cancer de cuello uterino",pildora: usuarias continuas,2015-05-01,1,6,18,11,0,36
SAN RAMON BENI,"anticoncepcion, prevencion de its y de cancer de cuello uterino",pildora: usuarias continuas,2015-05-01,0,0,9,3,0,12
SAN RAMON SCZ,"anticoncepcion, prevencion de its y de cancer de cuello uterino",pildora: usuarias continuas,2015-05-01,0,0,5,1,0,6
SANTA ANA,"anticoncepcion, prevencion de its y de cancer de cuello uterino",pildora: usuarias continuas,2015-05-01,0,4,26,8,0,38
SANTA CRUZ DE LA SIERRA,"anticoncepcion, prevencion de its y de cancer de cuello uterino",pildora: usuarias continuas,2015-05-01,0,79,120,37,0,236
SANTA ROSA DEL SARA,"anticoncepcion, prevencion de its y de cancer de cuello uterino",pildora: usuarias continuas,2015-05-01,0,5,16,5,0,26
SANTIAGO DE HUATA,"anticoncepcion, prevencion de its y de cancer de cuello uterino",pildora: usuarias continuas,2015-05-01,0,0,0,1,0,1
SANTIVAÑES,"anticoncepcion, prevencion de its y de cancer de cuello uterino",pildora: usuarias continuas,2015-05-01,0,0,4,1,0,5
SAPAHAQUI,"anticoncepcion, prevencion de its y de cancer de cuello uterino",pildora: usuarias continuas,2015-05-01,0,0,0,1,0,1
SHINAOTA,"anticoncepcion, prevencion de its y de cancer de cuello uterino",pildora: usuarias continuas,2015-05-01,0,1,7,0,0,8
SICA SICA (VILLA AROMA),"anticoncepcion, prevencion de its y de cancer de cuello uterino",pildora: usuarias continuas,2015-05-01,0,0,2,1,0,3
SICAYA,"anticoncepcion, prevencion de its y de cancer de cuello uterino",pildora: usuarias continuas,2015-05-01,0,0,0,1,0,1
SIPE SIPE,"anticoncepcion, prevencion de its y de cancer de cuello uterino",pildora: usuarias continuas,2015-05-01,0,0,10,2,1,13
SOPACHUY,"anticoncepcion, prevencion de its y de cancer de cuello uterino",pildora: usuarias continuas,2015-05-01,0,0,6,0,0,6
SORACACHI,"anticoncepcion, prevencion de its y de cancer de cuello uterino",pildora: usuarias continuas,2015-05-01,0,0,1,1,0,2
SORATA,"anticoncepcion, prevencion de its y de cancer de cuello uterino",pildora: usuarias continuas,2015-05-01,0,0,6,2,0,8
SUCRE,"anticoncepcion, prevencion de its y de cancer de cuello uterino",pildora: usuarias continuas,2015-05-01,0,6,103,33,0,142
TACACOMA,"anticoncepcion, prevencion de its y de cancer de cuello uterino",pildora: usuarias continuas,2015-05-01,0,0,7,1,0,8
TAPACARI,"anticoncepcion, prevencion de its y de cancer de cuello uterino",pildora: usuarias continuas,2015-05-01,0,0,0,1,0,1
TARABUCO,"anticoncepcion, prevencion de its y de cancer de cuello uterino",pildora: usuarias continuas,2015-05-01,0,1,0,0,0,1
TARACO,"anticoncepcion, prevencion de its y de cancer de cuello uterino",pildora: usuarias continuas,2015-05-01,0,0,1,1,0,2
TARIJA,"anticoncepcion, prevencion de its y de cancer de cuello uterino",pildora: usuarias continuas,2015-05-01,0,12,45,21,0,78
TARVITA,"anticoncepcion, prevencion de its y de cancer de cuello uterino",pildora: usuarias continuas,2015-05-01,0,0,3,3,0,6
TEOPONTE,"anticoncepcion, prevencion de its y de cancer de cuello uterino",pildora: usuarias continuas,2015-05-01,0,0,1,0,0,1
TIAWANACU,"anticoncepcion, prevencion de its y de cancer de cuello uterino",pildora: usuarias continuas,2015-05-01,0,1,6,2,0,9
TIPUANI,"anticoncepcion, prevencion de its y de cancer de cuello uterino",pildora: usuarias continuas,2015-05-01,0,0,2,0,0,2
TIQUIPAYA,"anticoncepcion, prevencion de its y de cancer de cuello uterino",pildora: usuarias continuas,2015-05-01,0,1,19,1,0,21
TIRAQUE (CBBA),"anticoncepcion, prevencion de its y de cancer de cuello uterino",pildora: usuarias continuas,2015-05-01,0,0,1,0,0,1
TOLATA,"anticoncepcion, prevencion de its y de cancer de cuello uterino",pildora: usuarias continuas,2015-05-01,0,0,1,1,0,2
TOMAVE,"anticoncepcion, prevencion de its y de cancer de cuello uterino",pildora: usuarias continuas,2015-05-01,0,1,6,1,0,8
TOMINA,"anticoncepcion, prevencion de its y de cancer de cuello uterino",pildora: usuarias continuas,2015-05-01,0,1,2,2,0,5
TORO TORO,"anticoncepcion, prevencion de its y de cancer de cuello uterino",pildora: usuarias continuas,2015-05-01,0,1,0,0,0,1
TRIGAL,"anticoncepcion, prevencion de its y de cancer de cuello uterino",pildora: usuarias continuas,2015-05-01,0,0,2,0,0,2
TRINIDAD,"anticoncepcion, prevencion de its y de cancer de cuello uterino",pildora: usuarias continuas,2015-05-01,0,3,36,19,0,58
TUPIZA,"anticoncepcion, prevencion de its y de cancer de cuello uterino",pildora: usuarias continuas,2015-05-01,0,1,6,1,0,8
UMALA,"anticoncepcion, prevencion de its y de cancer de cuello uterino",pildora: usuarias continuas,2015-05-01,0,0,1,0,0,1
UNCIA,"anticoncepcion, prevencion de its y de cancer de cuello uterino",pildora: usuarias continuas,2015-05-01,0,0,3,1,0,4
URIONDO (A. CONCEPCION),"anticoncepcion, prevencion de its y de cancer de cuello uterino",pildora: usuarias continuas,2015-05-01,1,3,8,4,1,17
URUBICHA,"anticoncepcion, prevencion de its y de cancer de cuello uterino",pildora: usuarias continuas,2015-05-01,0,0,11,2,0,13
UYUNI,"anticoncepcion, prevencion de its y de cancer de cuello uterino",pildora: usuarias continuas,2015-05-01,0,0,5,1,0,6
VACAS,"anticoncepcion, prevencion de its y de cancer de cuello uterino",pildora: usuarias continuas,2015-05-01,0,0,1,0,0,1
VALLEGRANDE,"anticoncepcion, prevencion de its y de cancer de cuello uterino",pildora: usuarias continuas,2015-05-01,1,2,8,4,0,15
VIACHA,"anticoncepcion, prevencion de its y de cancer de cuello uterino",pildora: usuarias continuas,2015-05-01,0,1,11,4,0,16
VILA VILA,"anticoncepcion, prevencion de its y de cancer de cuello uterino",pildora: usuarias continuas,2015-05-01,0,0,1,0,0,1
VILLA CHARCAS,"anticoncepcion, prevencion de its y de cancer de cuello uterino",pildora: usuarias continuas,2015-05-01,0,1,2,1,0,4
VILLA MONTES,"anticoncepcion, prevencion de its y de cancer de cuello uterino",pildora: usuarias continuas,2015-05-01,0,2,19,5,0,26
VILLA NUEVA (LOMA ALTA),"anticoncepcion, prevencion de its y de cancer de cuello uterino",pildora: usuarias continuas,2015-05-01,0,0,1,0,0,1
VILLA SERRANO,"anticoncepcion, prevencion de its y de cancer de cuello uterino",pildora: usuarias continuas,2015-05-01,0,1,2,3,0,6
VILLA TUNARI,"anticoncepcion, prevencion de its y de cancer de cuello uterino",pildora: usuarias continuas,2015-05-01,0,1,22,7,0,30
VILLA VACA GUZMAN (MUYUPAMPA),"anticoncepcion, prevencion de its y de cancer de cuello uterino",pildora: usuarias continuas,2015-05-01,0,2,6,3,0,11
VILLAZON,"anticoncepcion, prevencion de its y de cancer de cuello uterino",pildora: usuarias continuas,2015-05-01,0,3,12,7,0,22
VINTO,"anticoncepcion, prevencion de its y de cancer de cuello uterino",pildora: usuarias continuas,2015-05-01,0,0,3,2,0,5
VITICHI,"anticoncepcion, prevencion de its y de cancer de cuello uterino",pildora: usuarias continuas,2015-05-01,0,0,4,5,0,9
WALDO BALLIVIAN,"anticoncepcion, prevencion de its y de cancer de cuello uterino",pildora: usuarias continuas,2015-05-01,0,0,0,2,0,2
WARNES,"anticoncepcion, prevencion de its y de cancer de cuello uterino",pildora: usuarias continuas,2015-05-01,0,8,28,9,0,45
YACUIBA,"anticoncepcion, prevencion de its y de cancer de cuello uterino",pildora: usuarias continuas,2015-05-01,0,1,16,6,0,23
YANACACHI,"anticoncepcion, prevencion de its y de cancer de cuello uterino",pildora: usuarias continuas,2015-05-01,0,0,5,0,0,5
YAPACANI,"anticoncepcion, prevencion de its y de cancer de cuello uterino",pildora: usuarias continuas,2015-05-01,0,0,14,9,0,23
YUNCHARA,"anticoncepcion, prevencion de its y de cancer de cuello uterino",pildora: usuarias continuas,2015-05-01,0,3,2,0,0,5
ZUDAÑEZ,"anticoncepcion, prevencion de its y de cancer de cuello uterino",pildora: usuarias continuas,2015-05-01,0,0,3,1,0,4
ACACIO,"anticoncepcion, prevencion de its y de cancer de cuello uterino",pildora: usuarias continuas,2015-06-01,0,0,1,1,0,2
ACHACACHI,"anticoncepcion, prevencion de its y de cancer de cuello uterino",pildora: usuarias continuas,2015-06-01,0,0,4,1,0,5
ACHOCALLA,"anticoncepcion, prevencion de its y de cancer de cuello uterino",pildora: usuarias continuas,2015-06-01,0,1,3,0,0,4
AIQUILE,"anticoncepcion, prevencion de its y de cancer de cuello uterino",pildora: usuarias continuas,2015-06-01,0,1,2,2,0,5
ALCALA,"anticoncepcion, prevencion de its y de cancer de cuello uterino",pildora: usuarias continuas,2015-06-01,0,1,2,2,0,5
ALTO BENI,"anticoncepcion, prevencion de its y de cancer de cuello uterino",pildora: usuarias continuas,2015-06-01,0,0,7,3,0,10
ANCORAIMES,"anticoncepcion, prevencion de its y de cancer de cuello uterino",pildora: usuarias continuas,2015-06-01,0,0,2,0,0,2
ANTEQUERA,"anticoncepcion, prevencion de its y de cancer de cuello uterino",pildora: usuarias continuas,2015-06-01,0,0,7,0,0,7
APOLO,"anticoncepcion, prevencion de its y de cancer de cuello uterino",pildora: usuarias continuas,2015-06-01,0,1,7,0,0,8
ARAMPAMPA,"anticoncepcion, prevencion de its y de cancer de cuello uterino",pildora: usuarias continuas,2015-06-01,0,0,1,1,0,2
ARANI,"anticoncepcion, prevencion de its y de cancer de cuello uterino",pildora: usuarias continuas,2015-06-01,0,0,3,0,0,3
ARBIETO,"anticoncepcion, prevencion de its y de cancer de cuello uterino",pildora: usuarias continuas,2015-06-01,0,0,4,0,0,4
ARQUE,"anticoncepcion, prevencion de its y de cancer de cuello uterino",pildora: usuarias continuas,2015-06-01,0,0,4,0,0,4
ASCENCION DE GUARAYOS,"anticoncepcion, prevencion de its y de cancer de cuello uterino",pildora: usuarias continuas,2015-06-01,0,3,6,4,0,13
ATOCHA,"anticoncepcion, prevencion de its y de cancer de cuello uterino",pildora: usuarias continuas,2015-06-01,0,0,8,2,0,10
AYATA,"anticoncepcion, prevencion de its y de cancer de cuello uterino",pildora: usuarias continuas,2015-06-01,0,1,1,4,0,6
AYO AYO,"anticoncepcion, prevencion de its y de cancer de cuello uterino",pildora: usuarias continuas,2015-06-01,0,0,1,0,0,1
AYOPAYA (V. DE INDEPENDENCIA),"anticoncepcion, prevencion de its y de cancer de cuello uterino",pildora: usuarias continuas,2015-06-01,0,0,12,8,0,20
AZURDUY,"anticoncepcion, prevencion de its y de cancer de cuello uterino",pildora: usuarias continuas,2015-06-01,0,0,4,1,0,5
BATALLAS,"anticoncepcion, prevencion de its y de cancer de cuello uterino",pildora: usuarias continuas,2015-06-01,0,0,2,0,0,2
BAURES,"anticoncepcion, prevencion de its y de cancer de cuello uterino",pildora: usuarias continuas,2015-06-01,0,4,13,5,0,22
BELLA FLOR,"anticoncepcion, prevencion de its y de cancer de cuello uterino",pildora: usuarias continuas,2015-06-01,1,2,10,3,0,16
BERMEJO,"anticoncepcion, prevencion de its y de cancer de cuello uterino",pildora: usuarias continuas,2015-06-01,0,0,7,2,1,10
BETANZOS,"anticoncepcion, prevencion de its y de cancer de cuello uterino",pildora: usuarias continuas,2015-06-01,0,0,0,1,0,1
BOLPEBRA,"anticoncepcion, prevencion de its y de cancer de cuello uterino",pildora: usuarias continuas,2015-06-01,1,4,10,5,0,20
BOYUIBE,"anticoncepcion, prevencion de its y de cancer de cuello uterino",pildora: usuarias continuas,2015-06-01,0,0,4,2,0,6
BUENA VISTA,"anticoncepcion, prevencion de its y de cancer de cuello uterino",pildora: usuarias continuas,2015-06-01,1,3,21,4,0,29
CABEZAS,"anticoncepcion, prevencion de its y de cancer de cuello uterino",pildora: usuarias continuas,2015-06-01,0,3,30,2,0,35
"CAIZA ""D""","anticoncepcion, prevencion de its y de cancer de cuello uterino",pildora: usuarias continuas,2015-06-01,0,0,4,0,0,4
CAJUATA,"anticoncepcion, prevencion de its y de cancer de cuello uterino",pildora: usuarias continuas,2015-06-01,0,0,3,2,0,5
CALAMARCA,"anticoncepcion, prevencion de its y de cancer de cuello uterino",pildora: usuarias continuas,2015-06-01,0,0,5,2,0,7
CAMARGO,"anticoncepcion, prevencion de its y de cancer de cuello uterino",pildora: usuarias continuas,2015-06-01,0,0,1,1,0,2
CAMATAQUI (C. VILLA ABECIA),"anticoncepcion, prevencion de its y de cancer de cuello uterino",pildora: usuarias continuas,2015-06-01,0,0,2,1,0,3
CAMIRI,"anticoncepcion, prevencion de its y de cancer de cuello uterino",pildora: usuarias continuas,2015-06-01,0,0,5,5,0,10
CAPINOTA,"anticoncepcion, prevencion de its y de cancer de cuello uterino",pildora: usuarias continuas,2015-06-01,0,0,3,1,0,4
CARACOLLO,"anticoncepcion, prevencion de its y de cancer de cuello uterino",pildora: usuarias continuas,2015-06-01,0,0,4,0,0,4
CARANAVI,"anticoncepcion, prevencion de its y de cancer de cuello uterino",pildora: usuarias continuas,2015-06-01,0,0,5,3,1,9
CARAPARI,"anticoncepcion, prevencion de its y de cancer de cuello uterino",pildora: usuarias continuas,2015-06-01,0,0,21,2,0,23
CARMEN RIVERO TORREZ,"anticoncepcion, prevencion de its y de cancer de cuello uterino",pildora: usuarias continuas,2015-06-01,0,0,2,1,0,3
CATACORA,"anticoncepcion, prevencion de its y de cancer de cuello uterino",pildora: usuarias continuas,2015-06-01,0,0,0,1,0,1
CHALLAPATA,"anticoncepcion, prevencion de its y de cancer de cuello uterino",pildora: usuarias continuas,2015-06-01,0,1,4,1,0,6
CHARAGUA,"anticoncepcion, prevencion de its y de cancer de cuello uterino",pildora: usuarias continuas,2015-06-01,0,4,14,3,0,21
CHIMORE,"anticoncepcion, prevencion de its y de cancer de cuello uterino",pildora: usuarias continuas,2015-06-01,0,0,7,2,0,9
CHULUMANI (V. DE LA LIBERTAD),"anticoncepcion, prevencion de its y de cancer de cuello uterino",pildora: usuarias continuas,2015-06-01,0,0,1,1,0,2
CHUMA,"anticoncepcion, prevencion de its y de cancer de cuello uterino",pildora: usuarias continuas,2015-06-01,0,0,1,2,0,3
CHUQUIHUTA AYLLU JUCUMANI,"anticoncepcion, prevencion de its y de cancer de cuello uterino",pildora: usuarias continuas,2015-06-01,0,0,2,1,0,3
CLIZA,"anticoncepcion, prevencion de its y de cancer de cuello uterino",pildora: usuarias continuas,2015-06-01,0,2,8,1,0,11
COBIJA,"anticoncepcion, prevencion de its y de cancer de cuello uterino",pildora: usuarias continuas,2015-06-01,0,9,43,16,0,68
COCAPATA,"anticoncepcion, prevencion de its y de cancer de cuello uterino",pildora: usuarias continuas,2015-06-01,0,0,3,1,0,4
COCHABAMBA,"anticoncepcion, prevencion de its y de cancer de cuello uterino",pildora: usuarias continuas,2015-06-01,0,15,112,28,1,156
COIPASA,"anticoncepcion, prevencion de its y de cancer de cuello uterino",pildora: usuarias continuas,2015-06-01,0,0,1,0,0,1
COLCAPIRHUA,"anticoncepcion, prevencion de its y de cancer de cuello uterino",pildora: usuarias continuas,2015-06-01,0,0,3,4,0,7
"COLCHA ""K""","anticoncepcion, prevencion de its y de cancer de cuello uterino",pildora: usuarias continuas,2015-06-01,0,0,2,2,0,4
COLOMI,"anticoncepcion, prevencion de its y de cancer de cuello uterino",pildora: usuarias continuas,2015-06-01,0,0,1,0,0,1
COLPA BELGICA,"anticoncepcion, prevencion de its y de cancer de cuello uterino",pildora: usuarias continuas,2015-06-01,0,2,12,4,0,18
COLQUECHACA,"anticoncepcion, prevencion de its y de cancer de cuello uterino",pildora: usuarias continuas,2015-06-01,0,0,5,3,0,8
COLQUENCHA,"anticoncepcion, prevencion de its y de cancer de cuello uterino",pildora: usuarias continuas,2015-06-01,0,0,1,2,0,3
COMARAPA,"anticoncepcion, prevencion de its y de cancer de cuello uterino",pildora: usuarias continuas,2015-06-01,0,2,5,2,0,9
COMBAYA,"anticoncepcion, prevencion de its y de cancer de cuello uterino",pildora: usuarias continuas,2015-06-01,0,0,0,1,0,1
CONCEPCION,"anticoncepcion, prevencion de its y de cancer de cuello uterino",pildora: usuarias continuas,2015-06-01,0,1,10,0,0,11
CORIPATA,"anticoncepcion, prevencion de its y de cancer de cuello uterino",pildora: usuarias continuas,2015-06-01,0,0,1,1,0,2
COROICO,"anticoncepcion, prevencion de its y de cancer de cuello uterino",pildora: usuarias continuas,2015-06-01,0,0,6,3,0,9
CORQUE,"anticoncepcion, prevencion de its y de cancer de cuello uterino",pildora: usuarias continuas,2015-06-01,0,0,1,4,0,5
COTAGAITA,"anticoncepcion, prevencion de its y de cancer de cuello uterino",pildora: usuarias continuas,2015-06-01,0,1,9,8,0,18
COTOCA,"anticoncepcion, prevencion de its y de cancer de cuello uterino",pildora: usuarias continuas,2015-06-01,0,6,31,5,0,42
CRUZ DE MACHACAMARCA,"anticoncepcion, prevencion de its y de cancer de cuello uterino",pildora: usuarias continuas,2015-06-01,0,0,2,0,0,2
CUATRO CAÑADAS,"anticoncepcion, prevencion de its y de cancer de cuello uterino",pildora: usuarias continuas,2015-06-01,0,1,7,5,0,13
CUCHUMUELA (V. G. VILLARROEL),"anticoncepcion, prevencion de its y de cancer de cuello uterino",pildora: usuarias continuas,2015-06-01,0,1,0,0,0,1
CUEVO,"anticoncepcion, prevencion de its y de cancer de cuello uterino",pildora: usuarias continuas,2015-06-01,0,0,3,1,0,4
CULPINA,"anticoncepcion, prevencion de its y de cancer de cuello uterino",pildora: usuarias continuas,2015-06-01,0,0,5,1,0,6
CURAHUARA DE CARANGAS,"anticoncepcion, prevencion de its y de cancer de cuello uterino",pildora: usuarias continuas,2015-06-01,0,0,1,0,0,1
DESAGUADERO,"anticoncepcion, prevencion de its y de cancer de cuello uterino",pildora: usuarias continuas,2015-06-01,0,0,1,0,0,1
EL ALTO,"anticoncepcion, prevencion de its y de cancer de cuello uterino",pildora: usuarias continuas,2015-06-01,0,15,178,60,2,255
EL CHORO,"anticoncepcion, prevencion de its y de cancer de cuello uterino",pildora: usuarias continuas,2015-06-01,0,0,1,0,0,1
EL PUENTE(STC),"anticoncepcion, prevencion de its y de cancer de cuello uterino",pildora: usuarias continuas,2015-06-01,0,1,8,0,0,9
EL PUENTE(TJA),"anticoncepcion, prevencion de its y de cancer de cuello uterino",pildora: usuarias continuas,2015-06-01,0,0,6,3,2,11
EL TORNO,"anticoncepcion, prevencion de its y de cancer de cuello uterino",pildora: usuarias continuas,2015-06-01,3,10,44,17,0,74
EL VILLAR,"anticoncepcion, prevencion de its y de cancer de cuello uterino",pildora: usuarias continuas,2015-06-01,0,0,4,4,1,9
ENTRE RIOS TRJ,"anticoncepcion, prevencion de its y de cancer de cuello uterino",pildora: usuarias continuas,2015-06-01,0,5,20,5,0,30
ENTRE RIOS CBBA,"anticoncepcion, prevencion de its y de cancer de cuello uterino",pildora: usuarias continuas,2015-06-01,0,0,12,5,0,17
EUREKA (SANTOS MERCADO),"anticoncepcion, prevencion de its y de cancer de cuello uterino",pildora: usuarias continuas,2015-06-01,0,0,4,0,0,4
EXALTACION,"anticoncepcion, prevencion de its y de cancer de cuello uterino",pildora: usuarias continuas,2015-06-01,0,0,1,0,0,1
FERNANDEZ ALONSO,"anticoncepcion, prevencion de its y de cancer de cuello uterino",pildora: usuarias continuas,2015-06-01,0,0,10,0,0,10
FILADELFIA,"anticoncepcion, prevencion de its y de cancer de cuello uterino",pildora: usuarias continuas,2015-06-01,0,4,13,0,0,17
GENERAL SAAVEDRA,"anticoncepcion, prevencion de its y de cancer de cuello uterino",pildora: usuarias continuas,2015-06-01,0,2,27,13,0,42
GUANAY,"anticoncepcion, prevencion de its y de cancer de cuello uterino",pildora: usuarias continuas,2015-06-01,0,1,0,1,0,2
GUAQUI,"anticoncepcion, prevencion de its y de cancer de cuello uterino",pildora: usuarias continuas,2015-06-01,0,0,0,1,0,1
GUAYARAMERIN,"anticoncepcion, prevencion de its y de cancer de cuello uterino",pildora: usuarias continuas,2015-06-01,0,0,1,1,0,2
GUTIERREZ,"anticoncepcion, prevencion de its y de cancer de cuello uterino",pildora: usuarias continuas,2015-06-01,0,0,2,2,0,4
HUACARETA,"anticoncepcion, prevencion de its y de cancer de cuello uterino",pildora: usuarias continuas,2015-06-01,0,1,11,6,0,18
HUACAYA (VILLA DE HUACAYA),"anticoncepcion, prevencion de its y de cancer de cuello uterino",pildora: usuarias continuas,2015-06-01,0,0,1,0,0,1
HUACHACALLA,"anticoncepcion, prevencion de its y de cancer de cuello uterino",pildora: usuarias continuas,2015-06-01,0,0,4,0,0,4
HUANUNI,"anticoncepcion, prevencion de its y de cancer de cuello uterino",pildora: usuarias continuas,2015-06-01,0,0,4,0,0,4
HUARACAJE,"anticoncepcion, prevencion de its y de cancer de cuello uterino",pildora: usuarias continuas,2015-06-01,0,3,15,8,0,26
HUATAJATA,"anticoncepcion, prevencion de its y de cancer de cuello uterino",pildora: usuarias continuas,2015-06-01,0,0,1,0,0,1
HUAYLLAMARCA,"anticoncepcion, prevencion de its y de cancer de cuello uterino",pildora: usuarias continuas,2015-06-01,0,0,0,2,0,2
HUMANATA,"anticoncepcion, prevencion de its y de cancer de cuello uterino",pildora: usuarias continuas,2015-06-01,0,0,1,1,0,2
ICLA,"anticoncepcion, prevencion de its y de cancer de cuello uterino",pildora: usuarias continuas,2015-06-01,1,1,4,5,0,11
INCAHUASI,"anticoncepcion, prevencion de its y de cancer de cuello uterino",pildora: usuarias continuas,2015-06-01,0,0,3,1,0,4
INQUISIVI,"anticoncepcion, prevencion de its y de cancer de cuello uterino",pildora: usuarias continuas,2015-06-01,0,0,1,0,0,1
IRUPANA (VILLA DE LANZA),"anticoncepcion, prevencion de its y de cancer de cuello uterino",pildora: usuarias continuas,2015-06-01,0,1,3,6,2,12
IXIAMAS,"anticoncepcion, prevencion de its y de cancer de cuello uterino",pildora: usuarias continuas,2015-06-01,0,1,5,2,0,8
JESUS DE MACHACA,"anticoncepcion, prevencion de its y de cancer de cuello uterino",pildora: usuarias continuas,2015-06-01,0,0,3,0,0,3
LA ASUNTA,"anticoncepcion, prevencion de its y de cancer de cuello uterino",pildora: usuarias continuas,2015-06-01,0,0,20,4,0,24
LA GUARDIA,"anticoncepcion, prevencion de its y de cancer de cuello uterino",pildora: usuarias continuas,2015-06-01,0,1,30,4,0,35
LA PAZ,"anticoncepcion, prevencion de its y de cancer de cuello uterino",pildora: usuarias continuas,2015-06-01,0,3,93,41,0,137
LA RIVERA,"anticoncepcion, prevencion de its y de cancer de cuello uterino",pildora: usuarias continuas,2015-06-01,0,0,1,0,0,1
LAGUNILLAS,"anticoncepcion, prevencion de its y de cancer de cuello uterino",pildora: usuarias continuas,2015-06-01,0,0,6,7,0,13
LAJA,"anticoncepcion, prevencion de its y de cancer de cuello uterino",pildora: usuarias continuas,2015-06-01,0,1,5,2,0,8
LAS CARRERAS,"anticoncepcion, prevencion de its y de cancer de cuello uterino",pildora: usuarias continuas,2015-06-01,0,0,0,1,0,1
LICOMA PAMPA,"anticoncepcion, prevencion de its y de cancer de cuello uterino",pildora: usuarias continuas,2015-06-01,0,0,2,1,0,3
LLALLAGUA,"anticoncepcion, prevencion de its y de cancer de cuello uterino",pildora: usuarias continuas,2015-06-01,0,1,8,1,0,10
LLICA,"anticoncepcion, prevencion de its y de cancer de cuello uterino",pildora: usuarias continuas,2015-06-01,0,1,4,2,0,7
LORETO,"anticoncepcion, prevencion de its y de cancer de cuello uterino",pildora: usuarias continuas,2015-06-01,1,1,7,3,0,12
MACHARETI,"anticoncepcion, prevencion de its y de cancer de cuello uterino",pildora: usuarias continuas,2015-06-01,0,0,9,2,0,11
MAGDALENA,"anticoncepcion, prevencion de its y de cancer de cuello uterino",pildora: usuarias continuas,2015-06-01,0,2,29,8,0,39
MAIRANA,"anticoncepcion, prevencion de its y de cancer de cuello uterino",pildora: usuarias continuas,2015-06-01,0,1,8,1,0,10
MAPIRI,"anticoncepcion, prevencion de its y de cancer de cuello uterino",pildora: usuarias continuas,2015-06-01,0,0,2,0,0,2
MECAPACA,"anticoncepcion, prevencion de its y de cancer de cuello uterino",pildora: usuarias continuas,2015-06-01,0,0,0,1,0,1
MINEROS,"anticoncepcion, prevencion de its y de cancer de cuello uterino",pildora: usuarias continuas,2015-06-01,0,1,25,7,0,33
MIZQUE,"anticoncepcion, prevencion de its y de cancer de cuello uterino",pildora: usuarias continuas,2015-06-01,0,0,4,0,0,4
MOCOMOCO,"anticoncepcion, prevencion de its y de cancer de cuello uterino",pildora: usuarias continuas,2015-06-01,0,0,1,0,0,1
MOJOCOYA,"anticoncepcion, prevencion de its y de cancer de cuello uterino",pildora: usuarias continuas,2015-06-01,0,0,1,1,0,2
MONTEAGUDO,"anticoncepcion, prevencion de its y de cancer de cuello uterino",pildora: usuarias continuas,2015-06-01,0,3,7,7,0,17
MONTERO,"anticoncepcion, prevencion de its y de cancer de cuello uterino",pildora: usuarias continuas,2015-06-01,3,8,26,5,0,42
MORO MORO,"anticoncepcion, prevencion de its y de cancer de cuello uterino",pildora: usuarias continuas,2015-06-01,0,0,3,1,0,4
MOROCHATA,"anticoncepcion, prevencion de its y de cancer de cuello uterino",pildora: usuarias continuas,2015-06-01,0,0,3,3,0,6
OCURI,"anticoncepcion, prevencion de its y de cancer de cuello uterino",pildora: usuarias continuas,2015-06-01,0,0,3,2,0,5
OKINAWA,"anticoncepcion, prevencion de its y de cancer de cuello uterino",pildora: usuarias continuas,2015-06-01,0,1,7,5,0,13
OMEREQUE,"anticoncepcion, prevencion de its y de cancer de cuello uterino",pildora: usuarias continuas,2015-06-01,0,0,11,4,0,15
ORURO,"anticoncepcion, prevencion de its y de cancer de cuello uterino",pildora: usuarias continuas,2015-06-01,0,8,62,23,1,94
PADCAYA,"anticoncepcion, prevencion de its y de cancer de cuello uterino",pildora: usuarias continuas,2015-06-01,0,4,15,9,0,28
PADILLA,"anticoncepcion, prevencion de its y de cancer de cuello uterino",pildora: usuarias continuas,2015-06-01,0,2,15,1,0,18
PAILON,"anticoncepcion, prevencion de its y de cancer de cuello uterino",pildora: usuarias continuas,2015-06-01,0,0,2,0,0,2
PALCA,"anticoncepcion, prevencion de its y de cancer de cuello uterino",pildora: usuarias continuas,2015-06-01,0,0,3,1,0,4
PALOS BLANCOS,"anticoncepcion, prevencion de its y de cancer de cuello uterino",pildora: usuarias continuas,2015-06-01,0,0,18,10,0,28
PAMPA AULLAGAS,"anticoncepcion, prevencion de its y de cancer de cuello uterino",pildora: usuarias continuas,2015-06-01,0,0,2,1,0,3
PAMPA GRANDE,"anticoncepcion, prevencion de its y de cancer de cuello uterino",pildora: usuarias continuas,2015-06-01,0,0,5,1,1,7
PAPEL PAMPA,"anticoncepcion, prevencion de its y de cancer de cuello uterino",pildora: usuarias continuas,2015-06-01,0,0,1,1,0,2
PASORAPA,"anticoncepcion, prevencion de its y de cancer de cuello uterino",pildora: usuarias continuas,2015-06-01,0,0,1,2,0,3
PATACAMAYA,"anticoncepcion, prevencion de its y de cancer de cuello uterino",pildora: usuarias continuas,2015-06-01,0,0,1,1,0,2
PAZÑA,"anticoncepcion, prevencion de its y de cancer de cuello uterino",pildora: usuarias continuas,2015-06-01,0,0,1,1,0,2
PELECHUCO,"anticoncepcion, prevencion de its y de cancer de cuello uterino",pildora: usuarias continuas,2015-06-01,0,1,12,5,0,18
POCOATA,"anticoncepcion, prevencion de its y de cancer de cuello uterino",pildora: usuarias continuas,2015-06-01,0,0,1,0,0,1
POCONA,"anticoncepcion, prevencion de its y de cancer de cuello uterino",pildora: usuarias continuas,2015-06-01,0,1,4,1,0,6
POJO (CBBA),"anticoncepcion, prevencion de its y de cancer de cuello uterino",pildora: usuarias continuas,2015-06-01,0,0,3,1,0,4
POOPO,"anticoncepcion, prevencion de its y de cancer de cuello uterino",pildora: usuarias continuas,2015-06-01,0,0,1,0,0,1
PORCO,"anticoncepcion, prevencion de its y de cancer de cuello uterino",pildora: usuarias continuas,2015-06-01,0,0,3,1,0,4
POROMA,"anticoncepcion, prevencion de its y de cancer de cuello uterino",pildora: usuarias continuas,2015-06-01,0,1,5,4,0,10
PORONGO,"anticoncepcion, prevencion de its y de cancer de cuello uterino",pildora: usuarias continuas,2015-06-01,0,4,14,2,0,20
PORTACHUELO,"anticoncepcion, prevencion de its y de cancer de cuello uterino",pildora: usuarias continuas,2015-06-01,0,2,21,4,0,27
PORVENIR,"anticoncepcion, prevencion de its y de cancer de cuello uterino",pildora: usuarias continuas,2015-06-01,0,3,17,4,0,24
POSTRER VALLE,"anticoncepcion, prevencion de its y de cancer de cuello uterino",pildora: usuarias continuas,2015-06-01,0,0,2,2,0,4
POTOSI,"anticoncepcion, prevencion de its y de cancer de cuello uterino",pildora: usuarias continuas,2015-06-01,0,7,94,36,0,137
PRESTO,"anticoncepcion, prevencion de its y de cancer de cuello uterino",pildora: usuarias continuas,2015-06-01,0,0,4,0,0,4
PUCARA,"anticoncepcion, prevencion de its y de cancer de cuello uterino",pildora: usuarias continuas,2015-06-01,0,0,3,2,0,5
PUCARANI,"anticoncepcion, prevencion de its y de cancer de cuello uterino",pildora: usuarias continuas,2015-06-01,0,0,5,0,0,5
PUERTO ACOSTA,"anticoncepcion, prevencion de its y de cancer de cuello uterino",pildora: usuarias continuas,2015-06-01,0,0,0,1,0,1
PUERTO GONZALO MORENO,"anticoncepcion, prevencion de its y de cancer de cuello uterino",pildora: usuarias continuas,2015-06-01,0,0,5,3,1,9
PUERTO QUIJARRO,"anticoncepcion, prevencion de its y de cancer de cuello uterino",pildora: usuarias continuas,2015-06-01,0,0,10,1,0,11
PUERTO RICO,"anticoncepcion, prevencion de its y de cancer de cuello uterino",pildora: usuarias continuas,2015-06-01,0,1,12,3,1,17
PUERTO SILES,"anticoncepcion, prevencion de its y de cancer de cuello uterino",pildora: usuarias continuas,2015-06-01,0,0,9,1,0,10
PUERTO SUAREZ,"anticoncepcion, prevencion de its y de cancer de cuello uterino",pildora: usuarias continuas,2015-06-01,0,1,2,2,0,5
PUERTO VILLARROEL,"anticoncepcion, prevencion de its y de cancer de cuello uterino",pildora: usuarias continuas,2015-06-01,0,2,18,7,0,27
PUNA,"anticoncepcion, prevencion de its y de cancer de cuello uterino",pildora: usuarias continuas,2015-06-01,0,0,9,1,0,10
PUNATA,"anticoncepcion, prevencion de its y de cancer de cuello uterino",pildora: usuarias continuas,2015-06-01,0,0,2,1,0,3
QUIABAYA,"anticoncepcion, prevencion de its y de cancer de cuello uterino",pildora: usuarias continuas,2015-06-01,0,0,0,1,0,1
QUILLACOLLO,"anticoncepcion, prevencion de its y de cancer de cuello uterino",pildora: usuarias continuas,2015-06-01,0,4,12,10,0,26
QUIME,"anticoncepcion, prevencion de its y de cancer de cuello uterino",pildora: usuarias continuas,2015-06-01,0,0,8,1,0,9
QUIRUSILLAS,"anticoncepcion, prevencion de its y de cancer de cuello uterino",pildora: usuarias continuas,2015-06-01,0,2,1,2,0,5
RAVELO,"anticoncepcion, prevencion de its y de cancer de cuello uterino",pildora: usuarias continuas,2015-06-01,0,0,1,1,0,2
REYES,"anticoncepcion, prevencion de its y de cancer de cuello uterino",pildora: usuarias continuas,2015-06-01,0,6,14,12,0,32
RIBERALTA,"anticoncepcion, prevencion de its y de cancer de cuello uterino",pildora: usuarias continuas,2015-06-01,0,6,47,10,0,63
ROBORE,"anticoncepcion, prevencion de its y de cancer de cuello uterino",pildora: usuarias continuas,2015-06-01,0,0,22,4,0,26
RURRENABAQUE,"anticoncepcion, prevencion de its y de cancer de cuello uterino",pildora: usuarias continuas,2015-06-01,0,1,7,7,0,15
SABAYA,"anticoncepcion, prevencion de its y de cancer de cuello uterino",pildora: usuarias continuas,2015-06-01,0,0,2,0,0,2
SACABA,"anticoncepcion, prevencion de its y de cancer de cuello uterino",pildora: usuarias continuas,2015-06-01,0,5,19,5,0,29
SACACA,"anticoncepcion, prevencion de its y de cancer de cuello uterino",pildora: usuarias continuas,2015-06-01,0,0,12,3,0,15
SAIPINA,"anticoncepcion, prevencion de its y de cancer de cuello uterino",pildora: usuarias continuas,2015-06-01,0,0,1,0,0,1
SALINAS DE GARCI MENDOZA,"anticoncepcion, prevencion de its y de cancer de cuello uterino",pildora: usuarias continuas,2015-06-01,0,0,3,2,0,5
SAMAIPATA,"anticoncepcion, prevencion de its y de cancer de cuello uterino",pildora: usuarias continuas,2015-06-01,0,0,7,2,0,9
SAN AGUSTIN,"anticoncepcion, prevencion de its y de cancer de cuello uterino",pildora: usuarias continuas,2015-06-01,0,0,2,0,0,2
SAN ANDRES,"anticoncepcion, prevencion de its y de cancer de cuello uterino",pildora: usuarias continuas,2015-06-01,1,4,24,8,0,37
SAN ANDRES DE MACHACA,"anticoncepcion, prevencion de its y de cancer de cuello uterino",pildora: usuarias continuas,2015-06-01,0,0,1,0,0,1
SAN ANTONIO DE LOMERIO,"anticoncepcion, prevencion de its y de cancer de cuello uterino",pildora: usuarias continuas,2015-06-01,0,0,17,6,0,23
SAN BORJA,"anticoncepcion, prevencion de its y de cancer de cuello uterino",pildora: usuarias continuas,2015-06-01,0,5,59,20,1,85
SAN BUENA VENTURA,"anticoncepcion, prevencion de its y de cancer de cuello uterino",pildora: usuarias continuas,2015-06-01,0,0,2,0,0,2
SAN CARLOS,"anticoncepcion, prevencion de its y de cancer de cuello uterino",pildora: usuarias continuas,2015-06-01,0,3,22,2,0,27
SAN IGNACIO,"anticoncepcion, prevencion de its y de cancer de cuello uterino",pildora: usuarias continuas,2015-06-01,0,7,87,44,2,140
SAN IGNACIO DE VELASCO,"anticoncepcion, prevencion de its y de cancer de cuello uterino",pildora: usuarias continuas,2015-06-01,0,6,59,27,0,92
SAN JAVIER(BNI),"anticoncepcion, prevencion de its y de cancer de cuello uterino",pildora: usuarias continuas,2015-06-01,0,0,8,1,0,9
SAN JAVIER(STC),"anticoncepcion, prevencion de its y de cancer de cuello uterino",pildora: usuarias continuas,2015-06-01,0,4,16,7,0,27
SAN JOAQUIN,"anticoncepcion, prevencion de its y de cancer de cuello uterino",pildora: usuarias continuas,2015-06-01,0,0,1,0,0,1
SAN JOSE DE CHIQUITOS,"anticoncepcion, prevencion de its y de cancer de cuello uterino",pildora: usuarias continuas,2015-06-01,0,2,11,8,1,22
SAN JUAN DE YAPACANI,"anticoncepcion, prevencion de its y de cancer de cuello uterino",pildora: usuarias continuas,2015-06-01,0,2,4,0,0,6
SAN JULIAN,"anticoncepcion, prevencion de its y de cancer de cuello uterino",pildora: usuarias continuas,2015-06-01,0,0,13,5,0,18
SAN LORENZO(PND),"anticoncepcion, prevencion de its y de cancer de cuello uterino",pildora: usuarias continuas,2015-06-01,0,0,6,0,0,6
SAN LORENZO(TJA),"anticoncepcion, prevencion de its y de cancer de cuello uterino",pildora: usuarias continuas,2015-06-01,0,2,21,1,0,24
SAN LUCAS,"anticoncepcion, prevencion de its y de cancer de cuello uterino",pildora: usuarias continuas,2015-06-01,0,1,7,4,0,12
SAN MATIAS,"anticoncepcion, prevencion de its y de cancer de cuello uterino",pildora: usuarias continuas,2015-06-01,0,2,9,3,0,14
SAN MIGUEL DE VELASCO,"anticoncepcion, prevencion de its y de cancer de cuello uterino",pildora: usuarias continuas,2015-06-01,0,3,24,9,1,37
SAN PEDRO,"anticoncepcion, prevencion de its y de cancer de cuello uterino",pildora: usuarias continuas,2015-06-01,0,0,7,4,1,12
SAN PEDRO DE BUENA VISTA,"anticoncepcion, prevencion de its y de cancer de cuello uterino",pildora: usuarias continuas,2015-06-01,0,2,0,6,0,8
SAN PEDRO DE CURAHUARA,"anticoncepcion, prevencion de its y de cancer de cuello uterino",pildora: usuarias continuas,2015-06-01,0,1,2,1,0,4
SAN PEDRO DE QUEMES,"anticoncepcion, prevencion de its y de cancer de cuello uterino",pildora: usuarias continuas,2015-06-01,0,0,1,1,0,2
SAN PEDRO DE TIQUINA,"anticoncepcion, prevencion de its y de cancer de cuello uterino",pildora: usuarias continuas,2015-06-01,0,0,1,1,0,2
SAN RAFAEL,"anticoncepcion, prevencion de its y de cancer de cuello uterino",pildora: usuarias continuas,2015-06-01,1,4,24,11,0,40
SAN RAMON BENI,"anticoncepcion, prevencion de its y de cancer de cuello uterino",pildora: usuarias continuas,2015-06-01,0,0,3,2,0,5
SAN RAMON SCZ,"anticoncepcion, prevencion de its y de cancer de cuello uterino",pildora: usuarias continuas,2015-06-01,0,7,9,0,0,16
SANTA ANA,"anticoncepcion, prevencion de its y de cancer de cuello uterino",pildora: usuarias continuas,2015-06-01,0,2,16,7,0,25
SANTA CRUZ DE LA SIERRA,"anticoncepcion, prevencion de its y de cancer de cuello uterino",pildora: usuarias continuas,2015-06-01,0,27,155,34,1,217
SANTA ROSA DEL SARA,"anticoncepcion, prevencion de its y de cancer de cuello uterino",pildora: usuarias continuas,2015-06-01,1,5,11,7,0,24
SANTIAGO DE HUATA,"anticoncepcion, prevencion de its y de cancer de cuello uterino",pildora: usuarias continuas,2015-06-01,0,0,1,4,0,5
SANTIVAÑES,"anticoncepcion, prevencion de its y de cancer de cuello uterino",pildora: usuarias continuas,2015-06-01,0,0,7,0,0,7
SANTUARIO DE QUILLACAS,"anticoncepcion, prevencion de its y de cancer de cuello uterino",pildora: usuarias continuas,2015-06-01,0,0,1,7,0,8
SAPAHAQUI,"anticoncepcion, prevencion de its y de cancer de cuello uterino",pildora: usuarias continuas,2015-06-01,0,0,1,0,0,1
SENA,"anticoncepcion, prevencion de its y de cancer de cuello uterino",pildora: usuarias continuas,2015-06-01,0,1,4,0,0,5
SHINAOTA,"anticoncepcion, prevencion de its y de cancer de cuello uterino",pildora: usuarias continuas,2015-06-01,0,0,3,2,0,5
SICA SICA (VILLA AROMA),"anticoncepcion, prevencion de its y de cancer de cuello uterino",pildora: usuarias continuas,2015-06-01,0,0,2,2,0,4
SIPE SIPE,"anticoncepcion, prevencion de its y de cancer de cuello uterino",pildora: usuarias continuas,2015-06-01,0,0,10,2,1,13
SOPACHUY,"anticoncepcion, prevencion de its y de cancer de cuello uterino",pildora: usuarias continuas,2015-06-01,0,1,2,1,0,4
SORACACHI,"anticoncepcion, prevencion de its y de cancer de cuello uterino",pildora: usuarias continuas,2015-06-01,0,0,1,0,0,1
SORATA,"anticoncepcion, prevencion de its y de cancer de cuello uterino",pildora: usuarias continuas,2015-06-01,0,1,4,2,0,7
SUCRE,"anticoncepcion, prevencion de its y de cancer de cuello uterino",pildora: usuarias continuas,2015-06-01,0,6,114,32,0,152
TACACOMA,"anticoncepcion, prevencion de its y de cancer de cuello uterino",pildora: usuarias continuas,2015-06-01,0,1,9,2,0,12
TAHUA,"anticoncepcion, prevencion de its y de cancer de cuello uterino",pildora: usuarias continuas,2015-06-01,0,0,3,0,0,3
TAPACARI,"anticoncepcion, prevencion de its y de cancer de cuello uterino",pildora: usuarias continuas,2015-06-01,0,0,1,0,0,1
TARABUCO,"anticoncepcion, prevencion de its y de cancer de cuello uterino",pildora: usuarias continuas,2015-06-01,0,0,1,1,0,2
TARACO,"anticoncepcion, prevencion de its y de cancer de cuello uterino",pildora: usuarias continuas,2015-06-01,0,0,2,1,0,3
TARIJA,"anticoncepcion, prevencion de its y de cancer de cuello uterino",pildora: usuarias continuas,2015-06-01,0,14,47,19,0,80
TARVITA,"anticoncepcion, prevencion de its y de cancer de cuello uterino",pildora: usuarias continuas,2015-06-01,0,0,4,3,0,7
TEOPONTE,"anticoncepcion, prevencion de its y de cancer de cuello uterino",pildora: usuarias continuas,2015-06-01,0,0,2,1,0,3
TIAWANACU,"anticoncepcion, prevencion de its y de cancer de cuello uterino",pildora: usuarias continuas,2015-06-01,0,1,2,2,0,5
TINGUIPAYA,"anticoncepcion, prevencion de its y de cancer de cuello uterino",pildora: usuarias continuas,2015-06-01,0,0,4,0,0,4
TIPUANI,"anticoncepcion, prevencion de its y de cancer de cuello uterino",pildora: usuarias continuas,2015-06-01,0,2,1,1,0,4
TIQUIPAYA,"anticoncepcion, prevencion de its y de cancer de cuello uterino",pildora: usuarias continuas,2015-06-01,0,2,7,1,0,10
TOLATA,"anticoncepcion, prevencion de its y de cancer de cuello uterino",pildora: usuarias continuas,2015-06-01,0,0,1,2,0,3
TOMAVE,"anticoncepcion, prevencion de its y de cancer de cuello uterino",pildora: usuarias continuas,2015-06-01,0,0,5,0,0,5
TOMINA,"anticoncepcion, prevencion de its y de cancer de cuello uterino",pildora: usuarias continuas,2015-06-01,0,1,6,1,0,8
TORO TORO,"anticoncepcion, prevencion de its y de cancer de cuello uterino",pildora: usuarias continuas,2015-06-01,0,1,0,2,0,3
TOTORA(CBBA),"anticoncepcion, prevencion de its y de cancer de cuello uterino",pildora: usuarias continuas,2015-06-01,0,1,2,0,0,3
TOTORA(ORR),"anticoncepcion, prevencion de its y de cancer de cuello uterino",pildora: usuarias continuas,2015-06-01,1,1,2,0,0,4
TRIGAL,"anticoncepcion, prevencion de its y de cancer de cuello uterino",pildora: usuarias continuas,2015-06-01,0,0,5,3,0,8
TRINIDAD,"anticoncepcion, prevencion de its y de cancer de cuello uterino",pildora: usuarias continuas,2015-06-01,0,26,62,9,0,97
TUPIZA,"anticoncepcion, prevencion de its y de cancer de cuello uterino",pildora: usuarias continuas,2015-06-01,0,0,8,0,0,8
TURCO,"anticoncepcion, prevencion de its y de cancer de cuello uterino",pildora: usuarias continuas,2015-06-01,0,0,0,1,0,1
UNCIA,"anticoncepcion, prevencion de its y de cancer de cuello uterino",pildora: usuarias continuas,2015-06-01,0,0,2,0,0,2
URIONDO (A. CONCEPCION),"anticoncepcion, prevencion de its y de cancer de cuello uterino",pildora: usuarias continuas,2015-06-01,0,1,21,4,0,26
URUBICHA,"anticoncepcion, prevencion de its y de cancer de cuello uterino",pildora: usuarias continuas,2015-06-01,0,0,1,0,0,1
UYUNI,"anticoncepcion, prevencion de its y de cancer de cuello uterino",pildora: usuarias continuas,2015-06-01,0,1,7,7,0,15
VALLEGRANDE,"anticoncepcion, prevencion de its y de cancer de cuello uterino",pildora: usuarias continuas,2015-06-01,0,1,5,2,0,8
VIACHA,"anticoncepcion, prevencion de its y de cancer de cuello uterino",pildora: usuarias continuas,2015-06-01,0,1,9,7,0,17
VILLA CHARCAS,"anticoncepcion, prevencion de its y de cancer de cuello uterino",pildora: usuarias continuas,2015-06-01,0,1,3,3,0,7
VILLA MONTES,"anticoncepcion, prevencion de its y de cancer de cuello uterino",pildora: usuarias continuas,2015-06-01,0,9,23,8,3,43
VILLA NUEVA (LOMA ALTA),"anticoncepcion, prevencion de its y de cancer de cuello uterino",pildora: usuarias continuas,2015-06-01,0,0,1,0,0,1
VILLA SERRANO,"anticoncepcion, prevencion de its y de cancer de cuello uterino",pildora: usuarias continuas,2015-06-01,0,0,0,1,0,1
VILLA TUNARI,"anticoncepcion, prevencion de its y de cancer de cuello uterino",pildora: usuarias continuas,2015-06-01,0,2,34,8,0,44
VILLA VACA GUZMAN (MUYUPAMPA),"anticoncepcion, prevencion de its y de cancer de cuello uterino",pildora: usuarias continuas,2015-06-01,0,1,5,2,0,8
VILLAZON,"anticoncepcion, prevencion de its y de cancer de cuello uterino",pildora: usuarias continuas,2015-06-01,0,5,21,6,0,32
VINTO,"anticoncepcion, prevencion de its y de cancer de cuello uterino",pildora: usuarias continuas,2015-06-01,0,0,1,0,0,1
VITICHI,"anticoncepcion, prevencion de its y de cancer de cuello uterino",pildora: usuarias continuas,2015-06-01,0,0,1,4,0,5
WALDO BALLIVIAN,"anticoncepcion, prevencion de its y de cancer de cuello uterino",pildora: usuarias continuas,2015-06-01,0,0,1,0,0,1
WARNES,"anticoncepcion, prevencion de its y de cancer de cuello uterino",pildora: usuarias continuas,2015-06-01,1,9,70,26,0,106
YACO,"anticoncepcion, prevencion de its y de cancer de cuello uterino",pildora: usuarias continuas,2015-06-01,0,0,1,0,0,1
YACUIBA,"anticoncepcion, prevencion de its y de cancer de cuello uterino",pildora: usuarias continuas,2015-06-01,0,0,14,9,0,23
YANACACHI,"anticoncepcion, prevencion de its y de cancer de cuello uterino",pildora: usuarias continuas,2015-06-01,0,0,1,0,0,1
YAPACANI,"anticoncepcion, prevencion de its y de cancer de cuello uterino",pildora: usuarias continuas,2015-06-01,0,1,9,8,0,18
YOCALLA,"anticoncepcion, prevencion de its y de cancer de cuello uterino",pildora: usuarias continuas,2015-06-01,0,0,2,0,0,2
YOTALA,"anticoncepcion, prevencion de its y de cancer de cuello uterino",pildora: usuarias continuas,2015-06-01,0,0,0,1,0,1
YUNCHARA,"anticoncepcion, prevencion de its y de cancer de cuello uterino",pildora: usuarias continuas,2015-06-01,0,0,2,5,0,7
ZUDAÑEZ,"anticoncepcion, prevencion de its y de cancer de cuello uterino",pildora: usuarias continuas,2015-06-01,0,0,7,0,1,8
ACHACACHI,"anticoncepcion, prevencion de its y de cancer de cuello uterino",pildora: usuarias continuas,2015-07-01,0,0,0,2,0,2
ACHOCALLA,"anticoncepcion, prevencion de its y de cancer de cuello uterino",pildora: usuarias continuas,2015-07-01,0,0,7,5,0,12
AIQUILE,"anticoncepcion, prevencion de its y de cancer de cuello uterino",pildora: usuarias continuas,2015-07-01,0,1,2,1,0,4
ALCALA,"anticoncepcion, prevencion de its y de cancer de cuello uterino",pildora: usuarias continuas,2015-07-01,0,0,1,0,0,1
ALTO BENI,"anticoncepcion, prevencion de its y de cancer de cuello uterino",pildora: usuarias continuas,2015-07-01,0,1,9,1,0,11
ANCORAIMES,"anticoncepcion, prevencion de its y de cancer de cuello uterino",pildora: usuarias continuas,2015-07-01,0,1,2,2,0,5
ANDAMARCA,"anticoncepcion, prevencion de its y de cancer de cuello uterino",pildora: usuarias continuas,2015-07-01,0,0,1,1,0,2
ANTEQUERA,"anticoncepcion, prevencion de its y de cancer de cuello uterino",pildora: usuarias continuas,2015-07-01,0,0,4,0,0,4
ANZALDO,"anticoncepcion, prevencion de its y de cancer de cuello uterino",pildora: usuarias continuas,2015-07-01,0,0,1,0,0,1
APOLO,"anticoncepcion, prevencion de its y de cancer de cuello uterino",pildora: usuarias continuas,2015-07-01,0,1,9,3,0,13
ARAMPAMPA,"anticoncepcion, prevencion de its y de cancer de cuello uterino",pildora: usuarias continuas,2015-07-01,0,0,3,0,0,3
ARANI,"anticoncepcion, prevencion de its y de cancer de cuello uterino",pildora: usuarias continuas,2015-07-01,0,0,1,3,0,4
ARBIETO,"anticoncepcion, prevencion de its y de cancer de cuello uterino",pildora: usuarias continuas,2015-07-01,0,0,4,1,0,5
ARQUE,"anticoncepcion, prevencion de its y de cancer de cuello uterino",pildora: usuarias continuas,2015-07-01,0,0,0,1,0,1
ASCENCION DE GUARAYOS,"anticoncepcion, prevencion de its y de cancer de cuello uterino",pildora: usuarias continuas,2015-07-01,0,20,27,8,0,55
ATOCHA,"anticoncepcion, prevencion de its y de cancer de cuello uterino",pildora: usuarias continuas,2015-07-01,0,0,10,0,0,10
AUCAPATA,"anticoncepcion, prevencion de its y de cancer de cuello uterino",pildora: usuarias continuas,2015-07-01,0,0,1,0,0,1
AYATA,"anticoncepcion, prevencion de its y de cancer de cuello uterino",pildora: usuarias continuas,2015-07-01,0,0,4,3,0,7
AYO AYO,"anticoncepcion, prevencion de its y de cancer de cuello uterino",pildora: usuarias continuas,2015-07-01,0,0,1,0,0,1
AYOPAYA (V. DE INDEPENDENCIA),"anticoncepcion, prevencion de its y de cancer de cuello uterino",pildora: usuarias continuas,2015-07-01,0,2,16,6,0,24
AZURDUY,"anticoncepcion, prevencion de its y de cancer de cuello uterino",pildora: usuarias continuas,2015-07-01,0,1,1,2,0,4
BATALLAS,"anticoncepcion, prevencion de its y de cancer de cuello uterino",pildora: usuarias continuas,2015-07-01,0,0,3,2,0,5
BAURES,"anticoncepcion, prevencion de its y de cancer de cuello uterino",pildora: usuarias continuas,2015-07-01,0,0,12,0,0,12
BELLA FLOR,"anticoncepcion, prevencion de its y de cancer de cuello uterino",pildora: usuarias continuas,2015-07-01,0,2,3,1,0,6
BERMEJO,"anticoncepcion, prevencion de its y de cancer de cuello uterino",pildora: usuarias continuas,2015-07-01,0,1,22,4,0,27
BETANZOS,"anticoncepcion, prevencion de its y de cancer de cuello uterino",pildora: usuarias continuas,2015-07-01,0,1,1,2,0,4
BOLPEBRA,"anticoncepcion, prevencion de its y de cancer de cuello uterino",pildora: usuarias continuas,2015-07-01,0,1,4,0,0,5
BUENA VISTA,"anticoncepcion, prevencion de its y de cancer de cuello uterino",pildora: usuarias continuas,2015-07-01,0,4,18,6,0,28
CABEZAS,"anticoncepcion, prevencion de its y de cancer de cuello uterino",pildora: usuarias continuas,2015-07-01,0,4,34,5,1,44
CAIROMA,"anticoncepcion, prevencion de its y de cancer de cuello uterino",pildora: usuarias continuas,2015-07-01,0,0,1,0,0,1
"CAIZA ""D""","anticoncepcion, prevencion de its y de cancer de cuello uterino",pildora: usuarias continuas,2015-07-01,0,0,2,0,0,2
CAJUATA,"anticoncepcion, prevencion de its y de cancer de cuello uterino",pildora: usuarias continuas,2015-07-01,0,0,2,1,0,3
CALAMARCA,"anticoncepcion, prevencion de its y de cancer de cuello uterino",pildora: usuarias continuas,2015-07-01,0,0,3,3,0,6
CAMARGO,"anticoncepcion, prevencion de its y de cancer de cuello uterino",pildora: usuarias continuas,2015-07-01,0,1,2,3,0,6
CAMATAQUI (C. VILLA ABECIA),"anticoncepcion, prevencion de its y de cancer de cuello uterino",pildora: usuarias continuas,2015-07-01,0,0,0,1,0,1
CAMIRI,"anticoncepcion, prevencion de its y de cancer de cuello uterino",pildora: usuarias continuas,2015-07-01,0,0,6,4,0,10
CAPINOTA,"anticoncepcion, prevencion de its y de cancer de cuello uterino",pildora: usuarias continuas,2015-07-01,0,0,1,2,0,3
CARACOLLO,"anticoncepcion, prevencion de its y de cancer de cuello uterino",pildora: usuarias continuas,2015-07-01,0,0,3,2,0,5
CARANAVI,"anticoncepcion, prevencion de its y de cancer de cuello uterino",pildora: usuarias continuas,2015-07-01,0,0,10,1,0,11
CARANGAS,"anticoncepcion, prevencion de its y de cancer de cuello uterino",pildora: usuarias continuas,2015-07-01,0,0,1,0,0,1
CARAPARI,"anticoncepcion, prevencion de its y de cancer de cuello uterino",pildora: usuarias continuas,2015-07-01,0,1,19,4,1,25
CARMEN RIVERO TORREZ,"anticoncepcion, prevencion de its y de cancer de cuello uterino",pildora: usuarias continuas,2015-07-01,0,0,2,0,0,2
CHALLAPATA,"anticoncepcion, prevencion de its y de cancer de cuello uterino",pildora: usuarias continuas,2015-07-01,0,2,1,5,0,8
CHAQUI,"anticoncepcion, prevencion de its y de cancer de cuello uterino",pildora: usuarias continuas,2015-07-01,0,1,0,0,0,1
CHARAGUA,"anticoncepcion, prevencion de its y de cancer de cuello uterino",pildora: usuarias continuas,2015-07-01,0,2,14,6,0,22
CHIMORE,"anticoncepcion, prevencion de its y de cancer de cuello uterino",pildora: usuarias continuas,2015-07-01,0,1,9,3,0,13
CHULUMANI (V. DE LA LIBERTAD),"anticoncepcion, prevencion de its y de cancer de cuello uterino",pildora: usuarias continuas,2015-07-01,0,0,3,0,0,3
CHUMA,"anticoncepcion, prevencion de its y de cancer de cuello uterino",pildora: usuarias continuas,2015-07-01,0,0,0,2,0,2
CHUQUIHUTA AYLLU JUCUMANI,"anticoncepcion, prevencion de its y de cancer de cuello uterino",pildora: usuarias continuas,2015-07-01,0,0,2,1,0,3
CLIZA,"anticoncepcion, prevencion de its y de cancer de cuello uterino",pildora: usuarias continuas,2015-07-01,0,3,17,1,0,21
COBIJA,"anticoncepcion, prevencion de its y de cancer de cuello uterino",pildora: usuarias continuas,2015-07-01,1,7,57,7,0,72
COCAPATA,"anticoncepcion, prevencion de its y de cancer de cuello uterino",pildora: usuarias continuas,2015-07-01,0,1,6,0,0,7
COCHABAMBA,"anticoncepcion, prevencion de its y de cancer de cuello uterino",pildora: usuarias continuas,2015-07-01,0,40,97,40,0,177
COLCAPIRHUA,"anticoncepcion, prevencion de its y de cancer de cuello uterino",pildora: usuarias continuas,2015-07-01,0,0,8,1,0,9
"COLCHA ""K""","anticoncepcion, prevencion de its y de cancer de cuello uterino",pildora: usuarias continuas,2015-07-01,0,1,4,1,0,6
COLOMI,"anticoncepcion, prevencion de its y de cancer de cuello uterino",pildora: usuarias continuas,2015-07-01,0,0,7,4,0,11
COLPA BELGICA,"anticoncepcion, prevencion de its y de cancer de cuello uterino",pildora: usuarias continuas,2015-07-01,0,0,8,6,1,15
COLQUECHACA,"anticoncepcion, prevencion de its y de cancer de cuello uterino",pildora: usuarias continuas,2015-07-01,0,0,1,3,0,4
COLQUENCHA,"anticoncepcion, prevencion de its y de cancer de cuello uterino",pildora: usuarias continuas,2015-07-01,0,0,0,1,0,1
COMARAPA,"anticoncepcion, prevencion de its y de cancer de cuello uterino",pildora: usuarias continuas,2015-07-01,0,0,7,0,0,7
CONCEPCION,"anticoncepcion, prevencion de its y de cancer de cuello uterino",pildora: usuarias continuas,2015-07-01,0,2,11,5,0,18
COPACABANA,"anticoncepcion, prevencion de its y de cancer de cuello uterino",pildora: usuarias continuas,2015-07-01,0,0,3,0,0,3
COROICO,"anticoncepcion, prevencion de its y de cancer de cuello uterino",pildora: usuarias continuas,2015-07-01,0,0,1,1,0,2
CORQUE,"anticoncepcion, prevencion de its y de cancer de cuello uterino",pildora: usuarias continuas,2015-07-01,0,0,1,4,0,5
COTAGAITA,"anticoncepcion, prevencion de its y de cancer de cuello uterino",pildora: usuarias continuas,2015-07-01,0,1,9,4,0,14
COTOCA,"anticoncepcion, prevencion de its y de cancer de cuello uterino",pildora: usuarias continuas,2015-07-01,0,4,34,11,0,49
CUATRO CAÑADAS,"anticoncepcion, prevencion de its y de cancer de cuello uterino",pildora: usuarias continuas,2015-07-01,0,2,8,3,0,13
CUCHUMUELA (V. G. VILLARROEL),"anticoncepcion, prevencion de its y de cancer de cuello uterino",pildora: usuarias continuas,2015-07-01,0,1,3,0,0,4
CUEVO,"anticoncepcion, prevencion de its y de cancer de cuello uterino",pildora: usuarias continuas,2015-07-01,0,0,8,0,0,8
CULPINA,"anticoncepcion, prevencion de its y de cancer de cuello uterino",pildora: usuarias continuas,2015-07-01,0,0,7,6,0,13
CURAHUARA DE CARANGAS,"anticoncepcion, prevencion de its y de cancer de cuello uterino",pildora: usuarias continuas,2015-07-01,0,0,3,0,0,3
DESAGUADERO,"anticoncepcion, prevencion de its y de cancer de cuello uterino",pildora: usuarias continuas,2015-07-01,0,0,3,0,0,3
EL ALTO,"anticoncepcion, prevencion de its y de cancer de cuello uterino",pildora: usuarias continuas,2015-07-01,0,15,141,46,0,202
EL CHORO,"anticoncepcion, prevencion de its y de cancer de cuello uterino",pildora: usuarias continuas,2015-07-01,0,0,0,1,0,1
EL PUENTE(STC),"anticoncepcion, prevencion de its y de cancer de cuello uterino",pildora: usuarias continuas,2015-07-01,0,4,16,12,0,32
EL PUENTE(TJA),"anticoncepcion, prevencion de its y de cancer de cuello uterino",pildora: usuarias continuas,2015-07-01,0,0,8,4,0,12
EL TORNO,"anticoncepcion, prevencion de its y de cancer de cuello uterino",pildora: usuarias continuas,2015-07-01,2,8,28,8,0,46
EL VILLAR,"anticoncepcion, prevencion de its y de cancer de cuello uterino",pildora: usuarias continuas,2015-07-01,0,0,2,1,0,3
ENTRE RIOS TRJ,"anticoncepcion, prevencion de its y de cancer de cuello uterino",pildora: usuarias continuas,2015-07-01,0,2,21,6,0,29
ENTRE RIOS CBBA,"anticoncepcion, prevencion de its y de cancer de cuello uterino",pildora: usuarias continuas,2015-07-01,0,1,6,1,0,8
EUREKA (SANTOS MERCADO),"anticoncepcion, prevencion de its y de cancer de cuello uterino",pildora: usuarias continuas,2015-07-01,0,0,1,0,0,1
FERNANDEZ ALONSO,"anticoncepcion, prevencion de its y de cancer de cuello uterino",pildora: usuarias continuas,2015-07-01,0,0,8,2,0,10
FILADELFIA,"anticoncepcion, prevencion de its y de cancer de cuello uterino",pildora: usuarias continuas,2015-07-01,0,4,18,6,0,28
GENERAL SAAVEDRA,"anticoncepcion, prevencion de its y de cancer de cuello uterino",pildora: usuarias continuas,2015-07-01,0,0,16,2,0,18
GRAL. J.J. PEREZ (CHARAZANI),"anticoncepcion, prevencion de its y de cancer de cuello uterino",pildora: usuarias continuas,2015-07-01,0,0,0,3,0,3
GUANAY,"anticoncepcion, prevencion de its y de cancer de cuello uterino",pildora: usuarias continuas,2015-07-01,0,1,0,0,0,1
GUAQUI,"anticoncepcion, prevencion de its y de cancer de cuello uterino",pildora: usuarias continuas,2015-07-01,0,0,1,0,0,1
GUAYARAMERIN,"anticoncepcion, prevencion de its y de cancer de cuello uterino",pildora: usuarias continuas,2015-07-01,0,4,14,2,0,20
GUTIERREZ,"anticoncepcion, prevencion de its y de cancer de cuello uterino",pildora: usuarias continuas,2015-07-01,0,0,3,1,0,4
HUACARETA,"anticoncepcion, prevencion de its y de cancer de cuello uterino",pildora: usuarias continuas,2015-07-01,0,1,12,6,0,19
HUACAYA (VILLA DE HUACAYA),"anticoncepcion, prevencion de its y de cancer de cuello uterino",pildora: usuarias continuas,2015-07-01,0,1,0,0,0,1
HUACHACALLA,"anticoncepcion, prevencion de its y de cancer de cuello uterino",pildora: usuarias continuas,2015-07-01,0,0,1,1,0,2
HUANUNI,"anticoncepcion, prevencion de its y de cancer de cuello uterino",pildora: usuarias continuas,2015-07-01,0,0,2,0,0,2
HUARACAJE,"anticoncepcion, prevencion de its y de cancer de cuello uterino",pildora: usuarias continuas,2015-07-01,0,1,8,12,0,21
HUAYLLAMARCA,"anticoncepcion, prevencion de its y de cancer de cuello uterino",pildora: usuarias continuas,2015-07-01,0,0,0,1,0,1
HUMANATA,"anticoncepcion, prevencion de its y de cancer de cuello uterino",pildora: usuarias continuas,2015-07-01,0,0,1,1,0,2
ICLA,"anticoncepcion, prevencion de its y de cancer de cuello uterino",pildora: usuarias continuas,2015-07-01,0,0,4,1,0,5
INCAHUASI,"anticoncepcion, prevencion de its y de cancer de cuello uterino",pildora: usuarias continuas,2015-07-01,1,0,6,3,0,10
INGAVI (HUMAITA),"anticoncepcion, prevencion de its y de cancer de cuello uterino",pildora: usuarias continuas,2015-07-01,0,0,0,1,0,1
INQUISIVI,"anticoncepcion, prevencion de its y de cancer de cuello uterino",pildora: usuarias continuas,2015-07-01,0,1,0,1,0,2
IRUPANA (VILLA DE LANZA),"anticoncepcion, prevencion de its y de cancer de cuello uterino",pildora: usuarias continuas,2015-07-01,0,0,9,3,0,12
IXIAMAS,"anticoncepcion, prevencion de its y de cancer de cuello uterino",pildora: usuarias continuas,2015-07-01,0,0,4,2,0,6
JESUS DE MACHACA,"anticoncepcion, prevencion de its y de cancer de cuello uterino",pildora: usuarias continuas,2015-07-01,0,0,1,0,0,1
LA ASUNTA,"anticoncepcion, prevencion de its y de cancer de cuello uterino",pildora: usuarias continuas,2015-07-01,0,2,15,7,0,24
LA GUARDIA,"anticoncepcion, prevencion de its y de cancer de cuello uterino",pildora: usuarias continuas,2015-07-01,1,11,38,3,0,53
LA PAZ,"anticoncepcion, prevencion de its y de cancer de cuello uterino",pildora: usuarias continuas,2015-07-01,0,5,103,23,0,131
LAGUNILLAS,"anticoncepcion, prevencion de its y de cancer de cuello uterino",pildora: usuarias continuas,2015-07-01,0,0,6,1,0,7
LAJA,"anticoncepcion, prevencion de its y de cancer de cuello uterino",pildora: usuarias continuas,2015-07-01,0,0,6,5,0,11
LAS CARRERAS,"anticoncepcion, prevencion de its y de cancer de cuello uterino",pildora: usuarias continuas,2015-07-01,0,0,0,2,0,2
LICOMA PAMPA,"anticoncepcion, prevencion de its y de cancer de cuello uterino",pildora: usuarias continuas,2015-07-01,0,0,1,1,0,2
LLALLAGUA,"anticoncepcion, prevencion de its y de cancer de cuello uterino",pildora: usuarias continuas,2015-07-01,0,0,7,2,0,9
LLICA,"anticoncepcion, prevencion de its y de cancer de cuello uterino",pildora: usuarias continuas,2015-07-01,0,2,7,2,0,11
LORETO,"anticoncepcion, prevencion de its y de cancer de cuello uterino",pildora: usuarias continuas,2015-07-01,0,10,11,0,0,21
LURIBAY,"anticoncepcion, prevencion de its y de cancer de cuello uterino",pildora: usuarias continuas,2015-07-01,0,0,1,0,0,1
MACHARETI,"anticoncepcion, prevencion de its y de cancer de cuello uterino",pildora: usuarias continuas,2015-07-01,0,1,7,6,0,14
MAGDALENA,"anticoncepcion, prevencion de its y de cancer de cuello uterino",pildora: usuarias continuas,2015-07-01,0,7,37,13,0,57
MAIRANA,"anticoncepcion, prevencion de its y de cancer de cuello uterino",pildora: usuarias continuas,2015-07-01,0,0,5,1,0,6
MECAPACA,"anticoncepcion, prevencion de its y de cancer de cuello uterino",pildora: usuarias continuas,2015-07-01,0,1,0,2,0,3
MINEROS,"anticoncepcion, prevencion de its y de cancer de cuello uterino",pildora: usuarias continuas,2015-07-01,0,3,24,8,0,35
MIZQUE,"anticoncepcion, prevencion de its y de cancer de cuello uterino",pildora: usuarias continuas,2015-07-01,1,2,3,5,0,11
MOCOMOCO,"anticoncepcion, prevencion de its y de cancer de cuello uterino",pildora: usuarias continuas,2015-07-01,0,0,3,1,0,4
MOJOCOYA,"anticoncepcion, prevencion de its y de cancer de cuello uterino",pildora: usuarias continuas,2015-07-01,0,0,0,2,0,2
MONTEAGUDO,"anticoncepcion, prevencion de its y de cancer de cuello uterino",pildora: usuarias continuas,2015-07-01,0,2,15,17,0,34
MONTERO,"anticoncepcion, prevencion de its y de cancer de cuello uterino",pildora: usuarias continuas,2015-07-01,0,6,45,20,2,73
MORO MORO,"anticoncepcion, prevencion de its y de cancer de cuello uterino",pildora: usuarias continuas,2015-07-01,0,1,1,2,0,4
MOROCHATA,"anticoncepcion, prevencion de its y de cancer de cuello uterino",pildora: usuarias continuas,2015-07-01,0,0,3,2,0,5
NACEBE (SANTA ROSA DEL ABUNA),"anticoncepcion, prevencion de its y de cancer de cuello uterino",pildora: usuarias continuas,2015-07-01,0,0,1,0,0,1
NUEVO MANOA (NUEVA ESPERANZA),"anticoncepcion, prevencion de its y de cancer de cuello uterino",pildora: usuarias continuas,2015-07-01,0,0,0,1,0,1
OCURI,"anticoncepcion, prevencion de its y de cancer de cuello uterino",pildora: usuarias continuas,2015-07-01,0,0,6,0,0,6
OKINAWA,"anticoncepcion, prevencion de its y de cancer de cuello uterino",pildora: usuarias continuas,2015-07-01,1,3,12,6,0,22
OMEREQUE,"anticoncepcion, prevencion de its y de cancer de cuello uterino",pildora: usuarias continuas,2015-07-01,0,0,5,3,0,8
ORURO,"anticoncepcion, prevencion de its y de cancer de cuello uterino",pildora: usuarias continuas,2015-07-01,0,2,73,18,0,93
PADCAYA,"anticoncepcion, prevencion de its y de cancer de cuello uterino",pildora: usuarias continuas,2015-07-01,0,3,22,4,0,29
PADILLA,"anticoncepcion, prevencion de its y de cancer de cuello uterino",pildora: usuarias continuas,2015-07-01,0,0,15,4,0,19
PAILON,"anticoncepcion, prevencion de its y de cancer de cuello uterino",pildora: usuarias continuas,2015-07-01,0,0,2,1,0,3
PALCA,"anticoncepcion, prevencion de its y de cancer de cuello uterino",pildora: usuarias continuas,2015-07-01,0,0,3,1,0,4
PALOS BLANCOS,"anticoncepcion, prevencion de its y de cancer de cuello uterino",pildora: usuarias continuas,2015-07-01,1,0,17,10,0,28
PAMPA GRANDE,"anticoncepcion, prevencion de its y de cancer de cuello uterino",pildora: usuarias continuas,2015-07-01,0,0,7,2,0,9
PAPEL PAMPA,"anticoncepcion, prevencion de its y de cancer de cuello uterino",pildora: usuarias continuas,2015-07-01,0,0,3,2,0,5
PASORAPA,"anticoncepcion, prevencion de its y de cancer de cuello uterino",pildora: usuarias continuas,2015-07-01,0,0,2,1,0,3
PATACAMAYA,"anticoncepcion, prevencion de its y de cancer de cuello uterino",pildora: usuarias continuas,2015-07-01,0,0,1,0,0,1
PAZÑA,"anticoncepcion, prevencion de its y de cancer de cuello uterino",pildora: usuarias continuas,2015-07-01,0,0,2,4,0,6
PELECHUCO,"anticoncepcion, prevencion de its y de cancer de cuello uterino",pildora: usuarias continuas,2015-07-01,0,3,11,3,0,17
POCOATA,"anticoncepcion, prevencion de its y de cancer de cuello uterino",pildora: usuarias continuas,2015-07-01,0,0,2,0,0,2
POCONA,"anticoncepcion, prevencion de its y de cancer de cuello uterino",pildora: usuarias continuas,2015-07-01,0,0,8,6,0,14
POJO (CBBA),"anticoncepcion, prevencion de its y de cancer de cuello uterino",pildora: usuarias continuas,2015-07-01,0,0,3,0,0,3
POOPO,"anticoncepcion, prevencion de its y de cancer de cuello uterino",pildora: usuarias continuas,2015-07-01,0,0,3,1,0,4
PORCO,"anticoncepcion, prevencion de its y de cancer de cuello uterino",pildora: usuarias continuas,2015-07-01,0,0,0,1,0,1
POROMA,"anticoncepcion, prevencion de its y de cancer de cuello uterino",pildora: usuarias continuas,2015-07-01,0,0,0,3,0,3
PORONGO,"anticoncepcion, prevencion de its y de cancer de cuello uterino",pildora: usuarias continuas,2015-07-01,0,0,1,5,0,6
PORTACHUELO,"anticoncepcion, prevencion de its y de cancer de cuello uterino",pildora: usuarias continuas,2015-07-01,0,3,6,2,0,11
PORVENIR,"anticoncepcion, prevencion de its y de cancer de cuello uterino",pildora: usuarias continuas,2015-07-01,0,2,20,4,0,26
POSTRER VALLE,"anticoncepcion, prevencion de its y de cancer de cuello uterino",pildora: usuarias continuas,2015-07-01,0,1,3,1,0,5
POTOSI,"anticoncepcion, prevencion de its y de cancer de cuello uterino",pildora: usuarias continuas,2015-07-01,0,3,25,12,0,40
PRESTO,"anticoncepcion, prevencion de its y de cancer de cuello uterino",pildora: usuarias continuas,2015-07-01,0,0,1,2,0,3
PUCARANI,"anticoncepcion, prevencion de its y de cancer de cuello uterino",pildora: usuarias continuas,2015-07-01,0,0,2,2,0,4
PUERTO ACOSTA,"anticoncepcion, prevencion de its y de cancer de cuello uterino",pildora: usuarias continuas,2015-07-01,0,0,0,1,0,1
PUERTO CARABUCO,"anticoncepcion, prevencion de its y de cancer de cuello uterino",pildora: usuarias continuas,2015-07-01,0,0,5,1,0,6
PUERTO GONZALO MORENO,"anticoncepcion, prevencion de its y de cancer de cuello uterino",pildora: usuarias continuas,2015-07-01,0,6,12,3,0,21
PUERTO QUIJARRO,"anticoncepcion, prevencion de its y de cancer de cuello uterino",pildora: usuarias continuas,2015-07-01,0,0,9,6,0,15
PUERTO RICO,"anticoncepcion, prevencion de its y de cancer de cuello uterino",pildora: usuarias continuas,2015-07-01,0,0,1,0,0,1
PUERTO SILES,"anticoncepcion, prevencion de its y de cancer de cuello uterino",pildora: usuarias continuas,2015-07-01,0,0,8,0,0,8
PUERTO SUAREZ,"anticoncepcion, prevencion de its y de cancer de cuello uterino",pildora: usuarias continuas,2015-07-01,0,0,5,0,0,5
PUERTO VILLARROEL,"anticoncepcion, prevencion de its y de cancer de cuello uterino",pildora: usuarias continuas,2015-07-01,0,6,19,5,0,30
PUNA,"anticoncepcion, prevencion de its y de cancer de cuello uterino",pildora: usuarias continuas,2015-07-01,0,2,10,8,0,20
PUNATA,"anticoncepcion, prevencion de its y de cancer de cuello uterino",pildora: usuarias continuas,2015-07-01,0,0,4,1,0,5
QUIABAYA,"anticoncepcion, prevencion de its y de cancer de cuello uterino",pildora: usuarias continuas,2015-07-01,0,0,2,1,0,3
QUILLACOLLO,"anticoncepcion, prevencion de its y de cancer de cuello uterino",pildora: usuarias continuas,2015-07-01,0,2,19,4,0,25
QUIME,"anticoncepcion, prevencion de its y de cancer de cuello uterino",pildora: usuarias continuas,2015-07-01,0,0,6,0,0,6
QUIRUSILLAS,"anticoncepcion, prevencion de its y de cancer de cuello uterino",pildora: usuarias continuas,2015-07-01,0,0,1,0,0,1
REYES,"anticoncepcion, prevencion de its y de cancer de cuello uterino",pildora: usuarias continuas,2015-07-01,0,0,10,6,0,16
RIBERALTA,"anticoncepcion, prevencion de its y de cancer de cuello uterino",pildora: usuarias continuas,2015-07-01,0,3,39,8,0,50
ROBORE,"anticoncepcion, prevencion de its y de cancer de cuello uterino",pildora: usuarias continuas,2015-07-01,0,4,20,5,0,29
RURRENABAQUE,"anticoncepcion, prevencion de its y de cancer de cuello uterino",pildora: usuarias continuas,2015-07-01,1,4,11,8,0,24
SABAYA,"anticoncepcion, prevencion de its y de cancer de cuello uterino",pildora: usuarias continuas,2015-07-01,0,1,1,1,0,3
SACABA,"anticoncepcion, prevencion de its y de cancer de cuello uterino",pildora: usuarias continuas,2015-07-01,0,2,21,11,0,34
SACACA,"anticoncepcion, prevencion de its y de cancer de cuello uterino",pildora: usuarias continuas,2015-07-01,0,0,6,1,0,7
SAIPINA,"anticoncepcion, prevencion de its y de cancer de cuello uterino",pildora: usuarias continuas,2015-07-01,0,1,0,0,0,1
SALINAS DE GARCI MENDOZA,"anticoncepcion, prevencion de its y de cancer de cuello uterino",pildora: usuarias continuas,2015-07-01,0,0,1,0,0,1
SAMAIPATA,"anticoncepcion, prevencion de its y de cancer de cuello uterino",pildora: usuarias continuas,2015-07-01,0,1,12,3,0,16
SAN AGUSTIN,"anticoncepcion, prevencion de its y de cancer de cuello uterino",pildora: usuarias continuas,2015-07-01,0,0,2,3,0,5
SAN ANDRES,"anticoncepcion, prevencion de its y de cancer de cuello uterino",pildora: usuarias continuas,2015-07-01,1,6,31,17,0,55
SAN ANDRES DE MACHACA,"anticoncepcion, prevencion de its y de cancer de cuello uterino",pildora: usuarias continuas,2015-07-01,0,0,1,0,0,1
SAN ANTONIO DE LOMERIO,"anticoncepcion, prevencion de its y de cancer de cuello uterino",pildora: usuarias continuas,2015-07-01,0,4,7,3,0,14
SAN BORJA,"anticoncepcion, prevencion de its y de cancer de cuello uterino",pildora: usuarias continuas,2015-07-01,0,8,45,13,1,67
SAN CARLOS,"anticoncepcion, prevencion de its y de cancer de cuello uterino",pildora: usuarias continuas,2015-07-01,0,13,20,5,0,38
SAN IGNACIO,"anticoncepcion, prevencion de its y de cancer de cuello uterino",pildora: usuarias continuas,2015-07-01,1,13,82,41,0,137
SAN IGNACIO DE VELASCO,"anticoncepcion, prevencion de its y de cancer de cuello uterino",pildora: usuarias continuas,2015-07-01,2,7,63,16,0,88
SAN JAVIER(BNI),"anticoncepcion, prevencion de its y de cancer de cuello uterino",pildora: usuarias continuas,2015-07-01,0,1,0,1,0,2
SAN JAVIER(STC),"anticoncepcion, prevencion de its y de cancer de cuello uterino",pildora: usuarias continuas,2015-07-01,0,2,17,4,0,23
SAN JOAQUIN,"anticoncepcion, prevencion de its y de cancer de cuello uterino",pildora: usuarias continuas,2015-07-01,0,1,1,0,0,2
SAN JOSE DE CHIQUITOS,"anticoncepcion, prevencion de its y de cancer de cuello uterino",pildora: usuarias continuas,2015-07-01,0,0,10,12,0,22
SAN JUAN DE YAPACANI,"anticoncepcion, prevencion de its y de cancer de cuello uterino",pildora: usuarias continuas,2015-07-01,0,0,8,4,0,12
SAN JULIAN,"anticoncepcion, prevencion de its y de cancer de cuello uterino",pildora: usuarias continuas,2015-07-01,0,0,6,1,0,7
SAN LORENZO(PND),"anticoncepcion, prevencion de its y de cancer de cuello uterino",pildora: usuarias continuas,2015-07-01,0,2,4,0,0,6
SAN LORENZO(TJA),"anticoncepcion, prevencion de its y de cancer de cuello uterino",pildora: usuarias continuas,2015-07-01,0,7,21,5,1,34
SAN LUCAS,"anticoncepcion, prevencion de its y de cancer de cuello uterino",pildora: usuarias continuas,2015-07-01,0,1,2,2,0,5
SAN MATIAS,"anticoncepcion, prevencion de its y de cancer de cuello uterino",pildora: usuarias continuas,2015-07-01,0,1,13,9,0,23
SAN MIGUEL DE VELASCO,"anticoncepcion, prevencion de its y de cancer de cuello uterino",pildora: usuarias continuas,2015-07-01,0,3,19,12,0,34
SAN PEDRO,"anticoncepcion, prevencion de its y de cancer de cuello uterino",pildora: usuarias continuas,2015-07-01,0,2,13,8,0,23
SAN PEDRO DE BUENA VISTA,"anticoncepcion, prevencion de its y de cancer de cuello uterino",pildora: usuarias continuas,2015-07-01,0,1,1,0,0,2
SAN PEDRO DE CURAHUARA,"anticoncepcion, prevencion de its y de cancer de cuello uterino",pildora: usuarias continuas,2015-07-01,0,0,4,2,0,6
SAN PEDRO DE TIQUINA,"anticoncepcion, prevencion de its y de cancer de cuello uterino",pildora: usuarias continuas,2015-07-01,0,1,0,0,0,1
SAN PEDRO(PND),"anticoncepcion, prevencion de its y de cancer de cuello uterino",pildora: usuarias continuas,2015-07-01,0,0,0,1,0,1
SAN RAFAEL,"anticoncepcion, prevencion de its y de cancer de cuello uterino",pildora: usuarias continuas,2015-07-01,0,3,21,10,0,34
SAN RAMON BENI,"anticoncepcion, prevencion de its y de cancer de cuello uterino",pildora: usuarias continuas,2015-07-01,0,4,9,3,0,16
SAN RAMON SCZ,"anticoncepcion, prevencion de its y de cancer de cuello uterino",pildora: usuarias continuas,2015-07-01,1,3,8,0,0,12
SANTA ANA,"anticoncepcion, prevencion de its y de cancer de cuello uterino",pildora: usuarias continuas,2015-07-01,0,3,15,10,0,28
SANTA CRUZ DE LA SIERRA,"anticoncepcion, prevencion de its y de cancer de cuello uterino",pildora: usuarias continuas,2015-07-01,8,22,125,48,0,203
SANTA ROSA,"anticoncepcion, prevencion de its y de cancer de cuello uterino",pildora: usuarias continuas,2015-07-01,0,0,2,3,0,5
SANTA ROSA DEL SARA,"anticoncepcion, prevencion de its y de cancer de cuello uterino",pildora: usuarias continuas,2015-07-01,0,2,24,13,0,39
SANTIAGO DE HUATA,"anticoncepcion, prevencion de its y de cancer de cuello uterino",pildora: usuarias continuas,2015-07-01,0,0,1,1,0,2
SANTIVAÑES,"anticoncepcion, prevencion de its y de cancer de cuello uterino",pildora: usuarias continuas,2015-07-01,0,1,5,4,0,10
SANTUARIO DE QUILLACAS,"anticoncepcion, prevencion de its y de cancer de cuello uterino",pildora: usuarias continuas,2015-07-01,0,0,5,0,0,5
SAPAHAQUI,"anticoncepcion, prevencion de its y de cancer de cuello uterino",pildora: usuarias continuas,2015-07-01,0,0,2,1,0,3
SENA,"anticoncepcion, prevencion de its y de cancer de cuello uterino",pildora: usuarias continuas,2015-07-01,0,0,1,0,0,1
SHINAOTA,"anticoncepcion, prevencion de its y de cancer de cuello uterino",pildora: usuarias continuas,2015-07-01,0,1,4,0,0,5
SICA SICA (VILLA AROMA),"anticoncepcion, prevencion de its y de cancer de cuello uterino",pildora: usuarias continuas,2015-07-01,0,0,2,2,0,4
SICAYA,"anticoncepcion, prevencion de its y de cancer de cuello uterino",pildora: usuarias continuas,2015-07-01,0,0,1,0,0,1
SIPE SIPE,"anticoncepcion, prevencion de its y de cancer de cuello uterino",pildora: usuarias continuas,2015-07-01,0,0,11,7,0,18
SOPACHUY,"anticoncepcion, prevencion de its y de cancer de cuello uterino",pildora: usuarias continuas,2015-07-01,0,1,1,1,0,3
SORACACHI,"anticoncepcion, prevencion de its y de cancer de cuello uterino",pildora: usuarias continuas,2015-07-01,0,0,0,1,0,1
SORATA,"anticoncepcion, prevencion de its y de cancer de cuello uterino",pildora: usuarias continuas,2015-07-01,0,0,6,1,0,7
SUCRE,"anticoncepcion, prevencion de its y de cancer de cuello uterino",pildora: usuarias continuas,2015-07-01,1,11,109,23,0,144
TACACOMA,"anticoncepcion, prevencion de its y de cancer de cuello uterino",pildora: usuarias continuas,2015-07-01,0,0,2,1,0,3
TAHUA,"anticoncepcion, prevencion de its y de cancer de cuello uterino",pildora: usuarias continuas,2015-07-01,0,0,0,2,0,2
TAPACARI,"anticoncepcion, prevencion de its y de cancer de cuello uterino",pildora: usuarias continuas,2015-07-01,0,0,1,1,0,2
TARABUCO,"anticoncepcion, prevencion de its y de cancer de cuello uterino",pildora: usuarias continuas,2015-07-01,0,0,2,0,0,2
TARACO,"anticoncepcion, prevencion de its y de cancer de cuello uterino",pildora: usuarias continuas,2015-07-01,0,0,1,1,0,2
TARATA,"anticoncepcion, prevencion de its y de cancer de cuello uterino",pildora: usuarias continuas,2015-07-01,0,0,3,1,0,4
TARIJA,"anticoncepcion, prevencion de its y de cancer de cuello uterino",pildora: usuarias continuas,2015-07-01,0,11,67,27,5,110
TARVITA,"anticoncepcion, prevencion de its y de cancer de cuello uterino",pildora: usuarias continuas,2015-07-01,0,2,2,5,0,9
TEOPONTE,"anticoncepcion, prevencion de its y de cancer de cuello uterino",pildora: usuarias continuas,2015-07-01,0,0,3,0,0,3
TIAWANACU,"anticoncepcion, prevencion de its y de cancer de cuello uterino",pildora: usuarias continuas,2015-07-01,0,0,4,2,0,6
TINGUIPAYA,"anticoncepcion, prevencion de its y de cancer de cuello uterino",pildora: usuarias continuas,2015-07-01,0,0,1,0,0,1
TIPUANI,"anticoncepcion, prevencion de its y de cancer de cuello uterino",pildora: usuarias continuas,2015-07-01,0,0,4,1,0,5
TIQUIPAYA,"anticoncepcion, prevencion de its y de cancer de cuello uterino",pildora: usuarias continuas,2015-07-01,0,0,21,4,0,25
TIRAQUE (CBBA),"anticoncepcion, prevencion de its y de cancer de cuello uterino",pildora: usuarias continuas,2015-07-01,0,0,3,4,0,7
TOCO,"anticoncepcion, prevencion de its y de cancer de cuello uterino",pildora: usuarias continuas,2015-07-01,0,0,1,0,0,1
TOLATA,"anticoncepcion, prevencion de its y de cancer de cuello uterino",pildora: usuarias continuas,2015-07-01,0,0,15,0,0,15
TOLEDO,"anticoncepcion, prevencion de its y de cancer de cuello uterino",pildora: usuarias continuas,2015-07-01,0,0,1,0,0,1
TOMAVE,"anticoncepcion, prevencion de its y de cancer de cuello uterino",pildora: usuarias continuas,2015-07-01,0,0,4,1,0,5
TOMINA,"anticoncepcion, prevencion de its y de cancer de cuello uterino",pildora: usuarias continuas,2015-07-01,0,1,5,1,0,7
TOTORA(CBBA),"anticoncepcion, prevencion de its y de cancer de cuello uterino",pildora: usuarias continuas,2015-07-01,0,0,1,1,0,2
TRIGAL,"anticoncepcion, prevencion de its y de cancer de cuello uterino",pildora: usuarias continuas,2015-07-01,0,0,3,0,0,3
TRINIDAD,"anticoncepcion, prevencion de its y de cancer de cuello uterino",pildora: usuarias continuas,2015-07-01,0,15,58,26,0,99
TUPIZA,"anticoncepcion, prevencion de its y de cancer de cuello uterino",pildora: usuarias continuas,2015-07-01,0,0,1,0,0,1
TURCO,"anticoncepcion, prevencion de its y de cancer de cuello uterino",pildora: usuarias continuas,2015-07-01,0,0,1,0,0,1
UNCIA,"anticoncepcion, prevencion de its y de cancer de cuello uterino",pildora: usuarias continuas,2015-07-01,0,0,1,0,0,1
URIONDO (A. CONCEPCION),"anticoncepcion, prevencion de its y de cancer de cuello uterino",pildora: usuarias continuas,2015-07-01,0,0,12,3,1,16
URUBICHA,"anticoncepcion, prevencion de its y de cancer de cuello uterino",pildora: usuarias continuas,2015-07-01,0,2,8,5,0,15
UYUNI,"anticoncepcion, prevencion de its y de cancer de cuello uterino",pildora: usuarias continuas,2015-07-01,0,0,8,5,0,13
VACAS,"anticoncepcion, prevencion de its y de cancer de cuello uterino",pildora: usuarias continuas,2015-07-01,1,0,1,2,0,4
VALLEGRANDE,"anticoncepcion, prevencion de its y de cancer de cuello uterino",pildora: usuarias continuas,2015-07-01,0,1,8,2,0,11
VIACHA,"anticoncepcion, prevencion de its y de cancer de cuello uterino",pildora: usuarias continuas,2015-07-01,0,0,9,2,0,11
VILLA CHARCAS,"anticoncepcion, prevencion de its y de cancer de cuello uterino",pildora: usuarias continuas,2015-07-01,0,2,3,0,1,6
VILLA MONTES,"anticoncepcion, prevencion de its y de cancer de cuello uterino",pildora: usuarias continuas,2015-07-01,0,4,15,3,0,22
VILLA NUEVA (LOMA ALTA),"anticoncepcion, prevencion de its y de cancer de cuello uterino",pildora: usuarias continuas,2015-07-01,0,0,1,0,0,1
VILLA SERRANO,"anticoncepcion, prevencion de its y de cancer de cuello uterino",pildora: usuarias continuas,2015-07-01,0,0,3,2,0,5
VILLA TUNARI,"anticoncepcion, prevencion de its y de cancer de cuello uterino",pildora: usuarias continuas,2015-07-01,0,0,36,5,0,41
VILLA VACA GUZMAN (MUYUPAMPA),"anticoncepcion, prevencion de its y de cancer de cuello uterino",pildora: usuarias continuas,2015-07-01,0,0,11,4,0,15
VILLAZON,"anticoncepcion, prevencion de its y de cancer de cuello uterino",pildora: usuarias continuas,2015-07-01,0,4,18,7,0,29
VINTO,"anticoncepcion, prevencion de its y de cancer de cuello uterino",pildora: usuarias continuas,2015-07-01,0,0,7,1,0,8
VITICHI,"anticoncepcion, prevencion de its y de cancer de cuello uterino",pildora: usuarias continuas,2015-07-01,0,0,1,2,0,3
WALDO BALLIVIAN,"anticoncepcion, prevencion de its y de cancer de cuello uterino",pildora: usuarias continuas,2015-07-01,0,0,0,1,0,1
WARNES,"anticoncepcion, prevencion de its y de cancer de cuello uterino",pildora: usuarias continuas,2015-07-01,0,10,71,18,0,99
YACO,"anticoncepcion, prevencion de its y de cancer de cuello uterino",pildora: usuarias continuas,2015-07-01,0,1,0,0,0,1
YACUIBA,"anticoncepcion, prevencion de its y de cancer de cuello uterino",pildora: usuarias continuas,2015-07-01,0,0,12,4,0,16
YANACACHI,"anticoncepcion, prevencion de its y de cancer de cuello uterino",pildora: usuarias continuas,2015-07-01,0,0,2,0,0,2
YAPACANI,"anticoncepcion, prevencion de its y de cancer de cuello uterino",pildora: usuarias continuas,2015-07-01,1,2,10,8,1,22
YOCALLA,"anticoncepcion, prevencion de its y de cancer de cuello uterino",pildora: usuarias continuas,2015-07-01,0,0,2,0,0,2
YUNCHARA,"anticoncepcion, prevencion de its y de cancer de cuello uterino",pildora: usuarias continuas,2015-07-01,0,0,8,3,0,11
ZUDAÑEZ,"anticoncepcion, prevencion de its y de cancer de cuello uterino",pildora: usuarias continuas,2015-07-01,0,0,1,3,0,4
ACHACACHI,"anticoncepcion, prevencion de its y de cancer de cuello uterino",pildora: usuarias continuas,2015-08-01,0,0,2,2,0,4
ACHOCALLA,"anticoncepcion, prevencion de its y de cancer de cuello uterino",pildora: usuarias continuas,2015-08-01,0,0,4,3,0,7
AIQUILE,"anticoncepcion, prevencion de its y de cancer de cuello uterino",pildora: usuarias continuas,2015-08-01,0,2,2,0,0,4
ALCALA,"anticoncepcion, prevencion de its y de cancer de cuello uterino",pildora: usuarias continuas,2015-08-01,0,0,1,2,0,3
ALTO BENI,"anticoncepcion, prevencion de its y de cancer de cuello uterino",pildora: usuarias continuas,2015-08-01,0,0,6,3,0,9
ANCORAIMES,"anticoncepcion, prevencion de its y de cancer de cuello uterino",pildora: usuarias continuas,2015-08-01,0,0,4,2,0,6
ANTEQUERA,"anticoncepcion, prevencion de its y de cancer de cuello uterino",pildora: usuarias continuas,2015-08-01,0,0,0,1,0,1
APOLO,"anticoncepcion, prevencion de its y de cancer de cuello uterino",pildora: usuarias continuas,2015-08-01,0,1,10,3,0,14
ARAMPAMPA,"anticoncepcion, prevencion de its y de cancer de cuello uterino",pildora: usuarias continuas,2015-08-01,0,0,2,0,0,2
ARANI,"anticoncepcion, prevencion de its y de cancer de cuello uterino",pildora: usuarias continuas,2015-08-01,0,0,3,2,0,5
ARBIETO,"anticoncepcion, prevencion de its y de cancer de cuello uterino",pildora: usuarias continuas,2015-08-01,0,1,5,2,0,8
ARQUE,"anticoncepcion, prevencion de its y de cancer de cuello uterino",pildora: usuarias continuas,2015-08-01,0,0,1,1,0,2
ASCENCION DE GUARAYOS,"anticoncepcion, prevencion de its y de cancer de cuello uterino",pildora: usuarias continuas,2015-08-01,0,0,7,9,0,16
ATOCHA,"anticoncepcion, prevencion de its y de cancer de cuello uterino",pildora: usuarias continuas,2015-08-01,0,0,6,1,0,7
AYATA,"anticoncepcion, prevencion de its y de cancer de cuello uterino",pildora: usuarias continuas,2015-08-01,0,0,3,1,0,4
AYO AYO,"anticoncepcion, prevencion de its y de cancer de cuello uterino",pildora: usuarias continuas,2015-08-01,0,0,1,0,0,1
AYOPAYA (V. DE INDEPENDENCIA),"anticoncepcion, prevencion de its y de cancer de cuello uterino",pildora: usuarias continuas,2015-08-01,0,1,10,12,0,23
AZURDUY,"anticoncepcion, prevencion de its y de cancer de cuello uterino",pildora: usuarias continuas,2015-08-01,0,0,2,1,0,3
BATALLAS,"anticoncepcion, prevencion de its y de cancer de cuello uterino",pildora: usuarias continuas,2015-08-01,0,0,2,2,0,4
BAURES,"anticoncepcion, prevencion de its y de cancer de cuello uterino",pildora: usuarias continuas,2015-08-01,0,1,12,1,0,14
BELLA FLOR,"anticoncepcion, prevencion de its y de cancer de cuello uterino",pildora: usuarias continuas,2015-08-01,1,1,10,1,0,13
BERMEJO,"anticoncepcion, prevencion de its y de cancer de cuello uterino",pildora: usuarias continuas,2015-08-01,0,2,7,10,0,19
BETANZOS,"anticoncepcion, prevencion de its y de cancer de cuello uterino",pildora: usuarias continuas,2015-08-01,0,0,2,2,0,4
BOLIVAR,"anticoncepcion, prevencion de its y de cancer de cuello uterino",pildora: usuarias continuas,2015-08-01,0,0,1,0,0,1
BOLPEBRA,"anticoncepcion, prevencion de its y de cancer de cuello uterino",pildora: usuarias continuas,2015-08-01,0,0,5,1,0,6
BOYUIBE,"anticoncepcion, prevencion de its y de cancer de cuello uterino",pildora: usuarias continuas,2015-08-01,0,0,1,0,0,1
BUENA VISTA,"anticoncepcion, prevencion de its y de cancer de cuello uterino",pildora: usuarias continuas,2015-08-01,0,6,18,28,0,52
CABEZAS,"anticoncepcion, prevencion de its y de cancer de cuello uterino",pildora: usuarias continuas,2015-08-01,0,1,22,13,1,37
CAIROMA,"anticoncepcion, prevencion de its y de cancer de cuello uterino",pildora: usuarias continuas,2015-08-01,0,0,1,0,0,1
"CAIZA ""D""","anticoncepcion, prevencion de its y de cancer de cuello uterino",pildora: usuarias continuas,2015-08-01,0,0,2,1,0,3
CAJUATA,"anticoncepcion, prevencion de its y de cancer de cuello uterino",pildora: usuarias continuas,2015-08-01,0,0,1,0,0,1
CALAMARCA,"anticoncepcion, prevencion de its y de cancer de cuello uterino",pildora: usuarias continuas,2015-08-01,0,0,6,0,0,6
CAMIRI,"anticoncepcion, prevencion de its y de cancer de cuello uterino",pildora: usuarias continuas,2015-08-01,0,0,8,3,0,11
CAPINOTA,"anticoncepcion, prevencion de its y de cancer de cuello uterino",pildora: usuarias continuas,2015-08-01,0,0,2,1,0,3
CAQUIAVIRI,"anticoncepcion, prevencion de its y de cancer de cuello uterino",pildora: usuarias continuas,2015-08-01,0,0,0,1,0,1
CARACOLLO,"anticoncepcion, prevencion de its y de cancer de cuello uterino",pildora: usuarias continuas,2015-08-01,0,1,1,0,0,2
CARANAVI,"anticoncepcion, prevencion de its y de cancer de cuello uterino",pildora: usuarias continuas,2015-08-01,0,0,11,2,0,13
CARANGAS,"anticoncepcion, prevencion de its y de cancer de cuello uterino",pildora: usuarias continuas,2015-08-01,0,0,1,0,0,1
CARAPARI,"anticoncepcion, prevencion de its y de cancer de cuello uterino",pildora: usuarias continuas,2015-08-01,0,26,13,1,0,40
CARIPUYO,"anticoncepcion, prevencion de its y de cancer de cuello uterino",pildora: usuarias continuas,2015-08-01,0,0,0,1,0,1
CARMEN RIVERO TORREZ,"anticoncepcion, prevencion de its y de cancer de cuello uterino",pildora: usuarias continuas,2015-08-01,0,0,2,0,0,2
CATACORA,"anticoncepcion, prevencion de its y de cancer de cuello uterino",pildora: usuarias continuas,2015-08-01,0,0,4,1,0,5
CHALLAPATA,"anticoncepcion, prevencion de its y de cancer de cuello uterino",pildora: usuarias continuas,2015-08-01,0,0,1,2,0,3
CHAQUI,"anticoncepcion, prevencion de its y de cancer de cuello uterino",pildora: usuarias continuas,2015-08-01,0,0,0,0,2,2
CHARAGUA,"anticoncepcion, prevencion de its y de cancer de cuello uterino",pildora: usuarias continuas,2015-08-01,0,2,13,8,0,23
CHAYANTA,"anticoncepcion, prevencion de its y de cancer de cuello uterino",pildora: usuarias continuas,2015-08-01,0,0,1,0,0,1
CHIMORE,"anticoncepcion, prevencion de its y de cancer de cuello uterino",pildora: usuarias continuas,2015-08-01,0,7,10,3,0,20
CHIPAYA,"anticoncepcion, prevencion de its y de cancer de cuello uterino",pildora: usuarias continuas,2015-08-01,0,0,1,0,0,1
CHUA COCANI,"anticoncepcion, prevencion de its y de cancer de cuello uterino",pildora: usuarias continuas,2015-08-01,0,1,2,0,0,3
CHULUMANI (V. DE LA LIBERTAD),"anticoncepcion, prevencion de its y de cancer de cuello uterino",pildora: usuarias continuas,2015-08-01,0,0,1,1,0,2
CHUMA,"anticoncepcion, prevencion de its y de cancer de cuello uterino",pildora: usuarias continuas,2015-08-01,0,1,3,1,0,5
CHUQUIHUTA AYLLU JUCUMANI,"anticoncepcion, prevencion de its y de cancer de cuello uterino",pildora: usuarias continuas,2015-08-01,0,0,2,0,0,2
CLIZA,"anticoncepcion, prevencion de its y de cancer de cuello uterino",pildora: usuarias continuas,2015-08-01,0,1,7,0,0,8
COBIJA,"anticoncepcion, prevencion de its y de cancer de cuello uterino",pildora: usuarias continuas,2015-08-01,2,6,39,11,0,58
COCAPATA,"anticoncepcion, prevencion de its y de cancer de cuello uterino",pildora: usuarias continuas,2015-08-01,0,0,4,0,0,4
COCHABAMBA,"anticoncepcion, prevencion de its y de cancer de cuello uterino",pildora: usuarias continuas,2015-08-01,0,18,133,32,0,183
COIPASA,"anticoncepcion, prevencion de its y de cancer de cuello uterino",pildora: usuarias continuas,2015-08-01,0,0,1,1,0,2
COLCAPIRHUA,"anticoncepcion, prevencion de its y de cancer de cuello uterino",pildora: usuarias continuas,2015-08-01,0,2,3,3,0,8
"COLCHA ""K""","anticoncepcion, prevencion de its y de cancer de cuello uterino",pildora: usuarias continuas,2015-08-01,0,1,4,1,0,6
COLOMI,"anticoncepcion, prevencion de its y de cancer de cuello uterino",pildora: usuarias continuas,2015-08-01,0,1,6,2,0,9
COLPA BELGICA,"anticoncepcion, prevencion de its y de cancer de cuello uterino",pildora: usuarias continuas,2015-08-01,0,3,8,6,0,17
COLQUECHACA,"anticoncepcion, prevencion de its y de cancer de cuello uterino",pildora: usuarias continuas,2015-08-01,0,1,0,1,0,2
COLQUENCHA,"anticoncepcion, prevencion de its y de cancer de cuello uterino",pildora: usuarias continuas,2015-08-01,0,0,1,3,1,5
COLQUIRI,"anticoncepcion, prevencion de its y de cancer de cuello uterino",pildora: usuarias continuas,2015-08-01,0,0,0,2,0,2
COMARAPA,"anticoncepcion, prevencion de its y de cancer de cuello uterino",pildora: usuarias continuas,2015-08-01,0,2,6,2,0,10
COMBAYA,"anticoncepcion, prevencion de its y de cancer de cuello uterino",pildora: usuarias continuas,2015-08-01,0,0,0,1,0,1
CONCEPCION,"anticoncepcion, prevencion de its y de cancer de cuello uterino",pildora: usuarias continuas,2015-08-01,0,0,7,0,0,7
COPACABANA,"anticoncepcion, prevencion de its y de cancer de cuello uterino",pildora: usuarias continuas,2015-08-01,0,0,0,1,0,1
COROICO,"anticoncepcion, prevencion de its y de cancer de cuello uterino",pildora: usuarias continuas,2015-08-01,0,0,0,3,0,3
CORQUE,"anticoncepcion, prevencion de its y de cancer de cuello uterino",pildora: usuarias continuas,2015-08-01,0,0,2,2,0,4
COTAGAITA,"anticoncepcion, prevencion de its y de cancer de cuello uterino",pildora: usuarias continuas,2015-08-01,0,0,7,3,0,10
COTOCA,"anticoncepcion, prevencion de its y de cancer de cuello uterino",pildora: usuarias continuas,2015-08-01,0,1,13,7,0,21
CUATRO CAÑADAS,"anticoncepcion, prevencion de its y de cancer de cuello uterino",pildora: usuarias continuas,2015-08-01,0,2,10,4,0,16
CUEVO,"anticoncepcion, prevencion de its y de cancer de cuello uterino",pildora: usuarias continuas,2015-08-01,0,1,3,0,0,4
CULPINA,"anticoncepcion, prevencion de its y de cancer de cuello uterino",pildora: usuarias continuas,2015-08-01,0,1,3,3,0,7
CURAHUARA DE CARANGAS,"anticoncepcion, prevencion de its y de cancer de cuello uterino",pildora: usuarias continuas,2015-08-01,0,0,0,1,0,1
DESAGUADERO,"anticoncepcion, prevencion de its y de cancer de cuello uterino",pildora: usuarias continuas,2015-08-01,0,1,0,0,0,1
EL ALTO,"anticoncepcion, prevencion de its y de cancer de cuello uterino",pildora: usuarias continuas,2015-08-01,1,5,140,31,0,177
EL CHORO,"anticoncepcion, prevencion de its y de cancer de cuello uterino",pildora: usuarias continuas,2015-08-01,0,0,3,0,0,3
EL PUENTE(STC),"anticoncepcion, prevencion de its y de cancer de cuello uterino",pildora: usuarias continuas,2015-08-01,0,1,8,8,1,18
EL PUENTE(TJA),"anticoncepcion, prevencion de its y de cancer de cuello uterino",pildora: usuarias continuas,2015-08-01,0,0,6,6,0,12
EL TORNO,"anticoncepcion, prevencion de its y de cancer de cuello uterino",pildora: usuarias continuas,2015-08-01,1,6,36,15,0,58
EL VILLAR,"anticoncepcion, prevencion de its y de cancer de cuello uterino",pildora: usuarias continuas,2015-08-01,0,0,6,2,0,8
ENTRE RIOS TRJ,"anticoncepcion, prevencion de its y de cancer de cuello uterino",pildora: usuarias continuas,2015-08-01,0,4,18,6,1,29
ENTRE RIOS CBBA,"anticoncepcion, prevencion de its y de cancer de cuello uterino",pildora: usuarias continuas,2015-08-01,0,0,8,3,0,11
EUREKA (SANTOS MERCADO),"anticoncepcion, prevencion de its y de cancer de cuello uterino",pildora: usuarias continuas,2015-08-01,0,0,3,1,0,4
FERNANDEZ ALONSO,"anticoncepcion, prevencion de its y de cancer de cuello uterino",pildora: usuarias continuas,2015-08-01,0,1,4,1,0,6
FILADELFIA,"anticoncepcion, prevencion de its y de cancer de cuello uterino",pildora: usuarias continuas,2015-08-01,0,2,10,3,0,15
GENERAL SAAVEDRA,"anticoncepcion, prevencion de its y de cancer de cuello uterino",pildora: usuarias continuas,2015-08-01,0,0,18,4,0,22
GRAL. J.J. PEREZ (CHARAZANI),"anticoncepcion, prevencion de its y de cancer de cuello uterino",pildora: usuarias continuas,2015-08-01,0,0,1,0,0,1
GUANAY,"anticoncepcion, prevencion de its y de cancer de cuello uterino",pildora: usuarias continuas,2015-08-01,0,0,1,0,0,1
GUAQUI,"anticoncepcion, prevencion de its y de cancer de cuello uterino",pildora: usuarias continuas,2015-08-01,0,0,1,1,0,2
GUAYARAMERIN,"anticoncepcion, prevencion de its y de cancer de cuello uterino",pildora: usuarias continuas,2015-08-01,0,1,7,1,0,9
GUTIERREZ,"anticoncepcion, prevencion de its y de cancer de cuello uterino",pildora: usuarias continuas,2015-08-01,0,0,4,2,0,6
HUACARETA,"anticoncepcion, prevencion de its y de cancer de cuello uterino",pildora: usuarias continuas,2015-08-01,0,1,6,7,0,14
HUACAYA (VILLA DE HUACAYA),"anticoncepcion, prevencion de its y de cancer de cuello uterino",pildora: usuarias continuas,2015-08-01,0,0,0,1,0,1
HUACHACALLA,"anticoncepcion, prevencion de its y de cancer de cuello uterino",pildora: usuarias continuas,2015-08-01,0,1,3,0,0,4
HUANUNI,"anticoncepcion, prevencion de its y de cancer de cuello uterino",pildora: usuarias continuas,2015-08-01,0,0,5,1,0,6
HUARACAJE,"anticoncepcion, prevencion de its y de cancer de cuello uterino",pildora: usuarias continuas,2015-08-01,1,1,2,0,0,4
HUATAJATA,"anticoncepcion, prevencion de its y de cancer de cuello uterino",pildora: usuarias continuas,2015-08-01,0,0,1,1,0,2
HUAYLLAMARCA,"anticoncepcion, prevencion de its y de cancer de cuello uterino",pildora: usuarias continuas,2015-08-01,0,0,1,1,0,2
ICHOCA,"anticoncepcion, prevencion de its y de cancer de cuello uterino",pildora: usuarias continuas,2015-08-01,0,0,1,0,0,1
ICLA,"anticoncepcion, prevencion de its y de cancer de cuello uterino",pildora: usuarias continuas,2015-08-01,0,0,4,6,0,10
INCAHUASI,"anticoncepcion, prevencion de its y de cancer de cuello uterino",pildora: usuarias continuas,2015-08-01,0,0,4,0,0,4
INGAVI (HUMAITA),"anticoncepcion, prevencion de its y de cancer de cuello uterino",pildora: usuarias continuas,2015-08-01,0,1,2,1,0,4
INQUISIVI,"anticoncepcion, prevencion de its y de cancer de cuello uterino",pildora: usuarias continuas,2015-08-01,0,0,1,2,0,3
IRUPANA (VILLA DE LANZA),"anticoncepcion, prevencion de its y de cancer de cuello uterino",pildora: usuarias continuas,2015-08-01,0,1,9,3,0,13
IXIAMAS,"anticoncepcion, prevencion de its y de cancer de cuello uterino",pildora: usuarias continuas,2015-08-01,0,0,10,0,0,10
JESUS DE MACHACA,"anticoncepcion, prevencion de its y de cancer de cuello uterino",pildora: usuarias continuas,2015-08-01,0,0,1,1,0,2
LA ASUNTA,"anticoncepcion, prevencion de its y de cancer de cuello uterino",pildora: usuarias continuas,2015-08-01,0,0,13,5,0,18
LA GUARDIA,"anticoncepcion, prevencion de its y de cancer de cuello uterino",pildora: usuarias continuas,2015-08-01,0,6,36,11,0,53
LA PAZ,"anticoncepcion, prevencion de its y de cancer de cuello uterino",pildora: usuarias continuas,2015-08-01,0,3,83,33,0,119
LAGUNILLAS,"anticoncepcion, prevencion de its y de cancer de cuello uterino",pildora: usuarias continuas,2015-08-01,0,0,7,0,0,7
LAJA,"anticoncepcion, prevencion de its y de cancer de cuello uterino",pildora: usuarias continuas,2015-08-01,0,0,5,1,0,6
LICOMA PAMPA,"anticoncepcion, prevencion de its y de cancer de cuello uterino",pildora: usuarias continuas,2015-08-01,0,0,3,0,0,3
LLALLAGUA,"anticoncepcion, prevencion de its y de cancer de cuello uterino",pildora: usuarias continuas,2015-08-01,0,2,10,1,0,13
LLICA,"anticoncepcion, prevencion de its y de cancer de cuello uterino",pildora: usuarias continuas,2015-08-01,0,0,2,1,0,3
LORETO,"anticoncepcion, prevencion de its y de cancer de cuello uterino",pildora: usuarias continuas,2015-08-01,0,3,8,1,0,12
LURIBAY,"anticoncepcion, prevencion de its y de cancer de cuello uterino",pildora: usuarias continuas,2015-08-01,0,0,2,0,0,2
MACHARETI,"anticoncepcion, prevencion de its y de cancer de cuello uterino",pildora: usuarias continuas,2015-08-01,0,2,9,4,0,15
MAGDALENA,"anticoncepcion, prevencion de its y de cancer de cuello uterino",pildora: usuarias continuas,2015-08-01,0,1,7,2,0,10
MAIRANA,"anticoncepcion, prevencion de its y de cancer de cuello uterino",pildora: usuarias continuas,2015-08-01,0,0,6,0,0,6
MECAPACA,"anticoncepcion, prevencion de its y de cancer de cuello uterino",pildora: usuarias continuas,2015-08-01,0,0,0,1,0,1
MINEROS,"anticoncepcion, prevencion de its y de cancer de cuello uterino",pildora: usuarias continuas,2015-08-01,0,1,21,5,0,27
MIZQUE,"anticoncepcion, prevencion de its y de cancer de cuello uterino",pildora: usuarias continuas,2015-08-01,0,0,5,1,0,6
MOCOMOCO,"anticoncepcion, prevencion de its y de cancer de cuello uterino",pildora: usuarias continuas,2015-08-01,0,0,1,0,0,1
MOJOCOYA,"anticoncepcion, prevencion de its y de cancer de cuello uterino",pildora: usuarias continuas,2015-08-01,0,2,8,0,0,10
MONTEAGUDO,"anticoncepcion, prevencion de its y de cancer de cuello uterino",pildora: usuarias continuas,2015-08-01,0,1,9,3,0,13
MONTERO,"anticoncepcion, prevencion de its y de cancer de cuello uterino",pildora: usuarias continuas,2015-08-01,0,6,28,13,0,47
MORO MORO,"anticoncepcion, prevencion de its y de cancer de cuello uterino",pildora: usuarias continuas,2015-08-01,0,1,4,2,0,7
MOROCHATA,"anticoncepcion, prevencion de its y de cancer de cuello uterino",pildora: usuarias continuas,2015-08-01,0,0,5,0,0,5
NACEBE (SANTA ROSA DEL ABUNA),"anticoncepcion, prevencion de its y de cancer de cuello uterino",pildora: usuarias continuas,2015-08-01,0,0,1,0,0,1
OCURI,"anticoncepcion, prevencion de its y de cancer de cuello uterino",pildora: usuarias continuas,2015-08-01,0,3,7,1,0,11
OKINAWA,"anticoncepcion, prevencion de its y de cancer de cuello uterino",pildora: usuarias continuas,2015-08-01,0,2,18,8,0,28
OMEREQUE,"anticoncepcion, prevencion de its y de cancer de cuello uterino",pildora: usuarias continuas,2015-08-01,0,3,4,1,0,8
ORURO,"anticoncepcion, prevencion de its y de cancer de cuello uterino",pildora: usuarias continuas,2015-08-01,0,3,60,19,0,82
PADCAYA,"anticoncepcion, prevencion de its y de cancer de cuello uterino",pildora: usuarias continuas,2015-08-01,0,3,29,10,0,42
PADILLA,"anticoncepcion, prevencion de its y de cancer de cuello uterino",pildora: usuarias continuas,2015-08-01,0,2,7,2,0,11
PAILON,"anticoncepcion, prevencion de its y de cancer de cuello uterino",pildora: usuarias continuas,2015-08-01,0,3,17,5,0,25
PALCA,"anticoncepcion, prevencion de its y de cancer de cuello uterino",pildora: usuarias continuas,2015-08-01,0,1,0,0,0,1
PALOS BLANCOS,"anticoncepcion, prevencion de its y de cancer de cuello uterino",pildora: usuarias continuas,2015-08-01,0,0,12,4,0,16
PAMPA AULLAGAS,"anticoncepcion, prevencion de its y de cancer de cuello uterino",pildora: usuarias continuas,2015-08-01,0,0,2,1,0,3
PAMPA GRANDE,"anticoncepcion, prevencion de its y de cancer de cuello uterino",pildora: usuarias continuas,2015-08-01,0,0,10,2,0,12
PAPEL PAMPA,"anticoncepcion, prevencion de its y de cancer de cuello uterino",pildora: usuarias continuas,2015-08-01,0,0,3,0,0,3
PELECHUCO,"anticoncepcion, prevencion de its y de cancer de cuello uterino",pildora: usuarias continuas,2015-08-01,0,1,6,3,0,10
POCOATA,"anticoncepcion, prevencion de its y de cancer de cuello uterino",pildora: usuarias continuas,2015-08-01,0,0,2,0,0,2
POCONA,"anticoncepcion, prevencion de its y de cancer de cuello uterino",pildora: usuarias continuas,2015-08-01,0,0,8,0,0,8
POJO (CBBA),"anticoncepcion, prevencion de its y de cancer de cuello uterino",pildora: usuarias continuas,2015-08-01,0,0,6,1,0,7
PORCO,"anticoncepcion, prevencion de its y de cancer de cuello uterino",pildora: usuarias continuas,2015-08-01,0,0,1,1,0,2
POROMA,"anticoncepcion, prevencion de its y de cancer de cuello uterino",pildora: usuarias continuas,2015-08-01,0,0,3,6,0,9
PORONGO,"anticoncepcion, prevencion de its y de cancer de cuello uterino",pildora: usuarias continuas,2015-08-01,0,1,14,7,0,22
PORVENIR,"anticoncepcion, prevencion de its y de cancer de cuello uterino",pildora: usuarias continuas,2015-08-01,0,0,9,5,0,14
POSTRER VALLE,"anticoncepcion, prevencion de its y de cancer de cuello uterino",pildora: usuarias continuas,2015-08-01,0,0,2,0,0,2
POTOSI,"anticoncepcion, prevencion de its y de cancer de cuello uterino",pildora: usuarias continuas,2015-08-01,0,19,86,24,0,129
PRESTO,"anticoncepcion, prevencion de its y de cancer de cuello uterino",pildora: usuarias continuas,2015-08-01,0,0,2,3,0,5
PUCARA,"anticoncepcion, prevencion de its y de cancer de cuello uterino",pildora: usuarias continuas,2015-08-01,0,1,2,0,0,3
PUCARANI,"anticoncepcion, prevencion de its y de cancer de cuello uterino",pildora: usuarias continuas,2015-08-01,0,0,3,1,0,4
PUERTO ACOSTA,"anticoncepcion, prevencion de its y de cancer de cuello uterino",pildora: usuarias continuas,2015-08-01,0,0,0,1,0,1
PUERTO CARABUCO,"anticoncepcion, prevencion de its y de cancer de cuello uterino",pildora: usuarias continuas,2015-08-01,0,0,0,3,0,3
PUERTO GONZALO MORENO,"anticoncepcion, prevencion de its y de cancer de cuello uterino",pildora: usuarias continuas,2015-08-01,0,1,3,2,0,6
PUERTO QUIJARRO,"anticoncepcion, prevencion de its y de cancer de cuello uterino",pildora: usuarias continuas,2015-08-01,0,0,4,1,0,5
PUERTO RICO,"anticoncepcion, prevencion de its y de cancer de cuello uterino",pildora: usuarias continuas,2015-08-01,0,1,14,2,0,17
PUERTO SILES,"anticoncepcion, prevencion de its y de cancer de cuello uterino",pildora: usuarias continuas,2015-08-01,0,5,0,1,0,6
PUERTO SUAREZ,"anticoncepcion, prevencion de its y de cancer de cuello uterino",pildora: usuarias continuas,2015-08-01,0,0,20,3,0,23
PUERTO VILLARROEL,"anticoncepcion, prevencion de its y de cancer de cuello uterino",pildora: usuarias continuas,2015-08-01,0,1,19,4,0,24
PUNA,"anticoncepcion, prevencion de its y de cancer de cuello uterino",pildora: usuarias continuas,2015-08-01,0,0,11,2,0,13
PUNATA,"anticoncepcion, prevencion de its y de cancer de cuello uterino",pildora: usuarias continuas,2015-08-01,0,0,3,1,0,4
QUIABAYA,"anticoncepcion, prevencion de its y de cancer de cuello uterino",pildora: usuarias continuas,2015-08-01,0,0,1,0,0,1
QUILLACOLLO,"anticoncepcion, prevencion de its y de cancer de cuello uterino",pildora: usuarias continuas,2015-08-01,0,0,20,2,0,22
QUIME,"anticoncepcion, prevencion de its y de cancer de cuello uterino",pildora: usuarias continuas,2015-08-01,0,1,7,0,0,8
QUIRUSILLAS,"anticoncepcion, prevencion de its y de cancer de cuello uterino",pildora: usuarias continuas,2015-08-01,0,0,0,2,0,2
RAVELO,"anticoncepcion, prevencion de its y de cancer de cuello uterino",pildora: usuarias continuas,2015-08-01,0,0,1,0,0,1
REYES,"anticoncepcion, prevencion de its y de cancer de cuello uterino",pildora: usuarias continuas,2015-08-01,0,8,14,5,0,27
RIBERALTA,"anticoncepcion, prevencion de its y de cancer de cuello uterino",pildora: usuarias continuas,2015-08-01,0,6,25,7,0,38
ROBORE,"anticoncepcion, prevencion de its y de cancer de cuello uterino",pildora: usuarias continuas,2015-08-01,0,4,15,3,0,22
RURRENABAQUE,"anticoncepcion, prevencion de its y de cancer de cuello uterino",pildora: usuarias continuas,2015-08-01,0,1,4,9,0,14
SACABA,"anticoncepcion, prevencion de its y de cancer de cuello uterino",pildora: usuarias continuas,2015-08-01,0,4,27,3,0,34
SACACA,"anticoncepcion, prevencion de its y de cancer de cuello uterino",pildora: usuarias continuas,2015-08-01,0,0,4,2,0,6
SAIPINA,"anticoncepcion, prevencion de its y de cancer de cuello uterino",pildora: usuarias continuas,2015-08-01,0,0,0,1,0,1
SALINAS DE GARCI MENDOZA,"anticoncepcion, prevencion de its y de cancer de cuello uterino",pildora: usuarias continuas,2015-08-01,0,0,3,0,0,3
SAMAIPATA,"anticoncepcion, prevencion de its y de cancer de cuello uterino",pildora: usuarias continuas,2015-08-01,0,1,7,2,0,10
SAN AGUSTIN,"anticoncepcion, prevencion de its y de cancer de cuello uterino",pildora: usuarias continuas,2015-08-01,0,0,2,1,0,3
SAN ANDRES,"anticoncepcion, prevencion de its y de cancer de cuello uterino",pildora: usuarias continuas,2015-08-01,0,5,23,6,0,34
SAN ANDRES DE MACHACA,"anticoncepcion, prevencion de its y de cancer de cuello uterino",pildora: usuarias continuas,2015-08-01,0,0,1,0,0,1
SAN ANTONIO DE LOMERIO,"anticoncepcion, prevencion de its y de cancer de cuello uterino",pildora: usuarias continuas,2015-08-01,0,0,13,8,0,21
SAN BORJA,"anticoncepcion, prevencion de its y de cancer de cuello uterino",pildora: usuarias continuas,2015-08-01,0,7,47,18,1,73
SAN BUENA VENTURA,"anticoncepcion, prevencion de its y de cancer de cuello uterino",pildora: usuarias continuas,2015-08-01,0,0,3,0,0,3
SAN CARLOS,"anticoncepcion, prevencion de its y de cancer de cuello uterino",pildora: usuarias continuas,2015-08-01,0,2,41,4,0,47
SAN IGNACIO,"anticoncepcion, prevencion de its y de cancer de cuello uterino",pildora: usuarias continuas,2015-08-01,0,20,99,56,2,177
SAN IGNACIO DE VELASCO,"anticoncepcion, prevencion de its y de cancer de cuello uterino",pildora: usuarias continuas,2015-08-01,0,6,64,17,0,87
SAN JAVIER(BNI),"anticoncepcion, prevencion de its y de cancer de cuello uterino",pildora: usuarias continuas,2015-08-01,0,1,0,0,0,1
SAN JAVIER(STC),"anticoncepcion, prevencion de its y de cancer de cuello uterino",pildora: usuarias continuas,2015-08-01,0,5,19,4,0,28
SAN JOSE DE CHIQUITOS,"anticoncepcion, prevencion de its y de cancer de cuello uterino",pildora: usuarias continuas,2015-08-01,0,2,17,20,1,40
SAN JUAN DE YAPACANI,"anticoncepcion, prevencion de its y de cancer de cuello uterino",pildora: usuarias continuas,2015-08-01,0,3,7,1,0,11
SAN JULIAN,"anticoncepcion, prevencion de its y de cancer de cuello uterino",pildora: usuarias continuas,2015-08-01,0,2,13,2,0,17
SAN LORENZO(PND),"anticoncepcion, prevencion de its y de cancer de cuello uterino",pildora: usuarias continuas,2015-08-01,0,1,4,2,0,7
SAN LORENZO(TJA),"anticoncepcion, prevencion de its y de cancer de cuello uterino",pildora: usuarias continuas,2015-08-01,0,1,13,5,0,19
SAN LUCAS,"anticoncepcion, prevencion de its y de cancer de cuello uterino",pildora: usuarias continuas,2015-08-01,0,1,4,2,0,7
SAN MATIAS,"anticoncepcion, prevencion de its y de cancer de cuello uterino",pildora: usuarias continuas,2015-08-01,0,2,13,4,0,19
SAN MIGUEL DE VELASCO,"anticoncepcion, prevencion de its y de cancer de cuello uterino",pildora: usuarias continuas,2015-08-01,0,2,23,12,1,38
SAN PEDRO,"anticoncepcion, prevencion de its y de cancer de cuello uterino",pildora: usuarias continuas,2015-08-01,0,0,12,2,0,14
SAN PEDRO DE BUENA VISTA,"anticoncepcion, prevencion de its y de cancer de cuello uterino",pildora: usuarias continuas,2015-08-01,0,0,1,2,0,3
SAN PEDRO DE CURAHUARA,"anticoncepcion, prevencion de its y de cancer de cuello uterino",pildora: usuarias continuas,2015-08-01,0,1,0,1,0,2
SAN PEDRO DE QUEMES,"anticoncepcion, prevencion de its y de cancer de cuello uterino",pildora: usuarias continuas,2015-08-01,0,0,3,1,0,4
SAN PEDRO DE TIQUINA,"anticoncepcion, prevencion de its y de cancer de cuello uterino",pildora: usuarias continuas,2015-08-01,0,0,1,0,0,1
SAN RAFAEL,"anticoncepcion, prevencion de its y de cancer de cuello uterino",pildora: usuarias continuas,2015-08-01,1,6,11,13,0,31
SAN RAMON SCZ,"anticoncepcion, prevencion de its y de cancer de cuello uterino",pildora: usuarias continuas,2015-08-01,0,0,12,0,0,12
SANTA ANA,"anticoncepcion, prevencion de its y de cancer de cuello uterino",pildora: usuarias continuas,2015-08-01,0,5,79,29,2,115
SANTA CRUZ DE LA SIERRA,"anticoncepcion, prevencion de its y de cancer de cuello uterino",pildora: usuarias continuas,2015-08-01,1,42,115,44,1,203
SANTA ROSA,"anticoncepcion, prevencion de its y de cancer de cuello uterino",pildora: usuarias continuas,2015-08-01,4,1,7,1,0,13
SANTA ROSA DEL SARA,"anticoncepcion, prevencion de its y de cancer de cuello uterino",pildora: usuarias continuas,2015-08-01,0,2,24,9,0,35
SANTIAGO DE HUATA,"anticoncepcion, prevencion de its y de cancer de cuello uterino",pildora: usuarias continuas,2015-08-01,0,1,1,0,0,2
SANTIVAÑES,"anticoncepcion, prevencion de its y de cancer de cuello uterino",pildora: usuarias continuas,2015-08-01,0,0,2,0,0,2
SANTUARIO DE QUILLACAS,"anticoncepcion, prevencion de its y de cancer de cuello uterino",pildora: usuarias continuas,2015-08-01,0,0,3,0,0,3
SAPAHAQUI,"anticoncepcion, prevencion de its y de cancer de cuello uterino",pildora: usuarias continuas,2015-08-01,0,0,1,1,0,2
SENA,"anticoncepcion, prevencion de its y de cancer de cuello uterino",pildora: usuarias continuas,2015-08-01,0,0,2,0,0,2
SHINAOTA,"anticoncepcion, prevencion de its y de cancer de cuello uterino",pildora: usuarias continuas,2015-08-01,0,0,2,1,0,3
SICA SICA (VILLA AROMA),"anticoncepcion, prevencion de its y de cancer de cuello uterino",pildora: usuarias continuas,2015-08-01,0,3,1,2,0,6
SICAYA,"anticoncepcion, prevencion de its y de cancer de cuello uterino",pildora: usuarias continuas,2015-08-01,0,0,1,0,0,1
SIPE SIPE,"anticoncepcion, prevencion de its y de cancer de cuello uterino",pildora: usuarias continuas,2015-08-01,0,0,14,2,0,16
SOPACHUY,"anticoncepcion, prevencion de its y de cancer de cuello uterino",pildora: usuarias continuas,2015-08-01,0,0,1,2,0,3
SORACACHI,"anticoncepcion, prevencion de its y de cancer de cuello uterino",pildora: usuarias continuas,2015-08-01,0,0,2,1,0,3
SORATA,"anticoncepcion, prevencion de its y de cancer de cuello uterino",pildora: usuarias continuas,2015-08-01,0,0,2,2,0,4
SUCRE,"anticoncepcion, prevencion de its y de cancer de cuello uterino",pildora: usuarias continuas,2015-08-01,0,11,113,19,0,143
TACACOMA,"anticoncepcion, prevencion de its y de cancer de cuello uterino",pildora: usuarias continuas,2015-08-01,0,0,6,2,0,8
TAHUA,"anticoncepcion, prevencion de its y de cancer de cuello uterino",pildora: usuarias continuas,2015-08-01,0,0,0,1,0,1
TAPACARI,"anticoncepcion, prevencion de its y de cancer de cuello uterino",pildora: usuarias continuas,2015-08-01,0,0,3,0,0,3
TARACO,"anticoncepcion, prevencion de its y de cancer de cuello uterino",pildora: usuarias continuas,2015-08-01,0,0,0,1,0,1
TARATA,"anticoncepcion, prevencion de its y de cancer de cuello uterino",pildora: usuarias continuas,2015-08-01,0,0,2,0,0,2
TARIJA,"anticoncepcion, prevencion de its y de cancer de cuello uterino",pildora: usuarias continuas,2015-08-01,0,3,38,14,0,55
TARVITA,"anticoncepcion, prevencion de its y de cancer de cuello uterino",pildora: usuarias continuas,2015-08-01,0,0,5,3,0,8
TEOPONTE,"anticoncepcion, prevencion de its y de cancer de cuello uterino",pildora: usuarias continuas,2015-08-01,0,0,3,0,0,3
TIAWANACU,"anticoncepcion, prevencion de its y de cancer de cuello uterino",pildora: usuarias continuas,2015-08-01,0,0,4,1,0,5
TINGUIPAYA,"anticoncepcion, prevencion de its y de cancer de cuello uterino",pildora: usuarias continuas,2015-08-01,0,0,0,6,0,6
TIPUANI,"anticoncepcion, prevencion de its y de cancer de cuello uterino",pildora: usuarias continuas,2015-08-01,0,0,3,1,0,4
TIQUIPAYA,"anticoncepcion, prevencion de its y de cancer de cuello uterino",pildora: usuarias continuas,2015-08-01,0,1,14,5,0,20
TOLEDO,"anticoncepcion, prevencion de its y de cancer de cuello uterino",pildora: usuarias continuas,2015-08-01,0,0,4,1,0,5
TOMAVE,"anticoncepcion, prevencion de its y de cancer de cuello uterino",pildora: usuarias continuas,2015-08-01,0,0,2,2,0,4
TOMINA,"anticoncepcion, prevencion de its y de cancer de cuello uterino",pildora: usuarias continuas,2015-08-01,0,0,2,2,0,4
TORO TORO,"anticoncepcion, prevencion de its y de cancer de cuello uterino",pildora: usuarias continuas,2015-08-01,0,0,1,0,0,1
TOTORA(CBBA),"anticoncepcion, prevencion de its y de cancer de cuello uterino",pildora: usuarias continuas,2015-08-01,0,0,5,5,0,10
TOTORA(ORR),"anticoncepcion, prevencion de its y de cancer de cuello uterino",pildora: usuarias continuas,2015-08-01,0,0,1,0,0,1
TRIGAL,"anticoncepcion, prevencion de its y de cancer de cuello uterino",pildora: usuarias continuas,2015-08-01,0,0,3,0,0,3
TRINIDAD,"anticoncepcion, prevencion de its y de cancer de cuello uterino",pildora: usuarias continuas,2015-08-01,0,19,69,10,0,98
TUPIZA,"anticoncepcion, prevencion de its y de cancer de cuello uterino",pildora: usuarias continuas,2015-08-01,0,0,3,0,0,3
TURCO,"anticoncepcion, prevencion de its y de cancer de cuello uterino",pildora: usuarias continuas,2015-08-01,0,0,0,1,0,1
UMALA,"anticoncepcion, prevencion de its y de cancer de cuello uterino",pildora: usuarias continuas,2015-08-01,0,0,1,0,0,1
UNCIA,"anticoncepcion, prevencion de its y de cancer de cuello uterino",pildora: usuarias continuas,2015-08-01,0,0,3,1,0,4
URIONDO (A. CONCEPCION),"anticoncepcion, prevencion de its y de cancer de cuello uterino",pildora: usuarias continuas,2015-08-01,0,1,10,3,0,14
URUBICHA,"anticoncepcion, prevencion de its y de cancer de cuello uterino",pildora: usuarias continuas,2015-08-01,0,0,3,3,0,6
UYUNI,"anticoncepcion, prevencion de its y de cancer de cuello uterino",pildora: usuarias continuas,2015-08-01,0,0,3,1,0,4
VACAS,"anticoncepcion, prevencion de its y de cancer de cuello uterino",pildora: usuarias continuas,2015-08-01,0,0,1,0,0,1
VALLEGRANDE,"anticoncepcion, prevencion de its y de cancer de cuello uterino",pildora: usuarias continuas,2015-08-01,0,2,8,2,0,12
VIACHA,"anticoncepcion, prevencion de its y de cancer de cuello uterino",pildora: usuarias continuas,2015-08-01,0,0,3,1,0,4
VILA VILA,"anticoncepcion, prevencion de its y de cancer de cuello uterino",pildora: usuarias continuas,2015-08-01,0,0,1,0,0,1
VILLA CHARCAS,"anticoncepcion, prevencion de its y de cancer de cuello uterino",pildora: usuarias continuas,2015-08-01,0,0,1,0,0,1
VILLA MONTES,"anticoncepcion, prevencion de its y de cancer de cuello uterino",pildora: usuarias continuas,2015-08-01,0,4,48,5,0,57
VILLA NUEVA (LOMA ALTA),"anticoncepcion, prevencion de its y de cancer de cuello uterino",pildora: usuarias continuas,2015-08-01,0,2,4,0,0,6
VILLA RIVERO,"anticoncepcion, prevencion de its y de cancer de cuello uterino",pildora: usuarias continuas,2015-08-01,0,0,1,0,0,1
VILLA SERRANO,"anticoncepcion, prevencion de its y de cancer de cuello uterino",pildora: usuarias continuas,2015-08-01,0,0,3,0,0,3
VILLA TUNARI,"anticoncepcion, prevencion de its y de cancer de cuello uterino",pildora: usuarias continuas,2015-08-01,0,2,32,7,0,41
VILLA VACA GUZMAN (MUYUPAMPA),"anticoncepcion, prevencion de its y de cancer de cuello uterino",pildora: usuarias continuas,2015-08-01,0,2,8,2,0,12
VILLAZON,"anticoncepcion, prevencion de its y de cancer de cuello uterino",pildora: usuarias continuas,2015-08-01,0,3,19,8,0,30
VINTO,"anticoncepcion, prevencion de its y de cancer de cuello uterino",pildora: usuarias continuas,2015-08-01,0,0,2,0,0,2
VITICHI,"anticoncepcion, prevencion de its y de cancer de cuello uterino",pildora: usuarias continuas,2015-08-01,0,0,2,1,0,3
WARNES,"anticoncepcion, prevencion de its y de cancer de cuello uterino",pildora: usuarias continuas,2015-08-01,0,11,61,22,0,94
YACUIBA,"anticoncepcion, prevencion de its y de cancer de cuello uterino",pildora: usuarias continuas,2015-08-01,0,1,17,8,0,26
YANACACHI,"anticoncepcion, prevencion de its y de cancer de cuello uterino",pildora: usuarias continuas,2015-08-01,0,0,7,2,0,9
YAPACANI,"anticoncepcion, prevencion de its y de cancer de cuello uterino",pildora: usuarias continuas,2015-08-01,0,3,24,1,0,28
YOCALLA,"anticoncepcion, prevencion de its y de cancer de cuello uterino",pildora: usuarias continuas,2015-08-01,0,0,8,0,0,8
YOTALA,"anticoncepcion, prevencion de its y de cancer de cuello uterino",pildora: usuarias continuas,2015-08-01,0,0,1,1,0,2
YUNCHARA,"anticoncepcion, prevencion de its y de cancer de cuello uterino",pildora: usuarias continuas,2015-08-01,0,1,3,0,0,4
ZUDAÑEZ,"anticoncepcion, prevencion de its y de cancer de cuello uterino",pildora: usuarias continuas,2015-08-01,0,0,2,0,0,2
ACACIO,"anticoncepcion, prevencion de its y de cancer de cuello uterino",pildora: usuarias continuas,2015-09-01,0,0,0,1,0,1
ACHACACHI,"anticoncepcion, prevencion de its y de cancer de cuello uterino",pildora: usuarias continuas,2015-09-01,0,0,4,0,0,4
ACHOCALLA,"anticoncepcion, prevencion de its y de cancer de cuello uterino",pildora: usuarias continuas,2015-09-01,0,1,3,0,0,4
AIQUILE,"anticoncepcion, prevencion de its y de cancer de cuello uterino",pildora: usuarias continuas,2015-09-01,0,0,2,1,0,3
ALCALA,"anticoncepcion, prevencion de its y de cancer de cuello uterino",pildora: usuarias continuas,2015-09-01,0,1,1,1,0,3
ALTO BENI,"anticoncepcion, prevencion de its y de cancer de cuello uterino",pildora: usuarias continuas,2015-09-01,0,0,3,3,0,6
ANCORAIMES,"anticoncepcion, prevencion de its y de cancer de cuello uterino",pildora: usuarias continuas,2015-09-01,0,0,0,1,0,1
ANDAMARCA,"anticoncepcion, prevencion de its y de cancer de cuello uterino",pildora: usuarias continuas,2015-09-01,0,0,1,0,0,1
ANTEQUERA,"anticoncepcion, prevencion de its y de cancer de cuello uterino",pildora: usuarias continuas,2015-09-01,0,0,2,0,0,2
APOLO,"anticoncepcion, prevencion de its y de cancer de cuello uterino",pildora: usuarias continuas,2015-09-01,0,1,7,2,0,10
ARAMPAMPA,"anticoncepcion, prevencion de its y de cancer de cuello uterino",pildora: usuarias continuas,2015-09-01,0,0,4,3,0,7
ARANI,"anticoncepcion, prevencion de its y de cancer de cuello uterino",pildora: usuarias continuas,2015-09-01,0,0,2,2,0,4
ARBIETO,"anticoncepcion, prevencion de its y de cancer de cuello uterino",pildora: usuarias continuas,2015-09-01,0,0,6,1,0,7
ARQUE,"anticoncepcion, prevencion de its y de cancer de cuello uterino",pildora: usuarias continuas,2015-09-01,0,0,2,2,1,5
ASCENCION DE GUARAYOS,"anticoncepcion, prevencion de its y de cancer de cuello uterino",pildora: usuarias continuas,2015-09-01,0,5,9,4,0,18
ATOCHA,"anticoncepcion, prevencion de its y de cancer de cuello uterino",pildora: usuarias continuas,2015-09-01,0,1,11,0,0,12
AUCAPATA,"anticoncepcion, prevencion de its y de cancer de cuello uterino",pildora: usuarias continuas,2015-09-01,0,1,0,0,0,1
AYATA,"anticoncepcion, prevencion de its y de cancer de cuello uterino",pildora: usuarias continuas,2015-09-01,0,0,2,4,0,6
AYOPAYA (V. DE INDEPENDENCIA),"anticoncepcion, prevencion de its y de cancer de cuello uterino",pildora: usuarias continuas,2015-09-01,0,1,10,6,0,17
AZURDUY,"anticoncepcion, prevencion de its y de cancer de cuello uterino",pildora: usuarias continuas,2015-09-01,0,0,3,1,1,5
BATALLAS,"anticoncepcion, prevencion de its y de cancer de cuello uterino",pildora: usuarias continuas,2015-09-01,0,0,1,1,0,2
BAURES,"anticoncepcion, prevencion de its y de cancer de cuello uterino",pildora: usuarias continuas,2015-09-01,0,2,8,2,0,12
BELLA FLOR,"anticoncepcion, prevencion de its y de cancer de cuello uterino",pildora: usuarias continuas,2015-09-01,0,1,11,5,0,17
BERMEJO,"anticoncepcion, prevencion de its y de cancer de cuello uterino",pildora: usuarias continuas,2015-09-01,0,4,15,6,1,26
BETANZOS,"anticoncepcion, prevencion de its y de cancer de cuello uterino",pildora: usuarias continuas,2015-09-01,0,0,0,3,0,3
BOLPEBRA,"anticoncepcion, prevencion de its y de cancer de cuello uterino",pildora: usuarias continuas,2015-09-01,0,2,3,1,0,6
BOYUIBE,"anticoncepcion, prevencion de its y de cancer de cuello uterino",pildora: usuarias continuas,2015-09-01,0,0,2,1,0,3
BUENA VISTA,"anticoncepcion, prevencion de its y de cancer de cuello uterino",pildora: usuarias continuas,2015-09-01,0,5,34,4,0,43
CABEZAS,"anticoncepcion, prevencion de its y de cancer de cuello uterino",pildora: usuarias continuas,2015-09-01,0,4,36,6,1,47
"CAIZA ""D""","anticoncepcion, prevencion de its y de cancer de cuello uterino",pildora: usuarias continuas,2015-09-01,0,0,2,0,0,2
CAJUATA,"anticoncepcion, prevencion de its y de cancer de cuello uterino",pildora: usuarias continuas,2015-09-01,0,0,3,0,0,3
CALAMARCA,"anticoncepcion, prevencion de its y de cancer de cuello uterino",pildora: usuarias continuas,2015-09-01,0,0,6,2,0,8
CAMARGO,"anticoncepcion, prevencion de its y de cancer de cuello uterino",pildora: usuarias continuas,2015-09-01,0,1,0,0,0,1
CAMATAQUI (C. VILLA ABECIA),"anticoncepcion, prevencion de its y de cancer de cuello uterino",pildora: usuarias continuas,2015-09-01,0,0,1,1,0,2
CAMIRI,"anticoncepcion, prevencion de its y de cancer de cuello uterino",pildora: usuarias continuas,2015-09-01,0,0,5,3,0,8
CAPINOTA,"anticoncepcion, prevencion de its y de cancer de cuello uterino",pildora: usuarias continuas,2015-09-01,0,0,5,2,0,7
CARACOLLO,"anticoncepcion, prevencion de its y de cancer de cuello uterino",pildora: usuarias continuas,2015-09-01,0,0,1,1,0,2
CARANAVI,"anticoncepcion, prevencion de its y de cancer de cuello uterino",pildora: usuarias continuas,2015-09-01,0,1,6,4,0,11
CARAPARI,"anticoncepcion, prevencion de its y de cancer de cuello uterino",pildora: usuarias continuas,2015-09-01,0,1,29,9,0,39
CARMEN RIVERO TORREZ,"anticoncepcion, prevencion de its y de cancer de cuello uterino",pildora: usuarias continuas,2015-09-01,0,0,1,0,0,1
CHALLAPATA,"anticoncepcion, prevencion de its y de cancer de cuello uterino",pildora: usuarias continuas,2015-09-01,0,2,8,1,0,11
CHAQUI,"anticoncepcion, prevencion de its y de cancer de cuello uterino",pildora: usuarias continuas,2015-09-01,0,0,1,1,0,2
CHARAGUA,"anticoncepcion, prevencion de its y de cancer de cuello uterino",pildora: usuarias continuas,2015-09-01,0,3,15,5,0,23
CHAYANTA,"anticoncepcion, prevencion de its y de cancer de cuello uterino",pildora: usuarias continuas,2015-09-01,0,0,1,0,0,1
CHIMORE,"anticoncepcion, prevencion de its y de cancer de cuello uterino",pildora: usuarias continuas,2015-09-01,0,4,14,6,0,24
CHIPAYA,"anticoncepcion, prevencion de its y de cancer de cuello uterino",pildora: usuarias continuas,2015-09-01,0,0,2,0,0,2
CHULUMANI (V. DE LA LIBERTAD),"anticoncepcion, prevencion de its y de cancer de cuello uterino",pildora: usuarias continuas,2015-09-01,0,1,3,3,0,7
CHUMA,"anticoncepcion, prevencion de its y de cancer de cuello uterino",pildora: usuarias continuas,2015-09-01,0,0,0,3,0,3
CHUQUIHUTA AYLLU JUCUMANI,"anticoncepcion, prevencion de its y de cancer de cuello uterino",pildora: usuarias continuas,2015-09-01,0,0,2,1,0,3
CLIZA,"anticoncepcion, prevencion de its y de cancer de cuello uterino",pildora: usuarias continuas,2015-09-01,0,3,10,0,0,13
COBIJA,"anticoncepcion, prevencion de its y de cancer de cuello uterino",pildora: usuarias continuas,2015-09-01,0,8,39,9,1,57
COCAPATA,"anticoncepcion, prevencion de its y de cancer de cuello uterino",pildora: usuarias continuas,2015-09-01,0,1,3,1,0,5
COCHABAMBA,"anticoncepcion, prevencion de its y de cancer de cuello uterino",pildora: usuarias continuas,2015-09-01,1,9,96,26,0,132
COIPASA,"anticoncepcion, prevencion de its y de cancer de cuello uterino",pildora: usuarias continuas,2015-09-01,0,0,2,0,0,2
COLCAPIRHUA,"anticoncepcion, prevencion de its y de cancer de cuello uterino",pildora: usuarias continuas,2015-09-01,0,1,7,1,0,9
"COLCHA ""K""","anticoncepcion, prevencion de its y de cancer de cuello uterino",pildora: usuarias continuas,2015-09-01,0,0,4,0,0,4
COLLANA,"anticoncepcion, prevencion de its y de cancer de cuello uterino",pildora: usuarias continuas,2015-09-01,0,0,0,1,0,1
COLOMI,"anticoncepcion, prevencion de its y de cancer de cuello uterino",pildora: usuarias continuas,2015-09-01,0,0,3,0,0,3
COLPA BELGICA,"anticoncepcion, prevencion de its y de cancer de cuello uterino",pildora: usuarias continuas,2015-09-01,0,1,8,5,0,14
COLQUECHACA,"anticoncepcion, prevencion de its y de cancer de cuello uterino",pildora: usuarias continuas,2015-09-01,0,1,1,0,0,2
COLQUENCHA,"anticoncepcion, prevencion de its y de cancer de cuello uterino",pildora: usuarias continuas,2015-09-01,0,0,2,1,1,4
COMARAPA,"anticoncepcion, prevencion de its y de cancer de cuello uterino",pildora: usuarias continuas,2015-09-01,0,0,4,1,0,5
CONCEPCION,"anticoncepcion, prevencion de its y de cancer de cuello uterino",pildora: usuarias continuas,2015-09-01,0,0,1,0,0,1
COPACABANA,"anticoncepcion, prevencion de its y de cancer de cuello uterino",pildora: usuarias continuas,2015-09-01,0,2,0,0,0,2
CORIPATA,"anticoncepcion, prevencion de its y de cancer de cuello uterino",pildora: usuarias continuas,2015-09-01,0,1,1,1,0,3
COROICO,"anticoncepcion, prevencion de its y de cancer de cuello uterino",pildora: usuarias continuas,2015-09-01,0,1,1,3,0,5
CORQUE,"anticoncepcion, prevencion de its y de cancer de cuello uterino",pildora: usuarias continuas,2015-09-01,0,0,0,5,0,5
COTAGAITA,"anticoncepcion, prevencion de its y de cancer de cuello uterino",pildora: usuarias continuas,2015-09-01,0,1,10,4,0,15
COTOCA,"anticoncepcion, prevencion de its y de cancer de cuello uterino",pildora: usuarias continuas,2015-09-01,0,6,35,5,0,46
CUATRO CAÑADAS,"anticoncepcion, prevencion de its y de cancer de cuello uterino",pildora: usuarias continuas,2015-09-01,0,1,10,2,0,13
CUCHUMUELA (V. G. VILLARROEL),"anticoncepcion, prevencion de its y de cancer de cuello uterino",pildora: usuarias continuas,2015-09-01,0,0,1,0,0,1
CUEVO,"anticoncepcion, prevencion de its y de cancer de cuello uterino",pildora: usuarias continuas,2015-09-01,0,0,5,2,0,7
CULPINA,"anticoncepcion, prevencion de its y de cancer de cuello uterino",pildora: usuarias continuas,2015-09-01,0,0,8,3,1,12
CURAHUARA DE CARANGAS,"anticoncepcion, prevencion de its y de cancer de cuello uterino",pildora: usuarias continuas,2015-09-01,0,0,1,1,0,2
EL ALTO,"anticoncepcion, prevencion de its y de cancer de cuello uterino",pildora: usuarias continuas,2015-09-01,2,11,179,60,0,252
EL CHORO,"anticoncepcion, prevencion de its y de cancer de cuello uterino",pildora: usuarias continuas,2015-09-01,0,0,2,1,0,3
EL PUENTE(STC),"anticoncepcion, prevencion de its y de cancer de cuello uterino",pildora: usuarias continuas,2015-09-01,0,3,9,3,0,15
EL PUENTE(TJA),"anticoncepcion, prevencion de its y de cancer de cuello uterino",pildora: usuarias continuas,2015-09-01,0,1,8,3,0,12
EL TORNO,"anticoncepcion, prevencion de its y de cancer de cuello uterino",pildora: usuarias continuas,2015-09-01,4,8,38,15,1,66
EL VILLAR,"anticoncepcion, prevencion de its y de cancer de cuello uterino",pildora: usuarias continuas,2015-09-01,0,0,8,4,1,13
ENTRE RIOS TRJ,"anticoncepcion, prevencion de its y de cancer de cuello uterino",pildora: usuarias continuas,2015-09-01,0,5,16,9,0,30
ENTRE RIOS CBBA,"anticoncepcion, prevencion de its y de cancer de cuello uterino",pildora: usuarias continuas,2015-09-01,0,0,6,5,0,11
EUCALIPTUS,"anticoncepcion, prevencion de its y de cancer de cuello uterino",pildora: usuarias continuas,2015-09-01,0,0,1,0,0,1
EUREKA (SANTOS MERCADO),"anticoncepcion, prevencion de its y de cancer de cuello uterino",pildora: usuarias continuas,2015-09-01,0,2,0,0,0,2
FERNANDEZ ALONSO,"anticoncepcion, prevencion de its y de cancer de cuello uterino",pildora: usuarias continuas,2015-09-01,0,3,9,3,0,15
FILADELFIA,"anticoncepcion, prevencion de its y de cancer de cuello uterino",pildora: usuarias continuas,2015-09-01,0,2,10,1,0,13
GENERAL SAAVEDRA,"anticoncepcion, prevencion de its y de cancer de cuello uterino",pildora: usuarias continuas,2015-09-01,0,3,21,4,0,28
GRAL. J.J. PEREZ (CHARAZANI),"anticoncepcion, prevencion de its y de cancer de cuello uterino",pildora: usuarias continuas,2015-09-01,0,0,1,0,0,1
GUANAY,"anticoncepcion, prevencion de its y de cancer de cuello uterino",pildora: usuarias continuas,2015-09-01,0,0,2,0,0,2
GUAQUI,"anticoncepcion, prevencion de its y de cancer de cuello uterino",pildora: usuarias continuas,2015-09-01,0,0,0,1,0,1
GUAYARAMERIN,"anticoncepcion, prevencion de its y de cancer de cuello uterino",pildora: usuarias continuas,2015-09-01,0,0,2,0,0,2
GUTIERREZ,"anticoncepcion, prevencion de its y de cancer de cuello uterino",pildora: usuarias continuas,2015-09-01,0,0,3,6,0,9
HUACARETA,"anticoncepcion, prevencion de its y de cancer de cuello uterino",pildora: usuarias continuas,2015-09-01,0,1,6,4,0,11
HUACAYA (VILLA DE HUACAYA),"anticoncepcion, prevencion de its y de cancer de cuello uterino",pildora: usuarias continuas,2015-09-01,0,0,1,0,0,1
HUACHACALLA,"anticoncepcion, prevencion de its y de cancer de cuello uterino",pildora: usuarias continuas,2015-09-01,0,0,2,0,0,2
HUANUNI,"anticoncepcion, prevencion de its y de cancer de cuello uterino",pildora: usuarias continuas,2015-09-01,0,0,1,0,0,1
HUARACAJE,"anticoncepcion, prevencion de its y de cancer de cuello uterino",pildora: usuarias continuas,2015-09-01,0,0,16,5,0,21
HUATAJATA,"anticoncepcion, prevencion de its y de cancer de cuello uterino",pildora: usuarias continuas,2015-09-01,0,1,0,0,0,1
ICHOCA,"anticoncepcion, prevencion de its y de cancer de cuello uterino",pildora: usuarias continuas,2015-09-01,0,0,1,0,0,1
ICLA,"anticoncepcion, prevencion de its y de cancer de cuello uterino",pildora: usuarias continuas,2015-09-01,0,0,5,0,0,5
INCAHUASI,"anticoncepcion, prevencion de its y de cancer de cuello uterino",pildora: usuarias continuas,2015-09-01,0,0,2,4,0,6
INGAVI (HUMAITA),"anticoncepcion, prevencion de its y de cancer de cuello uterino",pildora: usuarias continuas,2015-09-01,0,0,0,2,0,2
INQUISIVI,"anticoncepcion, prevencion de its y de cancer de cuello uterino",pildora: usuarias continuas,2015-09-01,0,0,2,1,0,3
IRUPANA (VILLA DE LANZA),"anticoncepcion, prevencion de its y de cancer de cuello uterino",pildora: usuarias continuas,2015-09-01,0,0,7,2,0,9
IXIAMAS,"anticoncepcion, prevencion de its y de cancer de cuello uterino",pildora: usuarias continuas,2015-09-01,0,0,4,3,0,7
JESUS DE MACHACA,"anticoncepcion, prevencion de its y de cancer de cuello uterino",pildora: usuarias continuas,2015-09-01,0,0,0,1,0,1
LA ASUNTA,"anticoncepcion, prevencion de its y de cancer de cuello uterino",pildora: usuarias continuas,2015-09-01,0,0,16,6,0,22
LA GUARDIA,"anticoncepcion, prevencion de its y de cancer de cuello uterino",pildora: usuarias continuas,2015-09-01,0,2,27,8,0,37
LA PAZ,"anticoncepcion, prevencion de its y de cancer de cuello uterino",pildora: usuarias continuas,2015-09-01,0,3,70,28,0,101
LAGUNILLAS,"anticoncepcion, prevencion de its y de cancer de cuello uterino",pildora: usuarias continuas,2015-09-01,0,0,9,5,0,14
LAJA,"anticoncepcion, prevencion de its y de cancer de cuello uterino",pildora: usuarias continuas,2015-09-01,0,1,6,4,0,11
LAS CARRERAS,"anticoncepcion, prevencion de its y de cancer de cuello uterino",pildora: usuarias continuas,2015-09-01,0,0,0,1,0,1
LICOMA PAMPA,"anticoncepcion, prevencion de its y de cancer de cuello uterino",pildora: usuarias continuas,2015-09-01,0,0,0,2,0,2
LLALLAGUA,"anticoncepcion, prevencion de its y de cancer de cuello uterino",pildora: usuarias continuas,2015-09-01,0,1,2,0,0,3
LLICA,"anticoncepcion, prevencion de its y de cancer de cuello uterino",pildora: usuarias continuas,2015-09-01,0,1,2,1,0,4
LORETO,"anticoncepcion, prevencion de its y de cancer de cuello uterino",pildora: usuarias continuas,2015-09-01,0,2,4,1,0,7
LURIBAY,"anticoncepcion, prevencion de its y de cancer de cuello uterino",pildora: usuarias continuas,2015-09-01,0,0,1,0,0,1
MACHARETI,"anticoncepcion, prevencion de its y de cancer de cuello uterino",pildora: usuarias continuas,2015-09-01,0,1,11,5,0,17
MAGDALENA,"anticoncepcion, prevencion de its y de cancer de cuello uterino",pildora: usuarias continuas,2015-09-01,0,3,8,6,0,17
MAIRANA,"anticoncepcion, prevencion de its y de cancer de cuello uterino",pildora: usuarias continuas,2015-09-01,0,1,4,1,0,6
MAPIRI,"anticoncepcion, prevencion de its y de cancer de cuello uterino",pildora: usuarias continuas,2015-09-01,0,0,2,0,0,2
MINEROS,"anticoncepcion, prevencion de its y de cancer de cuello uterino",pildora: usuarias continuas,2015-09-01,0,4,23,5,0,32
MIZQUE,"anticoncepcion, prevencion de its y de cancer de cuello uterino",pildora: usuarias continuas,2015-09-01,0,0,1,0,0,1
MOCOMOCO,"anticoncepcion, prevencion de its y de cancer de cuello uterino",pildora: usuarias continuas,2015-09-01,0,0,2,0,0,2
MOJOCOYA,"anticoncepcion, prevencion de its y de cancer de cuello uterino",pildora: usuarias continuas,2015-09-01,0,1,1,4,0,6
MONTEAGUDO,"anticoncepcion, prevencion de its y de cancer de cuello uterino",pildora: usuarias continuas,2015-09-01,0,4,13,2,0,19
MONTERO,"anticoncepcion, prevencion de its y de cancer de cuello uterino",pildora: usuarias continuas,2015-09-01,2,7,36,19,1,65
MORO MORO,"anticoncepcion, prevencion de its y de cancer de cuello uterino",pildora: usuarias continuas,2015-09-01,0,0,6,3,0,9
MOROCHATA,"anticoncepcion, prevencion de its y de cancer de cuello uterino",pildora: usuarias continuas,2015-09-01,0,0,2,3,0,5
NACEBE (SANTA ROSA DEL ABUNA),"anticoncepcion, prevencion de its y de cancer de cuello uterino",pildora: usuarias continuas,2015-09-01,0,0,0,3,0,3
OCURI,"anticoncepcion, prevencion de its y de cancer de cuello uterino",pildora: usuarias continuas,2015-09-01,0,1,4,0,0,5
OKINAWA,"anticoncepcion, prevencion de its y de cancer de cuello uterino",pildora: usuarias continuas,2015-09-01,0,1,20,8,0,29
OMEREQUE,"anticoncepcion, prevencion de its y de cancer de cuello uterino",pildora: usuarias continuas,2015-09-01,0,0,7,2,0,9
ORURO,"anticoncepcion, prevencion de its y de cancer de cuello uterino",pildora: usuarias continuas,2015-09-01,0,9,72,40,0,121
PADCAYA,"anticoncepcion, prevencion de its y de cancer de cuello uterino",pildora: usuarias continuas,2015-09-01,0,1,14,14,0,29
PADILLA,"anticoncepcion, prevencion de its y de cancer de cuello uterino",pildora: usuarias continuas,2015-09-01,0,1,7,3,0,11
PAILON,"anticoncepcion, prevencion de its y de cancer de cuello uterino",pildora: usuarias continuas,2015-09-01,0,0,18,6,0,24
PALCA,"anticoncepcion, prevencion de its y de cancer de cuello uterino",pildora: usuarias continuas,2015-09-01,0,0,1,0,0,1
PALOS BLANCOS,"anticoncepcion, prevencion de its y de cancer de cuello uterino",pildora: usuarias continuas,2015-09-01,0,1,16,7,1,25
PAMPA GRANDE,"anticoncepcion, prevencion de its y de cancer de cuello uterino",pildora: usuarias continuas,2015-09-01,0,0,0,3,0,3
PAPEL PAMPA,"anticoncepcion, prevencion de its y de cancer de cuello uterino",pildora: usuarias continuas,2015-09-01,0,0,4,0,0,4
PASORAPA,"anticoncepcion, prevencion de its y de cancer de cuello uterino",pildora: usuarias continuas,2015-09-01,0,0,1,0,0,1
PATACAMAYA,"anticoncepcion, prevencion de its y de cancer de cuello uterino",pildora: usuarias continuas,2015-09-01,0,0,2,0,0,2
PAZÑA,"anticoncepcion, prevencion de its y de cancer de cuello uterino",pildora: usuarias continuas,2015-09-01,0,1,7,2,0,10
PELECHUCO,"anticoncepcion, prevencion de its y de cancer de cuello uterino",pildora: usuarias continuas,2015-09-01,0,1,6,4,0,11
POCOATA,"anticoncepcion, prevencion de its y de cancer de cuello uterino",pildora: usuarias continuas,2015-09-01,0,2,2,1,0,5
POCONA,"anticoncepcion, prevencion de its y de cancer de cuello uterino",pildora: usuarias continuas,2015-09-01,0,4,11,1,0,16
POJO (CBBA),"anticoncepcion, prevencion de its y de cancer de cuello uterino",pildora: usuarias continuas,2015-09-01,0,3,1,0,0,4
PORCO,"anticoncepcion, prevencion de its y de cancer de cuello uterino",pildora: usuarias continuas,2015-09-01,0,0,2,1,0,3
POROMA,"anticoncepcion, prevencion de its y de cancer de cuello uterino",pildora: usuarias continuas,2015-09-01,0,0,3,2,0,5
PORONGO,"anticoncepcion, prevencion de its y de cancer de cuello uterino",pildora: usuarias continuas,2015-09-01,0,2,10,1,0,13
PORTACHUELO,"anticoncepcion, prevencion de its y de cancer de cuello uterino",pildora: usuarias continuas,2015-09-01,0,0,3,1,0,4
PORVENIR,"anticoncepcion, prevencion de its y de cancer de cuello uterino",pildora: usuarias continuas,2015-09-01,0,0,16,3,0,19
POSTRER VALLE,"anticoncepcion, prevencion de its y de cancer de cuello uterino",pildora: usuarias continuas,2015-09-01,0,0,2,0,0,2
POTOSI,"anticoncepcion, prevencion de its y de cancer de cuello uterino",pildora: usuarias continuas,2015-09-01,0,4,56,20,0,80
PRESTO,"anticoncepcion, prevencion de its y de cancer de cuello uterino",pildora: usuarias continuas,2015-09-01,0,0,5,0,0,5
PUCARA,"anticoncepcion, prevencion de its y de cancer de cuello uterino",pildora: usuarias continuas,2015-09-01,0,0,2,2,0,4
PUCARANI,"anticoncepcion, prevencion de its y de cancer de cuello uterino",pildora: usuarias continuas,2015-09-01,0,0,3,1,0,4
PUERTO CARABUCO,"anticoncepcion, prevencion de its y de cancer de cuello uterino",pildora: usuarias continuas,2015-09-01,0,0,0,1,0,1
PUERTO GONZALO MORENO,"anticoncepcion, prevencion de its y de cancer de cuello uterino",pildora: usuarias continuas,2015-09-01,0,1,7,3,1,12
PUERTO QUIJARRO,"anticoncepcion, prevencion de its y de cancer de cuello uterino",pildora: usuarias continuas,2015-09-01,0,1,9,5,0,15
PUERTO RICO,"anticoncepcion, prevencion de its y de cancer de cuello uterino",pildora: usuarias continuas,2015-09-01,0,3,8,2,0,13
PUERTO SILES,"anticoncepcion, prevencion de its y de cancer de cuello uterino",pildora: usuarias continuas,2015-09-01,0,3,8,0,0,11
PUERTO SUAREZ,"anticoncepcion, prevencion de its y de cancer de cuello uterino",pildora: usuarias continuas,2015-09-01,0,1,3,2,0,6
PUERTO VILLARROEL,"anticoncepcion, prevencion de its y de cancer de cuello uterino",pildora: usuarias continuas,2015-09-01,0,8,12,7,0,27
PUNA,"anticoncepcion, prevencion de its y de cancer de cuello uterino",pildora: usuarias continuas,2015-09-01,0,2,6,2,0,10
PUNATA,"anticoncepcion, prevencion de its y de cancer de cuello uterino",pildora: usuarias continuas,2015-09-01,0,1,8,1,0,10
QUIABAYA,"anticoncepcion, prevencion de its y de cancer de cuello uterino",pildora: usuarias continuas,2015-09-01,0,0,1,1,0,2
QUILLACOLLO,"anticoncepcion, prevencion de its y de cancer de cuello uterino",pildora: usuarias continuas,2015-09-01,0,0,27,23,0,50
QUIME,"anticoncepcion, prevencion de its y de cancer de cuello uterino",pildora: usuarias continuas,2015-09-01,0,0,7,1,0,8
RAVELO,"anticoncepcion, prevencion de its y de cancer de cuello uterino",pildora: usuarias continuas,2015-09-01,0,0,0,2,0,2
REYES,"anticoncepcion, prevencion de its y de cancer de cuello uterino",pildora: usuarias continuas,2015-09-01,0,1,15,6,0,22
RIBERALTA,"anticoncepcion, prevencion de its y de cancer de cuello uterino",pildora: usuarias continuas,2015-09-01,0,9,37,9,0,55
ROBORE,"anticoncepcion, prevencion de its y de cancer de cuello uterino",pildora: usuarias continuas,2015-09-01,0,11,8,2,0,21
RURRENABAQUE,"anticoncepcion, prevencion de its y de cancer de cuello uterino",pildora: usuarias continuas,2015-09-01,0,1,11,4,0,16
SABAYA,"anticoncepcion, prevencion de its y de cancer de cuello uterino",pildora: usuarias continuas,2015-09-01,0,1,1,1,0,3
SACABA,"anticoncepcion, prevencion de its y de cancer de cuello uterino",pildora: usuarias continuas,2015-09-01,0,5,16,6,0,27
SACACA,"anticoncepcion, prevencion de its y de cancer de cuello uterino",pildora: usuarias continuas,2015-09-01,0,0,6,3,0,9
SAIPINA,"anticoncepcion, prevencion de its y de cancer de cuello uterino",pildora: usuarias continuas,2015-09-01,0,0,1,0,0,1
SALINAS DE GARCI MENDOZA,"anticoncepcion, prevencion de its y de cancer de cuello uterino",pildora: usuarias continuas,2015-09-01,0,0,4,1,0,5
SAMAIPATA,"anticoncepcion, prevencion de its y de cancer de cuello uterino",pildora: usuarias continuas,2015-09-01,0,2,9,3,1,15
SAN AGUSTIN,"anticoncepcion, prevencion de its y de cancer de cuello uterino",pildora: usuarias continuas,2015-09-01,0,0,2,2,0,4
SAN ANDRES,"anticoncepcion, prevencion de its y de cancer de cuello uterino",pildora: usuarias continuas,2015-09-01,0,7,28,14,1,50
SAN ANDRES DE MACHACA,"anticoncepcion, prevencion de its y de cancer de cuello uterino",pildora: usuarias continuas,2015-09-01,0,0,1,0,0,1
SAN ANTONIO DE ESMORUCO,"anticoncepcion, prevencion de its y de cancer de cuello uterino",pildora: usuarias continuas,2015-09-01,0,0,1,0,0,1
SAN ANTONIO DE LOMERIO,"anticoncepcion, prevencion de its y de cancer de cuello uterino",pildora: usuarias continuas,2015-09-01,0,1,12,5,0,18
SAN BORJA,"anticoncepcion, prevencion de its y de cancer de cuello uterino",pildora: usuarias continuas,2015-09-01,0,5,65,25,0,95
SAN BUENA VENTURA,"anticoncepcion, prevencion de its y de cancer de cuello uterino",pildora: usuarias continuas,2015-09-01,0,0,1,0,0,1
SAN CARLOS,"anticoncepcion, prevencion de its y de cancer de cuello uterino",pildora: usuarias continuas,2015-09-01,0,4,22,10,0,36
SAN IGNACIO,"anticoncepcion, prevencion de its y de cancer de cuello uterino",pildora: usuarias continuas,2015-09-01,1,10,82,32,1,126
SAN IGNACIO DE VELASCO,"anticoncepcion, prevencion de its y de cancer de cuello uterino",pildora: usuarias continuas,2015-09-01,0,12,67,21,1,101
SAN JAVIER(BNI),"anticoncepcion, prevencion de its y de cancer de cuello uterino",pildora: usuarias continuas,2015-09-01,0,0,4,12,0,16
SAN JAVIER(STC),"anticoncepcion, prevencion de its y de cancer de cuello uterino",pildora: usuarias continuas,2015-09-01,0,3,22,12,0,37
SAN JOAQUIN,"anticoncepcion, prevencion de its y de cancer de cuello uterino",pildora: usuarias continuas,2015-09-01,0,0,3,0,0,3
SAN JOSE DE CHIQUITOS,"anticoncepcion, prevencion de its y de cancer de cuello uterino",pildora: usuarias continuas,2015-09-01,0,2,9,7,0,18
SAN JUAN DE YAPACANI,"anticoncepcion, prevencion de its y de cancer de cuello uterino",pildora: usuarias continuas,2015-09-01,0,2,9,2,0,13
SAN JULIAN,"anticoncepcion, prevencion de its y de cancer de cuello uterino",pildora: usuarias continuas,2015-09-01,0,12,16,8,0,36
SAN LORENZO(PND),"anticoncepcion, prevencion de its y de cancer de cuello uterino",pildora: usuarias continuas,2015-09-01,0,1,0,1,0,2
SAN LORENZO(TJA),"anticoncepcion, prevencion de its y de cancer de cuello uterino",pildora: usuarias continuas,2015-09-01,0,4,10,5,0,19
SAN LUCAS,"anticoncepcion, prevencion de its y de cancer de cuello uterino",pildora: usuarias continuas,2015-09-01,0,1,6,3,0,10
SAN MATIAS,"anticoncepcion, prevencion de its y de cancer de cuello uterino",pildora: usuarias continuas,2015-09-01,0,1,16,0,0,17
SAN MIGUEL DE VELASCO,"anticoncepcion, prevencion de its y de cancer de cuello uterino",pildora: usuarias continuas,2015-09-01,0,5,19,12,1,37
SAN PEDRO,"anticoncepcion, prevencion de its y de cancer de cuello uterino",pildora: usuarias continuas,2015-09-01,0,0,11,6,0,17
SAN PEDRO DE QUEMES,"anticoncepcion, prevencion de its y de cancer de cuello uterino",pildora: usuarias continuas,2015-09-01,0,0,1,0,0,1
SAN PEDRO DE TIQUINA,"anticoncepcion, prevencion de its y de cancer de cuello uterino",pildora: usuarias continuas,2015-09-01,0,0,1,1,0,2
SAN PEDRO(PND),"anticoncepcion, prevencion de its y de cancer de cuello uterino",pildora: usuarias continuas,2015-09-01,0,1,0,0,0,1
SAN RAFAEL,"anticoncepcion, prevencion de its y de cancer de cuello uterino",pildora: usuarias continuas,2015-09-01,0,5,18,6,0,29
SAN RAMON BENI,"anticoncepcion, prevencion de its y de cancer de cuello uterino",pildora: usuarias continuas,2015-09-01,0,0,7,0,0,7
SAN RAMON SCZ,"anticoncepcion, prevencion de its y de cancer de cuello uterino",pildora: usuarias continuas,2015-09-01,1,0,1,0,1,3
SANTA ANA,"anticoncepcion, prevencion de its y de cancer de cuello uterino",pildora: usuarias continuas,2015-09-01,0,2,24,10,0,36
SANTA CRUZ DE LA SIERRA,"anticoncepcion, prevencion de its y de cancer de cuello uterino",pildora: usuarias continuas,2015-09-01,0,88,162,64,0,314
SANTA ROSA,"anticoncepcion, prevencion de its y de cancer de cuello uterino",pildora: usuarias continuas,2015-09-01,0,1,5,2,0,8
SANTA ROSA DEL SARA,"anticoncepcion, prevencion de its y de cancer de cuello uterino",pildora: usuarias continuas,2015-09-01,0,3,11,6,1,21
SANTIAGO DE HUARI,"anticoncepcion, prevencion de its y de cancer de cuello uterino",pildora: usuarias continuas,2015-09-01,0,0,3,2,0,5
SANTIVAÑES,"anticoncepcion, prevencion de its y de cancer de cuello uterino",pildora: usuarias continuas,2015-09-01,0,0,2,3,0,5
SANTUARIO DE QUILLACAS,"anticoncepcion, prevencion de its y de cancer de cuello uterino",pildora: usuarias continuas,2015-09-01,0,0,1,0,0,1
SAPAHAQUI,"anticoncepcion, prevencion de its y de cancer de cuello uterino",pildora: usuarias continuas,2015-09-01,0,0,1,2,0,3
SENA,"anticoncepcion, prevencion de its y de cancer de cuello uterino",pildora: usuarias continuas,2015-09-01,0,1,0,0,0,1
SHINAOTA,"anticoncepcion, prevencion de its y de cancer de cuello uterino",pildora: usuarias continuas,2015-09-01,0,1,5,4,0,10
SICA SICA (VILLA AROMA),"anticoncepcion, prevencion de its y de cancer de cuello uterino",pildora: usuarias continuas,2015-09-01,0,2,4,1,0,7
SIPE SIPE,"anticoncepcion, prevencion de its y de cancer de cuello uterino",pildora: usuarias continuas,2015-09-01,0,0,12,8,0,20
SOPACHUY,"anticoncepcion, prevencion de its y de cancer de cuello uterino",pildora: usuarias continuas,2015-09-01,0,0,4,1,0,5
SORACACHI,"anticoncepcion, prevencion de its y de cancer de cuello uterino",pildora: usuarias continuas,2015-09-01,0,0,2,0,0,2
SORATA,"anticoncepcion, prevencion de its y de cancer de cuello uterino",pildora: usuarias continuas,2015-09-01,0,1,6,1,0,8
SUCRE,"anticoncepcion, prevencion de its y de cancer de cuello uterino",pildora: usuarias continuas,2015-09-01,0,14,77,15,0,106
TACACOMA,"anticoncepcion, prevencion de its y de cancer de cuello uterino",pildora: usuarias continuas,2015-09-01,0,0,6,0,0,6
TACOBAMBA,"anticoncepcion, prevencion de its y de cancer de cuello uterino",pildora: usuarias continuas,2015-09-01,0,0,0,1,0,1
TAHUA,"anticoncepcion, prevencion de its y de cancer de cuello uterino",pildora: usuarias continuas,2015-09-01,0,0,1,0,0,1
TAPACARI,"anticoncepcion, prevencion de its y de cancer de cuello uterino",pildora: usuarias continuas,2015-09-01,0,0,2,0,0,2
TARABUCO,"anticoncepcion, prevencion de its y de cancer de cuello uterino",pildora: usuarias continuas,2015-09-01,0,0,2,0,0,2
TARACO,"anticoncepcion, prevencion de its y de cancer de cuello uterino",pildora: usuarias continuas,2015-09-01,0,0,1,1,0,2
TARATA,"anticoncepcion, prevencion de its y de cancer de cuello uterino",pildora: usuarias continuas,2015-09-01,0,0,1,0,0,1
TARIJA,"anticoncepcion, prevencion de its y de cancer de cuello uterino",pildora: usuarias continuas,2015-09-01,0,5,50,31,0,86
TARVITA,"anticoncepcion, prevencion de its y de cancer de cuello uterino",pildora: usuarias continuas,2015-09-01,0,1,6,0,0,7
TEOPONTE,"anticoncepcion, prevencion de its y de cancer de cuello uterino",pildora: usuarias continuas,2015-09-01,0,0,5,3,0,8
TIAWANACU,"anticoncepcion, prevencion de its y de cancer de cuello uterino",pildora: usuarias continuas,2015-09-01,0,0,4,3,0,7
TINGUIPAYA,"anticoncepcion, prevencion de its y de cancer de cuello uterino",pildora: usuarias continuas,2015-09-01,0,0,1,1,0,2
TIPUANI,"anticoncepcion, prevencion de its y de cancer de cuello uterino",pildora: usuarias continuas,2015-09-01,0,0,8,3,0,11
TIQUIPAYA,"anticoncepcion, prevencion de its y de cancer de cuello uterino",pildora: usuarias continuas,2015-09-01,0,1,13,2,0,16
TIRAQUE (CBBA),"anticoncepcion, prevencion de its y de cancer de cuello uterino",pildora: usuarias continuas,2015-09-01,0,0,2,0,0,2
TOCO,"anticoncepcion, prevencion de its y de cancer de cuello uterino",pildora: usuarias continuas,2015-09-01,0,0,3,0,0,3
TOLATA,"anticoncepcion, prevencion de its y de cancer de cuello uterino",pildora: usuarias continuas,2015-09-01,0,0,3,0,0,3
TOLEDO,"anticoncepcion, prevencion de its y de cancer de cuello uterino",pildora: usuarias continuas,2015-09-01,0,0,1,1,0,2
TOMAVE,"anticoncepcion, prevencion de its y de cancer de cuello uterino",pildora: usuarias continuas,2015-09-01,0,0,3,0,0,3
TOMINA,"anticoncepcion, prevencion de its y de cancer de cuello uterino",pildora: usuarias continuas,2015-09-01,0,1,4,1,0,6
TORO TORO,"anticoncepcion, prevencion de its y de cancer de cuello uterino",pildora: usuarias continuas,2015-09-01,0,1,2,0,0,3
TOTORA(CBBA),"anticoncepcion, prevencion de its y de cancer de cuello uterino",pildora: usuarias continuas,2015-09-01,0,0,3,1,0,4
TOTORA(ORR),"anticoncepcion, prevencion de its y de cancer de cuello uterino",pildora: usuarias continuas,2015-09-01,0,1,1,0,0,2
TRIGAL,"anticoncepcion, prevencion de its y de cancer de cuello uterino",pildora: usuarias continuas,2015-09-01,0,0,3,2,1,6
TRINIDAD,"anticoncepcion, prevencion de its y de cancer de cuello uterino",pildora: usuarias continuas,2015-09-01,1,2,33,6,0,42
TUPIZA,"anticoncepcion, prevencion de its y de cancer de cuello uterino",pildora: usuarias continuas,2015-09-01,0,0,3,1,0,4
TURCO,"anticoncepcion, prevencion de its y de cancer de cuello uterino",pildora: usuarias continuas,2015-09-01,0,0,1,0,0,1
UMALA,"anticoncepcion, prevencion de its y de cancer de cuello uterino",pildora: usuarias continuas,2015-09-01,0,0,1,0,0,1
UNCIA,"anticoncepcion, prevencion de its y de cancer de cuello uterino",pildora: usuarias continuas,2015-09-01,0,0,2,0,0,2
URIONDO (A. CONCEPCION),"anticoncepcion, prevencion de its y de cancer de cuello uterino",pildora: usuarias continuas,2015-09-01,1,4,13,6,0,24
URUBICHA,"anticoncepcion, prevencion de its y de cancer de cuello uterino",pildora: usuarias continuas,2015-09-01,0,0,12,5,0,17
UYUNI,"anticoncepcion, prevencion de its y de cancer de cuello uterino",pildora: usuarias continuas,2015-09-01,0,0,2,4,0,6
VACAS,"anticoncepcion, prevencion de its y de cancer de cuello uterino",pildora: usuarias continuas,2015-09-01,0,0,1,0,0,1
VALLEGRANDE,"anticoncepcion, prevencion de its y de cancer de cuello uterino",pildora: usuarias continuas,2015-09-01,0,0,12,5,0,17
VIACHA,"anticoncepcion, prevencion de its y de cancer de cuello uterino",pildora: usuarias continuas,2015-09-01,0,1,34,0,0,35
VILLA CHARCAS,"anticoncepcion, prevencion de its y de cancer de cuello uterino",pildora: usuarias continuas,2015-09-01,0,1,1,1,0,3
VILLA MONTES,"anticoncepcion, prevencion de its y de cancer de cuello uterino",pildora: usuarias continuas,2015-09-01,0,7,15,6,1,29
VILLA NUEVA (LOMA ALTA),"anticoncepcion, prevencion de its y de cancer de cuello uterino",pildora: usuarias continuas,2015-09-01,0,3,1,0,0,4
VILLA RIVERO,"anticoncepcion, prevencion de its y de cancer de cuello uterino",pildora: usuarias continuas,2015-09-01,0,0,3,0,0,3
VILLA SERRANO,"anticoncepcion, prevencion de its y de cancer de cuello uterino",pildora: usuarias continuas,2015-09-01,0,0,1,4,0,5
VILLA TUNARI,"anticoncepcion, prevencion de its y de cancer de cuello uterino",pildora: usuarias continuas,2015-09-01,0,2,26,12,0,40
VILLA VACA GUZMAN (MUYUPAMPA),"anticoncepcion, prevencion de its y de cancer de cuello uterino",pildora: usuarias continuas,2015-09-01,0,0,14,0,0,14
VILLAZON,"anticoncepcion, prevencion de its y de cancer de cuello uterino",pildora: usuarias continuas,2015-09-01,0,1,22,13,0,36
VINTO,"anticoncepcion, prevencion de its y de cancer de cuello uterino",pildora: usuarias continuas,2015-09-01,0,0,6,1,0,7
VITICHI,"anticoncepcion, prevencion de its y de cancer de cuello uterino",pildora: usuarias continuas,2015-09-01,0,0,1,0,0,1
WARNES,"anticoncepcion, prevencion de its y de cancer de cuello uterino",pildora: usuarias continuas,2015-09-01,0,3,52,22,0,77
YACUIBA,"anticoncepcion, prevencion de its y de cancer de cuello uterino",pildora: usuarias continuas,2015-09-01,0,0,26,9,1,36
YAMPARAEZ,"anticoncepcion, prevencion de its y de cancer de cuello uterino",pildora: usuarias continuas,2015-09-01,0,0,1,1,0,2
YANACACHI,"anticoncepcion, prevencion de its y de cancer de cuello uterino",pildora: usuarias continuas,2015-09-01,0,0,9,1,0,10
YAPACANI,"anticoncepcion, prevencion de its y de cancer de cuello uterino",pildora: usuarias continuas,2015-09-01,0,1,14,3,0,18
YOTALA,"anticoncepcion, prevencion de its y de cancer de cuello uterino",pildora: usuarias continuas,2015-09-01,0,1,1,0,0,2
YUNCHARA,"anticoncepcion, prevencion de its y de cancer de cuello uterino",pildora: usuarias continuas,2015-09-01,0,0,3,1,0,4
ZUDAÑEZ,"anticoncepcion, prevencion de its y de cancer de cuello uterino",pildora: usuarias continuas,2015-09-01,0,1,6,0,0,7
ACHACACHI,"anticoncepcion, prevencion de its y de cancer de cuello uterino",pildora: usuarias continuas,2015-10-01,0,0,4,1,0,5
ACHOCALLA,"anticoncepcion, prevencion de its y de cancer de cuello uterino",pildora: usuarias continuas,2015-10-01,0,0,2,4,0,6
AIQUILE,"anticoncepcion, prevencion de its y de cancer de cuello uterino",pildora: usuarias continuas,2015-10-01,0,1,4,3,0,8
ALCALA,"anticoncepcion, prevencion de its y de cancer de cuello uterino",pildora: usuarias continuas,2015-10-01,0,0,4,1,0,5
ALTO BENI,"anticoncepcion, prevencion de its y de cancer de cuello uterino",pildora: usuarias continuas,2015-10-01,0,0,7,1,0,8
ANCORAIMES,"anticoncepcion, prevencion de its y de cancer de cuello uterino",pildora: usuarias continuas,2015-10-01,0,0,2,4,0,6
ANDAMARCA,"anticoncepcion, prevencion de its y de cancer de cuello uterino",pildora: usuarias continuas,2015-10-01,0,0,2,0,0,2
ANTEQUERA,"anticoncepcion, prevencion de its y de cancer de cuello uterino",pildora: usuarias continuas,2015-10-01,0,1,15,3,0,19
ANZALDO,"anticoncepcion, prevencion de its y de cancer de cuello uterino",pildora: usuarias continuas,2015-10-01,0,0,0,1,0,1
APOLO,"anticoncepcion, prevencion de its y de cancer de cuello uterino",pildora: usuarias continuas,2015-10-01,0,1,6,1,0,8
ARAMPAMPA,"anticoncepcion, prevencion de its y de cancer de cuello uterino",pildora: usuarias continuas,2015-10-01,0,0,3,2,0,5
ARANI,"anticoncepcion, prevencion de its y de cancer de cuello uterino",pildora: usuarias continuas,2015-10-01,0,0,4,2,0,6
ARBIETO,"anticoncepcion, prevencion de its y de cancer de cuello uterino",pildora: usuarias continuas,2015-10-01,0,2,4,1,0,7
ARQUE,"anticoncepcion, prevencion de its y de cancer de cuello uterino",pildora: usuarias continuas,2015-10-01,0,0,1,0,0,1
ASCENCION DE GUARAYOS,"anticoncepcion, prevencion de its y de cancer de cuello uterino",pildora: usuarias continuas,2015-10-01,0,0,10,5,0,15
ATOCHA,"anticoncepcion, prevencion de its y de cancer de cuello uterino",pildora: usuarias continuas,2015-10-01,0,1,8,2,0,11
AUCAPATA,"anticoncepcion, prevencion de its y de cancer de cuello uterino",pildora: usuarias continuas,2015-10-01,0,0,0,1,0,1
AYATA,"anticoncepcion, prevencion de its y de cancer de cuello uterino",pildora: usuarias continuas,2015-10-01,0,0,0,1,0,1
AYOPAYA (V. DE INDEPENDENCIA),"anticoncepcion, prevencion de its y de cancer de cuello uterino",pildora: usuarias continuas,2015-10-01,0,2,10,8,0,20
AZURDUY,"anticoncepcion, prevencion de its y de cancer de cuello uterino",pildora: usuarias continuas,2015-10-01,0,1,3,1,0,5
BATALLAS,"anticoncepcion, prevencion de its y de cancer de cuello uterino",pildora: usuarias continuas,2015-10-01,0,0,4,0,0,4
BAURES,"anticoncepcion, prevencion de its y de cancer de cuello uterino",pildora: usuarias continuas,2015-10-01,0,2,9,5,0,16
BELLA FLOR,"anticoncepcion, prevencion de its y de cancer de cuello uterino",pildora: usuarias continuas,2015-10-01,0,2,1,0,0,3
BERMEJO,"anticoncepcion, prevencion de its y de cancer de cuello uterino",pildora: usuarias continuas,2015-10-01,0,2,11,4,0,17
BETANZOS,"anticoncepcion, prevencion de its y de cancer de cuello uterino",pildora: usuarias continuas,2015-10-01,0,0,0,2,0,2
BOLPEBRA,"anticoncepcion, prevencion de its y de cancer de cuello uterino",pildora: usuarias continuas,2015-10-01,0,3,6,4,0,13
BOYUIBE,"anticoncepcion, prevencion de its y de cancer de cuello uterino",pildora: usuarias continuas,2015-10-01,0,0,2,0,0,2
BUENA VISTA,"anticoncepcion, prevencion de its y de cancer de cuello uterino",pildora: usuarias continuas,2015-10-01,0,4,20,12,0,36
CABEZAS,"anticoncepcion, prevencion de its y de cancer de cuello uterino",pildora: usuarias continuas,2015-10-01,1,5,42,6,0,54
CAIROMA,"anticoncepcion, prevencion de its y de cancer de cuello uterino",pildora: usuarias continuas,2015-10-01,0,0,3,3,0,6
"CAIZA ""D""","anticoncepcion, prevencion de its y de cancer de cuello uterino",pildora: usuarias continuas,2015-10-01,0,2,2,1,0,5
CAJUATA,"anticoncepcion, prevencion de its y de cancer de cuello uterino",pildora: usuarias continuas,2015-10-01,0,0,0,1,0,1
CALACOTO,"anticoncepcion, prevencion de its y de cancer de cuello uterino",pildora: usuarias continuas,2015-10-01,0,0,1,0,0,1
CALAMARCA,"anticoncepcion, prevencion de its y de cancer de cuello uterino",pildora: usuarias continuas,2015-10-01,0,0,4,0,0,4
CAMARGO,"anticoncepcion, prevencion de its y de cancer de cuello uterino",pildora: usuarias continuas,2015-10-01,0,1,1,0,0,2
CAMATAQUI (C. VILLA ABECIA),"anticoncepcion, prevencion de its y de cancer de cuello uterino",pildora: usuarias continuas,2015-10-01,0,0,1,0,0,1
CAMIRI,"anticoncepcion, prevencion de its y de cancer de cuello uterino",pildora: usuarias continuas,2015-10-01,0,0,4,4,0,8
CAPINOTA,"anticoncepcion, prevencion de its y de cancer de cuello uterino",pildora: usuarias continuas,2015-10-01,0,0,2,1,0,3
CARACOLLO,"anticoncepcion, prevencion de its y de cancer de cuello uterino",pildora: usuarias continuas,2015-10-01,0,1,2,2,0,5
CARANAVI,"anticoncepcion, prevencion de its y de cancer de cuello uterino",pildora: usuarias continuas,2015-10-01,0,0,7,3,0,10
CARANGAS,"anticoncepcion, prevencion de its y de cancer de cuello uterino",pildora: usuarias continuas,2015-10-01,0,0,1,0,0,1
CARAPARI,"anticoncepcion, prevencion de its y de cancer de cuello uterino",pildora: usuarias continuas,2015-10-01,0,0,16,4,1,21
CARMEN RIVERO TORREZ,"anticoncepcion, prevencion de its y de cancer de cuello uterino",pildora: usuarias continuas,2015-10-01,0,0,3,1,0,4
CHALLAPATA,"anticoncepcion, prevencion de its y de cancer de cuello uterino",pildora: usuarias continuas,2015-10-01,0,0,4,6,0,10
CHAQUI,"anticoncepcion, prevencion de its y de cancer de cuello uterino",pildora: usuarias continuas,2015-10-01,0,0,0,1,0,1
CHARAGUA,"anticoncepcion, prevencion de its y de cancer de cuello uterino",pildora: usuarias continuas,2015-10-01,0,1,10,3,0,14
CHIMORE,"anticoncepcion, prevencion de its y de cancer de cuello uterino",pildora: usuarias continuas,2015-10-01,2,4,9,3,0,18
CHIPAYA,"anticoncepcion, prevencion de its y de cancer de cuello uterino",pildora: usuarias continuas,2015-10-01,0,0,2,0,0,2
CHUA COCANI,"anticoncepcion, prevencion de its y de cancer de cuello uterino",pildora: usuarias continuas,2015-10-01,0,0,1,1,0,2
CHULUMANI (V. DE LA LIBERTAD),"anticoncepcion, prevencion de its y de cancer de cuello uterino",pildora: usuarias continuas,2015-10-01,0,0,2,2,0,4
CHUMA,"anticoncepcion, prevencion de its y de cancer de cuello uterino",pildora: usuarias continuas,2015-10-01,0,0,1,2,0,3
CHUQUIHUTA AYLLU JUCUMANI,"anticoncepcion, prevencion de its y de cancer de cuello uterino",pildora: usuarias continuas,2015-10-01,0,0,1,1,0,2
CLIZA,"anticoncepcion, prevencion de its y de cancer de cuello uterino",pildora: usuarias continuas,2015-10-01,0,2,9,1,0,12
COBIJA,"anticoncepcion, prevencion de its y de cancer de cuello uterino",pildora: usuarias continuas,2015-10-01,0,5,48,11,0,64
COCAPATA,"anticoncepcion, prevencion de its y de cancer de cuello uterino",pildora: usuarias continuas,2015-10-01,0,3,9,3,0,15
COCHABAMBA,"anticoncepcion, prevencion de its y de cancer de cuello uterino",pildora: usuarias continuas,2015-10-01,0,6,79,25,0,110
COLCAPIRHUA,"anticoncepcion, prevencion de its y de cancer de cuello uterino",pildora: usuarias continuas,2015-10-01,0,0,10,3,0,13
"COLCHA ""K""","anticoncepcion, prevencion de its y de cancer de cuello uterino",pildora: usuarias continuas,2015-10-01,0,0,2,2,0,4
COLLANA,"anticoncepcion, prevencion de its y de cancer de cuello uterino",pildora: usuarias continuas,2015-10-01,0,0,0,1,0,1
COLOMI,"anticoncepcion, prevencion de its y de cancer de cuello uterino",pildora: usuarias continuas,2015-10-01,0,0,3,3,0,6
COLPA BELGICA,"anticoncepcion, prevencion de its y de cancer de cuello uterino",pildora: usuarias continuas,2015-10-01,0,1,8,5,0,14
COLQUECHACA,"anticoncepcion, prevencion de its y de cancer de cuello uterino",pildora: usuarias continuas,2015-10-01,0,0,1,1,0,2
COLQUENCHA,"anticoncepcion, prevencion de its y de cancer de cuello uterino",pildora: usuarias continuas,2015-10-01,0,0,0,1,0,1
COMARAPA,"anticoncepcion, prevencion de its y de cancer de cuello uterino",pildora: usuarias continuas,2015-10-01,0,0,8,2,0,10
CONCEPCION,"anticoncepcion, prevencion de its y de cancer de cuello uterino",pildora: usuarias continuas,2015-10-01,0,2,9,6,0,17
COPACABANA,"anticoncepcion, prevencion de its y de cancer de cuello uterino",pildora: usuarias continuas,2015-10-01,0,0,2,1,0,3
COROICO,"anticoncepcion, prevencion de its y de cancer de cuello uterino",pildora: usuarias continuas,2015-10-01,0,2,0,0,0,2
CORQUE,"anticoncepcion, prevencion de its y de cancer de cuello uterino",pildora: usuarias continuas,2015-10-01,0,0,16,5,0,21
COTAGAITA,"anticoncepcion, prevencion de its y de cancer de cuello uterino",pildora: usuarias continuas,2015-10-01,0,0,9,3,0,12
COTOCA,"anticoncepcion, prevencion de its y de cancer de cuello uterino",pildora: usuarias continuas,2015-10-01,0,6,21,7,0,34
CUATRO CAÑADAS,"anticoncepcion, prevencion de its y de cancer de cuello uterino",pildora: usuarias continuas,2015-10-01,0,4,5,1,0,10
CUCHUMUELA (V. G. VILLARROEL),"anticoncepcion, prevencion de its y de cancer de cuello uterino",pildora: usuarias continuas,2015-10-01,0,1,0,0,0,1
CUEVO,"anticoncepcion, prevencion de its y de cancer de cuello uterino",pildora: usuarias continuas,2015-10-01,0,0,4,1,0,5
CULPINA,"anticoncepcion, prevencion de its y de cancer de cuello uterino",pildora: usuarias continuas,2015-10-01,0,0,12,0,0,12
CURAHUARA DE CARANGAS,"anticoncepcion, prevencion de its y de cancer de cuello uterino",pildora: usuarias continuas,2015-10-01,0,0,2,0,0,2
CURVA,"anticoncepcion, prevencion de its y de cancer de cuello uterino",pildora: usuarias continuas,2015-10-01,0,0,1,0,0,1
DESAGUADERO,"anticoncepcion, prevencion de its y de cancer de cuello uterino",pildora: usuarias continuas,2015-10-01,0,0,1,0,0,1
EL ALTO,"anticoncepcion, prevencion de its y de cancer de cuello uterino",pildora: usuarias continuas,2015-10-01,0,7,139,38,1,185
EL PUENTE(STC),"anticoncepcion, prevencion de its y de cancer de cuello uterino",pildora: usuarias continuas,2015-10-01,0,1,7,5,0,13
EL PUENTE(TJA),"anticoncepcion, prevencion de its y de cancer de cuello uterino",pildora: usuarias continuas,2015-10-01,0,2,11,9,0,22
EL TORNO,"anticoncepcion, prevencion de its y de cancer de cuello uterino",pildora: usuarias continuas,2015-10-01,1,10,42,11,2,66
EL VILLAR,"anticoncepcion, prevencion de its y de cancer de cuello uterino",pildora: usuarias continuas,2015-10-01,0,1,6,3,0,10
ENTRE RIOS TRJ,"anticoncepcion, prevencion de its y de cancer de cuello uterino",pildora: usuarias continuas,2015-10-01,0,3,18,11,0,32
ENTRE RIOS CBBA,"anticoncepcion, prevencion de its y de cancer de cuello uterino",pildora: usuarias continuas,2015-10-01,0,2,9,3,0,14
ESCARA,"anticoncepcion, prevencion de its y de cancer de cuello uterino",pildora: usuarias continuas,2015-10-01,0,1,0,0,0,1
EUREKA (SANTOS MERCADO),"anticoncepcion, prevencion de its y de cancer de cuello uterino",pildora: usuarias continuas,2015-10-01,0,0,2,0,0,2
EXALTACION,"anticoncepcion, prevencion de its y de cancer de cuello uterino",pildora: usuarias continuas,2015-10-01,0,0,1,0,0,1
FERNANDEZ ALONSO,"anticoncepcion, prevencion de its y de cancer de cuello uterino",pildora: usuarias continuas,2015-10-01,0,0,6,0,0,6
FILADELFIA,"anticoncepcion, prevencion de its y de cancer de cuello uterino",pildora: usuarias continuas,2015-10-01,0,4,25,5,0,34
GENERAL SAAVEDRA,"anticoncepcion, prevencion de its y de cancer de cuello uterino",pildora: usuarias continuas,2015-10-01,0,1,14,3,0,18
GRAL. J.J. PEREZ (CHARAZANI),"anticoncepcion, prevencion de its y de cancer de cuello uterino",pildora: usuarias continuas,2015-10-01,0,0,1,1,0,2
GUAQUI,"anticoncepcion, prevencion de its y de cancer de cuello uterino",pildora: usuarias continuas,2015-10-01,0,0,2,0,0,2
GUAYARAMERIN,"anticoncepcion, prevencion de its y de cancer de cuello uterino",pildora: usuarias continuas,2015-10-01,0,1,5,4,0,10
HUACARETA,"anticoncepcion, prevencion de its y de cancer de cuello uterino",pildora: usuarias continuas,2015-10-01,0,2,7,6,0,15
HUACHACALLA,"anticoncepcion, prevencion de its y de cancer de cuello uterino",pildora: usuarias continuas,2015-10-01,0,0,1,0,0,1
HUANUNI,"anticoncepcion, prevencion de its y de cancer de cuello uterino",pildora: usuarias continuas,2015-10-01,0,0,3,1,0,4
HUARACAJE,"anticoncepcion, prevencion de its y de cancer de cuello uterino",pildora: usuarias continuas,2015-10-01,0,3,11,3,0,17
HUARINA,"anticoncepcion, prevencion de its y de cancer de cuello uterino",pildora: usuarias continuas,2015-10-01,0,0,1,0,0,1
ICHOCA,"anticoncepcion, prevencion de its y de cancer de cuello uterino",pildora: usuarias continuas,2015-10-01,0,0,1,0,0,1
ICLA,"anticoncepcion, prevencion de its y de cancer de cuello uterino",pildora: usuarias continuas,2015-10-01,0,3,7,3,0,13
INCAHUASI,"anticoncepcion, prevencion de its y de cancer de cuello uterino",pildora: usuarias continuas,2015-10-01,0,1,5,4,0,10
INGAVI (HUMAITA),"anticoncepcion, prevencion de its y de cancer de cuello uterino",pildora: usuarias continuas,2015-10-01,0,0,2,0,0,2
INQUISIVI,"anticoncepcion, prevencion de its y de cancer de cuello uterino",pildora: usuarias continuas,2015-10-01,0,0,0,2,0,2
IRUPANA (VILLA DE LANZA),"anticoncepcion, prevencion de its y de cancer de cuello uterino",pildora: usuarias continuas,2015-10-01,0,0,7,1,0,8
IXIAMAS,"anticoncepcion, prevencion de its y de cancer de cuello uterino",pildora: usuarias continuas,2015-10-01,0,0,6,4,0,10
JESUS DE MACHACA,"anticoncepcion, prevencion de its y de cancer de cuello uterino",pildora: usuarias continuas,2015-10-01,0,0,1,0,0,1
LA ASUNTA,"anticoncepcion, prevencion de its y de cancer de cuello uterino",pildora: usuarias continuas,2015-10-01,0,0,24,7,0,31
LA GUARDIA,"anticoncepcion, prevencion de its y de cancer de cuello uterino",pildora: usuarias continuas,2015-10-01,0,0,27,13,0,40
LA PAZ,"anticoncepcion, prevencion de its y de cancer de cuello uterino",pildora: usuarias continuas,2015-10-01,0,4,65,28,0,97
LA RIVERA,"anticoncepcion, prevencion de its y de cancer de cuello uterino",pildora: usuarias continuas,2015-10-01,0,0,1,0,0,1
LAGUNILLAS,"anticoncepcion, prevencion de its y de cancer de cuello uterino",pildora: usuarias continuas,2015-10-01,0,0,12,0,0,12
LAJA,"anticoncepcion, prevencion de its y de cancer de cuello uterino",pildora: usuarias continuas,2015-10-01,0,0,4,2,0,6
LAS CARRERAS,"anticoncepcion, prevencion de its y de cancer de cuello uterino",pildora: usuarias continuas,2015-10-01,1,1,6,2,0,10
LLALLAGUA,"anticoncepcion, prevencion de its y de cancer de cuello uterino",pildora: usuarias continuas,2015-10-01,0,0,31,4,0,35
LLICA,"anticoncepcion, prevencion de its y de cancer de cuello uterino",pildora: usuarias continuas,2015-10-01,0,1,5,1,1,8
LORETO,"anticoncepcion, prevencion de its y de cancer de cuello uterino",pildora: usuarias continuas,2015-10-01,0,3,4,5,0,12
LURIBAY,"anticoncepcion, prevencion de its y de cancer de cuello uterino",pildora: usuarias continuas,2015-10-01,0,0,3,0,0,3
MACHARETI,"anticoncepcion, prevencion de its y de cancer de cuello uterino",pildora: usuarias continuas,2015-10-01,0,3,5,5,0,13
MAGDALENA,"anticoncepcion, prevencion de its y de cancer de cuello uterino",pildora: usuarias continuas,2015-10-01,0,2,25,7,0,34
MAIRANA,"anticoncepcion, prevencion de its y de cancer de cuello uterino",pildora: usuarias continuas,2015-10-01,0,1,7,2,0,10
MAPIRI,"anticoncepcion, prevencion de its y de cancer de cuello uterino",pildora: usuarias continuas,2015-10-01,0,0,1,0,0,1
MECAPACA,"anticoncepcion, prevencion de its y de cancer de cuello uterino",pildora: usuarias continuas,2015-10-01,0,0,0,1,0,1
MINEROS,"anticoncepcion, prevencion de its y de cancer de cuello uterino",pildora: usuarias continuas,2015-10-01,0,0,19,8,0,27
MIZQUE,"anticoncepcion, prevencion de its y de cancer de cuello uterino",pildora: usuarias continuas,2015-10-01,0,9,5,7,0,21
MOCOMOCO,"anticoncepcion, prevencion de its y de cancer de cuello uterino",pildora: usuarias continuas,2015-10-01,0,0,2,1,0,3
MOJOCOYA,"anticoncepcion, prevencion de its y de cancer de cuello uterino",pildora: usuarias continuas,2015-10-01,0,1,2,0,1,4
MONTEAGUDO,"anticoncepcion, prevencion de its y de cancer de cuello uterino",pildora: usuarias continuas,2015-10-01,0,1,20,3,0,24
MONTERO,"anticoncepcion, prevencion de its y de cancer de cuello uterino",pildora: usuarias continuas,2015-10-01,0,3,35,14,2,54
MORO MORO,"anticoncepcion, prevencion de its y de cancer de cuello uterino",pildora: usuarias continuas,2015-10-01,0,0,2,1,0,3
MOROCHATA,"anticoncepcion, prevencion de its y de cancer de cuello uterino",pildora: usuarias continuas,2015-10-01,0,1,4,3,0,8
NUEVO MANOA (NUEVA ESPERANZA),"anticoncepcion, prevencion de its y de cancer de cuello uterino",pildora: usuarias continuas,2015-10-01,0,0,2,0,0,2
OCURI,"anticoncepcion, prevencion de its y de cancer de cuello uterino",pildora: usuarias continuas,2015-10-01,0,3,17,0,0,20
OKINAWA,"anticoncepcion, prevencion de its y de cancer de cuello uterino",pildora: usuarias continuas,2015-10-01,0,7,16,6,0,29
OMEREQUE,"anticoncepcion, prevencion de its y de cancer de cuello uterino",pildora: usuarias continuas,2015-10-01,0,0,4,0,0,4
ORURO,"anticoncepcion, prevencion de its y de cancer de cuello uterino",pildora: usuarias continuas,2015-10-01,0,13,79,24,0,116
PADCAYA,"anticoncepcion, prevencion de its y de cancer de cuello uterino",pildora: usuarias continuas,2015-10-01,0,7,20,4,0,31
PADILLA,"anticoncepcion, prevencion de its y de cancer de cuello uterino",pildora: usuarias continuas,2015-10-01,0,1,8,6,0,15
PAILON,"anticoncepcion, prevencion de its y de cancer de cuello uterino",pildora: usuarias continuas,2015-10-01,0,1,7,0,0,8
PALCA,"anticoncepcion, prevencion de its y de cancer de cuello uterino",pildora: usuarias continuas,2015-10-01,0,2,3,2,0,7
PALOS BLANCOS,"anticoncepcion, prevencion de its y de cancer de cuello uterino",pildora: usuarias continuas,2015-10-01,0,0,12,7,0,19
PAMPA GRANDE,"anticoncepcion, prevencion de its y de cancer de cuello uterino",pildora: usuarias continuas,2015-10-01,0,1,4,2,1,8
PAPEL PAMPA,"anticoncepcion, prevencion de its y de cancer de cuello uterino",pildora: usuarias continuas,2015-10-01,0,0,6,1,0,7
PASORAPA,"anticoncepcion, prevencion de its y de cancer de cuello uterino",pildora: usuarias continuas,2015-10-01,1,1,3,0,0,5
PATACAMAYA,"anticoncepcion, prevencion de its y de cancer de cuello uterino",pildora: usuarias continuas,2015-10-01,0,0,2,1,0,3
PAZÑA,"anticoncepcion, prevencion de its y de cancer de cuello uterino",pildora: usuarias continuas,2015-10-01,0,0,6,4,0,10
PELECHUCO,"anticoncepcion, prevencion de its y de cancer de cuello uterino",pildora: usuarias continuas,2015-10-01,0,2,9,7,0,18
POCOATA,"anticoncepcion, prevencion de its y de cancer de cuello uterino",pildora: usuarias continuas,2015-10-01,0,0,4,2,0,6
POCONA,"anticoncepcion, prevencion de its y de cancer de cuello uterino",pildora: usuarias continuas,2015-10-01,0,0,9,2,0,11
POJO (CBBA),"anticoncepcion, prevencion de its y de cancer de cuello uterino",pildora: usuarias continuas,2015-10-01,0,0,6,0,0,6
POOPO,"anticoncepcion, prevencion de its y de cancer de cuello uterino",pildora: usuarias continuas,2015-10-01,0,0,2,0,0,2
PORCO,"anticoncepcion, prevencion de its y de cancer de cuello uterino",pildora: usuarias continuas,2015-10-01,0,1,3,0,0,4
POROMA,"anticoncepcion, prevencion de its y de cancer de cuello uterino",pildora: usuarias continuas,2015-10-01,0,1,4,5,0,10
PORONGO,"anticoncepcion, prevencion de its y de cancer de cuello uterino",pildora: usuarias continuas,2015-10-01,0,4,8,5,1,18
PORTACHUELO,"anticoncepcion, prevencion de its y de cancer de cuello uterino",pildora: usuarias continuas,2015-10-01,0,1,2,0,0,3
PORVENIR,"anticoncepcion, prevencion de its y de cancer de cuello uterino",pildora: usuarias continuas,2015-10-01,0,1,15,2,0,18
POSTRER VALLE,"anticoncepcion, prevencion de its y de cancer de cuello uterino",pildora: usuarias continuas,2015-10-01,0,1,3,3,0,7
POTOSI,"anticoncepcion, prevencion de its y de cancer de cuello uterino",pildora: usuarias continuas,2015-10-01,0,6,65,19,0,90
PRESTO,"anticoncepcion, prevencion de its y de cancer de cuello uterino",pildora: usuarias continuas,2015-10-01,0,0,3,0,0,3
PUCARA,"anticoncepcion, prevencion de its y de cancer de cuello uterino",pildora: usuarias continuas,2015-10-01,0,0,1,0,0,1
PUCARANI,"anticoncepcion, prevencion de its y de cancer de cuello uterino",pildora: usuarias continuas,2015-10-01,0,0,2,0,0,2
PUERTO ACOSTA,"anticoncepcion, prevencion de its y de cancer de cuello uterino",pildora: usuarias continuas,2015-10-01,0,0,0,3,0,3
PUERTO CARABUCO,"anticoncepcion, prevencion de its y de cancer de cuello uterino",pildora: usuarias continuas,2015-10-01,0,0,1,2,0,3
PUERTO GONZALO MORENO,"anticoncepcion, prevencion de its y de cancer de cuello uterino",pildora: usuarias continuas,2015-10-01,0,0,6,4,0,10
PUERTO PEREZ,"anticoncepcion, prevencion de its y de cancer de cuello uterino",pildora: usuarias continuas,2015-10-01,0,0,1,1,0,2
PUERTO QUIJARRO,"anticoncepcion, prevencion de its y de cancer de cuello uterino",pildora: usuarias continuas,2015-10-01,0,0,4,6,0,10
PUERTO RICO,"anticoncepcion, prevencion de its y de cancer de cuello uterino",pildora: usuarias continuas,2015-10-01,0,0,2,1,0,3
PUERTO SILES,"anticoncepcion, prevencion de its y de cancer de cuello uterino",pildora: usuarias continuas,2015-10-01,0,1,9,1,0,11
PUERTO SUAREZ,"anticoncepcion, prevencion de its y de cancer de cuello uterino",pildora: usuarias continuas,2015-10-01,0,0,2,1,0,3
PUERTO VILLARROEL,"anticoncepcion, prevencion de its y de cancer de cuello uterino",pildora: usuarias continuas,2015-10-01,0,3,10,10,0,23
PUNA,"anticoncepcion, prevencion de its y de cancer de cuello uterino",pildora: usuarias continuas,2015-10-01,0,0,22,4,0,26
PUNATA,"anticoncepcion, prevencion de its y de cancer de cuello uterino",pildora: usuarias continuas,2015-10-01,0,0,5,0,0,5
QUIABAYA,"anticoncepcion, prevencion de its y de cancer de cuello uterino",pildora: usuarias continuas,2015-10-01,0,0,2,0,0,2
QUILLACOLLO,"anticoncepcion, prevencion de its y de cancer de cuello uterino",pildora: usuarias continuas,2015-10-01,0,20,24,14,0,58
QUIME,"anticoncepcion, prevencion de its y de cancer de cuello uterino",pildora: usuarias continuas,2015-10-01,0,0,6,0,0,6
QUIRUSILLAS,"anticoncepcion, prevencion de its y de cancer de cuello uterino",pildora: usuarias continuas,2015-10-01,0,0,2,2,0,4
RAVELO,"anticoncepcion, prevencion de its y de cancer de cuello uterino",pildora: usuarias continuas,2015-10-01,0,0,4,3,0,7
REYES,"anticoncepcion, prevencion de its y de cancer de cuello uterino",pildora: usuarias continuas,2015-10-01,0,0,8,5,0,13
RIBERALTA,"anticoncepcion, prevencion de its y de cancer de cuello uterino",pildora: usuarias continuas,2015-10-01,0,6,29,11,0,46
ROBORE,"anticoncepcion, prevencion de its y de cancer de cuello uterino",pildora: usuarias continuas,2015-10-01,0,1,23,10,1,35
RURRENABAQUE,"anticoncepcion, prevencion de its y de cancer de cuello uterino",pildora: usuarias continuas,2015-10-01,0,2,15,5,0,22
SABAYA,"anticoncepcion, prevencion de its y de cancer de cuello uterino",pildora: usuarias continuas,2015-10-01,0,2,10,2,0,14
SACABA,"anticoncepcion, prevencion de its y de cancer de cuello uterino",pildora: usuarias continuas,2015-10-01,0,2,13,4,0,19
SACACA,"anticoncepcion, prevencion de its y de cancer de cuello uterino",pildora: usuarias continuas,2015-10-01,0,1,7,7,0,15
SAIPINA,"anticoncepcion, prevencion de its y de cancer de cuello uterino",pildora: usuarias continuas,2015-10-01,0,1,2,0,0,3
SALINAS DE GARCI MENDOZA,"anticoncepcion, prevencion de its y de cancer de cuello uterino",pildora: usuarias continuas,2015-10-01,0,1,1,0,0,2
SAMAIPATA,"anticoncepcion, prevencion de its y de cancer de cuello uterino",pildora: usuarias continuas,2015-10-01,0,1,7,2,0,10
SAN AGUSTIN,"anticoncepcion, prevencion de its y de cancer de cuello uterino",pildora: usuarias continuas,2015-10-01,0,0,0,1,0,1
SAN ANDRES,"anticoncepcion, prevencion de its y de cancer de cuello uterino",pildora: usuarias continuas,2015-10-01,2,14,45,11,0,72
SAN ANDRES DE MACHACA,"anticoncepcion, prevencion de its y de cancer de cuello uterino",pildora: usuarias continuas,2015-10-01,0,0,1,0,0,1
SAN ANTONIO DE ESMORUCO,"anticoncepcion, prevencion de its y de cancer de cuello uterino",pildora: usuarias continuas,2015-10-01,0,0,1,0,0,1
SAN ANTONIO DE LOMERIO,"anticoncepcion, prevencion de its y de cancer de cuello uterino",pildora: usuarias continuas,2015-10-01,0,3,11,8,0,22
SAN BORJA,"anticoncepcion, prevencion de its y de cancer de cuello uterino",pildora: usuarias continuas,2015-10-01,0,3,62,20,0,85
SAN CARLOS,"anticoncepcion, prevencion de its y de cancer de cuello uterino",pildora: usuarias continuas,2015-10-01,0,10,23,6,0,39
SAN IGNACIO,"anticoncepcion, prevencion de its y de cancer de cuello uterino",pildora: usuarias continuas,2015-10-01,2,8,63,37,1,111
SAN IGNACIO DE VELASCO,"anticoncepcion, prevencion de its y de cancer de cuello uterino",pildora: usuarias continuas,2015-10-01,0,12,47,19,0,78
SAN JAVIER(BNI),"anticoncepcion, prevencion de its y de cancer de cuello uterino",pildora: usuarias continuas,2015-10-01,0,1,7,0,0,8
SAN JAVIER(STC),"anticoncepcion, prevencion de its y de cancer de cuello uterino",pildora: usuarias continuas,2015-10-01,0,3,18,8,0,29
SAN JOSE DE CHIQUITOS,"anticoncepcion, prevencion de its y de cancer de cuello uterino",pildora: usuarias continuas,2015-10-01,0,1,12,6,0,19
SAN JUAN DE YAPACANI,"anticoncepcion, prevencion de its y de cancer de cuello uterino",pildora: usuarias continuas,2015-10-01,0,3,12,0,0,15
SAN JULIAN,"anticoncepcion, prevencion de its y de cancer de cuello uterino",pildora: usuarias continuas,2015-10-01,0,6,28,3,0,37
SAN LORENZO(PND),"anticoncepcion, prevencion de its y de cancer de cuello uterino",pildora: usuarias continuas,2015-10-01,0,1,3,0,0,4
SAN LORENZO(TJA),"anticoncepcion, prevencion de its y de cancer de cuello uterino",pildora: usuarias continuas,2015-10-01,0,4,20,2,0,26
SAN LUCAS,"anticoncepcion, prevencion de its y de cancer de cuello uterino",pildora: usuarias continuas,2015-10-01,0,0,4,3,0,7
SAN MATIAS,"anticoncepcion, prevencion de its y de cancer de cuello uterino",pildora: usuarias continuas,2015-10-01,0,1,11,9,0,21
SAN MIGUEL DE VELASCO,"anticoncepcion, prevencion de its y de cancer de cuello uterino",pildora: usuarias continuas,2015-10-01,0,3,24,9,1,37
SAN PEDRO,"anticoncepcion, prevencion de its y de cancer de cuello uterino",pildora: usuarias continuas,2015-10-01,0,1,10,6,0,17
SAN PEDRO DE BUENA VISTA,"anticoncepcion, prevencion de its y de cancer de cuello uterino",pildora: usuarias continuas,2015-10-01,0,0,4,1,0,5
SAN PEDRO DE QUEMES,"anticoncepcion, prevencion de its y de cancer de cuello uterino",pildora: usuarias continuas,2015-10-01,0,0,1,0,0,1
SAN PEDRO DE TIQUINA,"anticoncepcion, prevencion de its y de cancer de cuello uterino",pildora: usuarias continuas,2015-10-01,0,0,0,1,0,1
SAN PEDRO(PND),"anticoncepcion, prevencion de its y de cancer de cuello uterino",pildora: usuarias continuas,2015-10-01,0,0,1,0,0,1
SAN RAFAEL,"anticoncepcion, prevencion de its y de cancer de cuello uterino",pildora: usuarias continuas,2015-10-01,0,3,15,7,0,25
SAN RAMON BENI,"anticoncepcion, prevencion de its y de cancer de cuello uterino",pildora: usuarias continuas,2015-10-01,0,0,5,0,0,5
SAN RAMON SCZ,"anticoncepcion, prevencion de its y de cancer de cuello uterino",pildora: usuarias continuas,2015-10-01,0,15,36,6,3,60
SANTA ANA,"anticoncepcion, prevencion de its y de cancer de cuello uterino",pildora: usuarias continuas,2015-10-01,0,4,49,18,1,72
SANTA CRUZ DE LA SIERRA,"anticoncepcion, prevencion de its y de cancer de cuello uterino",pildora: usuarias continuas,2015-10-01,2,46,163,44,1,256
SANTA ROSA,"anticoncepcion, prevencion de its y de cancer de cuello uterino",pildora: usuarias continuas,2015-10-01,0,1,8,4,0,13
SANTA ROSA DEL SARA,"anticoncepcion, prevencion de its y de cancer de cuello uterino",pildora: usuarias continuas,2015-10-01,0,3,22,8,0,33
SANTIAGO DE HUARI,"anticoncepcion, prevencion de its y de cancer de cuello uterino",pildora: usuarias continuas,2015-10-01,0,0,3,0,0,3
SANTIAGO DE HUATA,"anticoncepcion, prevencion de its y de cancer de cuello uterino",pildora: usuarias continuas,2015-10-01,0,0,1,1,0,2
SANTIVAÑES,"anticoncepcion, prevencion de its y de cancer de cuello uterino",pildora: usuarias continuas,2015-10-01,0,0,3,0,0,3
SANTUARIO DE QUILLACAS,"anticoncepcion, prevencion de its y de cancer de cuello uterino",pildora: usuarias continuas,2015-10-01,0,0,1,0,0,1
SENA,"anticoncepcion, prevencion de its y de cancer de cuello uterino",pildora: usuarias continuas,2015-10-01,0,1,8,1,0,10
SHINAOTA,"anticoncepcion, prevencion de its y de cancer de cuello uterino",pildora: usuarias continuas,2015-10-01,0,0,3,2,0,5
SICA SICA (VILLA AROMA),"anticoncepcion, prevencion de its y de cancer de cuello uterino",pildora: usuarias continuas,2015-10-01,0,0,1,4,0,5
SIPE SIPE,"anticoncepcion, prevencion de its y de cancer de cuello uterino",pildora: usuarias continuas,2015-10-01,0,1,13,4,0,18
SOPACHUY,"anticoncepcion, prevencion de its y de cancer de cuello uterino",pildora: usuarias continuas,2015-10-01,0,0,1,2,0,3
SORACACHI,"anticoncepcion, prevencion de its y de cancer de cuello uterino",pildora: usuarias continuas,2015-10-01,0,1,7,2,0,10
SORATA,"anticoncepcion, prevencion de its y de cancer de cuello uterino",pildora: usuarias continuas,2015-10-01,0,0,1,1,0,2
SUCRE,"anticoncepcion, prevencion de its y de cancer de cuello uterino",pildora: usuarias continuas,2015-10-01,0,4,107,13,0,124
TACACOMA,"anticoncepcion, prevencion de its y de cancer de cuello uterino",pildora: usuarias continuas,2015-10-01,0,0,6,1,0,7
TAPACARI,"anticoncepcion, prevencion de its y de cancer de cuello uterino",pildora: usuarias continuas,2015-10-01,0,0,0,3,0,3
TARACO,"anticoncepcion, prevencion de its y de cancer de cuello uterino",pildora: usuarias continuas,2015-10-01,0,0,1,3,1,5
TARATA,"anticoncepcion, prevencion de its y de cancer de cuello uterino",pildora: usuarias continuas,2015-10-01,0,0,2,0,0,2
TARIJA,"anticoncepcion, prevencion de its y de cancer de cuello uterino",pildora: usuarias continuas,2015-10-01,1,21,46,23,0,91
TARVITA,"anticoncepcion, prevencion de its y de cancer de cuello uterino",pildora: usuarias continuas,2015-10-01,0,2,6,1,0,9
TEOPONTE,"anticoncepcion, prevencion de its y de cancer de cuello uterino",pildora: usuarias continuas,2015-10-01,0,0,1,0,0,1
TIAWANACU,"anticoncepcion, prevencion de its y de cancer de cuello uterino",pildora: usuarias continuas,2015-10-01,0,1,3,3,0,7
TINGUIPAYA,"anticoncepcion, prevencion de its y de cancer de cuello uterino",pildora: usuarias continuas,2015-10-01,0,0,3,3,0,6
TIPUANI,"anticoncepcion, prevencion de its y de cancer de cuello uterino",pildora: usuarias continuas,2015-10-01,0,0,2,1,0,3
TIQUIPAYA,"anticoncepcion, prevencion de its y de cancer de cuello uterino",pildora: usuarias continuas,2015-10-01,0,5,13,4,1,23
TIRAQUE (CBBA),"anticoncepcion, prevencion de its y de cancer de cuello uterino",pildora: usuarias continuas,2015-10-01,0,0,3,3,0,6
TOLATA,"anticoncepcion, prevencion de its y de cancer de cuello uterino",pildora: usuarias continuas,2015-10-01,0,0,3,0,0,3
TOLEDO,"anticoncepcion, prevencion de its y de cancer de cuello uterino",pildora: usuarias continuas,2015-10-01,0,0,1,0,0,1
TOMAVE,"anticoncepcion, prevencion de its y de cancer de cuello uterino",pildora: usuarias continuas,2015-10-01,0,1,5,1,0,7
TOMINA,"anticoncepcion, prevencion de its y de cancer de cuello uterino",pildora: usuarias continuas,2015-10-01,0,2,8,3,0,13
TORO TORO,"anticoncepcion, prevencion de its y de cancer de cuello uterino",pildora: usuarias continuas,2015-10-01,0,0,1,0,0,1
TOTORA(CBBA),"anticoncepcion, prevencion de its y de cancer de cuello uterino",pildora: usuarias continuas,2015-10-01,0,1,4,2,0,7
TOTORA(ORR),"anticoncepcion, prevencion de its y de cancer de cuello uterino",pildora: usuarias continuas,2015-10-01,1,1,2,0,0,4
TRIGAL,"anticoncepcion, prevencion de its y de cancer de cuello uterino",pildora: usuarias continuas,2015-10-01,0,0,3,1,0,4
TRINIDAD,"anticoncepcion, prevencion de its y de cancer de cuello uterino",pildora: usuarias continuas,2015-10-01,0,4,36,15,0,55
TUPIZA,"anticoncepcion, prevencion de its y de cancer de cuello uterino",pildora: usuarias continuas,2015-10-01,0,1,2,1,0,4
TURCO,"anticoncepcion, prevencion de its y de cancer de cuello uterino",pildora: usuarias continuas,2015-10-01,0,0,1,0,0,1
UNCIA,"anticoncepcion, prevencion de its y de cancer de cuello uterino",pildora: usuarias continuas,2015-10-01,0,0,7,1,0,8
URIONDO (A. CONCEPCION),"anticoncepcion, prevencion de its y de cancer de cuello uterino",pildora: usuarias continuas,2015-10-01,1,1,14,2,1,19
URUBICHA,"anticoncepcion, prevencion de its y de cancer de cuello uterino",pildora: usuarias continuas,2015-10-01,0,2,3,5,0,10
UYUNI,"anticoncepcion, prevencion de its y de cancer de cuello uterino",pildora: usuarias continuas,2015-10-01,0,0,10,3,0,13
VACAS,"anticoncepcion, prevencion de its y de cancer de cuello uterino",pildora: usuarias continuas,2015-10-01,0,0,0,1,0,1
VALLEGRANDE,"anticoncepcion, prevencion de its y de cancer de cuello uterino",pildora: usuarias continuas,2015-10-01,0,4,10,0,0,14
VIACHA,"anticoncepcion, prevencion de its y de cancer de cuello uterino",pildora: usuarias continuas,2015-10-01,0,1,9,1,0,11
VILA VILA,"anticoncepcion, prevencion de its y de cancer de cuello uterino",pildora: usuarias continuas,2015-10-01,0,0,0,1,0,1
VILLA CHARCAS,"anticoncepcion, prevencion de its y de cancer de cuello uterino",pildora: usuarias continuas,2015-10-01,0,0,2,2,0,4
VILLA MONTES,"anticoncepcion, prevencion de its y de cancer de cuello uterino",pildora: usuarias continuas,2015-10-01,0,2,30,6,0,38
VILLA NUEVA (LOMA ALTA),"anticoncepcion, prevencion de its y de cancer de cuello uterino",pildora: usuarias continuas,2015-10-01,0,0,4,0,0,4
VILLA RIVERO,"anticoncepcion, prevencion de its y de cancer de cuello uterino",pildora: usuarias continuas,2015-10-01,0,0,7,0,0,7
VILLA SERRANO,"anticoncepcion, prevencion de its y de cancer de cuello uterino",pildora: usuarias continuas,2015-10-01,0,0,4,1,1,6
VILLA TUNARI,"anticoncepcion, prevencion de its y de cancer de cuello uterino",pildora: usuarias continuas,2015-10-01,0,5,45,10,0,60
VILLA VACA GUZMAN (MUYUPAMPA),"anticoncepcion, prevencion de its y de cancer de cuello uterino",pildora: usuarias continuas,2015-10-01,0,2,4,6,0,12
VILLAZON,"anticoncepcion, prevencion de its y de cancer de cuello uterino",pildora: usuarias continuas,2015-10-01,0,2,17,12,0,31
VINTO,"anticoncepcion, prevencion de its y de cancer de cuello uterino",pildora: usuarias continuas,2015-10-01,0,0,7,0,0,7
VITICHI,"anticoncepcion, prevencion de its y de cancer de cuello uterino",pildora: usuarias continuas,2015-10-01,0,0,4,2,0,6
WALDO BALLIVIAN,"anticoncepcion, prevencion de its y de cancer de cuello uterino",pildora: usuarias continuas,2015-10-01,0,0,0,1,0,1
WARNES,"anticoncepcion, prevencion de its y de cancer de cuello uterino",pildora: usuarias continuas,2015-10-01,1,7,68,29,0,105
YACUIBA,"anticoncepcion, prevencion de its y de cancer de cuello uterino",pildora: usuarias continuas,2015-10-01,0,4,24,10,0,38
YAPACANI,"anticoncepcion, prevencion de its y de cancer de cuello uterino",pildora: usuarias continuas,2015-10-01,0,2,22,5,0,29
YOCALLA,"anticoncepcion, prevencion de its y de cancer de cuello uterino",pildora: usuarias continuas,2015-10-01,0,0,3,0,0,3
YUNCHARA,"anticoncepcion, prevencion de its y de cancer de cuello uterino",pildora: usuarias continuas,2015-10-01,0,1,4,6,0,11
ZUDAÑEZ,"anticoncepcion, prevencion de its y de cancer de cuello uterino",pildora: usuarias continuas,2015-10-01,0,2,3,0,0,5
ACHACACHI,"anticoncepcion, prevencion de its y de cancer de cuello uterino",pildora: usuarias continuas,2015-11-01,0,0,2,1,0,3
ACHOCALLA,"anticoncepcion, prevencion de its y de cancer de cuello uterino",pildora: usuarias continuas,2015-11-01,0,0,6,2,0,8
AIQUILE,"anticoncepcion, prevencion de its y de cancer de cuello uterino",pildora: usuarias continuas,2015-11-01,0,0,4,0,0,4
ALCALA,"anticoncepcion, prevencion de its y de cancer de cuello uterino",pildora: usuarias continuas,2015-11-01,0,0,3,1,0,4
ALTO BENI,"anticoncepcion, prevencion de its y de cancer de cuello uterino",pildora: usuarias continuas,2015-11-01,0,0,6,2,0,8
ANCORAIMES,"anticoncepcion, prevencion de its y de cancer de cuello uterino",pildora: usuarias continuas,2015-11-01,0,0,2,1,0,3
ANDAMARCA,"anticoncepcion, prevencion de its y de cancer de cuello uterino",pildora: usuarias continuas,2015-11-01,0,0,2,2,0,4
APOLO,"anticoncepcion, prevencion de its y de cancer de cuello uterino",pildora: usuarias continuas,2015-11-01,0,1,8,3,0,12
ARAMPAMPA,"anticoncepcion, prevencion de its y de cancer de cuello uterino",pildora: usuarias continuas,2015-11-01,0,1,2,1,0,4
ARANI,"anticoncepcion, prevencion de its y de cancer de cuello uterino",pildora: usuarias continuas,2015-11-01,0,0,2,0,0,2
ARBIETO,"anticoncepcion, prevencion de its y de cancer de cuello uterino",pildora: usuarias continuas,2015-11-01,0,0,3,1,0,4
ARQUE,"anticoncepcion, prevencion de its y de cancer de cuello uterino",pildora: usuarias continuas,2015-11-01,0,0,2,3,0,5
ASCENCION DE GUARAYOS,"anticoncepcion, prevencion de its y de cancer de cuello uterino",pildora: usuarias continuas,2015-11-01,0,1,5,4,0,10
ATOCHA,"anticoncepcion, prevencion de its y de cancer de cuello uterino",pildora: usuarias continuas,2015-11-01,0,1,2,7,0,10
AUCAPATA,"anticoncepcion, prevencion de its y de cancer de cuello uterino",pildora: usuarias continuas,2015-11-01,0,0,2,1,0,3
AYATA,"anticoncepcion, prevencion de its y de cancer de cuello uterino",pildora: usuarias continuas,2015-11-01,0,0,5,1,0,6
AYOPAYA (V. DE INDEPENDENCIA),"anticoncepcion, prevencion de its y de cancer de cuello uterino",pildora: usuarias continuas,2015-11-01,0,2,7,8,0,17
AZURDUY,"anticoncepcion, prevencion de its y de cancer de cuello uterino",pildora: usuarias continuas,2015-11-01,0,0,0,1,0,1
BATALLAS,"anticoncepcion, prevencion de its y de cancer de cuello uterino",pildora: usuarias continuas,2015-11-01,0,0,4,0,0,4
BAURES,"anticoncepcion, prevencion de its y de cancer de cuello uterino",pildora: usuarias continuas,2015-11-01,0,3,7,0,0,10
BERMEJO,"anticoncepcion, prevencion de its y de cancer de cuello uterino",pildora: usuarias continuas,2015-11-01,0,1,12,4,1,18
BETANZOS,"anticoncepcion, prevencion de its y de cancer de cuello uterino",pildora: usuarias continuas,2015-11-01,0,0,1,0,0,1
BOLPEBRA,"anticoncepcion, prevencion de its y de cancer de cuello uterino",pildora: usuarias continuas,2015-11-01,0,1,0,1,0,2
BOYUIBE,"anticoncepcion, prevencion de its y de cancer de cuello uterino",pildora: usuarias continuas,2015-11-01,0,0,1,0,0,1
BUENA VISTA,"anticoncepcion, prevencion de its y de cancer de cuello uterino",pildora: usuarias continuas,2015-11-01,0,3,13,12,0,28
CABEZAS,"anticoncepcion, prevencion de its y de cancer de cuello uterino",pildora: usuarias continuas,2015-11-01,0,4,29,1,1,35
CAIROMA,"anticoncepcion, prevencion de its y de cancer de cuello uterino",pildora: usuarias continuas,2015-11-01,0,0,3,1,0,4
"CAIZA ""D""","anticoncepcion, prevencion de its y de cancer de cuello uterino",pildora: usuarias continuas,2015-11-01,0,0,5,0,0,5
CAJUATA,"anticoncepcion, prevencion de its y de cancer de cuello uterino",pildora: usuarias continuas,2015-11-01,0,0,2,0,0,2
CALAMARCA,"anticoncepcion, prevencion de its y de cancer de cuello uterino",pildora: usuarias continuas,2015-11-01,0,0,1,1,0,2
CAMARGO,"anticoncepcion, prevencion de its y de cancer de cuello uterino",pildora: usuarias continuas,2015-11-01,0,0,0,1,0,1
CAMATAQUI (C. VILLA ABECIA),"anticoncepcion, prevencion de its y de cancer de cuello uterino",pildora: usuarias continuas,2015-11-01,0,0,2,1,0,3
CAMIRI,"anticoncepcion, prevencion de its y de cancer de cuello uterino",pildora: usuarias continuas,2015-11-01,0,0,13,2,0,15
CAPINOTA,"anticoncepcion, prevencion de its y de cancer de cuello uterino",pildora: usuarias continuas,2015-11-01,0,0,1,0,0,1
CAQUIAVIRI,"anticoncepcion, prevencion de its y de cancer de cuello uterino",pildora: usuarias continuas,2015-11-01,0,0,1,0,0,1
CARACOLLO,"anticoncepcion, prevencion de its y de cancer de cuello uterino",pildora: usuarias continuas,2015-11-01,0,0,3,2,0,5
CARANAVI,"anticoncepcion, prevencion de its y de cancer de cuello uterino",pildora: usuarias continuas,2015-11-01,0,2,6,2,0,10
CARAPARI,"anticoncepcion, prevencion de its y de cancer de cuello uterino",pildora: usuarias continuas,2015-11-01,0,2,15,7,0,24
CARMEN RIVERO TORREZ,"anticoncepcion, prevencion de its y de cancer de cuello uterino",pildora: usuarias continuas,2015-11-01,0,0,8,3,0,11
CHALLAPATA,"anticoncepcion, prevencion de its y de cancer de cuello uterino",pildora: usuarias continuas,2015-11-01,0,1,4,1,0,6
CHARAGUA,"anticoncepcion, prevencion de its y de cancer de cuello uterino",pildora: usuarias continuas,2015-11-01,0,2,17,11,0,30
CHARAÑA,"anticoncepcion, prevencion de its y de cancer de cuello uterino",pildora: usuarias continuas,2015-11-01,0,1,0,0,0,1
CHIMORE,"anticoncepcion, prevencion de its y de cancer de cuello uterino",pildora: usuarias continuas,2015-11-01,0,1,10,4,0,15
CHIPAYA,"anticoncepcion, prevencion de its y de cancer de cuello uterino",pildora: usuarias continuas,2015-11-01,0,0,1,0,0,1
CHUA COCANI,"anticoncepcion, prevencion de its y de cancer de cuello uterino",pildora: usuarias continuas,2015-11-01,0,0,3,1,0,4
CHULUMANI (V. DE LA LIBERTAD),"anticoncepcion, prevencion de its y de cancer de cuello uterino",pildora: usuarias continuas,2015-11-01,0,0,2,0,0,2
CHUMA,"anticoncepcion, prevencion de its y de cancer de cuello uterino",pildora: usuarias continuas,2015-11-01,0,1,0,1,0,2
CHUQUIHUTA AYLLU JUCUMANI,"anticoncepcion, prevencion de its y de cancer de cuello uterino",pildora: usuarias continuas,2015-11-01,0,0,0,1,0,1
CLIZA,"anticoncepcion, prevencion de its y de cancer de cuello uterino",pildora: usuarias continuas,2015-11-01,0,1,5,2,0,8
COBIJA,"anticoncepcion, prevencion de its y de cancer de cuello uterino",pildora: usuarias continuas,2015-11-01,0,4,32,13,0,49
COCAPATA,"anticoncepcion, prevencion de its y de cancer de cuello uterino",pildora: usuarias continuas,2015-11-01,0,2,5,1,0,8
COCHABAMBA,"anticoncepcion, prevencion de its y de cancer de cuello uterino",pildora: usuarias continuas,2015-11-01,0,22,88,30,0,140
COLCAPIRHUA,"anticoncepcion, prevencion de its y de cancer de cuello uterino",pildora: usuarias continuas,2015-11-01,0,0,4,2,0,6
COLLANA,"anticoncepcion, prevencion de its y de cancer de cuello uterino",pildora: usuarias continuas,2015-11-01,0,0,0,1,0,1
COLOMI,"anticoncepcion, prevencion de its y de cancer de cuello uterino",pildora: usuarias continuas,2015-11-01,0,0,3,4,0,7
COLPA BELGICA,"anticoncepcion, prevencion de its y de cancer de cuello uterino",pildora: usuarias continuas,2015-11-01,0,1,11,5,0,17
COLQUECHACA,"anticoncepcion, prevencion de its y de cancer de cuello uterino",pildora: usuarias continuas,2015-11-01,0,0,4,3,0,7
COLQUENCHA,"anticoncepcion, prevencion de its y de cancer de cuello uterino",pildora: usuarias continuas,2015-11-01,0,0,2,3,1,6
COMARAPA,"anticoncepcion, prevencion de its y de cancer de cuello uterino",pildora: usuarias continuas,2015-11-01,0,1,4,2,0,7
COMBAYA,"anticoncepcion, prevencion de its y de cancer de cuello uterino",pildora: usuarias continuas,2015-11-01,0,0,0,1,0,1
CONCEPCION,"anticoncepcion, prevencion de its y de cancer de cuello uterino",pildora: usuarias continuas,2015-11-01,0,0,9,5,0,14
CORIPATA,"anticoncepcion, prevencion de its y de cancer de cuello uterino",pildora: usuarias continuas,2015-11-01,0,0,1,0,0,1
COROICO,"anticoncepcion, prevencion de its y de cancer de cuello uterino",pildora: usuarias continuas,2015-11-01,0,0,2,2,0,4
CORQUE,"anticoncepcion, prevencion de its y de cancer de cuello uterino",pildora: usuarias continuas,2015-11-01,0,1,2,2,0,5
COTAGAITA,"anticoncepcion, prevencion de its y de cancer de cuello uterino",pildora: usuarias continuas,2015-11-01,0,0,8,7,0,15
COTOCA,"anticoncepcion, prevencion de its y de cancer de cuello uterino",pildora: usuarias continuas,2015-11-01,1,5,36,9,0,51
CUATRO CAÑADAS,"anticoncepcion, prevencion de its y de cancer de cuello uterino",pildora: usuarias continuas,2015-11-01,2,5,8,4,0,19
CUEVO,"anticoncepcion, prevencion de its y de cancer de cuello uterino",pildora: usuarias continuas,2015-11-01,0,0,6,1,0,7
CULPINA,"anticoncepcion, prevencion de its y de cancer de cuello uterino",pildora: usuarias continuas,2015-11-01,0,0,2,2,0,4
CURVA,"anticoncepcion, prevencion de its y de cancer de cuello uterino",pildora: usuarias continuas,2015-11-01,0,0,2,0,0,2
DESAGUADERO,"anticoncepcion, prevencion de its y de cancer de cuello uterino",pildora: usuarias continuas,2015-11-01,0,0,1,0,0,1
EL ALTO,"anticoncepcion, prevencion de its y de cancer de cuello uterino",pildora: usuarias continuas,2015-11-01,0,12,117,56,0,185
EL PUENTE(STC),"anticoncepcion, prevencion de its y de cancer de cuello uterino",pildora: usuarias continuas,2015-11-01,0,7,13,2,0,22
EL PUENTE(TJA),"anticoncepcion, prevencion de its y de cancer de cuello uterino",pildora: usuarias continuas,2015-11-01,0,1,7,3,1,12
EL TORNO,"anticoncepcion, prevencion de its y de cancer de cuello uterino",pildora: usuarias continuas,2015-11-01,2,8,27,7,0,44
EL VILLAR,"anticoncepcion, prevencion de its y de cancer de cuello uterino",pildora: usuarias continuas,2015-11-01,0,0,5,3,0,8
ENTRE RIOS TRJ,"anticoncepcion, prevencion de its y de cancer de cuello uterino",pildora: usuarias continuas,2015-11-01,0,3,10,5,0,18
ENTRE RIOS CBBA,"anticoncepcion, prevencion de its y de cancer de cuello uterino",pildora: usuarias continuas,2015-11-01,0,1,12,3,0,16
EUREKA (SANTOS MERCADO),"anticoncepcion, prevencion de its y de cancer de cuello uterino",pildora: usuarias continuas,2015-11-01,0,0,1,0,0,1
EXALTACION,"anticoncepcion, prevencion de its y de cancer de cuello uterino",pildora: usuarias continuas,2015-11-01,0,0,2,0,0,2
FERNANDEZ ALONSO,"anticoncepcion, prevencion de its y de cancer de cuello uterino",pildora: usuarias continuas,2015-11-01,0,2,5,2,1,10
FILADELFIA,"anticoncepcion, prevencion de its y de cancer de cuello uterino",pildora: usuarias continuas,2015-11-01,0,1,10,2,0,13
GENERAL SAAVEDRA,"anticoncepcion, prevencion de its y de cancer de cuello uterino",pildora: usuarias continuas,2015-11-01,0,2,22,7,0,31
GRAL. J.J. PEREZ (CHARAZANI),"anticoncepcion, prevencion de its y de cancer de cuello uterino",pildora: usuarias continuas,2015-11-01,0,0,3,0,0,3
GUANAY,"anticoncepcion, prevencion de its y de cancer de cuello uterino",pildora: usuarias continuas,2015-11-01,0,0,2,0,0,2
GUAQUI,"anticoncepcion, prevencion de its y de cancer de cuello uterino",pildora: usuarias continuas,2015-11-01,0,0,2,1,0,3
GUAYARAMERIN,"anticoncepcion, prevencion de its y de cancer de cuello uterino",pildora: usuarias continuas,2015-11-01,0,0,4,0,0,4
GUTIERREZ,"anticoncepcion, prevencion de its y de cancer de cuello uterino",pildora: usuarias continuas,2015-11-01,0,0,3,5,0,8
HUACARETA,"anticoncepcion, prevencion de its y de cancer de cuello uterino",pildora: usuarias continuas,2015-11-01,0,0,19,11,0,30
HUACAYA (VILLA DE HUACAYA),"anticoncepcion, prevencion de its y de cancer de cuello uterino",pildora: usuarias continuas,2015-11-01,0,0,1,0,0,1
HUACHACALLA,"anticoncepcion, prevencion de its y de cancer de cuello uterino",pildora: usuarias continuas,2015-11-01,0,0,1,0,0,1
HUANUNI,"anticoncepcion, prevencion de its y de cancer de cuello uterino",pildora: usuarias continuas,2015-11-01,0,0,3,0,0,3
HUARACAJE,"anticoncepcion, prevencion de its y de cancer de cuello uterino",pildora: usuarias continuas,2015-11-01,0,2,32,12,0,46
HUAYLLAMARCA,"anticoncepcion, prevencion de its y de cancer de cuello uterino",pildora: usuarias continuas,2015-11-01,0,0,1,1,0,2
HUMANATA,"anticoncepcion, prevencion de its y de cancer de cuello uterino",pildora: usuarias continuas,2015-11-01,0,0,0,1,0,1
ICLA,"anticoncepcion, prevencion de its y de cancer de cuello uterino",pildora: usuarias continuas,2015-11-01,0,0,0,3,0,3
INCAHUASI,"anticoncepcion, prevencion de its y de cancer de cuello uterino",pildora: usuarias continuas,2015-11-01,0,0,3,2,1,6
INQUISIVI,"anticoncepcion, prevencion de its y de cancer de cuello uterino",pildora: usuarias continuas,2015-11-01,0,0,0,1,0,1
IRUPANA (VILLA DE LANZA),"anticoncepcion, prevencion de its y de cancer de cuello uterino",pildora: usuarias continuas,2015-11-01,0,1,7,8,0,16
IXIAMAS,"anticoncepcion, prevencion de its y de cancer de cuello uterino",pildora: usuarias continuas,2015-11-01,0,0,4,3,0,7
JESUS DE MACHACA,"anticoncepcion, prevencion de its y de cancer de cuello uterino",pildora: usuarias continuas,2015-11-01,0,0,1,2,0,3
LA ASUNTA,"anticoncepcion, prevencion de its y de cancer de cuello uterino",pildora: usuarias continuas,2015-11-01,0,1,19,10,12,42
LA GUARDIA,"anticoncepcion, prevencion de its y de cancer de cuello uterino",pildora: usuarias continuas,2015-11-01,0,0,5,3,0,8
LA PAZ,"anticoncepcion, prevencion de its y de cancer de cuello uterino",pildora: usuarias continuas,2015-11-01,0,7,94,25,0,126
LAGUNILLAS,"anticoncepcion, prevencion de its y de cancer de cuello uterino",pildora: usuarias continuas,2015-11-01,0,1,8,1,0,10
LAJA,"anticoncepcion, prevencion de its y de cancer de cuello uterino",pildora: usuarias continuas,2015-11-01,0,0,6,2,0,8
LICOMA PAMPA,"anticoncepcion, prevencion de its y de cancer de cuello uterino",pildora: usuarias continuas,2015-11-01,0,1,1,1,0,3
LLALLAGUA,"anticoncepcion, prevencion de its y de cancer de cuello uterino",pildora: usuarias continuas,2015-11-01,0,0,7,1,0,8
LLICA,"anticoncepcion, prevencion de its y de cancer de cuello uterino",pildora: usuarias continuas,2015-11-01,0,3,5,2,0,10
LORETO,"anticoncepcion, prevencion de its y de cancer de cuello uterino",pildora: usuarias continuas,2015-11-01,0,1,7,1,0,9
LURIBAY,"anticoncepcion, prevencion de its y de cancer de cuello uterino",pildora: usuarias continuas,2015-11-01,0,0,2,1,1,4
MACHARETI,"anticoncepcion, prevencion de its y de cancer de cuello uterino",pildora: usuarias continuas,2015-11-01,0,0,14,2,0,16
MAGDALENA,"anticoncepcion, prevencion de its y de cancer de cuello uterino",pildora: usuarias continuas,2015-11-01,0,1,38,15,4,58
MAIRANA,"anticoncepcion, prevencion de its y de cancer de cuello uterino",pildora: usuarias continuas,2015-11-01,0,0,9,4,0,13
MAPIRI,"anticoncepcion, prevencion de its y de cancer de cuello uterino",pildora: usuarias continuas,2015-11-01,0,0,2,0,0,2
MECAPACA,"anticoncepcion, prevencion de its y de cancer de cuello uterino",pildora: usuarias continuas,2015-11-01,0,0,0,1,0,1
MINEROS,"anticoncepcion, prevencion de its y de cancer de cuello uterino",pildora: usuarias continuas,2015-11-01,0,2,18,8,0,28
MIZQUE,"anticoncepcion, prevencion de its y de cancer de cuello uterino",pildora: usuarias continuas,2015-11-01,0,1,3,3,0,7
MOCOMOCO,"anticoncepcion, prevencion de its y de cancer de cuello uterino",pildora: usuarias continuas,2015-11-01,0,0,1,0,0,1
MOJOCOYA,"anticoncepcion, prevencion de its y de cancer de cuello uterino",pildora: usuarias continuas,2015-11-01,0,0,1,3,0,4
MONTEAGUDO,"anticoncepcion, prevencion de its y de cancer de cuello uterino",pildora: usuarias continuas,2015-11-01,0,3,17,6,0,26
MONTERO,"anticoncepcion, prevencion de its y de cancer de cuello uterino",pildora: usuarias continuas,2015-11-01,2,12,51,26,1,92
MORO MORO,"anticoncepcion, prevencion de its y de cancer de cuello uterino",pildora: usuarias continuas,2015-11-01,0,0,1,1,0,2
MOROCHATA,"anticoncepcion, prevencion de its y de cancer de cuello uterino",pildora: usuarias continuas,2015-11-01,0,0,1,3,0,4
NACEBE (SANTA ROSA DEL ABUNA),"anticoncepcion, prevencion de its y de cancer de cuello uterino",pildora: usuarias continuas,2015-11-01,0,0,8,2,0,10
OCURI,"anticoncepcion, prevencion de its y de cancer de cuello uterino",pildora: usuarias continuas,2015-11-01,0,0,1,2,0,3
OKINAWA,"anticoncepcion, prevencion de its y de cancer de cuello uterino",pildora: usuarias continuas,2015-11-01,0,1,15,2,0,18
OMEREQUE,"anticoncepcion, prevencion de its y de cancer de cuello uterino",pildora: usuarias continuas,2015-11-01,0,0,5,6,0,11
ORURO,"anticoncepcion, prevencion de its y de cancer de cuello uterino",pildora: usuarias continuas,2015-11-01,0,2,78,20,1,101
PADCAYA,"anticoncepcion, prevencion de its y de cancer de cuello uterino",pildora: usuarias continuas,2015-11-01,0,3,15,4,0,22
PADILLA,"anticoncepcion, prevencion de its y de cancer de cuello uterino",pildora: usuarias continuas,2015-11-01,0,1,9,6,0,16
PAILON,"anticoncepcion, prevencion de its y de cancer de cuello uterino",pildora: usuarias continuas,2015-11-01,0,1,3,4,0,8
PALOS BLANCOS,"anticoncepcion, prevencion de its y de cancer de cuello uterino",pildora: usuarias continuas,2015-11-01,0,0,12,2,0,14
PAMPA AULLAGAS,"anticoncepcion, prevencion de its y de cancer de cuello uterino",pildora: usuarias continuas,2015-11-01,0,0,0,1,0,1
PAMPA GRANDE,"anticoncepcion, prevencion de its y de cancer de cuello uterino",pildora: usuarias continuas,2015-11-01,0,0,7,1,1,9
PAPEL PAMPA,"anticoncepcion, prevencion de its y de cancer de cuello uterino",pildora: usuarias continuas,2015-11-01,0,1,7,0,0,8
PASORAPA,"anticoncepcion, prevencion de its y de cancer de cuello uterino",pildora: usuarias continuas,2015-11-01,0,0,0,2,0,2
PELECHUCO,"anticoncepcion, prevencion de its y de cancer de cuello uterino",pildora: usuarias continuas,2015-11-01,0,1,5,7,0,13
POCOATA,"anticoncepcion, prevencion de its y de cancer de cuello uterino",pildora: usuarias continuas,2015-11-01,0,0,2,2,0,4
POCONA,"anticoncepcion, prevencion de its y de cancer de cuello uterino",pildora: usuarias continuas,2015-11-01,0,0,7,2,0,9
POJO (CBBA),"anticoncepcion, prevencion de its y de cancer de cuello uterino",pildora: usuarias continuas,2015-11-01,0,0,2,0,0,2
POOPO,"anticoncepcion, prevencion de its y de cancer de cuello uterino",pildora: usuarias continuas,2015-11-01,0,0,2,0,0,2
PORCO,"anticoncepcion, prevencion de its y de cancer de cuello uterino",pildora: usuarias continuas,2015-11-01,0,0,1,0,0,1
POROMA,"anticoncepcion, prevencion de its y de cancer de cuello uterino",pildora: usuarias continuas,2015-11-01,0,3,10,4,0,17
PORONGO,"anticoncepcion, prevencion de its y de cancer de cuello uterino",pildora: usuarias continuas,2015-11-01,0,0,12,0,0,12
PORTACHUELO,"anticoncepcion, prevencion de its y de cancer de cuello uterino",pildora: usuarias continuas,2015-11-01,0,0,9,3,0,12
PORVENIR,"anticoncepcion, prevencion de its y de cancer de cuello uterino",pildora: usuarias continuas,2015-11-01,0,0,18,5,0,23
POSTRER VALLE,"anticoncepcion, prevencion de its y de cancer de cuello uterino",pildora: usuarias continuas,2015-11-01,0,0,1,1,0,2
POTOSI,"anticoncepcion, prevencion de its y de cancer de cuello uterino",pildora: usuarias continuas,2015-11-01,0,0,75,30,0,105
PRESTO,"anticoncepcion, prevencion de its y de cancer de cuello uterino",pildora: usuarias continuas,2015-11-01,0,0,4,1,0,5
PUCARA,"anticoncepcion, prevencion de its y de cancer de cuello uterino",pildora: usuarias continuas,2015-11-01,0,1,1,0,0,2
PUCARANI,"anticoncepcion, prevencion de its y de cancer de cuello uterino",pildora: usuarias continuas,2015-11-01,0,0,3,1,0,4
PUERTO ACOSTA,"anticoncepcion, prevencion de its y de cancer de cuello uterino",pildora: usuarias continuas,2015-11-01,0,0,1,0,0,1
PUERTO GONZALO MORENO,"anticoncepcion, prevencion de its y de cancer de cuello uterino",pildora: usuarias continuas,2015-11-01,0,1,7,4,1,13
PUERTO QUIJARRO,"anticoncepcion, prevencion de its y de cancer de cuello uterino",pildora: usuarias continuas,2015-11-01,0,0,2,1,0,3
PUERTO RICO,"anticoncepcion, prevencion de its y de cancer de cuello uterino",pildora: usuarias continuas,2015-11-01,0,1,8,3,0,12
PUERTO SILES,"anticoncepcion, prevencion de its y de cancer de cuello uterino",pildora: usuarias continuas,2015-11-01,0,2,5,0,0,7
PUERTO SUAREZ,"anticoncepcion, prevencion de its y de cancer de cuello uterino",pildora: usuarias continuas,2015-11-01,0,1,3,0,0,4
PUERTO VILLARROEL,"anticoncepcion, prevencion de its y de cancer de cuello uterino",pildora: usuarias continuas,2015-11-01,0,1,11,4,0,16
PUNA,"anticoncepcion, prevencion de its y de cancer de cuello uterino",pildora: usuarias continuas,2015-11-01,0,2,7,9,0,18
PUNATA,"anticoncepcion, prevencion de its y de cancer de cuello uterino",pildora: usuarias continuas,2015-11-01,0,0,6,2,1,9
QUIABAYA,"anticoncepcion, prevencion de its y de cancer de cuello uterino",pildora: usuarias continuas,2015-11-01,0,0,0,1,0,1
QUILLACOLLO,"anticoncepcion, prevencion de its y de cancer de cuello uterino",pildora: usuarias continuas,2015-11-01,0,0,21,2,0,23
QUIME,"anticoncepcion, prevencion de its y de cancer de cuello uterino",pildora: usuarias continuas,2015-11-01,0,2,9,2,0,13
QUIRUSILLAS,"anticoncepcion, prevencion de its y de cancer de cuello uterino",pildora: usuarias continuas,2015-11-01,0,0,2,0,1,3
REYES,"anticoncepcion, prevencion de its y de cancer de cuello uterino",pildora: usuarias continuas,2015-11-01,0,3,15,6,0,24
RIBERALTA,"anticoncepcion, prevencion de its y de cancer de cuello uterino",pildora: usuarias continuas,2015-11-01,0,5,35,7,0,47
ROBORE,"anticoncepcion, prevencion de its y de cancer de cuello uterino",pildora: usuarias continuas,2015-11-01,0,1,14,13,0,28
RURRENABAQUE,"anticoncepcion, prevencion de its y de cancer de cuello uterino",pildora: usuarias continuas,2015-11-01,0,1,6,6,0,13
SABAYA,"anticoncepcion, prevencion de its y de cancer de cuello uterino",pildora: usuarias continuas,2015-11-01,0,0,1,0,0,1
SACABA,"anticoncepcion, prevencion de its y de cancer de cuello uterino",pildora: usuarias continuas,2015-11-01,0,5,14,4,0,23
SACACA,"anticoncepcion, prevencion de its y de cancer de cuello uterino",pildora: usuarias continuas,2015-11-01,0,1,7,5,0,13
SAIPINA,"anticoncepcion, prevencion de its y de cancer de cuello uterino",pildora: usuarias continuas,2015-11-01,0,0,1,1,0,2
SALINAS DE GARCI MENDOZA,"anticoncepcion, prevencion de its y de cancer de cuello uterino",pildora: usuarias continuas,2015-11-01,0,0,2,0,0,2
SAMAIPATA,"anticoncepcion, prevencion de its y de cancer de cuello uterino",pildora: usuarias continuas,2015-11-01,0,2,3,2,0,7
SAN AGUSTIN,"anticoncepcion, prevencion de its y de cancer de cuello uterino",pildora: usuarias continuas,2015-11-01,0,0,1,1,0,2
SAN ANDRES,"anticoncepcion, prevencion de its y de cancer de cuello uterino",pildora: usuarias continuas,2015-11-01,1,7,20,9,0,37
SAN ANTONIO DE LOMERIO,"anticoncepcion, prevencion de its y de cancer de cuello uterino",pildora: usuarias continuas,2015-11-01,0,1,8,7,0,16
SAN BORJA,"anticoncepcion, prevencion de its y de cancer de cuello uterino",pildora: usuarias continuas,2015-11-01,0,4,40,22,0,66
SAN BUENA VENTURA,"anticoncepcion, prevencion de its y de cancer de cuello uterino",pildora: usuarias continuas,2015-11-01,0,0,4,0,0,4
SAN CARLOS,"anticoncepcion, prevencion de its y de cancer de cuello uterino",pildora: usuarias continuas,2015-11-01,0,5,24,12,0,41
SAN IGNACIO,"anticoncepcion, prevencion de its y de cancer de cuello uterino",pildora: usuarias continuas,2015-11-01,0,10,80,29,1,120
SAN IGNACIO DE VELASCO,"anticoncepcion, prevencion de its y de cancer de cuello uterino",pildora: usuarias continuas,2015-11-01,1,4,58,19,0,82
SAN JAVIER(BNI),"anticoncepcion, prevencion de its y de cancer de cuello uterino",pildora: usuarias continuas,2015-11-01,0,2,10,1,0,13
SAN JAVIER(STC),"anticoncepcion, prevencion de its y de cancer de cuello uterino",pildora: usuarias continuas,2015-11-01,0,0,20,7,0,27
SAN JOAQUIN,"anticoncepcion, prevencion de its y de cancer de cuello uterino",pildora: usuarias continuas,2015-11-01,0,1,4,0,0,5
SAN JOSE DE CHIQUITOS,"anticoncepcion, prevencion de its y de cancer de cuello uterino",pildora: usuarias continuas,2015-11-01,0,1,12,8,1,22
SAN JUAN DE YAPACANI,"anticoncepcion, prevencion de its y de cancer de cuello uterino",pildora: usuarias continuas,2015-11-01,0,0,11,3,0,14
SAN JULIAN,"anticoncepcion, prevencion de its y de cancer de cuello uterino",pildora: usuarias continuas,2015-11-01,0,1,14,8,0,23
SAN LORENZO(PND),"anticoncepcion, prevencion de its y de cancer de cuello uterino",pildora: usuarias continuas,2015-11-01,0,2,5,0,0,7
SAN LORENZO(TJA),"anticoncepcion, prevencion de its y de cancer de cuello uterino",pildora: usuarias continuas,2015-11-01,0,2,12,5,0,19
SAN LUCAS,"anticoncepcion, prevencion de its y de cancer de cuello uterino",pildora: usuarias continuas,2015-11-01,0,2,3,2,0,7
SAN MATIAS,"anticoncepcion, prevencion de its y de cancer de cuello uterino",pildora: usuarias continuas,2015-11-01,0,1,11,7,0,19
SAN MIGUEL DE VELASCO,"anticoncepcion, prevencion de its y de cancer de cuello uterino",pildora: usuarias continuas,2015-11-01,1,3,20,13,1,38
SAN PEDRO,"anticoncepcion, prevencion de its y de cancer de cuello uterino",pildora: usuarias continuas,2015-11-01,0,1,9,3,0,13
SAN PEDRO DE BUENA VISTA,"anticoncepcion, prevencion de its y de cancer de cuello uterino",pildora: usuarias continuas,2015-11-01,0,0,1,0,0,1
SAN PEDRO DE TIQUINA,"anticoncepcion, prevencion de its y de cancer de cuello uterino",pildora: usuarias continuas,2015-11-01,0,0,1,0,0,1
SAN PEDRO(PND),"anticoncepcion, prevencion de its y de cancer de cuello uterino",pildora: usuarias continuas,2015-11-01,0,0,2,0,0,2
SAN RAFAEL,"anticoncepcion, prevencion de its y de cancer de cuello uterino",pildora: usuarias continuas,2015-11-01,0,6,10,9,0,25
SAN RAMON BENI,"anticoncepcion, prevencion de its y de cancer de cuello uterino",pildora: usuarias continuas,2015-11-01,0,1,0,0,0,1
SAN RAMON SCZ,"anticoncepcion, prevencion de its y de cancer de cuello uterino",pildora: usuarias continuas,2015-11-01,0,0,6,15,0,21
SANTA ANA,"anticoncepcion, prevencion de its y de cancer de cuello uterino",pildora: usuarias continuas,2015-11-01,2,15,48,12,1,78
SANTA CRUZ DE LA SIERRA,"anticoncepcion, prevencion de its y de cancer de cuello uterino",pildora: usuarias continuas,2015-11-01,1,22,119,28,0,170
SANTA ROSA,"anticoncepcion, prevencion de its y de cancer de cuello uterino",pildora: usuarias continuas,2015-11-01,0,2,4,1,1,8
SANTA ROSA DEL SARA,"anticoncepcion, prevencion de its y de cancer de cuello uterino",pildora: usuarias continuas,2015-11-01,0,0,23,10,0,33
SANTIVAÑES,"anticoncepcion, prevencion de its y de cancer de cuello uterino",pildora: usuarias continuas,2015-11-01,0,0,4,2,0,6
SANTUARIO DE QUILLACAS,"anticoncepcion, prevencion de its y de cancer de cuello uterino",pildora: usuarias continuas,2015-11-01,0,0,4,1,0,5
SAPAHAQUI,"anticoncepcion, prevencion de its y de cancer de cuello uterino",pildora: usuarias continuas,2015-11-01,0,0,1,0,0,1
SENA,"anticoncepcion, prevencion de its y de cancer de cuello uterino",pildora: usuarias continuas,2015-11-01,0,0,1,0,0,1
SHINAOTA,"anticoncepcion, prevencion de its y de cancer de cuello uterino",pildora: usuarias continuas,2015-11-01,0,1,5,2,0,8
SICA SICA (VILLA AROMA),"anticoncepcion, prevencion de its y de cancer de cuello uterino",pildora: usuarias continuas,2015-11-01,0,1,5,0,0,6
SICAYA,"anticoncepcion, prevencion de its y de cancer de cuello uterino",pildora: usuarias continuas,2015-11-01,0,0,2,0,0,2
SIPE SIPE,"anticoncepcion, prevencion de its y de cancer de cuello uterino",pildora: usuarias continuas,2015-11-01,0,1,16,8,0,25
SOPACHUY,"anticoncepcion, prevencion de its y de cancer de cuello uterino",pildora: usuarias continuas,2015-11-01,0,0,7,7,0,14
SORACACHI,"anticoncepcion, prevencion de its y de cancer de cuello uterino",pildora: usuarias continuas,2015-11-01,0,0,1,1,0,2
SORATA,"anticoncepcion, prevencion de its y de cancer de cuello uterino",pildora: usuarias continuas,2015-11-01,0,0,2,2,0,4
SUCRE,"anticoncepcion, prevencion de its y de cancer de cuello uterino",pildora: usuarias continuas,2015-11-01,0,7,88,18,0,113
TACACOMA,"anticoncepcion, prevencion de its y de cancer de cuello uterino",pildora: usuarias continuas,2015-11-01,0,0,2,0,0,2
TARABUCO,"anticoncepcion, prevencion de its y de cancer de cuello uterino",pildora: usuarias continuas,2015-11-01,0,0,1,0,0,1
TARACO,"anticoncepcion, prevencion de its y de cancer de cuello uterino",pildora: usuarias continuas,2015-11-01,0,0,2,0,0,2
TARIJA,"anticoncepcion, prevencion de its y de cancer de cuello uterino",pildora: usuarias continuas,2015-11-01,0,4,42,16,0,62
TARVITA,"anticoncepcion, prevencion de its y de cancer de cuello uterino",pildora: usuarias continuas,2015-11-01,0,0,0,1,0,1
TEOPONTE,"anticoncepcion, prevencion de its y de cancer de cuello uterino",pildora: usuarias continuas,2015-11-01,0,0,2,0,0,2
TIAWANACU,"anticoncepcion, prevencion de its y de cancer de cuello uterino",pildora: usuarias continuas,2015-11-01,0,0,2,2,0,4
TIPUANI,"anticoncepcion, prevencion de its y de cancer de cuello uterino",pildora: usuarias continuas,2015-11-01,0,0,2,0,0,2
TIQUIPAYA,"anticoncepcion, prevencion de its y de cancer de cuello uterino",pildora: usuarias continuas,2015-11-01,0,2,12,3,0,17
TIRAQUE (CBBA),"anticoncepcion, prevencion de its y de cancer de cuello uterino",pildora: usuarias continuas,2015-11-01,0,0,4,0,0,4
TOLATA,"anticoncepcion, prevencion de its y de cancer de cuello uterino",pildora: usuarias continuas,2015-11-01,0,1,1,1,0,3
TOMAVE,"anticoncepcion, prevencion de its y de cancer de cuello uterino",pildora: usuarias continuas,2015-11-01,0,0,2,0,0,2
TOMINA,"anticoncepcion, prevencion de its y de cancer de cuello uterino",pildora: usuarias continuas,2015-11-01,0,1,7,7,0,15
TORO TORO,"anticoncepcion, prevencion de its y de cancer de cuello uterino",pildora: usuarias continuas,2015-11-01,0,0,1,0,0,1
TOTORA(CBBA),"anticoncepcion, prevencion de its y de cancer de cuello uterino",pildora: usuarias continuas,2015-11-01,0,0,2,1,0,3
TOTORA(ORR),"anticoncepcion, prevencion de its y de cancer de cuello uterino",pildora: usuarias continuas,2015-11-01,0,1,2,0,0,3
TRIGAL,"anticoncepcion, prevencion de its y de cancer de cuello uterino",pildora: usuarias continuas,2015-11-01,0,0,6,0,0,6
TRINIDAD,"anticoncepcion, prevencion de its y de cancer de cuello uterino",pildora: usuarias continuas,2015-11-01,0,5,30,22,0,57
TUPIZA,"anticoncepcion, prevencion de its y de cancer de cuello uterino",pildora: usuarias continuas,2015-11-01,0,0,1,0,0,1
TURCO,"anticoncepcion, prevencion de its y de cancer de cuello uterino",pildora: usuarias continuas,2015-11-01,0,0,1,0,0,1
UNCIA,"anticoncepcion, prevencion de its y de cancer de cuello uterino",pildora: usuarias continuas,2015-11-01,0,0,2,2,0,4
URIONDO (A. CONCEPCION),"anticoncepcion, prevencion de its y de cancer de cuello uterino",pildora: usuarias continuas,2015-11-01,0,3,14,3,0,20
URUBICHA,"anticoncepcion, prevencion de its y de cancer de cuello uterino",pildora: usuarias continuas,2015-11-01,0,0,9,5,0,14
UYUNI,"anticoncepcion, prevencion de its y de cancer de cuello uterino",pildora: usuarias continuas,2015-11-01,0,1,3,1,0,5
VACAS,"anticoncepcion, prevencion de its y de cancer de cuello uterino",pildora: usuarias continuas,2015-11-01,0,1,0,0,0,1
VALLEGRANDE,"anticoncepcion, prevencion de its y de cancer de cuello uterino",pildora: usuarias continuas,2015-11-01,0,0,13,2,0,15
VIACHA,"anticoncepcion, prevencion de its y de cancer de cuello uterino",pildora: usuarias continuas,2015-11-01,0,2,5,2,0,9
VILA VILA,"anticoncepcion, prevencion de its y de cancer de cuello uterino",pildora: usuarias continuas,2015-11-01,0,0,2,0,0,2
VILLA CHARCAS,"anticoncepcion, prevencion de its y de cancer de cuello uterino",pildora: usuarias continuas,2015-11-01,0,1,3,3,0,7
VILLA MONTES,"anticoncepcion, prevencion de its y de cancer de cuello uterino",pildora: usuarias continuas,2015-11-01,0,2,21,4,0,27
VILLA NUEVA (LOMA ALTA),"anticoncepcion, prevencion de its y de cancer de cuello uterino",pildora: usuarias continuas,2015-11-01,0,1,2,0,0,3
VILLA RIVERO,"anticoncepcion, prevencion de its y de cancer de cuello uterino",pildora: usuarias continuas,2015-11-01,0,0,1,0,0,1
VILLA SERRANO,"anticoncepcion, prevencion de its y de cancer de cuello uterino",pildora: usuarias continuas,2015-11-01,0,0,3,1,0,4
VILLA TUNARI,"anticoncepcion, prevencion de its y de cancer de cuello uterino",pildora: usuarias continuas,2015-11-01,0,9,46,13,0,68
VILLA VACA GUZMAN (MUYUPAMPA),"anticoncepcion, prevencion de its y de cancer de cuello uterino",pildora: usuarias continuas,2015-11-01,0,3,2,2,1,8
VILLAZON,"anticoncepcion, prevencion de its y de cancer de cuello uterino",pildora: usuarias continuas,2015-11-01,0,6,15,5,0,26
VINTO,"anticoncepcion, prevencion de its y de cancer de cuello uterino",pildora: usuarias continuas,2015-11-01,0,0,6,1,0,7
VITICHI,"anticoncepcion, prevencion de its y de cancer de cuello uterino",pildora: usuarias continuas,2015-11-01,0,0,2,1,0,3
WALDO BALLIVIAN,"anticoncepcion, prevencion de its y de cancer de cuello uterino",pildora: usuarias continuas,2015-11-01,0,0,1,1,0,2
WARNES,"anticoncepcion, prevencion de its y de cancer de cuello uterino",pildora: usuarias continuas,2015-11-01,0,7,62,25,1,95
YACUIBA,"anticoncepcion, prevencion de its y de cancer de cuello uterino",pildora: usuarias continuas,2015-11-01,0,0,23,10,1,34
YANACACHI,"anticoncepcion, prevencion de its y de cancer de cuello uterino",pildora: usuarias continuas,2015-11-01,0,0,5,1,0,6
YAPACANI,"anticoncepcion, prevencion de its y de cancer de cuello uterino",pildora: usuarias continuas,2015-11-01,0,5,18,3,0,26
YOCALLA,"anticoncepcion, prevencion de its y de cancer de cuello uterino",pildora: usuarias continuas,2015-11-01,0,0,1,0,0,1
YOTALA,"anticoncepcion, prevencion de its y de cancer de cuello uterino",pildora: usuarias continuas,2015-11-01,0,1,0,0,0,1
YUNCHARA,"anticoncepcion, prevencion de its y de cancer de cuello uterino",pildora: usuarias continuas,2015-11-01,0,1,3,1,0,5
ZUDAÑEZ,"anticoncepcion, prevencion de its y de cancer de cuello uterino",pildora: usuarias continuas,2015-11-01,0,0,0,1,0,1
ACACIO,"anticoncepcion, prevencion de its y de cancer de cuello uterino",pildora: usuarias continuas,2015-12-01,0,0,0,1,0,1
ACHACACHI,"anticoncepcion, prevencion de its y de cancer de cuello uterino",pildora: usuarias continuas,2015-12-01,0,0,3,1,0,4
ACHOCALLA,"anticoncepcion, prevencion de its y de cancer de cuello uterino",pildora: usuarias continuas,2015-12-01,0,5,7,1,0,13
AIQUILE,"anticoncepcion, prevencion de its y de cancer de cuello uterino",pildora: usuarias continuas,2015-12-01,0,0,7,3,0,10
ALCALA,"anticoncepcion, prevencion de its y de cancer de cuello uterino",pildora: usuarias continuas,2015-12-01,0,0,3,1,0,4
ALTO BENI,"anticoncepcion, prevencion de its y de cancer de cuello uterino",pildora: usuarias continuas,2015-12-01,0,1,9,2,0,12
ANCORAIMES,"anticoncepcion, prevencion de its y de cancer de cuello uterino",pildora: usuarias continuas,2015-12-01,0,0,1,2,0,3
ANDAMARCA,"anticoncepcion, prevencion de its y de cancer de cuello uterino",pildora: usuarias continuas,2015-12-01,0,0,1,0,0,1
ANTEQUERA,"anticoncepcion, prevencion de its y de cancer de cuello uterino",pildora: usuarias continuas,2015-12-01,0,0,2,1,0,3
APOLO,"anticoncepcion, prevencion de its y de cancer de cuello uterino",pildora: usuarias continuas,2015-12-01,0,0,6,1,0,7
ARAMPAMPA,"anticoncepcion, prevencion de its y de cancer de cuello uterino",pildora: usuarias continuas,2015-12-01,0,1,3,0,0,4
ARANI,"anticoncepcion, prevencion de its y de cancer de cuello uterino",pildora: usuarias continuas,2015-12-01,0,0,1,1,0,2
ARBIETO,"anticoncepcion, prevencion de its y de cancer de cuello uterino",pildora: usuarias continuas,2015-12-01,0,0,4,0,0,4
ARQUE,"anticoncepcion, prevencion de its y de cancer de cuello uterino",pildora: usuarias continuas,2015-12-01,0,0,2,1,0,3
ASCENCION DE GUARAYOS,"anticoncepcion, prevencion de its y de cancer de cuello uterino",pildora: usuarias continuas,2015-12-01,0,0,5,3,0,8
ATOCHA,"anticoncepcion, prevencion de its y de cancer de cuello uterino",pildora: usuarias continuas,2015-12-01,0,0,6,0,0,6
AUCAPATA,"anticoncepcion, prevencion de its y de cancer de cuello uterino",pildora: usuarias continuas,2015-12-01,0,0,0,2,0,2
AYATA,"anticoncepcion, prevencion de its y de cancer de cuello uterino",pildora: usuarias continuas,2015-12-01,0,0,0,3,1,4
AYO AYO,"anticoncepcion, prevencion de its y de cancer de cuello uterino",pildora: usuarias continuas,2015-12-01,0,1,0,1,0,2
AYOPAYA (V. DE INDEPENDENCIA),"anticoncepcion, prevencion de its y de cancer de cuello uterino",pildora: usuarias continuas,2015-12-01,0,2,2,3,0,7
AZURDUY,"anticoncepcion, prevencion de its y de cancer de cuello uterino",pildora: usuarias continuas,2015-12-01,0,1,5,2,0,8
BATALLAS,"anticoncepcion, prevencion de its y de cancer de cuello uterino",pildora: usuarias continuas,2015-12-01,0,1,3,0,0,4
BAURES,"anticoncepcion, prevencion de its y de cancer de cuello uterino",pildora: usuarias continuas,2015-12-01,0,1,5,1,0,7
BELLA FLOR,"anticoncepcion, prevencion de its y de cancer de cuello uterino",pildora: usuarias continuas,2015-12-01,0,3,3,3,0,9
BERMEJO,"anticoncepcion, prevencion de its y de cancer de cuello uterino",pildora: usuarias continuas,2015-12-01,0,3,11,8,2,24
BETANZOS,"anticoncepcion, prevencion de its y de cancer de cuello uterino",pildora: usuarias continuas,2015-12-01,0,0,2,2,0,4
BOLPEBRA,"anticoncepcion, prevencion de its y de cancer de cuello uterino",pildora: usuarias continuas,2015-12-01,0,1,1,1,0,3
BOYUIBE,"anticoncepcion, prevencion de its y de cancer de cuello uterino",pildora: usuarias continuas,2015-12-01,0,0,1,0,0,1
BUENA VISTA,"anticoncepcion, prevencion de its y de cancer de cuello uterino",pildora: usuarias continuas,2015-12-01,0,1,19,2,0,22
CABEZAS,"anticoncepcion, prevencion de its y de cancer de cuello uterino",pildora: usuarias continuas,2015-12-01,0,2,26,4,0,32
"CAIZA ""D""","anticoncepcion, prevencion de its y de cancer de cuello uterino",pildora: usuarias continuas,2015-12-01,0,0,2,1,0,3
CAJUATA,"anticoncepcion, prevencion de its y de cancer de cuello uterino",pildora: usuarias continuas,2015-12-01,0,0,0,1,0,1
CALAMARCA,"anticoncepcion, prevencion de its y de cancer de cuello uterino",pildora: usuarias continuas,2015-12-01,0,0,3,2,0,5
CAMIRI,"anticoncepcion, prevencion de its y de cancer de cuello uterino",pildora: usuarias continuas,2015-12-01,0,2,15,0,0,17
CAPINOTA,"anticoncepcion, prevencion de its y de cancer de cuello uterino",pildora: usuarias continuas,2015-12-01,0,0,2,1,0,3
CARACOLLO,"anticoncepcion, prevencion de its y de cancer de cuello uterino",pildora: usuarias continuas,2015-12-01,0,0,6,1,0,7
CARANAVI,"anticoncepcion, prevencion de its y de cancer de cuello uterino",pildora: usuarias continuas,2015-12-01,0,0,9,4,1,14
CARAPARI,"anticoncepcion, prevencion de its y de cancer de cuello uterino",pildora: usuarias continuas,2015-12-01,0,0,4,1,0,5
CARIPUYO,"anticoncepcion, prevencion de its y de cancer de cuello uterino",pildora: usuarias continuas,2015-12-01,0,0,0,1,0,1
CARMEN RIVERO TORREZ,"anticoncepcion, prevencion de its y de cancer de cuello uterino",pildora: usuarias continuas,2015-12-01,0,0,1,0,0,1
CATACORA,"anticoncepcion, prevencion de its y de cancer de cuello uterino",pildora: usuarias continuas,2015-12-01,0,0,1,0,0,1
CHALLAPATA,"anticoncepcion, prevencion de its y de cancer de cuello uterino",pildora: usuarias continuas,2015-12-01,0,1,3,0,0,4
CHAQUI,"anticoncepcion, prevencion de its y de cancer de cuello uterino",pildora: usuarias continuas,2015-12-01,0,0,0,1,0,1
CHARAGUA,"anticoncepcion, prevencion de its y de cancer de cuello uterino",pildora: usuarias continuas,2015-12-01,0,2,23,6,0,31
CHAYANTA,"anticoncepcion, prevencion de its y de cancer de cuello uterino",pildora: usuarias continuas,2015-12-01,0,0,5,4,0,9
CHIMORE,"anticoncepcion, prevencion de its y de cancer de cuello uterino",pildora: usuarias continuas,2015-12-01,1,1,8,4,0,14
CHIPAYA,"anticoncepcion, prevencion de its y de cancer de cuello uterino",pildora: usuarias continuas,2015-12-01,0,1,1,0,0,2
CHOQUE COTA,"anticoncepcion, prevencion de its y de cancer de cuello uterino",pildora: usuarias continuas,2015-12-01,0,1,0,0,0,1
CHUA COCANI,"anticoncepcion, prevencion de its y de cancer de cuello uterino",pildora: usuarias continuas,2015-12-01,0,0,1,0,0,1
CHULUMANI (V. DE LA LIBERTAD),"anticoncepcion, prevencion de its y de cancer de cuello uterino",pildora: usuarias continuas,2015-12-01,0,1,1,0,0,2
CHUMA,"anticoncepcion, prevencion de its y de cancer de cuello uterino",pildora: usuarias continuas,2015-12-01,0,0,3,6,0,9
CLIZA,"anticoncepcion, prevencion de its y de cancer de cuello uterino",pildora: usuarias continuas,2015-12-01,0,1,8,1,0,10
COBIJA,"anticoncepcion, prevencion de its y de cancer de cuello uterino",pildora: usuarias continuas,2015-12-01,0,1,40,8,0,49
COCAPATA,"anticoncepcion, prevencion de its y de cancer de cuello uterino",pildora: usuarias continuas,2015-12-01,0,0,5,1,0,6
COCHABAMBA,"anticoncepcion, prevencion de its y de cancer de cuello uterino",pildora: usuarias continuas,2015-12-01,0,8,96,28,0,132
COLCAPIRHUA,"anticoncepcion, prevencion de its y de cancer de cuello uterino",pildora: usuarias continuas,2015-12-01,0,2,4,0,0,6
"COLCHA ""K""","anticoncepcion, prevencion de its y de cancer de cuello uterino",pildora: usuarias continuas,2015-12-01,0,0,2,0,0,2
COLOMI,"anticoncepcion, prevencion de its y de cancer de cuello uterino",pildora: usuarias continuas,2015-12-01,0,1,4,1,0,6
COLPA BELGICA,"anticoncepcion, prevencion de its y de cancer de cuello uterino",pildora: usuarias continuas,2015-12-01,0,0,0,1,0,1
COLQUECHACA,"anticoncepcion, prevencion de its y de cancer de cuello uterino",pildora: usuarias continuas,2015-12-01,0,0,8,0,0,8
COLQUENCHA,"anticoncepcion, prevencion de its y de cancer de cuello uterino",pildora: usuarias continuas,2015-12-01,0,1,1,1,0,3
COMANCHE,"anticoncepcion, prevencion de its y de cancer de cuello uterino",pildora: usuarias continuas,2015-12-01,0,0,1,0,0,1
COMARAPA,"anticoncepcion, prevencion de its y de cancer de cuello uterino",pildora: usuarias continuas,2015-12-01,0,1,2,0,0,3
CONCEPCION,"anticoncepcion, prevencion de its y de cancer de cuello uterino",pildora: usuarias continuas,2015-12-01,0,0,3,0,0,3
COPACABANA,"anticoncepcion, prevencion de its y de cancer de cuello uterino",pildora: usuarias continuas,2015-12-01,0,0,1,0,0,1
CORIPATA,"anticoncepcion, prevencion de its y de cancer de cuello uterino",pildora: usuarias continuas,2015-12-01,0,3,2,0,0,5
COROICO,"anticoncepcion, prevencion de its y de cancer de cuello uterino",pildora: usuarias continuas,2015-12-01,0,1,1,5,0,7
CORQUE,"anticoncepcion, prevencion de its y de cancer de cuello uterino",pildora: usuarias continuas,2015-12-01,0,0,0,5,0,5
COTAGAITA,"anticoncepcion, prevencion de its y de cancer de cuello uterino",pildora: usuarias continuas,2015-12-01,1,0,4,3,0,8
COTOCA,"anticoncepcion, prevencion de its y de cancer de cuello uterino",pildora: usuarias continuas,2015-12-01,0,4,34,4,0,42
CUATRO CAÑADAS,"anticoncepcion, prevencion de its y de cancer de cuello uterino",pildora: usuarias continuas,2015-12-01,0,5,12,5,1,23
CUEVO,"anticoncepcion, prevencion de its y de cancer de cuello uterino",pildora: usuarias continuas,2015-12-01,0,1,3,2,0,6
CULPINA,"anticoncepcion, prevencion de its y de cancer de cuello uterino",pildora: usuarias continuas,2015-12-01,0,0,4,0,0,4
CURAHUARA DE CARANGAS,"anticoncepcion, prevencion de its y de cancer de cuello uterino",pildora: usuarias continuas,2015-12-01,0,0,1,0,0,1
DESAGUADERO,"anticoncepcion, prevencion de its y de cancer de cuello uterino",pildora: usuarias continuas,2015-12-01,0,0,1,1,0,2
EL ALTO,"anticoncepcion, prevencion de its y de cancer de cuello uterino",pildora: usuarias continuas,2015-12-01,0,16,116,48,0,180
EL CHORO,"anticoncepcion, prevencion de its y de cancer de cuello uterino",pildora: usuarias continuas,2015-12-01,0,0,1,0,0,1
EL PUENTE(STC),"anticoncepcion, prevencion de its y de cancer de cuello uterino",pildora: usuarias continuas,2015-12-01,0,3,12,3,0,18
EL PUENTE(TJA),"anticoncepcion, prevencion de its y de cancer de cuello uterino",pildora: usuarias continuas,2015-12-01,0,1,18,12,0,31
EL TORNO,"anticoncepcion, prevencion de its y de cancer de cuello uterino",pildora: usuarias continuas,2015-12-01,1,4,40,20,0,65
EL VILLAR,"anticoncepcion, prevencion de its y de cancer de cuello uterino",pildora: usuarias continuas,2015-12-01,0,1,2,0,0,3
ENTRE RIOS TRJ,"anticoncepcion, prevencion de its y de cancer de cuello uterino",pildora: usuarias continuas,2015-12-01,0,3,17,4,0,24
ENTRE RIOS CBBA,"anticoncepcion, prevencion de its y de cancer de cuello uterino",pildora: usuarias continuas,2015-12-01,0,1,7,3,0,11
FERNANDEZ ALONSO,"anticoncepcion, prevencion de its y de cancer de cuello uterino",pildora: usuarias continuas,2015-12-01,0,2,5,1,0,8
FILADELFIA,"anticoncepcion, prevencion de its y de cancer de cuello uterino",pildora: usuarias continuas,2015-12-01,0,2,7,2,0,11
GENERAL SAAVEDRA,"anticoncepcion, prevencion de its y de cancer de cuello uterino",pildora: usuarias continuas,2015-12-01,0,1,17,7,0,25
GRAL. J.J. PEREZ (CHARAZANI),"anticoncepcion, prevencion de its y de cancer de cuello uterino",pildora: usuarias continuas,2015-12-01,0,0,1,0,0,1
GUANAY,"anticoncepcion, prevencion de its y de cancer de cuello uterino",pildora: usuarias continuas,2015-12-01,0,0,2,0,0,2
GUAQUI,"anticoncepcion, prevencion de its y de cancer de cuello uterino",pildora: usuarias continuas,2015-12-01,0,0,1,0,0,1
GUAYARAMERIN,"anticoncepcion, prevencion de its y de cancer de cuello uterino",pildora: usuarias continuas,2015-12-01,1,0,2,0,0,3
GUTIERREZ,"anticoncepcion, prevencion de its y de cancer de cuello uterino",pildora: usuarias continuas,2015-12-01,0,0,1,3,0,4
HUACARETA,"anticoncepcion, prevencion de its y de cancer de cuello uterino",pildora: usuarias continuas,2015-12-01,0,1,6,4,0,11
HUACAYA (VILLA DE HUACAYA),"anticoncepcion, prevencion de its y de cancer de cuello uterino",pildora: usuarias continuas,2015-12-01,0,0,1,0,0,1
HUANUNI,"anticoncepcion, prevencion de its y de cancer de cuello uterino",pildora: usuarias continuas,2015-12-01,0,0,2,0,0,2
HUARACAJE,"anticoncepcion, prevencion de its y de cancer de cuello uterino",pildora: usuarias continuas,2015-12-01,0,2,20,5,0,27
HUATAJATA,"anticoncepcion, prevencion de its y de cancer de cuello uterino",pildora: usuarias continuas,2015-12-01,0,0,0,2,0,2
HUMANATA,"anticoncepcion, prevencion de its y de cancer de cuello uterino",pildora: usuarias continuas,2015-12-01,0,0,1,1,0,2
ICLA,"anticoncepcion, prevencion de its y de cancer de cuello uterino",pildora: usuarias continuas,2015-12-01,0,0,4,1,0,5
INCAHUASI,"anticoncepcion, prevencion de its y de cancer de cuello uterino",pildora: usuarias continuas,2015-12-01,0,1,6,1,0,8
IRUPANA (VILLA DE LANZA),"anticoncepcion, prevencion de its y de cancer de cuello uterino",pildora: usuarias continuas,2015-12-01,0,2,6,3,0,11
IXIAMAS,"anticoncepcion, prevencion de its y de cancer de cuello uterino",pildora: usuarias continuas,2015-12-01,0,0,1,2,0,3
LA ASUNTA,"anticoncepcion, prevencion de its y de cancer de cuello uterino",pildora: usuarias continuas,2015-12-01,0,2,17,8,0,27
LA GUARDIA,"anticoncepcion, prevencion de its y de cancer de cuello uterino",pildora: usuarias continuas,2015-12-01,0,1,12,5,0,18
LA PAZ,"anticoncepcion, prevencion de its y de cancer de cuello uterino",pildora: usuarias continuas,2015-12-01,0,1,59,29,0,89
LAGUNILLAS,"anticoncepcion, prevencion de its y de cancer de cuello uterino",pildora: usuarias continuas,2015-12-01,0,1,6,5,0,12
LAJA,"anticoncepcion, prevencion de its y de cancer de cuello uterino",pildora: usuarias continuas,2015-12-01,0,1,4,4,0,9
LAS CARRERAS,"anticoncepcion, prevencion de its y de cancer de cuello uterino",pildora: usuarias continuas,2015-12-01,0,0,0,1,0,1
LICOMA PAMPA,"anticoncepcion, prevencion de its y de cancer de cuello uterino",pildora: usuarias continuas,2015-12-01,0,0,0,1,0,1
LLALLAGUA,"anticoncepcion, prevencion de its y de cancer de cuello uterino",pildora: usuarias continuas,2015-12-01,0,0,3,0,0,3
LLICA,"anticoncepcion, prevencion de its y de cancer de cuello uterino",pildora: usuarias continuas,2015-12-01,0,0,2,0,0,2
LORETO,"anticoncepcion, prevencion de its y de cancer de cuello uterino",pildora: usuarias continuas,2015-12-01,0,0,3,4,0,7
LURIBAY,"anticoncepcion, prevencion de its y de cancer de cuello uterino",pildora: usuarias continuas,2015-12-01,0,0,2,0,1,3
MACHARETI,"anticoncepcion, prevencion de its y de cancer de cuello uterino",pildora: usuarias continuas,2015-12-01,1,0,9,3,0,13
MAGDALENA,"anticoncepcion, prevencion de its y de cancer de cuello uterino",pildora: usuarias continuas,2015-12-01,0,3,21,9,0,33
MAIRANA,"anticoncepcion, prevencion de its y de cancer de cuello uterino",pildora: usuarias continuas,2015-12-01,0,0,7,2,0,9
MAPIRI,"anticoncepcion, prevencion de its y de cancer de cuello uterino",pildora: usuarias continuas,2015-12-01,0,0,1,0,0,1
MECAPACA,"anticoncepcion, prevencion de its y de cancer de cuello uterino",pildora: usuarias continuas,2015-12-01,0,0,1,0,0,1
MINEROS,"anticoncepcion, prevencion de its y de cancer de cuello uterino",pildora: usuarias continuas,2015-12-01,0,1,10,1,0,12
MIZQUE,"anticoncepcion, prevencion de its y de cancer de cuello uterino",pildora: usuarias continuas,2015-12-01,0,0,5,2,0,7
MOCOMOCO,"anticoncepcion, prevencion de its y de cancer de cuello uterino",pildora: usuarias continuas,2015-12-01,0,0,1,0,0,1
MOJOCOYA,"anticoncepcion, prevencion de its y de cancer de cuello uterino",pildora: usuarias continuas,2015-12-01,0,0,1,0,0,1
MONTEAGUDO,"anticoncepcion, prevencion de its y de cancer de cuello uterino",pildora: usuarias continuas,2015-12-01,0,4,9,8,0,21
MONTERO,"anticoncepcion, prevencion de its y de cancer de cuello uterino",pildora: usuarias continuas,2015-12-01,3,9,49,14,0,75
MORO MORO,"anticoncepcion, prevencion de its y de cancer de cuello uterino",pildora: usuarias continuas,2015-12-01,0,0,5,4,0,9
MOROCHATA,"anticoncepcion, prevencion de its y de cancer de cuello uterino",pildora: usuarias continuas,2015-12-01,0,0,1,0,0,1
NACEBE (SANTA ROSA DEL ABUNA),"anticoncepcion, prevencion de its y de cancer de cuello uterino",pildora: usuarias continuas,2015-12-01,0,1,2,0,0,3
NUEVO MANOA (NUEVA ESPERANZA),"anticoncepcion, prevencion de its y de cancer de cuello uterino",pildora: usuarias continuas,2015-12-01,0,1,1,0,0,2
OCURI,"anticoncepcion, prevencion de its y de cancer de cuello uterino",pildora: usuarias continuas,2015-12-01,0,0,2,2,0,4
OKINAWA,"anticoncepcion, prevencion de its y de cancer de cuello uterino",pildora: usuarias continuas,2015-12-01,0,0,20,4,0,24
OMEREQUE,"anticoncepcion, prevencion de its y de cancer de cuello uterino",pildora: usuarias continuas,2015-12-01,0,0,1,0,0,1
ORURO,"anticoncepcion, prevencion de its y de cancer de cuello uterino",pildora: usuarias continuas,2015-12-01,0,5,90,34,0,129
PADCAYA,"anticoncepcion, prevencion de its y de cancer de cuello uterino",pildora: usuarias continuas,2015-12-01,0,1,19,10,0,30
PADILLA,"anticoncepcion, prevencion de its y de cancer de cuello uterino",pildora: usuarias continuas,2015-12-01,0,2,4,1,0,7
PAILON,"anticoncepcion, prevencion de its y de cancer de cuello uterino",pildora: usuarias continuas,2015-12-01,0,1,5,1,0,7
PALCA,"anticoncepcion, prevencion de its y de cancer de cuello uterino",pildora: usuarias continuas,2015-12-01,0,2,2,0,0,4
PALOS BLANCOS,"anticoncepcion, prevencion de its y de cancer de cuello uterino",pildora: usuarias continuas,2015-12-01,0,0,19,6,0,25
PAMPA AULLAGAS,"anticoncepcion, prevencion de its y de cancer de cuello uterino",pildora: usuarias continuas,2015-12-01,0,0,1,0,0,1
PAMPA GRANDE,"anticoncepcion, prevencion de its y de cancer de cuello uterino",pildora: usuarias continuas,2015-12-01,0,2,3,4,0,9
PAPEL PAMPA,"anticoncepcion, prevencion de its y de cancer de cuello uterino",pildora: usuarias continuas,2015-12-01,0,0,1,2,0,3
PASORAPA,"anticoncepcion, prevencion de its y de cancer de cuello uterino",pildora: usuarias continuas,2015-12-01,0,0,3,2,0,5
PATACAMAYA,"anticoncepcion, prevencion de its y de cancer de cuello uterino",pildora: usuarias continuas,2015-12-01,0,0,1,0,0,1
PAZÑA,"anticoncepcion, prevencion de its y de cancer de cuello uterino",pildora: usuarias continuas,2015-12-01,0,0,2,2,0,4
PELECHUCO,"anticoncepcion, prevencion de its y de cancer de cuello uterino",pildora: usuarias continuas,2015-12-01,0,1,8,2,0,11
POCOATA,"anticoncepcion, prevencion de its y de cancer de cuello uterino",pildora: usuarias continuas,2015-12-01,0,0,2,1,0,3
POCONA,"anticoncepcion, prevencion de its y de cancer de cuello uterino",pildora: usuarias continuas,2015-12-01,0,0,9,1,0,10
POJO (CBBA),"anticoncepcion, prevencion de its y de cancer de cuello uterino",pildora: usuarias continuas,2015-12-01,0,0,4,3,0,7
POROMA,"anticoncepcion, prevencion de its y de cancer de cuello uterino",pildora: usuarias continuas,2015-12-01,0,0,1,4,0,5
PORONGO,"anticoncepcion, prevencion de its y de cancer de cuello uterino",pildora: usuarias continuas,2015-12-01,0,1,4,2,0,7
PORTACHUELO,"anticoncepcion, prevencion de its y de cancer de cuello uterino",pildora: usuarias continuas,2015-12-01,0,3,14,2,0,19
PORVENIR,"anticoncepcion, prevencion de its y de cancer de cuello uterino",pildora: usuarias continuas,2015-12-01,0,1,14,1,0,16
POSTRER VALLE,"anticoncepcion, prevencion de its y de cancer de cuello uterino",pildora: usuarias continuas,2015-12-01,0,0,1,2,0,3
POTOSI,"anticoncepcion, prevencion de its y de cancer de cuello uterino",pildora: usuarias continuas,2015-12-01,0,3,228,35,0,266
PUCARA,"anticoncepcion, prevencion de its y de cancer de cuello uterino",pildora: usuarias continuas,2015-12-01,0,0,3,1,0,4
PUCARANI,"anticoncepcion, prevencion de its y de cancer de cuello uterino",pildora: usuarias continuas,2015-12-01,0,0,6,0,1,7
PUERTO GONZALO MORENO,"anticoncepcion, prevencion de its y de cancer de cuello uterino",pildora: usuarias continuas,2015-12-01,0,0,5,3,0,8
PUERTO PEREZ,"anticoncepcion, prevencion de its y de cancer de cuello uterino",pildora: usuarias continuas,2015-12-01,0,0,1,0,0,1
PUERTO QUIJARRO,"anticoncepcion, prevencion de its y de cancer de cuello uterino",pildora: usuarias continuas,2015-12-01,0,3,8,4,0,15
PUERTO RICO,"anticoncepcion, prevencion de its y de cancer de cuello uterino",pildora: usuarias continuas,2015-12-01,0,1,7,4,0,12
PUERTO SILES,"anticoncepcion, prevencion de its y de cancer de cuello uterino",pildora: usuarias continuas,2015-12-01,0,1,5,0,0,6
PUERTO SUAREZ,"anticoncepcion, prevencion de its y de cancer de cuello uterino",pildora: usuarias continuas,2015-12-01,0,0,1,0,0,1
PUERTO VILLARROEL,"anticoncepcion, prevencion de its y de cancer de cuello uterino",pildora: usuarias continuas,2015-12-01,0,2,9,3,0,14
PUNA,"anticoncepcion, prevencion de its y de cancer de cuello uterino",pildora: usuarias continuas,2015-12-01,0,1,8,2,0,11
PUNATA,"anticoncepcion, prevencion de its y de cancer de cuello uterino",pildora: usuarias continuas,2015-12-01,0,2,7,1,0,10
QUIABAYA,"anticoncepcion, prevencion de its y de cancer de cuello uterino",pildora: usuarias continuas,2015-12-01,0,0,2,1,0,3
QUILLACOLLO,"anticoncepcion, prevencion de its y de cancer de cuello uterino",pildora: usuarias continuas,2015-12-01,0,1,8,0,0,9
QUIME,"anticoncepcion, prevencion de its y de cancer de cuello uterino",pildora: usuarias continuas,2015-12-01,0,1,8,0,0,9
QUIRUSILLAS,"anticoncepcion, prevencion de its y de cancer de cuello uterino",pildora: usuarias continuas,2015-12-01,0,2,3,3,1,9
RAVELO,"anticoncepcion, prevencion de its y de cancer de cuello uterino",pildora: usuarias continuas,2015-12-01,0,0,3,0,0,3
REYES,"anticoncepcion, prevencion de its y de cancer de cuello uterino",pildora: usuarias continuas,2015-12-01,0,2,17,4,0,23
RIBERALTA,"anticoncepcion, prevencion de its y de cancer de cuello uterino",pildora: usuarias continuas,2015-12-01,0,7,21,8,0,36
ROBORE,"anticoncepcion, prevencion de its y de cancer de cuello uterino",pildora: usuarias continuas,2015-12-01,0,2,15,1,0,18
RURRENABAQUE,"anticoncepcion, prevencion de its y de cancer de cuello uterino",pildora: usuarias continuas,2015-12-01,0,0,11,9,0,20
SACABA,"anticoncepcion, prevencion de its y de cancer de cuello uterino",pildora: usuarias continuas,2015-12-01,0,1,18,6,0,25
SACACA,"anticoncepcion, prevencion de its y de cancer de cuello uterino",pildora: usuarias continuas,2015-12-01,0,0,2,2,0,4
SAIPINA,"anticoncepcion, prevencion de its y de cancer de cuello uterino",pildora: usuarias continuas,2015-12-01,0,0,0,1,0,1
SALINAS DE GARCI MENDOZA,"anticoncepcion, prevencion de its y de cancer de cuello uterino",pildora: usuarias continuas,2015-12-01,0,0,4,2,0,6
SAMAIPATA,"anticoncepcion, prevencion de its y de cancer de cuello uterino",pildora: usuarias continuas,2015-12-01,0,1,10,2,0,13
SAN AGUSTIN,"anticoncepcion, prevencion de its y de cancer de cuello uterino",pildora: usuarias continuas,2015-12-01,0,0,2,1,0,3
SAN ANDRES,"anticoncepcion, prevencion de its y de cancer de cuello uterino",pildora: usuarias continuas,2015-12-01,0,3,12,6,0,21
SAN ANTONIO DE LOMERIO,"anticoncepcion, prevencion de its y de cancer de cuello uterino",pildora: usuarias continuas,2015-12-01,0,1,13,6,0,20
SAN BORJA,"anticoncepcion, prevencion de its y de cancer de cuello uterino",pildora: usuarias continuas,2015-12-01,0,7,47,30,0,84
SAN BUENA VENTURA,"anticoncepcion, prevencion de its y de cancer de cuello uterino",pildora: usuarias continuas,2015-12-01,0,0,1,0,0,1
SAN CARLOS,"anticoncepcion, prevencion de its y de cancer de cuello uterino",pildora: usuarias continuas,2015-12-01,0,1,18,8,0,27
SAN IGNACIO,"anticoncepcion, prevencion de its y de cancer de cuello uterino",pildora: usuarias continuas,2015-12-01,0,13,64,35,1,113
SAN IGNACIO DE VELASCO,"anticoncepcion, prevencion de its y de cancer de cuello uterino",pildora: usuarias continuas,2015-12-01,0,6,33,8,0,47
SAN JAVIER(BNI),"anticoncepcion, prevencion de its y de cancer de cuello uterino",pildora: usuarias continuas,2015-12-01,0,0,0,1,0,1
SAN JAVIER(STC),"anticoncepcion, prevencion de its y de cancer de cuello uterino",pildora: usuarias continuas,2015-12-01,1,4,12,12,0,29
SAN JOAQUIN,"anticoncepcion, prevencion de its y de cancer de cuello uterino",pildora: usuarias continuas,2015-12-01,0,1,0,2,0,3
SAN JOSE DE CHIQUITOS,"anticoncepcion, prevencion de its y de cancer de cuello uterino",pildora: usuarias continuas,2015-12-01,0,1,11,8,1,21
SAN JUAN DE YAPACANI,"anticoncepcion, prevencion de its y de cancer de cuello uterino",pildora: usuarias continuas,2015-12-01,0,1,6,2,0,9
SAN JULIAN,"anticoncepcion, prevencion de its y de cancer de cuello uterino",pildora: usuarias continuas,2015-12-01,0,2,12,5,1,20
SAN LORENZO(PND),"anticoncepcion, prevencion de its y de cancer de cuello uterino",pildora: usuarias continuas,2015-12-01,0,0,1,0,0,1
SAN LORENZO(TJA),"anticoncepcion, prevencion de its y de cancer de cuello uterino",pildora: usuarias continuas,2015-12-01,0,1,15,4,0,20
SAN LUCAS,"anticoncepcion, prevencion de its y de cancer de cuello uterino",pildora: usuarias continuas,2015-12-01,0,0,6,5,0,11
SAN MATIAS,"anticoncepcion, prevencion de its y de cancer de cuello uterino",pildora: usuarias continuas,2015-12-01,0,1,13,4,0,18
SAN MIGUEL DE VELASCO,"anticoncepcion, prevencion de its y de cancer de cuello uterino",pildora: usuarias continuas,2015-12-01,0,3,22,8,0,33
SAN PEDRO,"anticoncepcion, prevencion de its y de cancer de cuello uterino",pildora: usuarias continuas,2015-12-01,0,1,13,9,0,23
SAN PEDRO DE BUENA VISTA,"anticoncepcion, prevencion de its y de cancer de cuello uterino",pildora: usuarias continuas,2015-12-01,0,0,8,2,0,10
SAN PEDRO DE CURAHUARA,"anticoncepcion, prevencion de its y de cancer de cuello uterino",pildora: usuarias continuas,2015-12-01,0,0,1,0,0,1
SAN PEDRO DE QUEMES,"anticoncepcion, prevencion de its y de cancer de cuello uterino",pildora: usuarias continuas,2015-12-01,0,0,1,0,0,1
SAN RAFAEL,"anticoncepcion, prevencion de its y de cancer de cuello uterino",pildora: usuarias continuas,2015-12-01,0,5,22,6,0,33
SAN RAMON BENI,"anticoncepcion, prevencion de its y de cancer de cuello uterino",pildora: usuarias continuas,2015-12-01,0,1,5,3,0,9
SAN RAMON SCZ,"anticoncepcion, prevencion de its y de cancer de cuello uterino",pildora: usuarias continuas,2015-12-01,0,1,5,3,0,9
SANTA ANA,"anticoncepcion, prevencion de its y de cancer de cuello uterino",pildora: usuarias continuas,2015-12-01,0,4,30,9,1,44
SANTA CRUZ DE LA SIERRA,"anticoncepcion, prevencion de its y de cancer de cuello uterino",pildora: usuarias continuas,2015-12-01,0,12,84,32,2,130
SANTA ROSA,"anticoncepcion, prevencion de its y de cancer de cuello uterino",pildora: usuarias continuas,2015-12-01,0,0,19,7,1,27
SANTA ROSA DEL SARA,"anticoncepcion, prevencion de its y de cancer de cuello uterino",pildora: usuarias continuas,2015-12-01,0,0,23,6,0,29
SANTIAGO DE HUARI,"anticoncepcion, prevencion de its y de cancer de cuello uterino",pildora: usuarias continuas,2015-12-01,0,0,1,2,0,3
SANTIVAÑES,"anticoncepcion, prevencion de its y de cancer de cuello uterino",pildora: usuarias continuas,2015-12-01,0,0,4,1,0,5
SAPAHAQUI,"anticoncepcion, prevencion de its y de cancer de cuello uterino",pildora: usuarias continuas,2015-12-01,0,0,0,2,0,2
SENA,"anticoncepcion, prevencion de its y de cancer de cuello uterino",pildora: usuarias continuas,2015-12-01,0,2,2,2,0,6
SHINAOTA,"anticoncepcion, prevencion de its y de cancer de cuello uterino",pildora: usuarias continuas,2015-12-01,0,2,2,3,0,7
SICA SICA (VILLA AROMA),"anticoncepcion, prevencion de its y de cancer de cuello uterino",pildora: usuarias continuas,2015-12-01,0,0,2,1,0,3
SIPE SIPE,"anticoncepcion, prevencion de its y de cancer de cuello uterino",pildora: usuarias continuas,2015-12-01,0,9,15,3,0,27
SOPACHUY,"anticoncepcion, prevencion de its y de cancer de cuello uterino",pildora: usuarias continuas,2015-12-01,0,0,2,3,0,5
SORACACHI,"anticoncepcion, prevencion de its y de cancer de cuello uterino",pildora: usuarias continuas,2015-12-01,0,1,1,0,0,2
SORATA,"anticoncepcion, prevencion de its y de cancer de cuello uterino",pildora: usuarias continuas,2015-12-01,0,0,2,1,0,3
SUCRE,"anticoncepcion, prevencion de its y de cancer de cuello uterino",pildora: usuarias continuas,2015-12-01,0,5,77,21,0,103
TACACOMA,"anticoncepcion, prevencion de its y de cancer de cuello uterino",pildora: usuarias continuas,2015-12-01,0,0,3,0,0,3
TAPACARI,"anticoncepcion, prevencion de its y de cancer de cuello uterino",pildora: usuarias continuas,2015-12-01,0,0,1,0,0,1
TARABUCO,"anticoncepcion, prevencion de its y de cancer de cuello uterino",pildora: usuarias continuas,2015-12-01,0,0,2,0,0,2
TARACO,"anticoncepcion, prevencion de its y de cancer de cuello uterino",pildora: usuarias continuas,2015-12-01,0,0,0,1,0,1
TARATA,"anticoncepcion, prevencion de its y de cancer de cuello uterino",pildora: usuarias continuas,2015-12-01,0,0,2,0,0,2
TARIJA,"anticoncepcion, prevencion de its y de cancer de cuello uterino",pildora: usuarias continuas,2015-12-01,0,5,42,15,0,62
TARVITA,"anticoncepcion, prevencion de its y de cancer de cuello uterino",pildora: usuarias continuas,2015-12-01,0,1,1,4,0,6
TEOPONTE,"anticoncepcion, prevencion de its y de cancer de cuello uterino",pildora: usuarias continuas,2015-12-01,0,0,0,2,0,2
TIAWANACU,"anticoncepcion, prevencion de its y de cancer de cuello uterino",pildora: usuarias continuas,2015-12-01,0,2,2,0,0,4
TIPUANI,"anticoncepcion, prevencion de its y de cancer de cuello uterino",pildora: usuarias continuas,2015-12-01,0,0,3,1,0,4
TIQUIPAYA,"anticoncepcion, prevencion de its y de cancer de cuello uterino",pildora: usuarias continuas,2015-12-01,0,3,12,6,0,21
TIRAQUE (CBBA),"anticoncepcion, prevencion de its y de cancer de cuello uterino",pildora: usuarias continuas,2015-12-01,0,0,5,1,0,6
TOCO,"anticoncepcion, prevencion de its y de cancer de cuello uterino",pildora: usuarias continuas,2015-12-01,0,0,1,0,0,1
TOLATA,"anticoncepcion, prevencion de its y de cancer de cuello uterino",pildora: usuarias continuas,2015-12-01,0,0,0,1,0,1
TOMAVE,"anticoncepcion, prevencion de its y de cancer de cuello uterino",pildora: usuarias continuas,2015-12-01,0,2,2,0,0,4
TOMINA,"anticoncepcion, prevencion de its y de cancer de cuello uterino",pildora: usuarias continuas,2015-12-01,0,1,3,1,0,5
TOTORA(CBBA),"anticoncepcion, prevencion de its y de cancer de cuello uterino",pildora: usuarias continuas,2015-12-01,0,0,1,1,0,2
TOTORA(ORR),"anticoncepcion, prevencion de its y de cancer de cuello uterino",pildora: usuarias continuas,2015-12-01,0,1,1,0,0,2
TRIGAL,"anticoncepcion, prevencion de its y de cancer de cuello uterino",pildora: usuarias continuas,2015-12-01,0,0,2,3,0,5
TRINIDAD,"anticoncepcion, prevencion de its y de cancer de cuello uterino",pildora: usuarias continuas,2015-12-01,0,2,114,48,0,164
TUPIZA,"anticoncepcion, prevencion de its y de cancer de cuello uterino",pildora: usuarias continuas,2015-12-01,0,0,1,0,0,1
UNCIA,"anticoncepcion, prevencion de its y de cancer de cuello uterino",pildora: usuarias continuas,2015-12-01,0,0,5,1,0,6
URIONDO (A. CONCEPCION),"anticoncepcion, prevencion de its y de cancer de cuello uterino",pildora: usuarias continuas,2015-12-01,0,3,18,6,0,27
UYUNI,"anticoncepcion, prevencion de its y de cancer de cuello uterino",pildora: usuarias continuas,2015-12-01,0,1,8,3,0,12
VACAS,"anticoncepcion, prevencion de its y de cancer de cuello uterino",pildora: usuarias continuas,2015-12-01,0,0,0,2,0,2
VALLEGRANDE,"anticoncepcion, prevencion de its y de cancer de cuello uterino",pildora: usuarias continuas,2015-12-01,0,0,14,2,0,16
VIACHA,"anticoncepcion, prevencion de its y de cancer de cuello uterino",pildora: usuarias continuas,2015-12-01,0,0,10,3,0,13
VILLA CHARCAS,"anticoncepcion, prevencion de its y de cancer de cuello uterino",pildora: usuarias continuas,2015-12-01,0,0,3,1,0,4
VILLA MONTES,"anticoncepcion, prevencion de its y de cancer de cuello uterino",pildora: usuarias continuas,2015-12-01,2,2,21,4,0,29
VILLA NUEVA (LOMA ALTA),"anticoncepcion, prevencion de its y de cancer de cuello uterino",pildora: usuarias continuas,2015-12-01,0,2,2,5,0,9
VILLA RIVERO,"anticoncepcion, prevencion de its y de cancer de cuello uterino",pildora: usuarias continuas,2015-12-01,0,0,1,0,0,1
VILLA SERRANO,"anticoncepcion, prevencion de its y de cancer de cuello uterino",pildora: usuarias continuas,2015-12-01,0,0,1,1,0,2
VILLA TUNARI,"anticoncepcion, prevencion de its y de cancer de cuello uterino",pildora: usuarias continuas,2015-12-01,0,5,32,9,0,46
VILLA VACA GUZMAN (MUYUPAMPA),"anticoncepcion, prevencion de its y de cancer de cuello uterino",pildora: usuarias continuas,2015-12-01,0,1,10,2,0,13
VILLAZON,"anticoncepcion, prevencion de its y de cancer de cuello uterino",pildora: usuarias continuas,2015-12-01,0,0,27,5,0,32
VINTO,"anticoncepcion, prevencion de its y de cancer de cuello uterino",pildora: usuarias continuas,2015-12-01,0,0,5,1,0,6
VITICHI,"anticoncepcion, prevencion de its y de cancer de cuello uterino",pildora: usuarias continuas,2015-12-01,0,0,3,0,0,3
WARNES,"anticoncepcion, prevencion de its y de cancer de cuello uterino",pildora: usuarias continuas,2015-12-01,0,5,56,22,0,83
YACO,"anticoncepcion, prevencion de its y de cancer de cuello uterino",pildora: usuarias continuas,2015-12-01,0,0,1,0,0,1
YACUIBA,"anticoncepcion, prevencion de its y de cancer de cuello uterino",pildora: usuarias continuas,2015-12-01,0,1,29,7,0,37
YAMPARAEZ,"anticoncepcion, prevencion de its y de cancer de cuello uterino",pildora: usuarias continuas,2015-12-01,0,0,0,2,0,2
YANACACHI,"anticoncepcion, prevencion de its y de cancer de cuello uterino",pildora: usuarias continuas,2015-12-01,0,0,5,0,0,5
YAPACANI,"anticoncepcion, prevencion de its y de cancer de cuello uterino",pildora: usuarias continuas,2015-12-01,0,1,19,5,0,25
YOCALLA,"anticoncepcion, prevencion de its y de cancer de cuello uterino",pildora: usuarias continuas,2015-12-01,0,1,1,0,0,2
YOTALA,"anticoncepcion, prevencion de its y de cancer de cuello uterino",pildora: usuarias continuas,2015-12-01,0,0,1,1,0,2
YUNCHARA,"anticoncepcion, prevencion de its y de cancer de cuello uterino",pildora: usuarias continuas,2015-12-01,0,0,5,0,0,5
ZUDAÑEZ,"anticoncepcion, prevencion de its y de cancer de cuello uterino",pildora: usuarias continuas,2015-12-01,0,1,3,0,0,4
