municipality,group,variable,month,Repetidas en personas de 60 años o más -Hombre,Repetidas en personas de 60 años o más -Mujer,TOTAL-H,TOTAL-M,TOTAL
ACACIO,consulta externa,repetidas en personas de 60 anos o mas,2007-01-01,0,4,0,4,4
ACHACACHI,consulta externa,repetidas en personas de 60 anos o mas,2007-01-01,39,30,39,30,69
ACHOCALLA,consulta externa,repetidas en personas de 60 anos o mas,2007-01-01,2,0,2,0,2
AIQUILE,consulta externa,repetidas en personas de 60 anos o mas,2007-01-01,49,55,49,55,104
ANCORAIMES,consulta externa,repetidas en personas de 60 anos o mas,2007-01-01,3,5,3,5,8
ANDAMARCA,consulta externa,repetidas en personas de 60 anos o mas,2007-01-01,9,5,9,5,14
ANZALDO,consulta externa,repetidas en personas de 60 anos o mas,2007-01-01,1,3,1,3,4
APOLO,consulta externa,repetidas en personas de 60 anos o mas,2007-01-01,2,11,2,11,13
ARANI,consulta externa,repetidas en personas de 60 anos o mas,2007-01-01,6,4,6,4,10
ARBIETO,consulta externa,repetidas en personas de 60 anos o mas,2007-01-01,4,8,4,8,12
ARQUE,consulta externa,repetidas en personas de 60 anos o mas,2007-01-01,0,1,0,1,1
ATOCHA,consulta externa,repetidas en personas de 60 anos o mas,2007-01-01,35,58,35,58,93
AUCAPATA,consulta externa,repetidas en personas de 60 anos o mas,2007-01-01,1,2,1,2,3
AYATA,consulta externa,repetidas en personas de 60 anos o mas,2007-01-01,1,1,1,1,2
AYO AYO,consulta externa,repetidas en personas de 60 anos o mas,2007-01-01,0,1,0,1,1
AYOPAYA (V. DE INDEPENDENCIA),consulta externa,repetidas en personas de 60 anos o mas,2007-01-01,5,8,5,8,13
BATALLAS,consulta externa,repetidas en personas de 60 anos o mas,2007-01-01,13,16,13,16,29
BAURES,consulta externa,repetidas en personas de 60 anos o mas,2007-01-01,0,1,0,1,1
BELEN DE ANDAMARCA,consulta externa,repetidas en personas de 60 anos o mas,2007-01-01,1,0,1,0,1
BELEN DE URMIRI,consulta externa,repetidas en personas de 60 anos o mas,2007-01-01,10,0,10,0,10
BERMEJO,consulta externa,repetidas en personas de 60 anos o mas,2007-01-01,53,56,53,56,109
BETANZOS,consulta externa,repetidas en personas de 60 anos o mas,2007-01-01,50,72,50,72,122
BOLIVAR,consulta externa,repetidas en personas de 60 anos o mas,2007-01-01,0,2,0,2,2
BOLPEBRA,consulta externa,repetidas en personas de 60 anos o mas,2007-01-01,1,0,1,0,1
BOYUIBE,consulta externa,repetidas en personas de 60 anos o mas,2007-01-01,10,15,10,15,25
BUENA VISTA,consulta externa,repetidas en personas de 60 anos o mas,2007-01-01,51,23,51,23,74
CABEZAS,consulta externa,repetidas en personas de 60 anos o mas,2007-01-01,4,2,4,2,6
CAIROMA,consulta externa,repetidas en personas de 60 anos o mas,2007-01-01,12,2,12,2,14
"CAIZA ""D""",consulta externa,repetidas en personas de 60 anos o mas,2007-01-01,0,5,0,5,5
CAJUATA,consulta externa,repetidas en personas de 60 anos o mas,2007-01-01,5,5,5,5,10
CALACOTO,consulta externa,repetidas en personas de 60 anos o mas,2007-01-01,4,6,4,6,10
CALAMARCA,consulta externa,repetidas en personas de 60 anos o mas,2007-01-01,3,1,3,1,4
CAMARGO,consulta externa,repetidas en personas de 60 anos o mas,2007-01-01,12,21,12,21,33
CAMATAQUI (C. VILLA ABECIA),consulta externa,repetidas en personas de 60 anos o mas,2007-01-01,7,9,7,9,16
CAMIRI,consulta externa,repetidas en personas de 60 anos o mas,2007-01-01,54,98,54,98,152
CAPINOTA,consulta externa,repetidas en personas de 60 anos o mas,2007-01-01,23,23,23,23,46
CAQUIAVIRI,consulta externa,repetidas en personas de 60 anos o mas,2007-01-01,2,1,2,1,3
CARACOLLO,consulta externa,repetidas en personas de 60 anos o mas,2007-01-01,9,13,9,13,22
CARANAVI,consulta externa,repetidas en personas de 60 anos o mas,2007-01-01,30,16,30,16,46
CHALLAPATA,consulta externa,repetidas en personas de 60 anos o mas,2007-01-01,7,4,7,4,11
CHAQUI,consulta externa,repetidas en personas de 60 anos o mas,2007-01-01,0,2,0,2,2
CHARAGUA,consulta externa,repetidas en personas de 60 anos o mas,2007-01-01,7,2,7,2,9
CHARAÑA,consulta externa,repetidas en personas de 60 anos o mas,2007-01-01,1,1,1,1,2
CHAYANTA,consulta externa,repetidas en personas de 60 anos o mas,2007-01-01,2,8,2,8,10
CHIMORE,consulta externa,repetidas en personas de 60 anos o mas,2007-01-01,2,0,2,0,2
CHIPAYA,consulta externa,repetidas en personas de 60 anos o mas,2007-01-01,0,3,0,3,3
CHOQUE COTA,consulta externa,repetidas en personas de 60 anos o mas,2007-01-01,1,0,1,0,1
CHULUMANI (V. DE LA LIBERTAD),consulta externa,repetidas en personas de 60 anos o mas,2007-01-01,16,13,16,13,29
CHUMA,consulta externa,repetidas en personas de 60 anos o mas,2007-01-01,4,4,4,4,8
CLIZA,consulta externa,repetidas en personas de 60 anos o mas,2007-01-01,10,10,10,10,20
COBIJA,consulta externa,repetidas en personas de 60 anos o mas,2007-01-01,26,47,26,47,73
COCHABAMBA,consulta externa,repetidas en personas de 60 anos o mas,2007-01-01,5620,6908,5620,6908,12528
COLCAPIRHUA,consulta externa,repetidas en personas de 60 anos o mas,2007-01-01,2,8,2,8,10
"COLCHA ""K""",consulta externa,repetidas en personas de 60 anos o mas,2007-01-01,8,5,8,5,13
COLLANA,consulta externa,repetidas en personas de 60 anos o mas,2007-01-01,4,3,4,3,7
COLOMI,consulta externa,repetidas en personas de 60 anos o mas,2007-01-01,2,1,2,1,3
COLPA BELGICA,consulta externa,repetidas en personas de 60 anos o mas,2007-01-01,12,12,12,12,24
COLQUECHACA,consulta externa,repetidas en personas de 60 anos o mas,2007-01-01,4,5,4,5,9
COLQUENCHA,consulta externa,repetidas en personas de 60 anos o mas,2007-01-01,3,7,3,7,10
COLQUIRI,consulta externa,repetidas en personas de 60 anos o mas,2007-01-01,25,30,25,30,55
COMANCHE,consulta externa,repetidas en personas de 60 anos o mas,2007-01-01,5,4,5,4,9
COMARAPA,consulta externa,repetidas en personas de 60 anos o mas,2007-01-01,6,13,6,13,19
COMBAYA,consulta externa,repetidas en personas de 60 anos o mas,2007-01-01,1,0,1,0,1
CONCEPCION,consulta externa,repetidas en personas de 60 anos o mas,2007-01-01,1,0,1,0,1
COPACABANA,consulta externa,repetidas en personas de 60 anos o mas,2007-01-01,2,0,2,0,2
CORIPATA,consulta externa,repetidas en personas de 60 anos o mas,2007-01-01,6,9,6,9,15
CORO CORO,consulta externa,repetidas en personas de 60 anos o mas,2007-01-01,0,4,0,4,4
COROICO,consulta externa,repetidas en personas de 60 anos o mas,2007-01-01,44,37,44,37,81
CORQUE,consulta externa,repetidas en personas de 60 anos o mas,2007-01-01,13,2,13,2,15
COTAGAITA,consulta externa,repetidas en personas de 60 anos o mas,2007-01-01,18,37,18,37,55
COTOCA,consulta externa,repetidas en personas de 60 anos o mas,2007-01-01,24,31,24,31,55
CUATRO CAÑADAS,consulta externa,repetidas en personas de 60 anos o mas,2007-01-01,4,3,4,3,7
CUCHUMUELA (V. G. VILLARROEL),consulta externa,repetidas en personas de 60 anos o mas,2007-01-01,4,2,4,2,6
CUEVO,consulta externa,repetidas en personas de 60 anos o mas,2007-01-01,3,2,3,2,5
CULPINA,consulta externa,repetidas en personas de 60 anos o mas,2007-01-01,1,1,1,1,2
CURAHUARA DE CARANGAS,consulta externa,repetidas en personas de 60 anos o mas,2007-01-01,0,1,0,1,1
DESAGUADERO,consulta externa,repetidas en personas de 60 anos o mas,2007-01-01,3,3,3,3,6
EL ALTO,consulta externa,repetidas en personas de 60 anos o mas,2007-01-01,665,759,665,759,1424
EL CHORO,consulta externa,repetidas en personas de 60 anos o mas,2007-01-01,2,0,2,0,2
EL PUENTE(TJA),consulta externa,repetidas en personas de 60 anos o mas,2007-01-01,33,9,33,9,42
EL TORNO,consulta externa,repetidas en personas de 60 anos o mas,2007-01-01,386,356,386,356,742
EL VILLAR,consulta externa,repetidas en personas de 60 anos o mas,2007-01-01,1,0,1,0,1
ENTRE RIOS,consulta externa,repetidas en personas de 60 anos o mas,2007-01-01,0,1,0,1,1
ENTRE RIOS,consulta externa,repetidas en personas de 60 anos o mas,2007-01-01,1,8,1,8,9
ESMERALDA,consulta externa,repetidas en personas de 60 anos o mas,2007-01-01,0,2,0,2,2
EUCALIPTUS,consulta externa,repetidas en personas de 60 anos o mas,2007-01-01,6,9,6,9,15
FERNANDEZ ALONSO,consulta externa,repetidas en personas de 60 anos o mas,2007-01-01,1,2,1,2,3
FILADELFIA,consulta externa,repetidas en personas de 60 anos o mas,2007-01-01,1,3,1,3,4
GENERAL SAAVEDRA,consulta externa,repetidas en personas de 60 anos o mas,2007-01-01,1,0,1,0,1
GRAL. J.J. PEREZ (CHARAZANI),consulta externa,repetidas en personas de 60 anos o mas,2007-01-01,0,1,0,1,1
GUANAY,consulta externa,repetidas en personas de 60 anos o mas,2007-01-01,3,3,3,3,6
GUAQUI,consulta externa,repetidas en personas de 60 anos o mas,2007-01-01,7,4,7,4,11
GUAYARAMERIN,consulta externa,repetidas en personas de 60 anos o mas,2007-01-01,134,192,134,192,326
GUTIERREZ,consulta externa,repetidas en personas de 60 anos o mas,2007-01-01,2,8,2,8,10
HUACARETA,consulta externa,repetidas en personas de 60 anos o mas,2007-01-01,8,6,8,6,14
HUACAYA (VILLA DE HUACAYA),consulta externa,repetidas en personas de 60 anos o mas,2007-01-01,2,1,2,1,3
HUACHACALLA,consulta externa,repetidas en personas de 60 anos o mas,2007-01-01,6,3,6,3,9
HUANUNI,consulta externa,repetidas en personas de 60 anos o mas,2007-01-01,124,92,124,92,216
HUARACAJE,consulta externa,repetidas en personas de 60 anos o mas,2007-01-01,2,0,2,0,2
HUAYLLAMARCA,consulta externa,repetidas en personas de 60 anos o mas,2007-01-01,1,0,1,0,1
ICLA,consulta externa,repetidas en personas de 60 anos o mas,2007-01-01,0,5,0,5,5
INCAHUASI,consulta externa,repetidas en personas de 60 anos o mas,2007-01-01,1,2,1,2,3
INGAVI (HUMAITA),consulta externa,repetidas en personas de 60 anos o mas,2007-01-01,0,2,0,2,2
INQUISIVI,consulta externa,repetidas en personas de 60 anos o mas,2007-01-01,5,3,5,3,8
IRUPANA (VILLA DE LANZA),consulta externa,repetidas en personas de 60 anos o mas,2007-01-01,7,5,7,5,12
IXIAMAS,consulta externa,repetidas en personas de 60 anos o mas,2007-01-01,10,5,10,5,15
JESUS DE MACHACA,consulta externa,repetidas en personas de 60 anos o mas,2007-01-01,17,12,17,12,29
LA GUARDIA,consulta externa,repetidas en personas de 60 anos o mas,2007-01-01,3,12,3,12,15
LA PAZ,consulta externa,repetidas en personas de 60 anos o mas,2007-01-01,10049,11663,10049,11663,21712
LAGUNILLAS,consulta externa,repetidas en personas de 60 anos o mas,2007-01-01,1,0,1,0,1
LAJA,consulta externa,repetidas en personas de 60 anos o mas,2007-01-01,3,5,3,5,8
LAS CARRERAS,consulta externa,repetidas en personas de 60 anos o mas,2007-01-01,5,2,5,2,7
LICOMA PAMPA,consulta externa,repetidas en personas de 60 anos o mas,2007-01-01,4,1,4,1,5
LLALLAGUA,consulta externa,repetidas en personas de 60 anos o mas,2007-01-01,40,38,40,38,78
LLICA,consulta externa,repetidas en personas de 60 anos o mas,2007-01-01,2,7,2,7,9
LORETO,consulta externa,repetidas en personas de 60 anos o mas,2007-01-01,7,7,7,7,14
LURIBAY,consulta externa,repetidas en personas de 60 anos o mas,2007-01-01,21,10,21,10,31
MACHACAMARCA,consulta externa,repetidas en personas de 60 anos o mas,2007-01-01,26,33,26,33,59
MACHARETI,consulta externa,repetidas en personas de 60 anos o mas,2007-01-01,5,11,5,11,16
MAGDALENA,consulta externa,repetidas en personas de 60 anos o mas,2007-01-01,49,86,49,86,135
MAPIRI,consulta externa,repetidas en personas de 60 anos o mas,2007-01-01,2,2,2,2,4
MECAPACA,consulta externa,repetidas en personas de 60 anos o mas,2007-01-01,3,6,3,6,9
MINEROS,consulta externa,repetidas en personas de 60 anos o mas,2007-01-01,0,3,0,3,3
MIZQUE,consulta externa,repetidas en personas de 60 anos o mas,2007-01-01,0,2,0,2,2
MOCOMOCO,consulta externa,repetidas en personas de 60 anos o mas,2007-01-01,8,3,8,3,11
MOJINETE,consulta externa,repetidas en personas de 60 anos o mas,2007-01-01,3,3,3,3,6
MOJOCOYA,consulta externa,repetidas en personas de 60 anos o mas,2007-01-01,2,3,2,3,5
MONTEAGUDO,consulta externa,repetidas en personas de 60 anos o mas,2007-01-01,83,122,83,122,205
MONTERO,consulta externa,repetidas en personas de 60 anos o mas,2007-01-01,561,632,561,632,1193
MORO MORO,consulta externa,repetidas en personas de 60 anos o mas,2007-01-01,5,2,5,2,7
MOROCHATA,consulta externa,repetidas en personas de 60 anos o mas,2007-01-01,13,22,13,22,35
NAZACARA DE PACAJES,consulta externa,repetidas en personas de 60 anos o mas,2007-01-01,0,1,0,1,1
OCURI,consulta externa,repetidas en personas de 60 anos o mas,2007-01-01,0,3,0,3,3
OKINAWA,consulta externa,repetidas en personas de 60 anos o mas,2007-01-01,15,17,15,17,32
OMEREQUE,consulta externa,repetidas en personas de 60 anos o mas,2007-01-01,1,1,1,1,2
ORURO,consulta externa,repetidas en personas de 60 anos o mas,2007-01-01,1441,1690,1441,1690,3131
PADCAYA,consulta externa,repetidas en personas de 60 anos o mas,2007-01-01,3,59,3,59,62
PADILLA,consulta externa,repetidas en personas de 60 anos o mas,2007-01-01,24,32,24,32,56
PAILON,consulta externa,repetidas en personas de 60 anos o mas,2007-01-01,1,0,1,0,1
PALCA,consulta externa,repetidas en personas de 60 anos o mas,2007-01-01,8,3,8,3,11
PALOS BLANCOS,consulta externa,repetidas en personas de 60 anos o mas,2007-01-01,3,3,3,3,6
PAMPA AULLAGAS,consulta externa,repetidas en personas de 60 anos o mas,2007-01-01,2,0,2,0,2
PAMPA GRANDE,consulta externa,repetidas en personas de 60 anos o mas,2007-01-01,1,2,1,2,3
PAPEL PAMPA,consulta externa,repetidas en personas de 60 anos o mas,2007-01-01,2,3,2,3,5
PATACAMAYA,consulta externa,repetidas en personas de 60 anos o mas,2007-01-01,0,1,0,1,1
PAZÑA,consulta externa,repetidas en personas de 60 anos o mas,2007-01-01,18,15,18,15,33
POCOATA,consulta externa,repetidas en personas de 60 anos o mas,2007-01-01,0,1,0,1,1
POCONA,consulta externa,repetidas en personas de 60 anos o mas,2007-01-01,0,15,0,15,15
POOPO,consulta externa,repetidas en personas de 60 anos o mas,2007-01-01,7,9,7,9,16
POROMA,consulta externa,repetidas en personas de 60 anos o mas,2007-01-01,1,2,1,2,3
PORTACHUELO,consulta externa,repetidas en personas de 60 anos o mas,2007-01-01,18,22,18,22,40
PORVENIR,consulta externa,repetidas en personas de 60 anos o mas,2007-01-01,3,1,3,1,4
POSTRER VALLE,consulta externa,repetidas en personas de 60 anos o mas,2007-01-01,4,0,4,0,4
POTOSI,consulta externa,repetidas en personas de 60 anos o mas,2007-01-01,987,1160,987,1160,2147
PUCARANI,consulta externa,repetidas en personas de 60 anos o mas,2007-01-01,6,5,6,5,11
PUERTO ACOSTA,consulta externa,repetidas en personas de 60 anos o mas,2007-01-01,20,7,20,7,27
PUERTO CARABUCO,consulta externa,repetidas en personas de 60 anos o mas,2007-01-01,3,4,3,4,7
PUERTO GONZALO MORENO,consulta externa,repetidas en personas de 60 anos o mas,2007-01-01,1,0,1,0,1
PUERTO PEREZ,consulta externa,repetidas en personas de 60 anos o mas,2007-01-01,4,2,4,2,6
PUERTO QUIJARRO,consulta externa,repetidas en personas de 60 anos o mas,2007-01-01,6,2,6,2,8
PUERTO RICO,consulta externa,repetidas en personas de 60 anos o mas,2007-01-01,1,0,1,0,1
PUERTO SUAREZ,consulta externa,repetidas en personas de 60 anos o mas,2007-01-01,7,18,7,18,25
PUERTO VILLARROEL,consulta externa,repetidas en personas de 60 anos o mas,2007-01-01,2,4,2,4,6
PUNA,consulta externa,repetidas en personas de 60 anos o mas,2007-01-01,8,6,8,6,14
PUNATA,consulta externa,repetidas en personas de 60 anos o mas,2007-01-01,133,138,133,138,271
QUIABAYA,consulta externa,repetidas en personas de 60 anos o mas,2007-01-01,1,1,1,1,2
QUILLACOLLO,consulta externa,repetidas en personas de 60 anos o mas,2007-01-01,307,481,307,481,788
RAVELO,consulta externa,repetidas en personas de 60 anos o mas,2007-01-01,0,2,0,2,2
REYES,consulta externa,repetidas en personas de 60 anos o mas,2007-01-01,32,35,32,35,67
RIBERALTA,consulta externa,repetidas en personas de 60 anos o mas,2007-01-01,23,33,23,33,56
ROBORE,consulta externa,repetidas en personas de 60 anos o mas,2007-01-01,20,26,20,26,46
RURRENABAQUE,consulta externa,repetidas en personas de 60 anos o mas,2007-01-01,104,82,104,82,186
SABAYA,consulta externa,repetidas en personas de 60 anos o mas,2007-01-01,8,3,8,3,11
SACABA,consulta externa,repetidas en personas de 60 anos o mas,2007-01-01,66,95,66,95,161
SACABAMBA,consulta externa,repetidas en personas de 60 anos o mas,2007-01-01,1,2,1,2,3
SACACA,consulta externa,repetidas en personas de 60 anos o mas,2007-01-01,1,1,1,1,2
SAIPINA,consulta externa,repetidas en personas de 60 anos o mas,2007-01-01,0,2,0,2,2
SALINAS DE GARCI MENDOZA,consulta externa,repetidas en personas de 60 anos o mas,2007-01-01,4,7,4,7,11
SAMAIPATA,consulta externa,repetidas en personas de 60 anos o mas,2007-01-01,0,2,0,2,2
SAN AGUSTIN,consulta externa,repetidas en personas de 60 anos o mas,2007-01-01,1,2,1,2,3
SAN ANDRES,consulta externa,repetidas en personas de 60 anos o mas,2007-01-01,2,4,2,4,6
SAN ANDRES DE MACHACA,consulta externa,repetidas en personas de 60 anos o mas,2007-01-01,3,7,3,7,10
SAN ANTONIO DE ESMORUCO,consulta externa,repetidas en personas de 60 anos o mas,2007-01-01,2,4,2,4,6
SAN ANTONIO DE LOMERIO,consulta externa,repetidas en personas de 60 anos o mas,2007-01-01,2,1,2,1,3
SAN BENITO,consulta externa,repetidas en personas de 60 anos o mas,2007-01-01,6,7,6,7,13
SAN BORJA,consulta externa,repetidas en personas de 60 anos o mas,2007-01-01,60,37,60,37,97
SAN BUENA VENTURA,consulta externa,repetidas en personas de 60 anos o mas,2007-01-01,29,79,29,79,108
SAN CARLOS,consulta externa,repetidas en personas de 60 anos o mas,2007-01-01,10,10,10,10,20
SAN IGNACIO,consulta externa,repetidas en personas de 60 anos o mas,2007-01-01,16,10,16,10,26
SAN IGNACIO DE VELASCO,consulta externa,repetidas en personas de 60 anos o mas,2007-01-01,75,93,75,93,168
SAN JAVIER(STC),consulta externa,repetidas en personas de 60 anos o mas,2007-01-01,18,12,18,12,30
SAN JOAQUIN,consulta externa,repetidas en personas de 60 anos o mas,2007-01-01,60,82,60,82,142
SAN JOSE DE CHIQUITOS,consulta externa,repetidas en personas de 60 anos o mas,2007-01-01,9,11,9,11,20
SAN JUAN DE YAPACANI,consulta externa,repetidas en personas de 60 anos o mas,2007-01-01,42,28,42,28,70
SAN JULIAN,consulta externa,repetidas en personas de 60 anos o mas,2007-01-01,3,8,3,8,11
SAN LORENZO(TJA),consulta externa,repetidas en personas de 60 anos o mas,2007-01-01,1,8,1,8,9
SAN LUCAS,consulta externa,repetidas en personas de 60 anos o mas,2007-01-01,1,7,1,7,8
SAN MATIAS,consulta externa,repetidas en personas de 60 anos o mas,2007-01-01,4,3,4,3,7
SAN MIGUEL DE VELASCO,consulta externa,repetidas en personas de 60 anos o mas,2007-01-01,85,111,85,111,196
SAN PABLO DE LIPEZ,consulta externa,repetidas en personas de 60 anos o mas,2007-01-01,1,5,1,5,6
SAN PEDRO,consulta externa,repetidas en personas de 60 anos o mas,2007-01-01,4,4,4,4,8
SAN PEDRO DE BUENA VISTA,consulta externa,repetidas en personas de 60 anos o mas,2007-01-01,0,1,0,1,1
SAN PEDRO DE CURAHUARA,consulta externa,repetidas en personas de 60 anos o mas,2007-01-01,13,6,13,6,19
SAN PEDRO DE TIQUINA,consulta externa,repetidas en personas de 60 anos o mas,2007-01-01,10,15,10,15,25
SAN RAFAEL,consulta externa,repetidas en personas de 60 anos o mas,2007-01-01,1,3,1,3,4
SAN RAMON,consulta externa,repetidas en personas de 60 anos o mas,2007-01-01,1,3,1,3,4
SANTA ANA,consulta externa,repetidas en personas de 60 anos o mas,2007-01-01,68,134,68,134,202
SANTA CRUZ DE LA SIERRA,consulta externa,repetidas en personas de 60 anos o mas,2007-01-01,2673,3783,2673,3783,6456
SANTA ROSA DEL SARA,consulta externa,repetidas en personas de 60 anos o mas,2007-01-01,19,12,19,12,31
SANTIAGO DE CALLAPA,consulta externa,repetidas en personas de 60 anos o mas,2007-01-01,6,3,6,3,9
SANTIAGO DE HUARI,consulta externa,repetidas en personas de 60 anos o mas,2007-01-01,10,32,10,32,42
SANTIAGO DE MACHACA,consulta externa,repetidas en personas de 60 anos o mas,2007-01-01,0,3,0,3,3
SANTIVAÑES,consulta externa,repetidas en personas de 60 anos o mas,2007-01-01,3,2,3,2,5
SANTUARIO DE QUILLACAS,consulta externa,repetidas en personas de 60 anos o mas,2007-01-01,0,11,0,11,11
SAPAHAQUI,consulta externa,repetidas en personas de 60 anos o mas,2007-01-01,0,2,0,2,2
SICA SICA (VILLA AROMA),consulta externa,repetidas en personas de 60 anos o mas,2007-01-01,2,2,2,2,4
SIPE SIPE,consulta externa,repetidas en personas de 60 anos o mas,2007-01-01,8,6,8,6,14
SOPACHUY,consulta externa,repetidas en personas de 60 anos o mas,2007-01-01,0,1,0,1,1
SORACACHI,consulta externa,repetidas en personas de 60 anos o mas,2007-01-01,2,1,2,1,3
SORATA,consulta externa,repetidas en personas de 60 anos o mas,2007-01-01,4,1,4,1,5
SUCRE,consulta externa,repetidas en personas de 60 anos o mas,2007-01-01,1185,1641,1185,1641,2826
TACACOMA,consulta externa,repetidas en personas de 60 anos o mas,2007-01-01,1,1,1,1,2
TACOPAYA,consulta externa,repetidas en personas de 60 anos o mas,2007-01-01,0,1,0,1,1
TAHUA,consulta externa,repetidas en personas de 60 anos o mas,2007-01-01,0,1,0,1,1
TAPACARI,consulta externa,repetidas en personas de 60 anos o mas,2007-01-01,0,2,0,2,2
TARABUCO,consulta externa,repetidas en personas de 60 anos o mas,2007-01-01,12,37,12,37,49
TARACO,consulta externa,repetidas en personas de 60 anos o mas,2007-01-01,4,6,4,6,10
TARATA,consulta externa,repetidas en personas de 60 anos o mas,2007-01-01,2,2,2,2,4
TARIJA,consulta externa,repetidas en personas de 60 anos o mas,2007-01-01,1376,2241,1376,2241,3617
TARVITA,consulta externa,repetidas en personas de 60 anos o mas,2007-01-01,3,6,3,6,9
TEOPONTE,consulta externa,repetidas en personas de 60 anos o mas,2007-01-01,8,4,8,4,12
TIAWANACU,consulta externa,repetidas en personas de 60 anos o mas,2007-01-01,5,1,5,1,6
TINGUIPAYA,consulta externa,repetidas en personas de 60 anos o mas,2007-01-01,0,1,0,1,1
TIPUANI,consulta externa,repetidas en personas de 60 anos o mas,2007-01-01,1,0,1,0,1
TIQUIPAYA,consulta externa,repetidas en personas de 60 anos o mas,2007-01-01,8,10,8,10,18
TIRAQUE (CBBA),consulta externa,repetidas en personas de 60 anos o mas,2007-01-01,22,23,22,23,45
TITO YUPANQUI (PARQUIPUJIO),consulta externa,repetidas en personas de 60 anos o mas,2007-01-01,3,4,3,4,7
TOLATA,consulta externa,repetidas en personas de 60 anos o mas,2007-01-01,1,0,1,0,1
TOLEDO,consulta externa,repetidas en personas de 60 anos o mas,2007-01-01,1,1,1,1,2
TOMAVE,consulta externa,repetidas en personas de 60 anos o mas,2007-01-01,2,1,2,1,3
TOMINA,consulta externa,repetidas en personas de 60 anos o mas,2007-01-01,8,7,8,7,15
TOTORA(CBBA),consulta externa,repetidas en personas de 60 anos o mas,2007-01-01,1,2,1,2,3
TOTORA(ORR),consulta externa,repetidas en personas de 60 anos o mas,2007-01-01,1,0,1,0,1
TRIGAL,consulta externa,repetidas en personas de 60 anos o mas,2007-01-01,1,2,1,2,3
TRINIDAD,consulta externa,repetidas en personas de 60 anos o mas,2007-01-01,215,242,215,242,457
TUPIZA,consulta externa,repetidas en personas de 60 anos o mas,2007-01-01,42,39,42,39,81
TURCO,consulta externa,repetidas en personas de 60 anos o mas,2007-01-01,2,1,2,1,3
UMALA,consulta externa,repetidas en personas de 60 anos o mas,2007-01-01,0,1,0,1,1
UNCIA,consulta externa,repetidas en personas de 60 anos o mas,2007-01-01,45,59,45,59,104
URIONDO (A. CONCEPCION),consulta externa,repetidas en personas de 60 anos o mas,2007-01-01,2,2,2,2,4
URUBICHA,consulta externa,repetidas en personas de 60 anos o mas,2007-01-01,0,1,0,1,1
UYUNI,consulta externa,repetidas en personas de 60 anos o mas,2007-01-01,47,52,47,52,99
VACAS,consulta externa,repetidas en personas de 60 anos o mas,2007-01-01,4,15,4,15,19
VALLEGRANDE,consulta externa,repetidas en personas de 60 anos o mas,2007-01-01,171,225,171,225,396
VIACHA,consulta externa,repetidas en personas de 60 anos o mas,2007-01-01,147,182,147,182,329
VILA VILA,consulta externa,repetidas en personas de 60 anos o mas,2007-01-01,0,2,0,2,2
VILLA MONTES,consulta externa,repetidas en personas de 60 anos o mas,2007-01-01,87,56,87,56,143
VILLA NUEVA (LOMA ALTA),consulta externa,repetidas en personas de 60 anos o mas,2007-01-01,1,1,1,1,2
VILLA RIVERO,consulta externa,repetidas en personas de 60 anos o mas,2007-01-01,0,1,0,1,1
VILLA SERRANO,consulta externa,repetidas en personas de 60 anos o mas,2007-01-01,2,5,2,5,7
VILLA TUNARI,consulta externa,repetidas en personas de 60 anos o mas,2007-01-01,43,25,43,25,68
VILLA VACA GUZMAN (MUYUPAMPA),consulta externa,repetidas en personas de 60 anos o mas,2007-01-01,2,4,2,4,6
VILLAZON,consulta externa,repetidas en personas de 60 anos o mas,2007-01-01,58,83,58,83,141
VINTO,consulta externa,repetidas en personas de 60 anos o mas,2007-01-01,8,4,8,4,12
VITICHI,consulta externa,repetidas en personas de 60 anos o mas,2007-01-01,10,7,10,7,17
WALDO BALLIVIAN,consulta externa,repetidas en personas de 60 anos o mas,2007-01-01,0,4,0,4,4
WARNES,consulta externa,repetidas en personas de 60 anos o mas,2007-01-01,4,3,4,3,7
YACO,consulta externa,repetidas en personas de 60 anos o mas,2007-01-01,1,1,1,1,2
YACUIBA,consulta externa,repetidas en personas de 60 anos o mas,2007-01-01,257,311,257,311,568
YAMPARAEZ,consulta externa,repetidas en personas de 60 anos o mas,2007-01-01,2,4,2,4,6
YANACACHI,consulta externa,repetidas en personas de 60 anos o mas,2007-01-01,2,0,2,0,2
YAPACANI,consulta externa,repetidas en personas de 60 anos o mas,2007-01-01,2,1,2,1,3
YOCALLA,consulta externa,repetidas en personas de 60 anos o mas,2007-01-01,4,4,4,4,8
YOTALA,consulta externa,repetidas en personas de 60 anos o mas,2007-01-01,2,13,2,13,15
ZUDAÑEZ,consulta externa,repetidas en personas de 60 anos o mas,2007-01-01,3,6,3,6,9
ACACIO,consulta externa,repetidas en personas de 60 anos o mas,2007-02-01,11,0,11,0,11
ACHACACHI,consulta externa,repetidas en personas de 60 anos o mas,2007-02-01,18,21,18,21,39
ACHOCALLA,consulta externa,repetidas en personas de 60 anos o mas,2007-02-01,2,0,2,0,2
AIQUILE,consulta externa,repetidas en personas de 60 anos o mas,2007-02-01,28,65,28,65,93
ALCALA,consulta externa,repetidas en personas de 60 anos o mas,2007-02-01,0,2,0,2,2
ANCORAIMES,consulta externa,repetidas en personas de 60 anos o mas,2007-02-01,1,2,1,2,3
ANDAMARCA,consulta externa,repetidas en personas de 60 anos o mas,2007-02-01,2,4,2,4,6
ANTEQUERA,consulta externa,repetidas en personas de 60 anos o mas,2007-02-01,1,0,1,0,1
ANZALDO,consulta externa,repetidas en personas de 60 anos o mas,2007-02-01,0,1,0,1,1
APOLO,consulta externa,repetidas en personas de 60 anos o mas,2007-02-01,2,6,2,6,8
ARAMPAMPA,consulta externa,repetidas en personas de 60 anos o mas,2007-02-01,1,0,1,0,1
ARANI,consulta externa,repetidas en personas de 60 anos o mas,2007-02-01,0,4,0,4,4
ARBIETO,consulta externa,repetidas en personas de 60 anos o mas,2007-02-01,5,10,5,10,15
ARQUE,consulta externa,repetidas en personas de 60 anos o mas,2007-02-01,1,6,1,6,7
ASCENCION DE GUARAYOS,consulta externa,repetidas en personas de 60 anos o mas,2007-02-01,0,1,0,1,1
ATOCHA,consulta externa,repetidas en personas de 60 anos o mas,2007-02-01,23,36,23,36,59
AUCAPATA,consulta externa,repetidas en personas de 60 anos o mas,2007-02-01,0,1,0,1,1
AYATA,consulta externa,repetidas en personas de 60 anos o mas,2007-02-01,1,1,1,1,2
AYO AYO,consulta externa,repetidas en personas de 60 anos o mas,2007-02-01,1,2,1,2,3
AYOPAYA (V. DE INDEPENDENCIA),consulta externa,repetidas en personas de 60 anos o mas,2007-02-01,2,4,2,4,6
BATALLAS,consulta externa,repetidas en personas de 60 anos o mas,2007-02-01,15,8,15,8,23
BAURES,consulta externa,repetidas en personas de 60 anos o mas,2007-02-01,5,6,5,6,11
BELEN DE URMIRI,consulta externa,repetidas en personas de 60 anos o mas,2007-02-01,0,4,0,4,4
BERMEJO,consulta externa,repetidas en personas de 60 anos o mas,2007-02-01,56,50,56,50,106
BETANZOS,consulta externa,repetidas en personas de 60 anos o mas,2007-02-01,40,56,40,56,96
BOLIVAR,consulta externa,repetidas en personas de 60 anos o mas,2007-02-01,2,0,2,0,2
BOLPEBRA,consulta externa,repetidas en personas de 60 anos o mas,2007-02-01,1,0,1,0,1
BOYUIBE,consulta externa,repetidas en personas de 60 anos o mas,2007-02-01,4,10,4,10,14
BUENA VISTA,consulta externa,repetidas en personas de 60 anos o mas,2007-02-01,79,43,79,43,122
CABEZAS,consulta externa,repetidas en personas de 60 anos o mas,2007-02-01,0,1,0,1,1
CAIROMA,consulta externa,repetidas en personas de 60 anos o mas,2007-02-01,7,2,7,2,9
"CAIZA ""D""",consulta externa,repetidas en personas de 60 anos o mas,2007-02-01,1,0,1,0,1
CAJUATA,consulta externa,repetidas en personas de 60 anos o mas,2007-02-01,3,3,3,3,6
CALACOTO,consulta externa,repetidas en personas de 60 anos o mas,2007-02-01,3,6,3,6,9
CALAMARCA,consulta externa,repetidas en personas de 60 anos o mas,2007-02-01,2,4,2,4,6
CAMARGO,consulta externa,repetidas en personas de 60 anos o mas,2007-02-01,10,14,10,14,24
CAMATAQUI (C. VILLA ABECIA),consulta externa,repetidas en personas de 60 anos o mas,2007-02-01,6,3,6,3,9
CAMIRI,consulta externa,repetidas en personas de 60 anos o mas,2007-02-01,58,74,58,74,132
CAPINOTA,consulta externa,repetidas en personas de 60 anos o mas,2007-02-01,2,5,2,5,7
CAQUIAVIRI,consulta externa,repetidas en personas de 60 anos o mas,2007-02-01,5,1,5,1,6
CARACOLLO,consulta externa,repetidas en personas de 60 anos o mas,2007-02-01,8,11,8,11,19
CARANAVI,consulta externa,repetidas en personas de 60 anos o mas,2007-02-01,24,11,24,11,35
CARAPARI,consulta externa,repetidas en personas de 60 anos o mas,2007-02-01,1,0,1,0,1
CATACORA,consulta externa,repetidas en personas de 60 anos o mas,2007-02-01,1,1,1,1,2
CHALLAPATA,consulta externa,repetidas en personas de 60 anos o mas,2007-02-01,6,1,6,1,7
CHAQUI,consulta externa,repetidas en personas de 60 anos o mas,2007-02-01,0,3,0,3,3
CHARAGUA,consulta externa,repetidas en personas de 60 anos o mas,2007-02-01,5,2,5,2,7
CHARAÑA,consulta externa,repetidas en personas de 60 anos o mas,2007-02-01,0,1,0,1,1
CHAYANTA,consulta externa,repetidas en personas de 60 anos o mas,2007-02-01,7,9,7,9,16
CHIMORE,consulta externa,repetidas en personas de 60 anos o mas,2007-02-01,1,0,1,0,1
CHOQUE COTA,consulta externa,repetidas en personas de 60 anos o mas,2007-02-01,0,2,0,2,2
CHULUMANI (V. DE LA LIBERTAD),consulta externa,repetidas en personas de 60 anos o mas,2007-02-01,19,12,19,12,31
CHUMA,consulta externa,repetidas en personas de 60 anos o mas,2007-02-01,7,7,7,7,14
CLIZA,consulta externa,repetidas en personas de 60 anos o mas,2007-02-01,4,7,4,7,11
COBIJA,consulta externa,repetidas en personas de 60 anos o mas,2007-02-01,11,12,11,12,23
COCHABAMBA,consulta externa,repetidas en personas de 60 anos o mas,2007-02-01,5637,7194,5637,7194,12831
COIPASA,consulta externa,repetidas en personas de 60 anos o mas,2007-02-01,0,1,0,1,1
COLCAPIRHUA,consulta externa,repetidas en personas de 60 anos o mas,2007-02-01,31,80,31,80,111
"COLCHA ""K""",consulta externa,repetidas en personas de 60 anos o mas,2007-02-01,13,13,13,13,26
COLLANA,consulta externa,repetidas en personas de 60 anos o mas,2007-02-01,2,4,2,4,6
COLOMI,consulta externa,repetidas en personas de 60 anos o mas,2007-02-01,2,2,2,2,4
COLPA BELGICA,consulta externa,repetidas en personas de 60 anos o mas,2007-02-01,30,16,30,16,46
COLQUECHACA,consulta externa,repetidas en personas de 60 anos o mas,2007-02-01,2,4,2,4,6
COLQUENCHA,consulta externa,repetidas en personas de 60 anos o mas,2007-02-01,1,1,1,1,2
COLQUIRI,consulta externa,repetidas en personas de 60 anos o mas,2007-02-01,130,14,130,14,144
COMANCHE,consulta externa,repetidas en personas de 60 anos o mas,2007-02-01,0,2,0,2,2
COMARAPA,consulta externa,repetidas en personas de 60 anos o mas,2007-02-01,1,9,1,9,10
CONCEPCION,consulta externa,repetidas en personas de 60 anos o mas,2007-02-01,0,5,0,5,5
CORIPATA,consulta externa,repetidas en personas de 60 anos o mas,2007-02-01,5,2,5,2,7
CORO CORO,consulta externa,repetidas en personas de 60 anos o mas,2007-02-01,1,0,1,0,1
COROICO,consulta externa,repetidas en personas de 60 anos o mas,2007-02-01,38,27,38,27,65
CORQUE,consulta externa,repetidas en personas de 60 anos o mas,2007-02-01,6,4,6,4,10
COTAGAITA,consulta externa,repetidas en personas de 60 anos o mas,2007-02-01,18,21,18,21,39
COTOCA,consulta externa,repetidas en personas de 60 anos o mas,2007-02-01,5,1,5,1,6
CUATRO CAÑADAS,consulta externa,repetidas en personas de 60 anos o mas,2007-02-01,5,1,5,1,6
CUCHUMUELA (V. G. VILLARROEL),consulta externa,repetidas en personas de 60 anos o mas,2007-02-01,1,3,1,3,4
CUEVO,consulta externa,repetidas en personas de 60 anos o mas,2007-02-01,1,1,1,1,2
CULPINA,consulta externa,repetidas en personas de 60 anos o mas,2007-02-01,0,3,0,3,3
CURAHUARA DE CARANGAS,consulta externa,repetidas en personas de 60 anos o mas,2007-02-01,0,1,0,1,1
CURVA,consulta externa,repetidas en personas de 60 anos o mas,2007-02-01,0,2,0,2,2
DESAGUADERO,consulta externa,repetidas en personas de 60 anos o mas,2007-02-01,2,8,2,8,10
EL ALTO,consulta externa,repetidas en personas de 60 anos o mas,2007-02-01,847,941,847,941,1788
EL CHORO,consulta externa,repetidas en personas de 60 anos o mas,2007-02-01,0,1,0,1,1
EL PUENTE(TJA),consulta externa,repetidas en personas de 60 anos o mas,2007-02-01,0,1,0,1,1
EL TORNO,consulta externa,repetidas en personas de 60 anos o mas,2007-02-01,12,18,12,18,30
ENTRE RIOS,consulta externa,repetidas en personas de 60 anos o mas,2007-02-01,5,11,5,11,16
ENTRE RIOS,consulta externa,repetidas en personas de 60 anos o mas,2007-02-01,5,1,5,1,6
EUCALIPTUS,consulta externa,repetidas en personas de 60 anos o mas,2007-02-01,13,9,13,9,22
EXALTACION,consulta externa,repetidas en personas de 60 anos o mas,2007-02-01,6,5,6,5,11
FERNANDEZ ALONSO,consulta externa,repetidas en personas de 60 anos o mas,2007-02-01,0,2,0,2,2
FILADELFIA,consulta externa,repetidas en personas de 60 anos o mas,2007-02-01,3,1,3,1,4
GENERAL SAAVEDRA,consulta externa,repetidas en personas de 60 anos o mas,2007-02-01,4,8,4,8,12
GRAL. J.J. PEREZ (CHARAZANI),consulta externa,repetidas en personas de 60 anos o mas,2007-02-01,2,1,2,1,3
GUANAY,consulta externa,repetidas en personas de 60 anos o mas,2007-02-01,2,2,2,2,4
GUAQUI,consulta externa,repetidas en personas de 60 anos o mas,2007-02-01,2,1,2,1,3
GUAYARAMERIN,consulta externa,repetidas en personas de 60 anos o mas,2007-02-01,203,168,203,168,371
HUACARETA,consulta externa,repetidas en personas de 60 anos o mas,2007-02-01,5,8,5,8,13
HUACHACALLA,consulta externa,repetidas en personas de 60 anos o mas,2007-02-01,4,3,4,3,7
HUANUNI,consulta externa,repetidas en personas de 60 anos o mas,2007-02-01,171,147,171,147,318
HUARACAJE,consulta externa,repetidas en personas de 60 anos o mas,2007-02-01,2,0,2,0,2
ICHOCA,consulta externa,repetidas en personas de 60 anos o mas,2007-02-01,2,0,2,0,2
ICLA,consulta externa,repetidas en personas de 60 anos o mas,2007-02-01,4,2,4,2,6
INCAHUASI,consulta externa,repetidas en personas de 60 anos o mas,2007-02-01,4,0,4,0,4
INQUISIVI,consulta externa,repetidas en personas de 60 anos o mas,2007-02-01,6,2,6,2,8
IRUPANA (VILLA DE LANZA),consulta externa,repetidas en personas de 60 anos o mas,2007-02-01,4,1,4,1,5
IXIAMAS,consulta externa,repetidas en personas de 60 anos o mas,2007-02-01,2,1,2,1,3
JESUS DE MACHACA,consulta externa,repetidas en personas de 60 anos o mas,2007-02-01,8,9,8,9,17
LA ASUNTA,consulta externa,repetidas en personas de 60 anos o mas,2007-02-01,5,0,5,0,5
LA GUARDIA,consulta externa,repetidas en personas de 60 anos o mas,2007-02-01,14,14,14,14,28
LA PAZ,consulta externa,repetidas en personas de 60 anos o mas,2007-02-01,9277,11144,9277,11144,20421
LAJA,consulta externa,repetidas en personas de 60 anos o mas,2007-02-01,19,5,19,5,24
LAS CARRERAS,consulta externa,repetidas en personas de 60 anos o mas,2007-02-01,7,10,7,10,17
LICOMA PAMPA,consulta externa,repetidas en personas de 60 anos o mas,2007-02-01,0,1,0,1,1
LLALLAGUA,consulta externa,repetidas en personas de 60 anos o mas,2007-02-01,30,37,30,37,67
LLICA,consulta externa,repetidas en personas de 60 anos o mas,2007-02-01,6,3,6,3,9
LORETO,consulta externa,repetidas en personas de 60 anos o mas,2007-02-01,8,10,8,10,18
LURIBAY,consulta externa,repetidas en personas de 60 anos o mas,2007-02-01,23,5,23,5,28
MACHACAMARCA,consulta externa,repetidas en personas de 60 anos o mas,2007-02-01,22,24,22,24,46
MACHARETI,consulta externa,repetidas en personas de 60 anos o mas,2007-02-01,7,9,7,9,16
MAGDALENA,consulta externa,repetidas en personas de 60 anos o mas,2007-02-01,42,52,42,52,94
MAIRANA,consulta externa,repetidas en personas de 60 anos o mas,2007-02-01,2,0,2,0,2
MALLA,consulta externa,repetidas en personas de 60 anos o mas,2007-02-01,0,2,0,2,2
MAPIRI,consulta externa,repetidas en personas de 60 anos o mas,2007-02-01,2,2,2,2,4
MECAPACA,consulta externa,repetidas en personas de 60 anos o mas,2007-02-01,8,3,8,3,11
MINEROS,consulta externa,repetidas en personas de 60 anos o mas,2007-02-01,3,0,3,0,3
MIZQUE,consulta externa,repetidas en personas de 60 anos o mas,2007-02-01,2,0,2,0,2
MOCOMOCO,consulta externa,repetidas en personas de 60 anos o mas,2007-02-01,5,4,5,4,9
MOJINETE,consulta externa,repetidas en personas de 60 anos o mas,2007-02-01,0,3,0,3,3
MOJOCOYA,consulta externa,repetidas en personas de 60 anos o mas,2007-02-01,0,2,0,2,2
MONTEAGUDO,consulta externa,repetidas en personas de 60 anos o mas,2007-02-01,77,73,77,73,150
MONTERO,consulta externa,repetidas en personas de 60 anos o mas,2007-02-01,272,564,272,564,836
MORO MORO,consulta externa,repetidas en personas de 60 anos o mas,2007-02-01,1,4,1,4,5
MOROCHATA,consulta externa,repetidas en personas de 60 anos o mas,2007-02-01,12,28,12,28,40
OKINAWA,consulta externa,repetidas en personas de 60 anos o mas,2007-02-01,5,3,5,3,8
OMEREQUE,consulta externa,repetidas en personas de 60 anos o mas,2007-02-01,1,0,1,0,1
ORURO,consulta externa,repetidas en personas de 60 anos o mas,2007-02-01,1228,1476,1228,1476,2704
PADCAYA,consulta externa,repetidas en personas de 60 anos o mas,2007-02-01,26,42,26,42,68
PADILLA,consulta externa,repetidas en personas de 60 anos o mas,2007-02-01,12,20,12,20,32
PALCA,consulta externa,repetidas en personas de 60 anos o mas,2007-02-01,2,1,2,1,3
PALOS BLANCOS,consulta externa,repetidas en personas de 60 anos o mas,2007-02-01,1,2,1,2,3
PAMPA AULLAGAS,consulta externa,repetidas en personas de 60 anos o mas,2007-02-01,1,0,1,0,1
PAMPA GRANDE,consulta externa,repetidas en personas de 60 anos o mas,2007-02-01,1,1,1,1,2
PAPEL PAMPA,consulta externa,repetidas en personas de 60 anos o mas,2007-02-01,1,0,1,0,1
PATACAMAYA,consulta externa,repetidas en personas de 60 anos o mas,2007-02-01,1,0,1,0,1
PAZÑA,consulta externa,repetidas en personas de 60 anos o mas,2007-02-01,13,14,13,14,27
POCOATA,consulta externa,repetidas en personas de 60 anos o mas,2007-02-01,5,2,5,2,7
POCONA,consulta externa,repetidas en personas de 60 anos o mas,2007-02-01,1,5,1,5,6
POOPO,consulta externa,repetidas en personas de 60 anos o mas,2007-02-01,6,8,6,8,14
PORCO,consulta externa,repetidas en personas de 60 anos o mas,2007-02-01,0,4,0,4,4
POROMA,consulta externa,repetidas en personas de 60 anos o mas,2007-02-01,1,3,1,3,4
PORTACHUELO,consulta externa,repetidas en personas de 60 anos o mas,2007-02-01,9,13,9,13,22
PORVENIR,consulta externa,repetidas en personas de 60 anos o mas,2007-02-01,1,0,1,0,1
POSTRER VALLE,consulta externa,repetidas en personas de 60 anos o mas,2007-02-01,1,4,1,4,5
POTOSI,consulta externa,repetidas en personas de 60 anos o mas,2007-02-01,207,1100,207,1100,1307
PRESTO,consulta externa,repetidas en personas de 60 anos o mas,2007-02-01,1,0,1,0,1
PUCARANI,consulta externa,repetidas en personas de 60 anos o mas,2007-02-01,9,7,9,7,16
PUERTO ACOSTA,consulta externa,repetidas en personas de 60 anos o mas,2007-02-01,19,6,19,6,25
PUERTO CARABUCO,consulta externa,repetidas en personas de 60 anos o mas,2007-02-01,7,5,7,5,12
PUERTO GONZALO MORENO,consulta externa,repetidas en personas de 60 anos o mas,2007-02-01,4,1,4,1,5
PUERTO QUIJARRO,consulta externa,repetidas en personas de 60 anos o mas,2007-02-01,4,3,4,3,7
PUERTO SILES,consulta externa,repetidas en personas de 60 anos o mas,2007-02-01,2,3,2,3,5
PUERTO SUAREZ,consulta externa,repetidas en personas de 60 anos o mas,2007-02-01,13,29,13,29,42
PUERTO VILLARROEL,consulta externa,repetidas en personas de 60 anos o mas,2007-02-01,10,4,10,4,14
PUNA,consulta externa,repetidas en personas de 60 anos o mas,2007-02-01,3,8,3,8,11
PUNATA,consulta externa,repetidas en personas de 60 anos o mas,2007-02-01,73,86,73,86,159
QUIABAYA,consulta externa,repetidas en personas de 60 anos o mas,2007-02-01,6,2,6,2,8
QUILLACOLLO,consulta externa,repetidas en personas de 60 anos o mas,2007-02-01,267,403,267,403,670
QUIME,consulta externa,repetidas en personas de 60 anos o mas,2007-02-01,2,0,2,0,2
QUIRUSILLAS,consulta externa,repetidas en personas de 60 anos o mas,2007-02-01,1,0,1,0,1
REYES,consulta externa,repetidas en personas de 60 anos o mas,2007-02-01,25,43,25,43,68
RIBERALTA,consulta externa,repetidas en personas de 60 anos o mas,2007-02-01,244,218,244,218,462
ROBORE,consulta externa,repetidas en personas de 60 anos o mas,2007-02-01,21,31,21,31,52
RURRENABAQUE,consulta externa,repetidas en personas de 60 anos o mas,2007-02-01,106,54,106,54,160
SABAYA,consulta externa,repetidas en personas de 60 anos o mas,2007-02-01,5,8,5,8,13
SACABA,consulta externa,repetidas en personas de 60 anos o mas,2007-02-01,77,109,77,109,186
SACABAMBA,consulta externa,repetidas en personas de 60 anos o mas,2007-02-01,4,6,4,6,10
SACACA,consulta externa,repetidas en personas de 60 anos o mas,2007-02-01,0,1,0,1,1
SALINAS DE GARCI MENDOZA,consulta externa,repetidas en personas de 60 anos o mas,2007-02-01,15,25,15,25,40
SAMAIPATA,consulta externa,repetidas en personas de 60 anos o mas,2007-02-01,3,0,3,0,3
SAN ANDRES,consulta externa,repetidas en personas de 60 anos o mas,2007-02-01,9,9,9,9,18
SAN ANDRES DE MACHACA,consulta externa,repetidas en personas de 60 anos o mas,2007-02-01,4,7,4,7,11
SAN ANTONIO DE ESMORUCO,consulta externa,repetidas en personas de 60 anos o mas,2007-02-01,1,1,1,1,2
SAN ANTONIO DE LOMERIO,consulta externa,repetidas en personas de 60 anos o mas,2007-02-01,1,0,1,0,1
SAN BENITO,consulta externa,repetidas en personas de 60 anos o mas,2007-02-01,9,3,9,3,12
SAN BORJA,consulta externa,repetidas en personas de 60 anos o mas,2007-02-01,59,47,59,47,106
SAN BUENA VENTURA,consulta externa,repetidas en personas de 60 anos o mas,2007-02-01,8,2,8,2,10
SAN CARLOS,consulta externa,repetidas en personas de 60 anos o mas,2007-02-01,10,15,10,15,25
SAN IGNACIO,consulta externa,repetidas en personas de 60 anos o mas,2007-02-01,58,66,58,66,124
SAN IGNACIO DE VELASCO,consulta externa,repetidas en personas de 60 anos o mas,2007-02-01,74,98,74,98,172
SAN JAVIER(STC),consulta externa,repetidas en personas de 60 anos o mas,2007-02-01,4,11,4,11,15
SAN JOAQUIN,consulta externa,repetidas en personas de 60 anos o mas,2007-02-01,51,79,51,79,130
SAN JOSE DE CHIQUITOS,consulta externa,repetidas en personas de 60 anos o mas,2007-02-01,5,1,5,1,6
SAN JUAN DE YAPACANI,consulta externa,repetidas en personas de 60 anos o mas,2007-02-01,28,10,28,10,38
SAN JULIAN,consulta externa,repetidas en personas de 60 anos o mas,2007-02-01,2,3,2,3,5
SAN LORENZO(TJA),consulta externa,repetidas en personas de 60 anos o mas,2007-02-01,4,13,4,13,17
SAN LUCAS,consulta externa,repetidas en personas de 60 anos o mas,2007-02-01,22,29,22,29,51
SAN MATIAS,consulta externa,repetidas en personas de 60 anos o mas,2007-02-01,2,1,2,1,3
SAN MIGUEL DE VELASCO,consulta externa,repetidas en personas de 60 anos o mas,2007-02-01,63,94,63,94,157
SAN PABLO DE LIPEZ,consulta externa,repetidas en personas de 60 anos o mas,2007-02-01,4,4,4,4,8
SAN PEDRO,consulta externa,repetidas en personas de 60 anos o mas,2007-02-01,6,9,6,9,15
SAN PEDRO DE CURAHUARA,consulta externa,repetidas en personas de 60 anos o mas,2007-02-01,7,3,7,3,10
SAN PEDRO DE TIQUINA,consulta externa,repetidas en personas de 60 anos o mas,2007-02-01,3,4,3,4,7
SAN RAFAEL,consulta externa,repetidas en personas de 60 anos o mas,2007-02-01,1,0,1,0,1
SAN RAMON,consulta externa,repetidas en personas de 60 anos o mas,2007-02-01,21,15,21,15,36
SAN RAMON,consulta externa,repetidas en personas de 60 anos o mas,2007-02-01,5,4,5,4,9
SANTA ANA,consulta externa,repetidas en personas de 60 anos o mas,2007-02-01,45,73,45,73,118
SANTA CRUZ DE LA SIERRA,consulta externa,repetidas en personas de 60 anos o mas,2007-02-01,2123,4012,2123,4012,6135
SANTA ROSA DEL SARA,consulta externa,repetidas en personas de 60 anos o mas,2007-02-01,1,2,1,2,3
SANTIAGO DE CALLAPA,consulta externa,repetidas en personas de 60 anos o mas,2007-02-01,3,0,3,0,3
SANTIAGO DE HUARI,consulta externa,repetidas en personas de 60 anos o mas,2007-02-01,15,29,15,29,44
SANTIAGO DE MACHACA,consulta externa,repetidas en personas de 60 anos o mas,2007-02-01,1,3,1,3,4
SANTIVAÑES,consulta externa,repetidas en personas de 60 anos o mas,2007-02-01,1,2,1,2,3
SANTUARIO DE QUILLACAS,consulta externa,repetidas en personas de 60 anos o mas,2007-02-01,1,3,1,3,4
SAPAHAQUI,consulta externa,repetidas en personas de 60 anos o mas,2007-02-01,1,1,1,1,2
SENA,consulta externa,repetidas en personas de 60 anos o mas,2007-02-01,1,1,1,1,2
SICA SICA (VILLA AROMA),consulta externa,repetidas en personas de 60 anos o mas,2007-02-01,1,1,1,1,2
SIPE SIPE,consulta externa,repetidas en personas de 60 anos o mas,2007-02-01,8,16,8,16,24
SOPACHUY,consulta externa,repetidas en personas de 60 anos o mas,2007-02-01,2,3,2,3,5
SORACACHI,consulta externa,repetidas en personas de 60 anos o mas,2007-02-01,3,0,3,0,3
SORATA,consulta externa,repetidas en personas de 60 anos o mas,2007-02-01,3,0,3,0,3
SUCRE,consulta externa,repetidas en personas de 60 anos o mas,2007-02-01,1330,1600,1330,1600,2930
TACACHI,consulta externa,repetidas en personas de 60 anos o mas,2007-02-01,3,5,3,5,8
TACOBAMBA,consulta externa,repetidas en personas de 60 anos o mas,2007-02-01,0,1,0,1,1
TAHUA,consulta externa,repetidas en personas de 60 anos o mas,2007-02-01,2,3,2,3,5
TAPACARI,consulta externa,repetidas en personas de 60 anos o mas,2007-02-01,1,6,1,6,7
TARABUCO,consulta externa,repetidas en personas de 60 anos o mas,2007-02-01,33,56,33,56,89
TARACO,consulta externa,repetidas en personas de 60 anos o mas,2007-02-01,3,1,3,1,4
TARATA,consulta externa,repetidas en personas de 60 anos o mas,2007-02-01,2,8,2,8,10
TARIJA,consulta externa,repetidas en personas de 60 anos o mas,2007-02-01,1322,1801,1322,1801,3123
TARVITA,consulta externa,repetidas en personas de 60 anos o mas,2007-02-01,0,1,0,1,1
TEOPONTE,consulta externa,repetidas en personas de 60 anos o mas,2007-02-01,1,1,1,1,2
TIAWANACU,consulta externa,repetidas en personas de 60 anos o mas,2007-02-01,1,3,1,3,4
TIPUANI,consulta externa,repetidas en personas de 60 anos o mas,2007-02-01,1,0,1,0,1
TIQUIPAYA,consulta externa,repetidas en personas de 60 anos o mas,2007-02-01,4,5,4,5,9
TIRAQUE (CBBA),consulta externa,repetidas en personas de 60 anos o mas,2007-02-01,39,25,39,25,64
TITO YUPANQUI (PARQUIPUJIO),consulta externa,repetidas en personas de 60 anos o mas,2007-02-01,4,2,4,2,6
TOCO,consulta externa,repetidas en personas de 60 anos o mas,2007-02-01,1,2,1,2,3
TOLATA,consulta externa,repetidas en personas de 60 anos o mas,2007-02-01,6,0,6,0,6
TOLEDO,consulta externa,repetidas en personas de 60 anos o mas,2007-02-01,0,1,0,1,1
TOMAVE,consulta externa,repetidas en personas de 60 anos o mas,2007-02-01,2,4,2,4,6
TOMINA,consulta externa,repetidas en personas de 60 anos o mas,2007-02-01,1,3,1,3,4
TOTORA(CBBA),consulta externa,repetidas en personas de 60 anos o mas,2007-02-01,0,3,0,3,3
TOTORA(ORR),consulta externa,repetidas en personas de 60 anos o mas,2007-02-01,0,1,0,1,1
TRIGAL,consulta externa,repetidas en personas de 60 anos o mas,2007-02-01,1,0,1,0,1
TRINIDAD,consulta externa,repetidas en personas de 60 anos o mas,2007-02-01,181,208,181,208,389
TUPIZA,consulta externa,repetidas en personas de 60 anos o mas,2007-02-01,42,80,42,80,122
TURCO,consulta externa,repetidas en personas de 60 anos o mas,2007-02-01,2,0,2,0,2
UMALA,consulta externa,repetidas en personas de 60 anos o mas,2007-02-01,1,1,1,1,2
UNCIA,consulta externa,repetidas en personas de 60 anos o mas,2007-02-01,42,61,42,61,103
URIONDO (A. CONCEPCION),consulta externa,repetidas en personas de 60 anos o mas,2007-02-01,3,10,3,10,13
URUBICHA,consulta externa,repetidas en personas de 60 anos o mas,2007-02-01,2,1,2,1,3
UYUNI,consulta externa,repetidas en personas de 60 anos o mas,2007-02-01,62,72,62,72,134
VACAS,consulta externa,repetidas en personas de 60 anos o mas,2007-02-01,5,18,5,18,23
VALLEGRANDE,consulta externa,repetidas en personas de 60 anos o mas,2007-02-01,180,219,180,219,399
VIACHA,consulta externa,repetidas en personas de 60 anos o mas,2007-02-01,121,189,121,189,310
VILLA MONTES,consulta externa,repetidas en personas de 60 anos o mas,2007-02-01,36,34,36,34,70
VILLA NUEVA (LOMA ALTA),consulta externa,repetidas en personas de 60 anos o mas,2007-02-01,1,3,1,3,4
VILLA RIVERO,consulta externa,repetidas en personas de 60 anos o mas,2007-02-01,5,5,5,5,10
VILLA SERRANO,consulta externa,repetidas en personas de 60 anos o mas,2007-02-01,1,6,1,6,7
VILLA TUNARI,consulta externa,repetidas en personas de 60 anos o mas,2007-02-01,49,8,49,8,57
VILLA VACA GUZMAN (MUYUPAMPA),consulta externa,repetidas en personas de 60 anos o mas,2007-02-01,6,8,6,8,14
VILLAZON,consulta externa,repetidas en personas de 60 anos o mas,2007-02-01,48,49,48,49,97
VINTO,consulta externa,repetidas en personas de 60 anos o mas,2007-02-01,8,11,8,11,19
VITICHI,consulta externa,repetidas en personas de 60 anos o mas,2007-02-01,8,7,8,7,15
WALDO BALLIVIAN,consulta externa,repetidas en personas de 60 anos o mas,2007-02-01,0,1,0,1,1
WARNES,consulta externa,repetidas en personas de 60 anos o mas,2007-02-01,2,3,2,3,5
YACO,consulta externa,repetidas en personas de 60 anos o mas,2007-02-01,1,0,1,0,1
YACUIBA,consulta externa,repetidas en personas de 60 anos o mas,2007-02-01,183,230,183,230,413
YAMPARAEZ,consulta externa,repetidas en personas de 60 anos o mas,2007-02-01,2,5,2,5,7
YANACACHI,consulta externa,repetidas en personas de 60 anos o mas,2007-02-01,4,1,4,1,5
YAPACANI,consulta externa,repetidas en personas de 60 anos o mas,2007-02-01,4,3,4,3,7
YOCALLA,consulta externa,repetidas en personas de 60 anos o mas,2007-02-01,1,2,1,2,3
YOTALA,consulta externa,repetidas en personas de 60 anos o mas,2007-02-01,2,10,2,10,12
YUNCHARA,consulta externa,repetidas en personas de 60 anos o mas,2007-02-01,0,2,0,2,2
ZUDAÑEZ,consulta externa,repetidas en personas de 60 anos o mas,2007-02-01,0,1,0,1,1
ACACIO,consulta externa,repetidas en personas de 60 anos o mas,2007-03-01,1,2,1,2,3
ACHACACHI,consulta externa,repetidas en personas de 60 anos o mas,2007-03-01,31,20,31,20,51
ACHOCALLA,consulta externa,repetidas en personas de 60 anos o mas,2007-03-01,3,0,3,0,3
AIQUILE,consulta externa,repetidas en personas de 60 anos o mas,2007-03-01,35,67,35,67,102
ANCORAIMES,consulta externa,repetidas en personas de 60 anos o mas,2007-03-01,3,2,3,2,5
ANDAMARCA,consulta externa,repetidas en personas de 60 anos o mas,2007-03-01,5,5,5,5,10
ANZALDO,consulta externa,repetidas en personas de 60 anos o mas,2007-03-01,5,3,5,3,8
APOLO,consulta externa,repetidas en personas de 60 anos o mas,2007-03-01,8,9,8,9,17
ARANI,consulta externa,repetidas en personas de 60 anos o mas,2007-03-01,0,2,0,2,2
ARBIETO,consulta externa,repetidas en personas de 60 anos o mas,2007-03-01,5,8,5,8,13
ATOCHA,consulta externa,repetidas en personas de 60 anos o mas,2007-03-01,32,55,32,55,87
AUCAPATA,consulta externa,repetidas en personas de 60 anos o mas,2007-03-01,8,4,8,4,12
AYATA,consulta externa,repetidas en personas de 60 anos o mas,2007-03-01,3,4,3,4,7
AYO AYO,consulta externa,repetidas en personas de 60 anos o mas,2007-03-01,2,0,2,0,2
AYOPAYA (V. DE INDEPENDENCIA),consulta externa,repetidas en personas de 60 anos o mas,2007-03-01,9,11,9,11,20
BATALLAS,consulta externa,repetidas en personas de 60 anos o mas,2007-03-01,5,3,5,3,8
BAURES,consulta externa,repetidas en personas de 60 anos o mas,2007-03-01,0,1,0,1,1
BELEN DE ANDAMARCA,consulta externa,repetidas en personas de 60 anos o mas,2007-03-01,2,0,2,0,2
BELEN DE URMIRI,consulta externa,repetidas en personas de 60 anos o mas,2007-03-01,0,1,0,1,1
BELLA FLOR,consulta externa,repetidas en personas de 60 anos o mas,2007-03-01,2,4,2,4,6
BERMEJO,consulta externa,repetidas en personas de 60 anos o mas,2007-03-01,60,30,60,30,90
BETANZOS,consulta externa,repetidas en personas de 60 anos o mas,2007-03-01,59,71,59,71,130
BOLIVAR,consulta externa,repetidas en personas de 60 anos o mas,2007-03-01,2,4,2,4,6
BOYUIBE,consulta externa,repetidas en personas de 60 anos o mas,2007-03-01,2,27,2,27,29
BUENA VISTA,consulta externa,repetidas en personas de 60 anos o mas,2007-03-01,31,40,31,40,71
CABEZAS,consulta externa,repetidas en personas de 60 anos o mas,2007-03-01,2,0,2,0,2
CAIROMA,consulta externa,repetidas en personas de 60 anos o mas,2007-03-01,10,2,10,2,12
"CAIZA ""D""",consulta externa,repetidas en personas de 60 anos o mas,2007-03-01,0,1,0,1,1
CAJUATA,consulta externa,repetidas en personas de 60 anos o mas,2007-03-01,4,0,4,0,4
CALACOTO,consulta externa,repetidas en personas de 60 anos o mas,2007-03-01,6,6,6,6,12
CALAMARCA,consulta externa,repetidas en personas de 60 anos o mas,2007-03-01,1,0,1,0,1
CAMARGO,consulta externa,repetidas en personas de 60 anos o mas,2007-03-01,9,33,9,33,42
CAMATAQUI (C. VILLA ABECIA),consulta externa,repetidas en personas de 60 anos o mas,2007-03-01,21,5,21,5,26
CAMIRI,consulta externa,repetidas en personas de 60 anos o mas,2007-03-01,93,133,93,133,226
CAPINOTA,consulta externa,repetidas en personas de 60 anos o mas,2007-03-01,23,23,23,23,46
CAQUIAVIRI,consulta externa,repetidas en personas de 60 anos o mas,2007-03-01,0,3,0,3,3
CARACOLLO,consulta externa,repetidas en personas de 60 anos o mas,2007-03-01,8,8,8,8,16
CARANAVI,consulta externa,repetidas en personas de 60 anos o mas,2007-03-01,35,12,35,12,47
CARAPARI,consulta externa,repetidas en personas de 60 anos o mas,2007-03-01,3,0,3,0,3
CATACORA,consulta externa,repetidas en personas de 60 anos o mas,2007-03-01,0,1,0,1,1
CHALLAPATA,consulta externa,repetidas en personas de 60 anos o mas,2007-03-01,11,17,11,17,28
CHAQUI,consulta externa,repetidas en personas de 60 anos o mas,2007-03-01,1,1,1,1,2
CHARAGUA,consulta externa,repetidas en personas de 60 anos o mas,2007-03-01,4,3,4,3,7
CHAYANTA,consulta externa,repetidas en personas de 60 anos o mas,2007-03-01,1,8,1,8,9
CHIMORE,consulta externa,repetidas en personas de 60 anos o mas,2007-03-01,2,1,2,1,3
CHOQUE COTA,consulta externa,repetidas en personas de 60 anos o mas,2007-03-01,0,1,0,1,1
CHULUMANI (V. DE LA LIBERTAD),consulta externa,repetidas en personas de 60 anos o mas,2007-03-01,23,15,23,15,38
CHUMA,consulta externa,repetidas en personas de 60 anos o mas,2007-03-01,8,9,8,9,17
CLIZA,consulta externa,repetidas en personas de 60 anos o mas,2007-03-01,6,18,6,18,24
COBIJA,consulta externa,repetidas en personas de 60 anos o mas,2007-03-01,19,15,19,15,34
COCHABAMBA,consulta externa,repetidas en personas de 60 anos o mas,2007-03-01,6481,8861,6481,8861,15342
COLCAPIRHUA,consulta externa,repetidas en personas de 60 anos o mas,2007-03-01,49,74,49,74,123
"COLCHA ""K""",consulta externa,repetidas en personas de 60 anos o mas,2007-03-01,12,9,12,9,21
COLLANA,consulta externa,repetidas en personas de 60 anos o mas,2007-03-01,3,1,3,1,4
COLOMI,consulta externa,repetidas en personas de 60 anos o mas,2007-03-01,2,1,2,1,3
COLPA BELGICA,consulta externa,repetidas en personas de 60 anos o mas,2007-03-01,14,19,14,19,33
COLQUECHACA,consulta externa,repetidas en personas de 60 anos o mas,2007-03-01,5,5,5,5,10
COLQUENCHA,consulta externa,repetidas en personas de 60 anos o mas,2007-03-01,0,3,0,3,3
COLQUIRI,consulta externa,repetidas en personas de 60 anos o mas,2007-03-01,6,3,6,3,9
COMANCHE,consulta externa,repetidas en personas de 60 anos o mas,2007-03-01,1,0,1,0,1
COMARAPA,consulta externa,repetidas en personas de 60 anos o mas,2007-03-01,9,11,9,11,20
CONCEPCION,consulta externa,repetidas en personas de 60 anos o mas,2007-03-01,0,7,0,7,7
COPACABANA,consulta externa,repetidas en personas de 60 anos o mas,2007-03-01,0,4,0,4,4
CORIPATA,consulta externa,repetidas en personas de 60 anos o mas,2007-03-01,4,1,4,1,5
COROICO,consulta externa,repetidas en personas de 60 anos o mas,2007-03-01,61,48,61,48,109
CORQUE,consulta externa,repetidas en personas de 60 anos o mas,2007-03-01,7,2,7,2,9
COTAGAITA,consulta externa,repetidas en personas de 60 anos o mas,2007-03-01,21,44,21,44,65
COTOCA,consulta externa,repetidas en personas de 60 anos o mas,2007-03-01,1,0,1,0,1
CUATRO CAÑADAS,consulta externa,repetidas en personas de 60 anos o mas,2007-03-01,6,7,6,7,13
CUCHUMUELA (V. G. VILLARROEL),consulta externa,repetidas en personas de 60 anos o mas,2007-03-01,1,1,1,1,2
CUEVO,consulta externa,repetidas en personas de 60 anos o mas,2007-03-01,1,5,1,5,6
CULPINA,consulta externa,repetidas en personas de 60 anos o mas,2007-03-01,0,2,0,2,2
CURAHUARA DE CARANGAS,consulta externa,repetidas en personas de 60 anos o mas,2007-03-01,0,1,0,1,1
DESAGUADERO,consulta externa,repetidas en personas de 60 anos o mas,2007-03-01,0,1,0,1,1
EL ALTO,consulta externa,repetidas en personas de 60 anos o mas,2007-03-01,866,828,866,828,1694
EL CHORO,consulta externa,repetidas en personas de 60 anos o mas,2007-03-01,8,4,8,4,12
EL PUENTE(STC),consulta externa,repetidas en personas de 60 anos o mas,2007-03-01,1,0,1,0,1
EL PUENTE(TJA),consulta externa,repetidas en personas de 60 anos o mas,2007-03-01,1,1,1,1,2
EL TORNO,consulta externa,repetidas en personas de 60 anos o mas,2007-03-01,215,256,215,256,471
ENTRE RIOS,consulta externa,repetidas en personas de 60 anos o mas,2007-03-01,1,1,1,1,2
ENTRE RIOS,consulta externa,repetidas en personas de 60 anos o mas,2007-03-01,3,14,3,14,17
ESMERALDA,consulta externa,repetidas en personas de 60 anos o mas,2007-03-01,1,1,1,1,2
EUCALIPTUS,consulta externa,repetidas en personas de 60 anos o mas,2007-03-01,6,7,6,7,13
EXALTACION,consulta externa,repetidas en personas de 60 anos o mas,2007-03-01,0,4,0,4,4
FERNANDEZ ALONSO,consulta externa,repetidas en personas de 60 anos o mas,2007-03-01,1,0,1,0,1
FILADELFIA,consulta externa,repetidas en personas de 60 anos o mas,2007-03-01,6,1,6,1,7
GENERAL SAAVEDRA,consulta externa,repetidas en personas de 60 anos o mas,2007-03-01,1,0,1,0,1
GRAL. J.J. PEREZ (CHARAZANI),consulta externa,repetidas en personas de 60 anos o mas,2007-03-01,5,4,5,4,9
GUANAY,consulta externa,repetidas en personas de 60 anos o mas,2007-03-01,6,4,6,4,10
GUAQUI,consulta externa,repetidas en personas de 60 anos o mas,2007-03-01,3,6,3,6,9
GUAYARAMERIN,consulta externa,repetidas en personas de 60 anos o mas,2007-03-01,109,143,109,143,252
GUTIERREZ,consulta externa,repetidas en personas de 60 anos o mas,2007-03-01,11,9,11,9,20
HUACARETA,consulta externa,repetidas en personas de 60 anos o mas,2007-03-01,7,13,7,13,20
HUACHACALLA,consulta externa,repetidas en personas de 60 anos o mas,2007-03-01,1,1,1,1,2
HUANUNI,consulta externa,repetidas en personas de 60 anos o mas,2007-03-01,196,211,196,211,407
HUARACAJE,consulta externa,repetidas en personas de 60 anos o mas,2007-03-01,5,2,5,2,7
HUAYLLAMARCA,consulta externa,repetidas en personas de 60 anos o mas,2007-03-01,0,1,0,1,1
ICLA,consulta externa,repetidas en personas de 60 anos o mas,2007-03-01,0,1,0,1,1
INCAHUASI,consulta externa,repetidas en personas de 60 anos o mas,2007-03-01,0,1,0,1,1
INQUISIVI,consulta externa,repetidas en personas de 60 anos o mas,2007-03-01,2,4,2,4,6
IRUPANA (VILLA DE LANZA),consulta externa,repetidas en personas de 60 anos o mas,2007-03-01,2,2,2,2,4
JESUS DE MACHACA,consulta externa,repetidas en personas de 60 anos o mas,2007-03-01,13,17,13,17,30
LA ASUNTA,consulta externa,repetidas en personas de 60 anos o mas,2007-03-01,1,3,1,3,4
LA GUARDIA,consulta externa,repetidas en personas de 60 anos o mas,2007-03-01,11,12,11,12,23
LA PAZ,consulta externa,repetidas en personas de 60 anos o mas,2007-03-01,9492,14420,9492,14420,23912
LAGUNILLAS,consulta externa,repetidas en personas de 60 anos o mas,2007-03-01,1,2,1,2,3
LAJA,consulta externa,repetidas en personas de 60 anos o mas,2007-03-01,16,5,16,5,21
LAS CARRERAS,consulta externa,repetidas en personas de 60 anos o mas,2007-03-01,6,13,6,13,19
LICOMA PAMPA,consulta externa,repetidas en personas de 60 anos o mas,2007-03-01,1,0,1,0,1
LLALLAGUA,consulta externa,repetidas en personas de 60 anos o mas,2007-03-01,41,58,41,58,99
LLICA,consulta externa,repetidas en personas de 60 anos o mas,2007-03-01,6,8,6,8,14
LORETO,consulta externa,repetidas en personas de 60 anos o mas,2007-03-01,1,3,1,3,4
LURIBAY,consulta externa,repetidas en personas de 60 anos o mas,2007-03-01,14,6,14,6,20
MACHACAMARCA,consulta externa,repetidas en personas de 60 anos o mas,2007-03-01,30,35,30,35,65
MACHARETI,consulta externa,repetidas en personas de 60 anos o mas,2007-03-01,8,11,8,11,19
MAGDALENA,consulta externa,repetidas en personas de 60 anos o mas,2007-03-01,61,73,61,73,134
MAIRANA,consulta externa,repetidas en personas de 60 anos o mas,2007-03-01,2,0,2,0,2
MALLA,consulta externa,repetidas en personas de 60 anos o mas,2007-03-01,1,1,1,1,2
MAPIRI,consulta externa,repetidas en personas de 60 anos o mas,2007-03-01,1,1,1,1,2
MECAPACA,consulta externa,repetidas en personas de 60 anos o mas,2007-03-01,3,4,3,4,7
MINEROS,consulta externa,repetidas en personas de 60 anos o mas,2007-03-01,0,1,0,1,1
MIZQUE,consulta externa,repetidas en personas de 60 anos o mas,2007-03-01,7,4,7,4,11
MOCOMOCO,consulta externa,repetidas en personas de 60 anos o mas,2007-03-01,5,6,5,6,11
MOJINETE,consulta externa,repetidas en personas de 60 anos o mas,2007-03-01,0,2,0,2,2
MOJOCOYA,consulta externa,repetidas en personas de 60 anos o mas,2007-03-01,5,2,5,2,7
MONTEAGUDO,consulta externa,repetidas en personas de 60 anos o mas,2007-03-01,76,71,76,71,147
MONTERO,consulta externa,repetidas en personas de 60 anos o mas,2007-03-01,385,402,385,402,787
MORO MORO,consulta externa,repetidas en personas de 60 anos o mas,2007-03-01,0,2,0,2,2
MOROCHATA,consulta externa,repetidas en personas de 60 anos o mas,2007-03-01,8,14,8,14,22
OCURI,consulta externa,repetidas en personas de 60 anos o mas,2007-03-01,0,1,0,1,1
OKINAWA,consulta externa,repetidas en personas de 60 anos o mas,2007-03-01,5,7,5,7,12
OMEREQUE,consulta externa,repetidas en personas de 60 anos o mas,2007-03-01,0,1,0,1,1
ORURO,consulta externa,repetidas en personas de 60 anos o mas,2007-03-01,1601,1898,1601,1898,3499
PADCAYA,consulta externa,repetidas en personas de 60 anos o mas,2007-03-01,57,63,57,63,120
PADILLA,consulta externa,repetidas en personas de 60 anos o mas,2007-03-01,17,24,17,24,41
PAILON,consulta externa,repetidas en personas de 60 anos o mas,2007-03-01,5,0,5,0,5
PALCA,consulta externa,repetidas en personas de 60 anos o mas,2007-03-01,3,10,3,10,13
PALOS BLANCOS,consulta externa,repetidas en personas de 60 anos o mas,2007-03-01,1,4,1,4,5
PAMPA GRANDE,consulta externa,repetidas en personas de 60 anos o mas,2007-03-01,1,4,1,4,5
PAPEL PAMPA,consulta externa,repetidas en personas de 60 anos o mas,2007-03-01,3,1,3,1,4
PASORAPA,consulta externa,repetidas en personas de 60 anos o mas,2007-03-01,2,1,2,1,3
PATACAMAYA,consulta externa,repetidas en personas de 60 anos o mas,2007-03-01,1,0,1,0,1
PAZÑA,consulta externa,repetidas en personas de 60 anos o mas,2007-03-01,12,25,12,25,37
POCOATA,consulta externa,repetidas en personas de 60 anos o mas,2007-03-01,0,3,0,3,3
POCONA,consulta externa,repetidas en personas de 60 anos o mas,2007-03-01,3,7,3,7,10
POOPO,consulta externa,repetidas en personas de 60 anos o mas,2007-03-01,18,10,18,10,28
PORCO,consulta externa,repetidas en personas de 60 anos o mas,2007-03-01,0,5,0,5,5
POROMA,consulta externa,repetidas en personas de 60 anos o mas,2007-03-01,0,5,0,5,5
PORONGO,consulta externa,repetidas en personas de 60 anos o mas,2007-03-01,2,1,2,1,3
PORTACHUELO,consulta externa,repetidas en personas de 60 anos o mas,2007-03-01,13,18,13,18,31
PORVENIR,consulta externa,repetidas en personas de 60 anos o mas,2007-03-01,0,1,0,1,1
POSTRER VALLE,consulta externa,repetidas en personas de 60 anos o mas,2007-03-01,1,5,1,5,6
POTOSI,consulta externa,repetidas en personas de 60 anos o mas,2007-03-01,1198,1495,1198,1495,2693
PUCARA,consulta externa,repetidas en personas de 60 anos o mas,2007-03-01,1,0,1,0,1
PUCARANI,consulta externa,repetidas en personas de 60 anos o mas,2007-03-01,11,4,11,4,15
PUERTO ACOSTA,consulta externa,repetidas en personas de 60 anos o mas,2007-03-01,22,10,22,10,32
PUERTO CARABUCO,consulta externa,repetidas en personas de 60 anos o mas,2007-03-01,4,2,4,2,6
PUERTO GONZALO MORENO,consulta externa,repetidas en personas de 60 anos o mas,2007-03-01,1,3,1,3,4
PUERTO PEREZ,consulta externa,repetidas en personas de 60 anos o mas,2007-03-01,1,4,1,4,5
PUERTO QUIJARRO,consulta externa,repetidas en personas de 60 anos o mas,2007-03-01,7,5,7,5,12
PUERTO RICO,consulta externa,repetidas en personas de 60 anos o mas,2007-03-01,2,2,2,2,4
PUERTO SUAREZ,consulta externa,repetidas en personas de 60 anos o mas,2007-03-01,16,10,16,10,26
PUERTO VILLARROEL,consulta externa,repetidas en personas de 60 anos o mas,2007-03-01,9,7,9,7,16
PUNA,consulta externa,repetidas en personas de 60 anos o mas,2007-03-01,12,14,12,14,26
PUNATA,consulta externa,repetidas en personas de 60 anos o mas,2007-03-01,89,135,89,135,224
QUILLACOLLO,consulta externa,repetidas en personas de 60 anos o mas,2007-03-01,377,486,377,486,863
QUIME,consulta externa,repetidas en personas de 60 anos o mas,2007-03-01,5,2,5,2,7
QUIRUSILLAS,consulta externa,repetidas en personas de 60 anos o mas,2007-03-01,2,2,2,2,4
REYES,consulta externa,repetidas en personas de 60 anos o mas,2007-03-01,42,55,42,55,97
RIBERALTA,consulta externa,repetidas en personas de 60 anos o mas,2007-03-01,219,192,219,192,411
ROBORE,consulta externa,repetidas en personas de 60 anos o mas,2007-03-01,19,23,19,23,42
RURRENABAQUE,consulta externa,repetidas en personas de 60 anos o mas,2007-03-01,74,97,74,97,171
SABAYA,consulta externa,repetidas en personas de 60 anos o mas,2007-03-01,4,7,4,7,11
SACABA,consulta externa,repetidas en personas de 60 anos o mas,2007-03-01,85,139,85,139,224
SACABAMBA,consulta externa,repetidas en personas de 60 anos o mas,2007-03-01,4,4,4,4,8
SACACA,consulta externa,repetidas en personas de 60 anos o mas,2007-03-01,1,2,1,2,3
SAIPINA,consulta externa,repetidas en personas de 60 anos o mas,2007-03-01,42,80,42,80,122
SALINAS DE GARCI MENDOZA,consulta externa,repetidas en personas de 60 anos o mas,2007-03-01,7,21,7,21,28
SAMAIPATA,consulta externa,repetidas en personas de 60 anos o mas,2007-03-01,5,5,5,5,10
SAN ANDRES,consulta externa,repetidas en personas de 60 anos o mas,2007-03-01,6,5,6,5,11
SAN ANDRES DE MACHACA,consulta externa,repetidas en personas de 60 anos o mas,2007-03-01,4,6,4,6,10
SAN ANTONIO DE ESMORUCO,consulta externa,repetidas en personas de 60 anos o mas,2007-03-01,1,1,1,1,2
SAN ANTONIO DE LOMERIO,consulta externa,repetidas en personas de 60 anos o mas,2007-03-01,2,2,2,2,4
SAN BENITO,consulta externa,repetidas en personas de 60 anos o mas,2007-03-01,6,7,6,7,13
SAN BORJA,consulta externa,repetidas en personas de 60 anos o mas,2007-03-01,50,59,50,59,109
SAN BUENA VENTURA,consulta externa,repetidas en personas de 60 anos o mas,2007-03-01,9,4,9,4,13
SAN CARLOS,consulta externa,repetidas en personas de 60 anos o mas,2007-03-01,21,18,21,18,39
SAN IGNACIO,consulta externa,repetidas en personas de 60 anos o mas,2007-03-01,48,51,48,51,99
SAN IGNACIO DE VELASCO,consulta externa,repetidas en personas de 60 anos o mas,2007-03-01,131,109,131,109,240
SAN JAVIER(STC),consulta externa,repetidas en personas de 60 anos o mas,2007-03-01,11,11,11,11,22
SAN JOAQUIN,consulta externa,repetidas en personas de 60 anos o mas,2007-03-01,35,54,35,54,89
SAN JOSE DE CHIQUITOS,consulta externa,repetidas en personas de 60 anos o mas,2007-03-01,12,9,12,9,21
SAN JUAN DE YAPACANI,consulta externa,repetidas en personas de 60 anos o mas,2007-03-01,7,19,7,19,26
SAN JULIAN,consulta externa,repetidas en personas de 60 anos o mas,2007-03-01,66,73,66,73,139
SAN LORENZO(PND),consulta externa,repetidas en personas de 60 anos o mas,2007-03-01,4,1,4,1,5
SAN LORENZO(TJA),consulta externa,repetidas en personas de 60 anos o mas,2007-03-01,8,12,8,12,20
SAN LUCAS,consulta externa,repetidas en personas de 60 anos o mas,2007-03-01,41,21,41,21,62
SAN MATIAS,consulta externa,repetidas en personas de 60 anos o mas,2007-03-01,5,5,5,5,10
SAN MIGUEL DE VELASCO,consulta externa,repetidas en personas de 60 anos o mas,2007-03-01,77,118,77,118,195
SAN PABLO DE LIPEZ,consulta externa,repetidas en personas de 60 anos o mas,2007-03-01,3,2,3,2,5
SAN PEDRO,consulta externa,repetidas en personas de 60 anos o mas,2007-03-01,12,12,12,12,24
SAN PEDRO DE CURAHUARA,consulta externa,repetidas en personas de 60 anos o mas,2007-03-01,3,5,3,5,8
SAN PEDRO DE TIQUINA,consulta externa,repetidas en personas de 60 anos o mas,2007-03-01,2,1,2,1,3
SAN RAMON,consulta externa,repetidas en personas de 60 anos o mas,2007-03-01,4,4,4,4,8
SAN RAMON,consulta externa,repetidas en personas de 60 anos o mas,2007-03-01,43,18,43,18,61
SANTA ANA,consulta externa,repetidas en personas de 60 anos o mas,2007-03-01,38,68,38,68,106
SANTA CRUZ DE LA SIERRA,consulta externa,repetidas en personas de 60 anos o mas,2007-03-01,3269,4881,3269,4881,8150
SANTA ROSA DEL SARA,consulta externa,repetidas en personas de 60 anos o mas,2007-03-01,2,1,2,1,3
SANTIAGO DE CALLAPA,consulta externa,repetidas en personas de 60 anos o mas,2007-03-01,0,1,0,1,1
SANTIAGO DE HUARI,consulta externa,repetidas en personas de 60 anos o mas,2007-03-01,31,25,31,25,56
SANTIAGO DE MACHACA,consulta externa,repetidas en personas de 60 anos o mas,2007-03-01,1,0,1,0,1
SANTIVAÑES,consulta externa,repetidas en personas de 60 anos o mas,2007-03-01,2,4,2,4,6
SANTUARIO DE QUILLACAS,consulta externa,repetidas en personas de 60 anos o mas,2007-03-01,1,5,1,5,6
SICA SICA (VILLA AROMA),consulta externa,repetidas en personas de 60 anos o mas,2007-03-01,1,2,1,2,3
SIPE SIPE,consulta externa,repetidas en personas de 60 anos o mas,2007-03-01,17,28,17,28,45
SOPACHUY,consulta externa,repetidas en personas de 60 anos o mas,2007-03-01,9,8,9,8,17
SORACACHI,consulta externa,repetidas en personas de 60 anos o mas,2007-03-01,5,2,5,2,7
SORATA,consulta externa,repetidas en personas de 60 anos o mas,2007-03-01,1,0,1,0,1
SUCRE,consulta externa,repetidas en personas de 60 anos o mas,2007-03-01,1652,2250,1652,2250,3902
TACACHI,consulta externa,repetidas en personas de 60 anos o mas,2007-03-01,3,6,3,6,9
TACOBAMBA,consulta externa,repetidas en personas de 60 anos o mas,2007-03-01,0,2,0,2,2
TAHUA,consulta externa,repetidas en personas de 60 anos o mas,2007-03-01,2,7,2,7,9
TAPACARI,consulta externa,repetidas en personas de 60 anos o mas,2007-03-01,3,5,3,5,8
TARABUCO,consulta externa,repetidas en personas de 60 anos o mas,2007-03-01,29,56,29,56,85
TARACO,consulta externa,repetidas en personas de 60 anos o mas,2007-03-01,2,3,2,3,5
TARATA,consulta externa,repetidas en personas de 60 anos o mas,2007-03-01,5,6,5,6,11
TARIJA,consulta externa,repetidas en personas de 60 anos o mas,2007-03-01,1587,2482,1587,2482,4069
TARVITA,consulta externa,repetidas en personas de 60 anos o mas,2007-03-01,1,1,1,1,2
TEOPONTE,consulta externa,repetidas en personas de 60 anos o mas,2007-03-01,1,3,1,3,4
TIAWANACU,consulta externa,repetidas en personas de 60 anos o mas,2007-03-01,5,0,5,0,5
TINGUIPAYA,consulta externa,repetidas en personas de 60 anos o mas,2007-03-01,2,0,2,0,2
TIPUANI,consulta externa,repetidas en personas de 60 anos o mas,2007-03-01,3,5,3,5,8
TIQUIPAYA,consulta externa,repetidas en personas de 60 anos o mas,2007-03-01,3,9,3,9,12
TIRAQUE (CBBA),consulta externa,repetidas en personas de 60 anos o mas,2007-03-01,21,22,21,22,43
TITO YUPANQUI (PARQUIPUJIO),consulta externa,repetidas en personas de 60 anos o mas,2007-03-01,2,4,2,4,6
TOCO,consulta externa,repetidas en personas de 60 anos o mas,2007-03-01,3,2,3,2,5
TOLEDO,consulta externa,repetidas en personas de 60 anos o mas,2007-03-01,13,6,13,6,19
TOMAVE,consulta externa,repetidas en personas de 60 anos o mas,2007-03-01,3,5,3,5,8
TOMINA,consulta externa,repetidas en personas de 60 anos o mas,2007-03-01,1,7,1,7,8
TORO TORO,consulta externa,repetidas en personas de 60 anos o mas,2007-03-01,1,3,1,3,4
TOTORA(CBBA),consulta externa,repetidas en personas de 60 anos o mas,2007-03-01,6,9,6,9,15
TOTORA(ORR),consulta externa,repetidas en personas de 60 anos o mas,2007-03-01,1,1,1,1,2
TRIGAL,consulta externa,repetidas en personas de 60 anos o mas,2007-03-01,0,1,0,1,1
TRINIDAD,consulta externa,repetidas en personas de 60 anos o mas,2007-03-01,231,301,231,301,532
TUPIZA,consulta externa,repetidas en personas de 60 anos o mas,2007-03-01,43,54,43,54,97
UMALA,consulta externa,repetidas en personas de 60 anos o mas,2007-03-01,1,0,1,0,1
UNCIA,consulta externa,repetidas en personas de 60 anos o mas,2007-03-01,51,68,51,68,119
URIONDO (A. CONCEPCION),consulta externa,repetidas en personas de 60 anos o mas,2007-03-01,5,2,5,2,7
URUBICHA,consulta externa,repetidas en personas de 60 anos o mas,2007-03-01,1,5,1,5,6
UYUNI,consulta externa,repetidas en personas de 60 anos o mas,2007-03-01,93,96,93,96,189
VACAS,consulta externa,repetidas en personas de 60 anos o mas,2007-03-01,10,20,10,20,30
VALLEGRANDE,consulta externa,repetidas en personas de 60 anos o mas,2007-03-01,208,321,208,321,529
VIACHA,consulta externa,repetidas en personas de 60 anos o mas,2007-03-01,219,164,219,164,383
VILLA MONTES,consulta externa,repetidas en personas de 60 anos o mas,2007-03-01,65,43,65,43,108
VILLA NUEVA (LOMA ALTA),consulta externa,repetidas en personas de 60 anos o mas,2007-03-01,1,1,1,1,2
VILLA RIVERO,consulta externa,repetidas en personas de 60 anos o mas,2007-03-01,1,4,1,4,5
VILLA SERRANO,consulta externa,repetidas en personas de 60 anos o mas,2007-03-01,4,10,4,10,14
VILLA TUNARI,consulta externa,repetidas en personas de 60 anos o mas,2007-03-01,46,31,46,31,77
VILLA VACA GUZMAN (MUYUPAMPA),consulta externa,repetidas en personas de 60 anos o mas,2007-03-01,5,5,5,5,10
VILLAZON,consulta externa,repetidas en personas de 60 anos o mas,2007-03-01,26,57,26,57,83
VINTO,consulta externa,repetidas en personas de 60 anos o mas,2007-03-01,1,7,1,7,8
VITICHI,consulta externa,repetidas en personas de 60 anos o mas,2007-03-01,3,4,3,4,7
WALDO BALLIVIAN,consulta externa,repetidas en personas de 60 anos o mas,2007-03-01,1,3,1,3,4
WARNES,consulta externa,repetidas en personas de 60 anos o mas,2007-03-01,6,10,6,10,16
YACO,consulta externa,repetidas en personas de 60 anos o mas,2007-03-01,1,1,1,1,2
YACUIBA,consulta externa,repetidas en personas de 60 anos o mas,2007-03-01,167,327,167,327,494
YAMPARAEZ,consulta externa,repetidas en personas de 60 anos o mas,2007-03-01,7,4,7,4,11
YANACACHI,consulta externa,repetidas en personas de 60 anos o mas,2007-03-01,0,2,0,2,2
YAPACANI,consulta externa,repetidas en personas de 60 anos o mas,2007-03-01,5,1,5,1,6
YOCALLA,consulta externa,repetidas en personas de 60 anos o mas,2007-03-01,2,3,2,3,5
YOTALA,consulta externa,repetidas en personas de 60 anos o mas,2007-03-01,3,10,3,10,13
YUNCHARA,consulta externa,repetidas en personas de 60 anos o mas,2007-03-01,0,1,0,1,1
ZUDAÑEZ,consulta externa,repetidas en personas de 60 anos o mas,2007-03-01,4,3,4,3,7
ACACIO,consulta externa,repetidas en personas de 60 anos o mas,2007-04-01,0,1,0,1,1
ACHACACHI,consulta externa,repetidas en personas de 60 anos o mas,2007-04-01,44,28,44,28,72
ACHOCALLA,consulta externa,repetidas en personas de 60 anos o mas,2007-04-01,3,0,3,0,3
AIQUILE,consulta externa,repetidas en personas de 60 anos o mas,2007-04-01,47,63,47,63,110
ALALAY,consulta externa,repetidas en personas de 60 anos o mas,2007-04-01,0,1,0,1,1
ANCORAIMES,consulta externa,repetidas en personas de 60 anos o mas,2007-04-01,9,5,9,5,14
ANDAMARCA,consulta externa,repetidas en personas de 60 anos o mas,2007-04-01,4,1,4,1,5
ANTEQUERA,consulta externa,repetidas en personas de 60 anos o mas,2007-04-01,2,0,2,0,2
ANZALDO,consulta externa,repetidas en personas de 60 anos o mas,2007-04-01,1,2,1,2,3
APOLO,consulta externa,repetidas en personas de 60 anos o mas,2007-04-01,7,18,7,18,25
ARAMPAMPA,consulta externa,repetidas en personas de 60 anos o mas,2007-04-01,1,0,1,0,1
ARANI,consulta externa,repetidas en personas de 60 anos o mas,2007-04-01,6,7,6,7,13
ARBIETO,consulta externa,repetidas en personas de 60 anos o mas,2007-04-01,1,2,1,2,3
ARQUE,consulta externa,repetidas en personas de 60 anos o mas,2007-04-01,0,1,0,1,1
ASCENCION DE GUARAYOS,consulta externa,repetidas en personas de 60 anos o mas,2007-04-01,3,3,3,3,6
ATOCHA,consulta externa,repetidas en personas de 60 anos o mas,2007-04-01,23,39,23,39,62
AUCAPATA,consulta externa,repetidas en personas de 60 anos o mas,2007-04-01,0,3,0,3,3
AYATA,consulta externa,repetidas en personas de 60 anos o mas,2007-04-01,3,1,3,1,4
AYO AYO,consulta externa,repetidas en personas de 60 anos o mas,2007-04-01,5,0,5,0,5
AYOPAYA (V. DE INDEPENDENCIA),consulta externa,repetidas en personas de 60 anos o mas,2007-04-01,11,15,11,15,26
BATALLAS,consulta externa,repetidas en personas de 60 anos o mas,2007-04-01,4,5,4,5,9
BAURES,consulta externa,repetidas en personas de 60 anos o mas,2007-04-01,1,0,1,0,1
BELEN DE ANDAMARCA,consulta externa,repetidas en personas de 60 anos o mas,2007-04-01,0,2,0,2,2
BELEN DE URMIRI,consulta externa,repetidas en personas de 60 anos o mas,2007-04-01,0,2,0,2,2
BERMEJO,consulta externa,repetidas en personas de 60 anos o mas,2007-04-01,55,45,55,45,100
BETANZOS,consulta externa,repetidas en personas de 60 anos o mas,2007-04-01,52,63,52,63,115
BOLPEBRA,consulta externa,repetidas en personas de 60 anos o mas,2007-04-01,0,1,0,1,1
BOYUIBE,consulta externa,repetidas en personas de 60 anos o mas,2007-04-01,2,14,2,14,16
BUENA VISTA,consulta externa,repetidas en personas de 60 anos o mas,2007-04-01,39,22,39,22,61
CABEZAS,consulta externa,repetidas en personas de 60 anos o mas,2007-04-01,3,6,3,6,9
CAIROMA,consulta externa,repetidas en personas de 60 anos o mas,2007-04-01,3,6,3,6,9
"CAIZA ""D""",consulta externa,repetidas en personas de 60 anos o mas,2007-04-01,1,3,1,3,4
CAJUATA,consulta externa,repetidas en personas de 60 anos o mas,2007-04-01,1,0,1,0,1
CALACOTO,consulta externa,repetidas en personas de 60 anos o mas,2007-04-01,5,4,5,4,9
CALAMARCA,consulta externa,repetidas en personas de 60 anos o mas,2007-04-01,4,0,4,0,4
CAMARGO,consulta externa,repetidas en personas de 60 anos o mas,2007-04-01,3,16,3,16,19
CAMATAQUI (C. VILLA ABECIA),consulta externa,repetidas en personas de 60 anos o mas,2007-04-01,6,10,6,10,16
CAMIRI,consulta externa,repetidas en personas de 60 anos o mas,2007-04-01,45,61,45,61,106
CAPINOTA,consulta externa,repetidas en personas de 60 anos o mas,2007-04-01,2,5,2,5,7
CAQUIAVIRI,consulta externa,repetidas en personas de 60 anos o mas,2007-04-01,2,6,2,6,8
CARACOLLO,consulta externa,repetidas en personas de 60 anos o mas,2007-04-01,7,6,7,6,13
CARANAVI,consulta externa,repetidas en personas de 60 anos o mas,2007-04-01,43,25,43,25,68
CARAPARI,consulta externa,repetidas en personas de 60 anos o mas,2007-04-01,0,1,0,1,1
CARIPUYO,consulta externa,repetidas en personas de 60 anos o mas,2007-04-01,2,1,2,1,3
CATACORA,consulta externa,repetidas en personas de 60 anos o mas,2007-04-01,2,4,2,4,6
CHALLAPATA,consulta externa,repetidas en personas de 60 anos o mas,2007-04-01,8,12,8,12,20
CHAQUI,consulta externa,repetidas en personas de 60 anos o mas,2007-04-01,0,1,0,1,1
CHARAGUA,consulta externa,repetidas en personas de 60 anos o mas,2007-04-01,5,2,5,2,7
CHAYANTA,consulta externa,repetidas en personas de 60 anos o mas,2007-04-01,4,9,4,9,13
CHIMORE,consulta externa,repetidas en personas de 60 anos o mas,2007-04-01,3,0,3,0,3
CHOQUE COTA,consulta externa,repetidas en personas de 60 anos o mas,2007-04-01,1,2,1,2,3
CHULUMANI (V. DE LA LIBERTAD),consulta externa,repetidas en personas de 60 anos o mas,2007-04-01,16,20,16,20,36
CHUMA,consulta externa,repetidas en personas de 60 anos o mas,2007-04-01,4,0,4,0,4
CLIZA,consulta externa,repetidas en personas de 60 anos o mas,2007-04-01,9,10,9,10,19
COBIJA,consulta externa,repetidas en personas de 60 anos o mas,2007-04-01,32,54,32,54,86
COCHABAMBA,consulta externa,repetidas en personas de 60 anos o mas,2007-04-01,5588,7395,5588,7395,12983
COLCAPIRHUA,consulta externa,repetidas en personas de 60 anos o mas,2007-04-01,66,78,66,78,144
"COLCHA ""K""",consulta externa,repetidas en personas de 60 anos o mas,2007-04-01,5,7,5,7,12
COLOMI,consulta externa,repetidas en personas de 60 anos o mas,2007-04-01,2,1,2,1,3
COLPA BELGICA,consulta externa,repetidas en personas de 60 anos o mas,2007-04-01,26,13,26,13,39
COLQUECHACA,consulta externa,repetidas en personas de 60 anos o mas,2007-04-01,4,6,4,6,10
COLQUENCHA,consulta externa,repetidas en personas de 60 anos o mas,2007-04-01,5,1,5,1,6
COLQUIRI,consulta externa,repetidas en personas de 60 anos o mas,2007-04-01,1,0,1,0,1
COMANCHE,consulta externa,repetidas en personas de 60 anos o mas,2007-04-01,5,2,5,2,7
COMARAPA,consulta externa,repetidas en personas de 60 anos o mas,2007-04-01,16,14,16,14,30
COMBAYA,consulta externa,repetidas en personas de 60 anos o mas,2007-04-01,0,1,0,1,1
COPACABANA,consulta externa,repetidas en personas de 60 anos o mas,2007-04-01,1,1,1,1,2
CORIPATA,consulta externa,repetidas en personas de 60 anos o mas,2007-04-01,1,1,1,1,2
CORO CORO,consulta externa,repetidas en personas de 60 anos o mas,2007-04-01,0,1,0,1,1
COROICO,consulta externa,repetidas en personas de 60 anos o mas,2007-04-01,46,64,46,64,110
CORQUE,consulta externa,repetidas en personas de 60 anos o mas,2007-04-01,4,10,4,10,14
COTAGAITA,consulta externa,repetidas en personas de 60 anos o mas,2007-04-01,28,36,28,36,64
COTOCA,consulta externa,repetidas en personas de 60 anos o mas,2007-04-01,2,1,2,1,3
CUATRO CAÑADAS,consulta externa,repetidas en personas de 60 anos o mas,2007-04-01,9,19,9,19,28
CUCHUMUELA (V. G. VILLARROEL),consulta externa,repetidas en personas de 60 anos o mas,2007-04-01,3,1,3,1,4
CUEVO,consulta externa,repetidas en personas de 60 anos o mas,2007-04-01,0,6,0,6,6
CULPINA,consulta externa,repetidas en personas de 60 anos o mas,2007-04-01,1,1,1,1,2
DESAGUADERO,consulta externa,repetidas en personas de 60 anos o mas,2007-04-01,3,2,3,2,5
EL ALTO,consulta externa,repetidas en personas de 60 anos o mas,2007-04-01,881,1038,881,1038,1919
EL PUENTE(STC),consulta externa,repetidas en personas de 60 anos o mas,2007-04-01,1,1,1,1,2
EL PUENTE(TJA),consulta externa,repetidas en personas de 60 anos o mas,2007-04-01,0,2,0,2,2
EL TORNO,consulta externa,repetidas en personas de 60 anos o mas,2007-04-01,262,249,262,249,511
EL VILLAR,consulta externa,repetidas en personas de 60 anos o mas,2007-04-01,1,1,1,1,2
ENTRE RIOS,consulta externa,repetidas en personas de 60 anos o mas,2007-04-01,5,5,5,5,10
ENTRE RIOS,consulta externa,repetidas en personas de 60 anos o mas,2007-04-01,1,1,1,1,2
EUCALIPTUS,consulta externa,repetidas en personas de 60 anos o mas,2007-04-01,7,9,7,9,16
EXALTACION,consulta externa,repetidas en personas de 60 anos o mas,2007-04-01,5,3,5,3,8
FERNANDEZ ALONSO,consulta externa,repetidas en personas de 60 anos o mas,2007-04-01,0,2,0,2,2
FILADELFIA,consulta externa,repetidas en personas de 60 anos o mas,2007-04-01,1,0,1,0,1
GENERAL SAAVEDRA,consulta externa,repetidas en personas de 60 anos o mas,2007-04-01,1,3,1,3,4
GRAL. J.J. PEREZ (CHARAZANI),consulta externa,repetidas en personas de 60 anos o mas,2007-04-01,3,2,3,2,5
GUANAY,consulta externa,repetidas en personas de 60 anos o mas,2007-04-01,5,10,5,10,15
GUAQUI,consulta externa,repetidas en personas de 60 anos o mas,2007-04-01,3,5,3,5,8
GUAYARAMERIN,consulta externa,repetidas en personas de 60 anos o mas,2007-04-01,182,182,182,182,364
GUTIERREZ,consulta externa,repetidas en personas de 60 anos o mas,2007-04-01,4,6,4,6,10
HUACARETA,consulta externa,repetidas en personas de 60 anos o mas,2007-04-01,8,4,8,4,12
HUACHACALLA,consulta externa,repetidas en personas de 60 anos o mas,2007-04-01,1,1,1,1,2
HUANUNI,consulta externa,repetidas en personas de 60 anos o mas,2007-04-01,135,152,135,152,287
HUARACAJE,consulta externa,repetidas en personas de 60 anos o mas,2007-04-01,2,5,2,5,7
HUAYLLAMARCA,consulta externa,repetidas en personas de 60 anos o mas,2007-04-01,0,2,0,2,2
ICHOCA,consulta externa,repetidas en personas de 60 anos o mas,2007-04-01,1,0,1,0,1
ICLA,consulta externa,repetidas en personas de 60 anos o mas,2007-04-01,3,2,3,2,5
INCAHUASI,consulta externa,repetidas en personas de 60 anos o mas,2007-04-01,0,3,0,3,3
INQUISIVI,consulta externa,repetidas en personas de 60 anos o mas,2007-04-01,7,4,7,4,11
IRUPANA (VILLA DE LANZA),consulta externa,repetidas en personas de 60 anos o mas,2007-04-01,7,7,7,7,14
IXIAMAS,consulta externa,repetidas en personas de 60 anos o mas,2007-04-01,1,0,1,0,1
JESUS DE MACHACA,consulta externa,repetidas en personas de 60 anos o mas,2007-04-01,19,16,19,16,35
LA ASUNTA,consulta externa,repetidas en personas de 60 anos o mas,2007-04-01,2,4,2,4,6
LA GUARDIA,consulta externa,repetidas en personas de 60 anos o mas,2007-04-01,6,7,6,7,13
LA PAZ,consulta externa,repetidas en personas de 60 anos o mas,2007-04-01,9296,13397,9296,13397,22693
LA RIVERA,consulta externa,repetidas en personas de 60 anos o mas,2007-04-01,1,0,1,0,1
LAGUNILLAS,consulta externa,repetidas en personas de 60 anos o mas,2007-04-01,5,1,5,1,6
LAJA,consulta externa,repetidas en personas de 60 anos o mas,2007-04-01,18,12,18,12,30
LAS CARRERAS,consulta externa,repetidas en personas de 60 anos o mas,2007-04-01,5,5,5,5,10
LICOMA PAMPA,consulta externa,repetidas en personas de 60 anos o mas,2007-04-01,1,1,1,1,2
LLALLAGUA,consulta externa,repetidas en personas de 60 anos o mas,2007-04-01,39,42,39,42,81
LLICA,consulta externa,repetidas en personas de 60 anos o mas,2007-04-01,8,4,8,4,12
LORETO,consulta externa,repetidas en personas de 60 anos o mas,2007-04-01,2,2,2,2,4
LURIBAY,consulta externa,repetidas en personas de 60 anos o mas,2007-04-01,1,2,1,2,3
MACHACAMARCA,consulta externa,repetidas en personas de 60 anos o mas,2007-04-01,31,28,31,28,59
MACHARETI,consulta externa,repetidas en personas de 60 anos o mas,2007-04-01,10,9,10,9,19
MAGDALENA,consulta externa,repetidas en personas de 60 anos o mas,2007-04-01,53,98,53,98,151
MAIRANA,consulta externa,repetidas en personas de 60 anos o mas,2007-04-01,2,0,2,0,2
MALLA,consulta externa,repetidas en personas de 60 anos o mas,2007-04-01,0,3,0,3,3
MAPIRI,consulta externa,repetidas en personas de 60 anos o mas,2007-04-01,2,3,2,3,5
MECAPACA,consulta externa,repetidas en personas de 60 anos o mas,2007-04-01,5,4,5,4,9
MIZQUE,consulta externa,repetidas en personas de 60 anos o mas,2007-04-01,3,3,3,3,6
MOCOMOCO,consulta externa,repetidas en personas de 60 anos o mas,2007-04-01,5,4,5,4,9
MOJINETE,consulta externa,repetidas en personas de 60 anos o mas,2007-04-01,0,1,0,1,1
MOJOCOYA,consulta externa,repetidas en personas de 60 anos o mas,2007-04-01,1,3,1,3,4
MONTEAGUDO,consulta externa,repetidas en personas de 60 anos o mas,2007-04-01,118,118,118,118,236
MONTERO,consulta externa,repetidas en personas de 60 anos o mas,2007-04-01,471,374,471,374,845
MORO MORO,consulta externa,repetidas en personas de 60 anos o mas,2007-04-01,2,2,2,2,4
MOROCHATA,consulta externa,repetidas en personas de 60 anos o mas,2007-04-01,4,12,4,12,16
NACEBE (SANTA ROSA DEL ABUNA),consulta externa,repetidas en personas de 60 anos o mas,2007-04-01,4,0,4,0,4
OKINAWA,consulta externa,repetidas en personas de 60 anos o mas,2007-04-01,8,10,8,10,18
ORURO,consulta externa,repetidas en personas de 60 anos o mas,2007-04-01,1613,1858,1613,1858,3471
PADCAYA,consulta externa,repetidas en personas de 60 anos o mas,2007-04-01,19,23,19,23,42
PADILLA,consulta externa,repetidas en personas de 60 anos o mas,2007-04-01,10,31,10,31,41
PALCA,consulta externa,repetidas en personas de 60 anos o mas,2007-04-01,4,8,4,8,12
PALOS BLANCOS,consulta externa,repetidas en personas de 60 anos o mas,2007-04-01,5,6,5,6,11
PAMPA GRANDE,consulta externa,repetidas en personas de 60 anos o mas,2007-04-01,1,2,1,2,3
PAPEL PAMPA,consulta externa,repetidas en personas de 60 anos o mas,2007-04-01,1,2,1,2,3
PASORAPA,consulta externa,repetidas en personas de 60 anos o mas,2007-04-01,1,1,1,1,2
PATACAMAYA,consulta externa,repetidas en personas de 60 anos o mas,2007-04-01,2,3,2,3,5
PAZÑA,consulta externa,repetidas en personas de 60 anos o mas,2007-04-01,7,17,7,17,24
POCOATA,consulta externa,repetidas en personas de 60 anos o mas,2007-04-01,1,0,1,0,1
POCONA,consulta externa,repetidas en personas de 60 anos o mas,2007-04-01,1,10,1,10,11
POOPO,consulta externa,repetidas en personas de 60 anos o mas,2007-04-01,9,12,9,12,21
PORCO,consulta externa,repetidas en personas de 60 anos o mas,2007-04-01,0,1,0,1,1
POROMA,consulta externa,repetidas en personas de 60 anos o mas,2007-04-01,22,6,22,6,28
PORONGO,consulta externa,repetidas en personas de 60 anos o mas,2007-04-01,1,0,1,0,1
PORTACHUELO,consulta externa,repetidas en personas de 60 anos o mas,2007-04-01,14,19,14,19,33
PORVENIR,consulta externa,repetidas en personas de 60 anos o mas,2007-04-01,1,1,1,1,2
POSTRER VALLE,consulta externa,repetidas en personas de 60 anos o mas,2007-04-01,1,2,1,2,3
POTOSI,consulta externa,repetidas en personas de 60 anos o mas,2007-04-01,1030,1482,1030,1482,2512
PRESTO,consulta externa,repetidas en personas de 60 anos o mas,2007-04-01,0,1,0,1,1
PUCARA,consulta externa,repetidas en personas de 60 anos o mas,2007-04-01,4,14,4,14,18
PUCARANI,consulta externa,repetidas en personas de 60 anos o mas,2007-04-01,3,11,3,11,14
PUERTO ACOSTA,consulta externa,repetidas en personas de 60 anos o mas,2007-04-01,31,14,31,14,45
PUERTO CARABUCO,consulta externa,repetidas en personas de 60 anos o mas,2007-04-01,5,10,5,10,15
PUERTO PEREZ,consulta externa,repetidas en personas de 60 anos o mas,2007-04-01,0,3,0,3,3
PUERTO QUIJARRO,consulta externa,repetidas en personas de 60 anos o mas,2007-04-01,5,6,5,6,11
PUERTO RICO,consulta externa,repetidas en personas de 60 anos o mas,2007-04-01,3,0,3,0,3
PUERTO SILES,consulta externa,repetidas en personas de 60 anos o mas,2007-04-01,3,2,3,2,5
PUERTO SUAREZ,consulta externa,repetidas en personas de 60 anos o mas,2007-04-01,12,12,12,12,24
PUERTO VILLARROEL,consulta externa,repetidas en personas de 60 anos o mas,2007-04-01,8,6,8,6,14
PUNA,consulta externa,repetidas en personas de 60 anos o mas,2007-04-01,6,7,6,7,13
PUNATA,consulta externa,repetidas en personas de 60 anos o mas,2007-04-01,86,106,86,106,192
QUIABAYA,consulta externa,repetidas en personas de 60 anos o mas,2007-04-01,1,0,1,0,1
QUILLACOLLO,consulta externa,repetidas en personas de 60 anos o mas,2007-04-01,299,419,299,419,718
QUIME,consulta externa,repetidas en personas de 60 anos o mas,2007-04-01,1,0,1,0,1
QUIRUSILLAS,consulta externa,repetidas en personas de 60 anos o mas,2007-04-01,0,1,0,1,1
REYES,consulta externa,repetidas en personas de 60 anos o mas,2007-04-01,50,65,50,65,115
RIBERALTA,consulta externa,repetidas en personas de 60 anos o mas,2007-04-01,14,7,14,7,21
ROBORE,consulta externa,repetidas en personas de 60 anos o mas,2007-04-01,11,30,11,30,41
RURRENABAQUE,consulta externa,repetidas en personas de 60 anos o mas,2007-04-01,83,109,83,109,192
SABAYA,consulta externa,repetidas en personas de 60 anos o mas,2007-04-01,4,4,4,4,8
SACABA,consulta externa,repetidas en personas de 60 anos o mas,2007-04-01,75,181,75,181,256
SACABAMBA,consulta externa,repetidas en personas de 60 anos o mas,2007-04-01,2,5,2,5,7
SALINAS DE GARCI MENDOZA,consulta externa,repetidas en personas de 60 anos o mas,2007-04-01,9,5,9,5,14
SAMAIPATA,consulta externa,repetidas en personas de 60 anos o mas,2007-04-01,4,2,4,2,6
SAN AGUSTIN,consulta externa,repetidas en personas de 60 anos o mas,2007-04-01,1,0,1,0,1
SAN ANDRES,consulta externa,repetidas en personas de 60 anos o mas,2007-04-01,1,7,1,7,8
SAN ANDRES DE MACHACA,consulta externa,repetidas en personas de 60 anos o mas,2007-04-01,3,3,3,3,6
SAN ANTONIO DE ESMORUCO,consulta externa,repetidas en personas de 60 anos o mas,2007-04-01,5,1,5,1,6
SAN BENITO,consulta externa,repetidas en personas de 60 anos o mas,2007-04-01,2,5,2,5,7
SAN BORJA,consulta externa,repetidas en personas de 60 anos o mas,2007-04-01,34,82,34,82,116
SAN BUENA VENTURA,consulta externa,repetidas en personas de 60 anos o mas,2007-04-01,8,6,8,6,14
SAN CARLOS,consulta externa,repetidas en personas de 60 anos o mas,2007-04-01,13,27,13,27,40
SAN IGNACIO,consulta externa,repetidas en personas de 60 anos o mas,2007-04-01,74,84,74,84,158
SAN IGNACIO DE VELASCO,consulta externa,repetidas en personas de 60 anos o mas,2007-04-01,59,99,59,99,158
SAN JAVIER(BNI),consulta externa,repetidas en personas de 60 anos o mas,2007-04-01,1,0,1,0,1
SAN JAVIER(STC),consulta externa,repetidas en personas de 60 anos o mas,2007-04-01,6,3,6,3,9
SAN JOAQUIN,consulta externa,repetidas en personas de 60 anos o mas,2007-04-01,10,5,10,5,15
SAN JOSE DE CHIQUITOS,consulta externa,repetidas en personas de 60 anos o mas,2007-04-01,3,10,3,10,13
SAN JUAN DE YAPACANI,consulta externa,repetidas en personas de 60 anos o mas,2007-04-01,2,3,2,3,5
SAN JULIAN,consulta externa,repetidas en personas de 60 anos o mas,2007-04-01,10,6,10,6,16
SAN LUCAS,consulta externa,repetidas en personas de 60 anos o mas,2007-04-01,5,7,5,7,12
SAN MATIAS,consulta externa,repetidas en personas de 60 anos o mas,2007-04-01,3,2,3,2,5
SAN MIGUEL DE VELASCO,consulta externa,repetidas en personas de 60 anos o mas,2007-04-01,43,78,43,78,121
SAN PABLO DE LIPEZ,consulta externa,repetidas en personas de 60 anos o mas,2007-04-01,0,1,0,1,1
SAN PEDRO,consulta externa,repetidas en personas de 60 anos o mas,2007-04-01,3,7,3,7,10
SAN PEDRO DE BUENA VISTA,consulta externa,repetidas en personas de 60 anos o mas,2007-04-01,13,4,13,4,17
SAN PEDRO DE CURAHUARA,consulta externa,repetidas en personas de 60 anos o mas,2007-04-01,5,4,5,4,9
SAN PEDRO DE TIQUINA,consulta externa,repetidas en personas de 60 anos o mas,2007-04-01,1,1,1,1,2
SAN RAFAEL,consulta externa,repetidas en personas de 60 anos o mas,2007-04-01,6,2,6,2,8
SAN RAMON,consulta externa,repetidas en personas de 60 anos o mas,2007-04-01,20,42,20,42,62
SAN RAMON,consulta externa,repetidas en personas de 60 anos o mas,2007-04-01,6,5,6,5,11
SANTA ANA,consulta externa,repetidas en personas de 60 anos o mas,2007-04-01,59,74,59,74,133
SANTA CRUZ DE LA SIERRA,consulta externa,repetidas en personas de 60 anos o mas,2007-04-01,3068,4745,3068,4745,7813
SANTA ROSA,consulta externa,repetidas en personas de 60 anos o mas,2007-04-01,1,0,1,0,1
SANTA ROSA DEL SARA,consulta externa,repetidas en personas de 60 anos o mas,2007-04-01,2,1,2,1,3
SANTIAGO DE CALLAPA,consulta externa,repetidas en personas de 60 anos o mas,2007-04-01,2,0,2,0,2
SANTIAGO DE HUARI,consulta externa,repetidas en personas de 60 anos o mas,2007-04-01,31,33,31,33,64
SANTIAGO DE MACHACA,consulta externa,repetidas en personas de 60 anos o mas,2007-04-01,0,3,0,3,3
SANTIVAÑES,consulta externa,repetidas en personas de 60 anos o mas,2007-04-01,7,5,7,5,12
SANTUARIO DE QUILLACAS,consulta externa,repetidas en personas de 60 anos o mas,2007-04-01,1,4,1,4,5
SAPAHAQUI,consulta externa,repetidas en personas de 60 anos o mas,2007-04-01,0,2,0,2,2
SICAYA,consulta externa,repetidas en personas de 60 anos o mas,2007-04-01,0,1,0,1,1
SIPE SIPE,consulta externa,repetidas en personas de 60 anos o mas,2007-04-01,12,14,12,14,26
SOPACHUY,consulta externa,repetidas en personas de 60 anos o mas,2007-04-01,2,9,2,9,11
SORACACHI,consulta externa,repetidas en personas de 60 anos o mas,2007-04-01,4,0,4,0,4
SORATA,consulta externa,repetidas en personas de 60 anos o mas,2007-04-01,4,1,4,1,5
SUCRE,consulta externa,repetidas en personas de 60 anos o mas,2007-04-01,1746,2756,1746,2756,4502
TACACHI,consulta externa,repetidas en personas de 60 anos o mas,2007-04-01,2,6,2,6,8
TACACOMA,consulta externa,repetidas en personas de 60 anos o mas,2007-04-01,0,1,0,1,1
TACOPAYA,consulta externa,repetidas en personas de 60 anos o mas,2007-04-01,1,4,1,4,5
TAHUA,consulta externa,repetidas en personas de 60 anos o mas,2007-04-01,3,4,3,4,7
TAPACARI,consulta externa,repetidas en personas de 60 anos o mas,2007-04-01,2,5,2,5,7
TARABUCO,consulta externa,repetidas en personas de 60 anos o mas,2007-04-01,7,10,7,10,17
TARACO,consulta externa,repetidas en personas de 60 anos o mas,2007-04-01,4,1,4,1,5
TARATA,consulta externa,repetidas en personas de 60 anos o mas,2007-04-01,2,1,2,1,3
TARIJA,consulta externa,repetidas en personas de 60 anos o mas,2007-04-01,1325,2125,1325,2125,3450
TARVITA,consulta externa,repetidas en personas de 60 anos o mas,2007-04-01,1,2,1,2,3
TEOPONTE,consulta externa,repetidas en personas de 60 anos o mas,2007-04-01,6,4,6,4,10
TIAWANACU,consulta externa,repetidas en personas de 60 anos o mas,2007-04-01,0,4,0,4,4
TINGUIPAYA,consulta externa,repetidas en personas de 60 anos o mas,2007-04-01,0,1,0,1,1
TIPUANI,consulta externa,repetidas en personas de 60 anos o mas,2007-04-01,4,5,4,5,9
TIQUIPAYA,consulta externa,repetidas en personas de 60 anos o mas,2007-04-01,11,19,11,19,30
TIRAQUE (CBBA),consulta externa,repetidas en personas de 60 anos o mas,2007-04-01,14,9,14,9,23
TITO YUPANQUI (PARQUIPUJIO),consulta externa,repetidas en personas de 60 anos o mas,2007-04-01,5,4,5,4,9
TOCO,consulta externa,repetidas en personas de 60 anos o mas,2007-04-01,1,2,1,2,3
TOLATA,consulta externa,repetidas en personas de 60 anos o mas,2007-04-01,1,0,1,0,1
TOLEDO,consulta externa,repetidas en personas de 60 anos o mas,2007-04-01,5,11,5,11,16
TOMAVE,consulta externa,repetidas en personas de 60 anos o mas,2007-04-01,2,3,2,3,5
TOMINA,consulta externa,repetidas en personas de 60 anos o mas,2007-04-01,3,2,3,2,5
TORO TORO,consulta externa,repetidas en personas de 60 anos o mas,2007-04-01,2,4,2,4,6
TOTORA(CBBA),consulta externa,repetidas en personas de 60 anos o mas,2007-04-01,8,8,8,8,16
TRIGAL,consulta externa,repetidas en personas de 60 anos o mas,2007-04-01,1,2,1,2,3
TRINIDAD,consulta externa,repetidas en personas de 60 anos o mas,2007-04-01,372,466,372,466,838
TUPIZA,consulta externa,repetidas en personas de 60 anos o mas,2007-04-01,36,58,36,58,94
TURCO,consulta externa,repetidas en personas de 60 anos o mas,2007-04-01,0,1,0,1,1
UMALA,consulta externa,repetidas en personas de 60 anos o mas,2007-04-01,3,2,3,2,5
UNCIA,consulta externa,repetidas en personas de 60 anos o mas,2007-04-01,41,80,41,80,121
URIONDO (A. CONCEPCION),consulta externa,repetidas en personas de 60 anos o mas,2007-04-01,9,13,9,13,22
URUBICHA,consulta externa,repetidas en personas de 60 anos o mas,2007-04-01,0,1,0,1,1
UYUNI,consulta externa,repetidas en personas de 60 anos o mas,2007-04-01,86,95,86,95,181
VACAS,consulta externa,repetidas en personas de 60 anos o mas,2007-04-01,3,16,3,16,19
VALLEGRANDE,consulta externa,repetidas en personas de 60 anos o mas,2007-04-01,164,308,164,308,472
VIACHA,consulta externa,repetidas en personas de 60 anos o mas,2007-04-01,171,189,171,189,360
VILLA MONTES,consulta externa,repetidas en personas de 60 anos o mas,2007-04-01,16,29,16,29,45
VILLA NUEVA (LOMA ALTA),consulta externa,repetidas en personas de 60 anos o mas,2007-04-01,1,1,1,1,2
VILLA RIVERO,consulta externa,repetidas en personas de 60 anos o mas,2007-04-01,3,4,3,4,7
VILLA SERRANO,consulta externa,repetidas en personas de 60 anos o mas,2007-04-01,9,4,9,4,13
VILLA TUNARI,consulta externa,repetidas en personas de 60 anos o mas,2007-04-01,3,3,3,3,6
VILLA VACA GUZMAN (MUYUPAMPA),consulta externa,repetidas en personas de 60 anos o mas,2007-04-01,2,4,2,4,6
VILLAZON,consulta externa,repetidas en personas de 60 anos o mas,2007-04-01,14,63,14,63,77
VINTO,consulta externa,repetidas en personas de 60 anos o mas,2007-04-01,3,15,3,15,18
VITICHI,consulta externa,repetidas en personas de 60 anos o mas,2007-04-01,5,4,5,4,9
WALDO BALLIVIAN,consulta externa,repetidas en personas de 60 anos o mas,2007-04-01,0,6,0,6,6
WARNES,consulta externa,repetidas en personas de 60 anos o mas,2007-04-01,3,9,3,9,12
YACO,consulta externa,repetidas en personas de 60 anos o mas,2007-04-01,3,2,3,2,5
YACUIBA,consulta externa,repetidas en personas de 60 anos o mas,2007-04-01,95,138,95,138,233
YAMPARAEZ,consulta externa,repetidas en personas de 60 anos o mas,2007-04-01,2,12,2,12,14
YAPACANI,consulta externa,repetidas en personas de 60 anos o mas,2007-04-01,9,10,9,10,19
YOCALLA,consulta externa,repetidas en personas de 60 anos o mas,2007-04-01,1,2,1,2,3
YOTALA,consulta externa,repetidas en personas de 60 anos o mas,2007-04-01,9,17,9,17,26
YUNCHARA,consulta externa,repetidas en personas de 60 anos o mas,2007-04-01,0,1,0,1,1
ZUDAÑEZ,consulta externa,repetidas en personas de 60 anos o mas,2007-04-01,1,3,1,3,4
ACHACACHI,consulta externa,repetidas en personas de 60 anos o mas,2007-05-01,38,18,38,18,56
ACHOCALLA,consulta externa,repetidas en personas de 60 anos o mas,2007-05-01,1,1,1,1,2
AIQUILE,consulta externa,repetidas en personas de 60 anos o mas,2007-05-01,65,57,65,57,122
ALALAY,consulta externa,repetidas en personas de 60 anos o mas,2007-05-01,0,1,0,1,1
ANCORAIMES,consulta externa,repetidas en personas de 60 anos o mas,2007-05-01,8,2,8,2,10
ANDAMARCA,consulta externa,repetidas en personas de 60 anos o mas,2007-05-01,1,1,1,1,2
ANZALDO,consulta externa,repetidas en personas de 60 anos o mas,2007-05-01,0,2,0,2,2
APOLO,consulta externa,repetidas en personas de 60 anos o mas,2007-05-01,6,3,6,3,9
ARANI,consulta externa,repetidas en personas de 60 anos o mas,2007-05-01,2,2,2,2,4
ARBIETO,consulta externa,repetidas en personas de 60 anos o mas,2007-05-01,1,2,1,2,3
ARQUE,consulta externa,repetidas en personas de 60 anos o mas,2007-05-01,1,1,1,1,2
ASCENCION DE GUARAYOS,consulta externa,repetidas en personas de 60 anos o mas,2007-05-01,1,0,1,0,1
ATOCHA,consulta externa,repetidas en personas de 60 anos o mas,2007-05-01,26,46,26,46,72
AUCAPATA,consulta externa,repetidas en personas de 60 anos o mas,2007-05-01,1,0,1,0,1
AYATA,consulta externa,repetidas en personas de 60 anos o mas,2007-05-01,1,1,1,1,2
AYO AYO,consulta externa,repetidas en personas de 60 anos o mas,2007-05-01,6,1,6,1,7
AYOPAYA (V. DE INDEPENDENCIA),consulta externa,repetidas en personas de 60 anos o mas,2007-05-01,7,13,7,13,20
BATALLAS,consulta externa,repetidas en personas de 60 anos o mas,2007-05-01,2,3,2,3,5
BAURES,consulta externa,repetidas en personas de 60 anos o mas,2007-05-01,3,2,3,2,5
BELEN DE URMIRI,consulta externa,repetidas en personas de 60 anos o mas,2007-05-01,1,0,1,0,1
BERMEJO,consulta externa,repetidas en personas de 60 anos o mas,2007-05-01,56,57,56,57,113
BETANZOS,consulta externa,repetidas en personas de 60 anos o mas,2007-05-01,47,89,47,89,136
BOLIVAR,consulta externa,repetidas en personas de 60 anos o mas,2007-05-01,1,1,1,1,2
BOYUIBE,consulta externa,repetidas en personas de 60 anos o mas,2007-05-01,0,1,0,1,1
BUENA VISTA,consulta externa,repetidas en personas de 60 anos o mas,2007-05-01,18,11,18,11,29
CABEZAS,consulta externa,repetidas en personas de 60 anos o mas,2007-05-01,1,1,1,1,2
CAIROMA,consulta externa,repetidas en personas de 60 anos o mas,2007-05-01,8,1,8,1,9
"CAIZA ""D""",consulta externa,repetidas en personas de 60 anos o mas,2007-05-01,2,4,2,4,6
CAJUATA,consulta externa,repetidas en personas de 60 anos o mas,2007-05-01,1,1,1,1,2
CALACOTO,consulta externa,repetidas en personas de 60 anos o mas,2007-05-01,1,2,1,2,3
CALAMARCA,consulta externa,repetidas en personas de 60 anos o mas,2007-05-01,3,1,3,1,4
CAMARGO,consulta externa,repetidas en personas de 60 anos o mas,2007-05-01,10,17,10,17,27
CAMATAQUI (C. VILLA ABECIA),consulta externa,repetidas en personas de 60 anos o mas,2007-05-01,12,8,12,8,20
CAMIRI,consulta externa,repetidas en personas de 60 anos o mas,2007-05-01,50,108,50,108,158
CAPINOTA,consulta externa,repetidas en personas de 60 anos o mas,2007-05-01,27,39,27,39,66
CAQUIAVIRI,consulta externa,repetidas en personas de 60 anos o mas,2007-05-01,0,2,0,2,2
CARACOLLO,consulta externa,repetidas en personas de 60 anos o mas,2007-05-01,9,9,9,9,18
CARANAVI,consulta externa,repetidas en personas de 60 anos o mas,2007-05-01,33,17,33,17,50
CARAPARI,consulta externa,repetidas en personas de 60 anos o mas,2007-05-01,3,0,3,0,3
CARIPUYO,consulta externa,repetidas en personas de 60 anos o mas,2007-05-01,1,0,1,0,1
CATACORA,consulta externa,repetidas en personas de 60 anos o mas,2007-05-01,1,2,1,2,3
CHALLAPATA,consulta externa,repetidas en personas de 60 anos o mas,2007-05-01,6,3,6,3,9
CHAQUI,consulta externa,repetidas en personas de 60 anos o mas,2007-05-01,0,1,0,1,1
CHARAGUA,consulta externa,repetidas en personas de 60 anos o mas,2007-05-01,4,2,4,2,6
CHARAÑA,consulta externa,repetidas en personas de 60 anos o mas,2007-05-01,1,0,1,0,1
CHAYANTA,consulta externa,repetidas en personas de 60 anos o mas,2007-05-01,4,8,4,8,12
CHIMORE,consulta externa,repetidas en personas de 60 anos o mas,2007-05-01,1,3,1,3,4
CHOQUE COTA,consulta externa,repetidas en personas de 60 anos o mas,2007-05-01,1,1,1,1,2
CHULUMANI (V. DE LA LIBERTAD),consulta externa,repetidas en personas de 60 anos o mas,2007-05-01,18,20,18,20,38
CHUMA,consulta externa,repetidas en personas de 60 anos o mas,2007-05-01,6,0,6,0,6
CLIZA,consulta externa,repetidas en personas de 60 anos o mas,2007-05-01,7,12,7,12,19
COBIJA,consulta externa,repetidas en personas de 60 anos o mas,2007-05-01,22,55,22,55,77
COCHABAMBA,consulta externa,repetidas en personas de 60 anos o mas,2007-05-01,6458,7869,6458,7869,14327
COIPASA,consulta externa,repetidas en personas de 60 anos o mas,2007-05-01,4,0,4,0,4
COLCAPIRHUA,consulta externa,repetidas en personas de 60 anos o mas,2007-05-01,132,111,132,111,243
"COLCHA ""K""",consulta externa,repetidas en personas de 60 anos o mas,2007-05-01,8,5,8,5,13
COLLANA,consulta externa,repetidas en personas de 60 anos o mas,2007-05-01,3,2,3,2,5
COLOMI,consulta externa,repetidas en personas de 60 anos o mas,2007-05-01,1,1,1,1,2
COLPA BELGICA,consulta externa,repetidas en personas de 60 anos o mas,2007-05-01,19,15,19,15,34
COLQUECHACA,consulta externa,repetidas en personas de 60 anos o mas,2007-05-01,3,5,3,5,8
COLQUENCHA,consulta externa,repetidas en personas de 60 anos o mas,2007-05-01,5,4,5,4,9
COLQUIRI,consulta externa,repetidas en personas de 60 anos o mas,2007-05-01,0,1,0,1,1
COMANCHE,consulta externa,repetidas en personas de 60 anos o mas,2007-05-01,1,3,1,3,4
COMARAPA,consulta externa,repetidas en personas de 60 anos o mas,2007-05-01,19,16,19,16,35
CORIPATA,consulta externa,repetidas en personas de 60 anos o mas,2007-05-01,3,4,3,4,7
CORO CORO,consulta externa,repetidas en personas de 60 anos o mas,2007-05-01,3,0,3,0,3
COROICO,consulta externa,repetidas en personas de 60 anos o mas,2007-05-01,42,63,42,63,105
CORQUE,consulta externa,repetidas en personas de 60 anos o mas,2007-05-01,3,4,3,4,7
COTAGAITA,consulta externa,repetidas en personas de 60 anos o mas,2007-05-01,15,24,15,24,39
COTOCA,consulta externa,repetidas en personas de 60 anos o mas,2007-05-01,1,1,1,1,2
CUATRO CAÑADAS,consulta externa,repetidas en personas de 60 anos o mas,2007-05-01,4,12,4,12,16
CUCHUMUELA (V. G. VILLARROEL),consulta externa,repetidas en personas de 60 anos o mas,2007-05-01,4,2,4,2,6
CULPINA,consulta externa,repetidas en personas de 60 anos o mas,2007-05-01,3,2,3,2,5
CURAHUARA DE CARANGAS,consulta externa,repetidas en personas de 60 anos o mas,2007-05-01,0,3,0,3,3
CURVA,consulta externa,repetidas en personas de 60 anos o mas,2007-05-01,1,8,1,8,9
DESAGUADERO,consulta externa,repetidas en personas de 60 anos o mas,2007-05-01,3,3,3,3,6
EL ALTO,consulta externa,repetidas en personas de 60 anos o mas,2007-05-01,937,1067,937,1067,2004
EL PUENTE(STC),consulta externa,repetidas en personas de 60 anos o mas,2007-05-01,4,1,4,1,5
EL PUENTE(TJA),consulta externa,repetidas en personas de 60 anos o mas,2007-05-01,0,2,0,2,2
EL TORNO,consulta externa,repetidas en personas de 60 anos o mas,2007-05-01,289,268,289,268,557
ENTRE RIOS,consulta externa,repetidas en personas de 60 anos o mas,2007-05-01,2,2,2,2,4
ENTRE RIOS,consulta externa,repetidas en personas de 60 anos o mas,2007-05-01,1,3,1,3,4
ESCARA,consulta externa,repetidas en personas de 60 anos o mas,2007-05-01,0,1,0,1,1
EUCALIPTUS,consulta externa,repetidas en personas de 60 anos o mas,2007-05-01,8,11,8,11,19
EXALTACION,consulta externa,repetidas en personas de 60 anos o mas,2007-05-01,5,6,5,6,11
FERNANDEZ ALONSO,consulta externa,repetidas en personas de 60 anos o mas,2007-05-01,2,4,2,4,6
FILADELFIA,consulta externa,repetidas en personas de 60 anos o mas,2007-05-01,8,0,8,0,8
GENERAL SAAVEDRA,consulta externa,repetidas en personas de 60 anos o mas,2007-05-01,1,0,1,0,1
GRAL. J.J. PEREZ (CHARAZANI),consulta externa,repetidas en personas de 60 anos o mas,2007-05-01,0,4,0,4,4
GUANAY,consulta externa,repetidas en personas de 60 anos o mas,2007-05-01,3,7,3,7,10
GUAQUI,consulta externa,repetidas en personas de 60 anos o mas,2007-05-01,7,6,7,6,13
GUAYARAMERIN,consulta externa,repetidas en personas de 60 anos o mas,2007-05-01,77,118,77,118,195
GUTIERREZ,consulta externa,repetidas en personas de 60 anos o mas,2007-05-01,2,0,2,0,2
HUACARETA,consulta externa,repetidas en personas de 60 anos o mas,2007-05-01,2,6,2,6,8
HUACHACALLA,consulta externa,repetidas en personas de 60 anos o mas,2007-05-01,0,2,0,2,2
HUANUNI,consulta externa,repetidas en personas de 60 anos o mas,2007-05-01,74,77,74,77,151
HUARACAJE,consulta externa,repetidas en personas de 60 anos o mas,2007-05-01,1,1,1,1,2
HUAYLLAMARCA,consulta externa,repetidas en personas de 60 anos o mas,2007-05-01,1,7,1,7,8
ICLA,consulta externa,repetidas en personas de 60 anos o mas,2007-05-01,2,6,2,6,8
INGAVI (HUMAITA),consulta externa,repetidas en personas de 60 anos o mas,2007-05-01,1,1,1,1,2
INQUISIVI,consulta externa,repetidas en personas de 60 anos o mas,2007-05-01,2,1,2,1,3
IRUPANA (VILLA DE LANZA),consulta externa,repetidas en personas de 60 anos o mas,2007-05-01,3,4,3,4,7
JESUS DE MACHACA,consulta externa,repetidas en personas de 60 anos o mas,2007-05-01,21,15,21,15,36
LA GUARDIA,consulta externa,repetidas en personas de 60 anos o mas,2007-05-01,8,43,8,43,51
LA PAZ,consulta externa,repetidas en personas de 60 anos o mas,2007-05-01,9796,13973,9796,13973,23769
LA RIVERA,consulta externa,repetidas en personas de 60 anos o mas,2007-05-01,1,0,1,0,1
LAGUNILLAS,consulta externa,repetidas en personas de 60 anos o mas,2007-05-01,1,2,1,2,3
LAJA,consulta externa,repetidas en personas de 60 anos o mas,2007-05-01,2,2,2,2,4
LAS CARRERAS,consulta externa,repetidas en personas de 60 anos o mas,2007-05-01,16,8,16,8,24
LICOMA PAMPA,consulta externa,repetidas en personas de 60 anos o mas,2007-05-01,1,0,1,0,1
LLALLAGUA,consulta externa,repetidas en personas de 60 anos o mas,2007-05-01,60,73,60,73,133
LLICA,consulta externa,repetidas en personas de 60 anos o mas,2007-05-01,3,9,3,9,12
LORETO,consulta externa,repetidas en personas de 60 anos o mas,2007-05-01,1,0,1,0,1
LURIBAY,consulta externa,repetidas en personas de 60 anos o mas,2007-05-01,7,1,7,1,8
MACHACAMARCA,consulta externa,repetidas en personas de 60 anos o mas,2007-05-01,35,38,35,38,73
MACHARETI,consulta externa,repetidas en personas de 60 anos o mas,2007-05-01,5,5,5,5,10
MAGDALENA,consulta externa,repetidas en personas de 60 anos o mas,2007-05-01,36,88,36,88,124
MAIRANA,consulta externa,repetidas en personas de 60 anos o mas,2007-05-01,2,0,2,0,2
MALLA,consulta externa,repetidas en personas de 60 anos o mas,2007-05-01,1,1,1,1,2
MAPIRI,consulta externa,repetidas en personas de 60 anos o mas,2007-05-01,3,4,3,4,7
MECAPACA,consulta externa,repetidas en personas de 60 anos o mas,2007-05-01,1,8,1,8,9
MINEROS,consulta externa,repetidas en personas de 60 anos o mas,2007-05-01,2,0,2,0,2
MIZQUE,consulta externa,repetidas en personas de 60 anos o mas,2007-05-01,4,6,4,6,10
MOCOMOCO,consulta externa,repetidas en personas de 60 anos o mas,2007-05-01,3,6,3,6,9
MOJINETE,consulta externa,repetidas en personas de 60 anos o mas,2007-05-01,1,0,1,0,1
MOJOCOYA,consulta externa,repetidas en personas de 60 anos o mas,2007-05-01,3,6,3,6,9
MONTEAGUDO,consulta externa,repetidas en personas de 60 anos o mas,2007-05-01,106,100,106,100,206
MONTERO,consulta externa,repetidas en personas de 60 anos o mas,2007-05-01,378,332,378,332,710
MORO MORO,consulta externa,repetidas en personas de 60 anos o mas,2007-05-01,1,3,1,3,4
MOROCHATA,consulta externa,repetidas en personas de 60 anos o mas,2007-05-01,7,14,7,14,21
OCURI,consulta externa,repetidas en personas de 60 anos o mas,2007-05-01,0,1,0,1,1
OKINAWA,consulta externa,repetidas en personas de 60 anos o mas,2007-05-01,17,15,17,15,32
OMEREQUE,consulta externa,repetidas en personas de 60 anos o mas,2007-05-01,0,1,0,1,1
ORURO,consulta externa,repetidas en personas de 60 anos o mas,2007-05-01,1755,2104,1755,2104,3859
PADCAYA,consulta externa,repetidas en personas de 60 anos o mas,2007-05-01,14,13,14,13,27
PADILLA,consulta externa,repetidas en personas de 60 anos o mas,2007-05-01,11,25,11,25,36
PALCA,consulta externa,repetidas en personas de 60 anos o mas,2007-05-01,2,0,2,0,2
PALOS BLANCOS,consulta externa,repetidas en personas de 60 anos o mas,2007-05-01,3,1,3,1,4
PAMPA GRANDE,consulta externa,repetidas en personas de 60 anos o mas,2007-05-01,3,3,3,3,6
PASORAPA,consulta externa,repetidas en personas de 60 anos o mas,2007-05-01,1,1,1,1,2
PAZÑA,consulta externa,repetidas en personas de 60 anos o mas,2007-05-01,39,24,39,24,63
POCOATA,consulta externa,repetidas en personas de 60 anos o mas,2007-05-01,2,1,2,1,3
POCONA,consulta externa,repetidas en personas de 60 anos o mas,2007-05-01,0,3,0,3,3
POOPO,consulta externa,repetidas en personas de 60 anos o mas,2007-05-01,8,8,8,8,16
POROMA,consulta externa,repetidas en personas de 60 anos o mas,2007-05-01,0,2,0,2,2
PORONGO,consulta externa,repetidas en personas de 60 anos o mas,2007-05-01,1,0,1,0,1
PORTACHUELO,consulta externa,repetidas en personas de 60 anos o mas,2007-05-01,7,10,7,10,17
PORVENIR,consulta externa,repetidas en personas de 60 anos o mas,2007-05-01,9,1,9,1,10
POSTRER VALLE,consulta externa,repetidas en personas de 60 anos o mas,2007-05-01,1,0,1,0,1
POTOSI,consulta externa,repetidas en personas de 60 anos o mas,2007-05-01,1000,1349,1000,1349,2349
PRESTO,consulta externa,repetidas en personas de 60 anos o mas,2007-05-01,1,0,1,0,1
PUCARA,consulta externa,repetidas en personas de 60 anos o mas,2007-05-01,1,14,1,14,15
PUCARANI,consulta externa,repetidas en personas de 60 anos o mas,2007-05-01,5,2,5,2,7
PUERTO ACOSTA,consulta externa,repetidas en personas de 60 anos o mas,2007-05-01,23,7,23,7,30
PUERTO CARABUCO,consulta externa,repetidas en personas de 60 anos o mas,2007-05-01,5,3,5,3,8
PUERTO PEREZ,consulta externa,repetidas en personas de 60 anos o mas,2007-05-01,4,1,4,1,5
PUERTO QUIJARRO,consulta externa,repetidas en personas de 60 anos o mas,2007-05-01,0,1,0,1,1
PUERTO SUAREZ,consulta externa,repetidas en personas de 60 anos o mas,2007-05-01,12,8,12,8,20
PUERTO VILLARROEL,consulta externa,repetidas en personas de 60 anos o mas,2007-05-01,7,1,7,1,8
PUNA,consulta externa,repetidas en personas de 60 anos o mas,2007-05-01,14,12,14,12,26
PUNATA,consulta externa,repetidas en personas de 60 anos o mas,2007-05-01,81,85,81,85,166
QUILLACOLLO,consulta externa,repetidas en personas de 60 anos o mas,2007-05-01,340,492,340,492,832
QUIME,consulta externa,repetidas en personas de 60 anos o mas,2007-05-01,1,1,1,1,2
QUIRUSILLAS,consulta externa,repetidas en personas de 60 anos o mas,2007-05-01,0,1,0,1,1
REYES,consulta externa,repetidas en personas de 60 anos o mas,2007-05-01,33,51,33,51,84
RIBERALTA,consulta externa,repetidas en personas de 60 anos o mas,2007-05-01,376,438,376,438,814
ROBORE,consulta externa,repetidas en personas de 60 anos o mas,2007-05-01,21,26,21,26,47
RURRENABAQUE,consulta externa,repetidas en personas de 60 anos o mas,2007-05-01,85,78,85,78,163
SABAYA,consulta externa,repetidas en personas de 60 anos o mas,2007-05-01,2,2,2,2,4
SACABA,consulta externa,repetidas en personas de 60 anos o mas,2007-05-01,80,141,80,141,221
SACABAMBA,consulta externa,repetidas en personas de 60 anos o mas,2007-05-01,2,7,2,7,9
SACACA,consulta externa,repetidas en personas de 60 anos o mas,2007-05-01,0,2,0,2,2
SAIPINA,consulta externa,repetidas en personas de 60 anos o mas,2007-05-01,21,47,21,47,68
SALINAS DE GARCI MENDOZA,consulta externa,repetidas en personas de 60 anos o mas,2007-05-01,2,5,2,5,7
SAMAIPATA,consulta externa,repetidas en personas de 60 anos o mas,2007-05-01,4,4,4,4,8
SAN ANDRES,consulta externa,repetidas en personas de 60 anos o mas,2007-05-01,1,0,1,0,1
SAN ANDRES DE MACHACA,consulta externa,repetidas en personas de 60 anos o mas,2007-05-01,3,7,3,7,10
SAN ANTONIO DE ESMORUCO,consulta externa,repetidas en personas de 60 anos o mas,2007-05-01,0,1,0,1,1
SAN ANTONIO DE LOMERIO,consulta externa,repetidas en personas de 60 anos o mas,2007-05-01,0,2,0,2,2
SAN BENITO,consulta externa,repetidas en personas de 60 anos o mas,2007-05-01,4,3,4,3,7
SAN BORJA,consulta externa,repetidas en personas de 60 anos o mas,2007-05-01,44,61,44,61,105
SAN BUENA VENTURA,consulta externa,repetidas en personas de 60 anos o mas,2007-05-01,3,9,3,9,12
SAN CARLOS,consulta externa,repetidas en personas de 60 anos o mas,2007-05-01,24,24,24,24,48
SAN IGNACIO,consulta externa,repetidas en personas de 60 anos o mas,2007-05-01,49,65,49,65,114
SAN IGNACIO DE VELASCO,consulta externa,repetidas en personas de 60 anos o mas,2007-05-01,54,111,54,111,165
SAN JAVIER(STC),consulta externa,repetidas en personas de 60 anos o mas,2007-05-01,15,15,15,15,30
SAN JOAQUIN,consulta externa,repetidas en personas de 60 anos o mas,2007-05-01,30,35,30,35,65
SAN JOSE DE CHIQUITOS,consulta externa,repetidas en personas de 60 anos o mas,2007-05-01,3,6,3,6,9
SAN JUAN DE YAPACANI,consulta externa,repetidas en personas de 60 anos o mas,2007-05-01,5,9,5,9,14
SAN JULIAN,consulta externa,repetidas en personas de 60 anos o mas,2007-05-01,4,9,4,9,13
SAN LORENZO(TJA),consulta externa,repetidas en personas de 60 anos o mas,2007-05-01,2,4,2,4,6
SAN LUCAS,consulta externa,repetidas en personas de 60 anos o mas,2007-05-01,11,13,11,13,24
SAN MATIAS,consulta externa,repetidas en personas de 60 anos o mas,2007-05-01,1,0,1,0,1
SAN MIGUEL DE VELASCO,consulta externa,repetidas en personas de 60 anos o mas,2007-05-01,13,32,13,32,45
SAN PABLO DE LIPEZ,consulta externa,repetidas en personas de 60 anos o mas,2007-05-01,3,2,3,2,5
SAN PEDRO,consulta externa,repetidas en personas de 60 anos o mas,2007-05-01,10,5,10,5,15
SAN PEDRO DE BUENA VISTA,consulta externa,repetidas en personas de 60 anos o mas,2007-05-01,7,1,7,1,8
SAN PEDRO DE CURAHUARA,consulta externa,repetidas en personas de 60 anos o mas,2007-05-01,13,12,13,12,25
SAN PEDRO DE TIQUINA,consulta externa,repetidas en personas de 60 anos o mas,2007-05-01,1,4,1,4,5
SAN RAFAEL,consulta externa,repetidas en personas de 60 anos o mas,2007-05-01,2,1,2,1,3
SAN RAMON,consulta externa,repetidas en personas de 60 anos o mas,2007-05-01,36,40,36,40,76
SAN RAMON,consulta externa,repetidas en personas de 60 anos o mas,2007-05-01,5,4,5,4,9
SANTA ANA,consulta externa,repetidas en personas de 60 anos o mas,2007-05-01,63,72,63,72,135
SANTA CRUZ DE LA SIERRA,consulta externa,repetidas en personas de 60 anos o mas,2007-05-01,2873,4749,2873,4749,7622
SANTA ROSA DEL SARA,consulta externa,repetidas en personas de 60 anos o mas,2007-05-01,2,1,2,1,3
SANTIAGO DE HUARI,consulta externa,repetidas en personas de 60 anos o mas,2007-05-01,42,47,42,47,89
SANTIAGO DE MACHACA,consulta externa,repetidas en personas de 60 anos o mas,2007-05-01,1,2,1,2,3
SANTIVAÑES,consulta externa,repetidas en personas de 60 anos o mas,2007-05-01,0,7,0,7,7
SANTUARIO DE QUILLACAS,consulta externa,repetidas en personas de 60 anos o mas,2007-05-01,3,1,3,1,4
SAPAHAQUI,consulta externa,repetidas en personas de 60 anos o mas,2007-05-01,1,0,1,0,1
SICA SICA (VILLA AROMA),consulta externa,repetidas en personas de 60 anos o mas,2007-05-01,0,2,0,2,2
SICAYA,consulta externa,repetidas en personas de 60 anos o mas,2007-05-01,1,6,1,6,7
SIPE SIPE,consulta externa,repetidas en personas de 60 anos o mas,2007-05-01,8,22,8,22,30
SOPACHUY,consulta externa,repetidas en personas de 60 anos o mas,2007-05-01,4,5,4,5,9
SORACACHI,consulta externa,repetidas en personas de 60 anos o mas,2007-05-01,0,1,0,1,1
SORATA,consulta externa,repetidas en personas de 60 anos o mas,2007-05-01,2,1,2,1,3
SUCRE,consulta externa,repetidas en personas de 60 anos o mas,2007-05-01,1489,1956,1489,1956,3445
TACACHI,consulta externa,repetidas en personas de 60 anos o mas,2007-05-01,2,5,2,5,7
TACACOMA,consulta externa,repetidas en personas de 60 anos o mas,2007-05-01,0,1,0,1,1
TACOBAMBA,consulta externa,repetidas en personas de 60 anos o mas,2007-05-01,1,3,1,3,4
TAHUA,consulta externa,repetidas en personas de 60 anos o mas,2007-05-01,2,2,2,2,4
TAPACARI,consulta externa,repetidas en personas de 60 anos o mas,2007-05-01,4,10,4,10,14
TARABUCO,consulta externa,repetidas en personas de 60 anos o mas,2007-05-01,19,35,19,35,54
TARACO,consulta externa,repetidas en personas de 60 anos o mas,2007-05-01,1,2,1,2,3
TARATA,consulta externa,repetidas en personas de 60 anos o mas,2007-05-01,2,1,2,1,3
TARIJA,consulta externa,repetidas en personas de 60 anos o mas,2007-05-01,1485,2478,1485,2478,3963
TARVITA,consulta externa,repetidas en personas de 60 anos o mas,2007-05-01,1,6,1,6,7
TEOPONTE,consulta externa,repetidas en personas de 60 anos o mas,2007-05-01,7,15,7,15,22
TIAWANACU,consulta externa,repetidas en personas de 60 anos o mas,2007-05-01,2,3,2,3,5
TINGUIPAYA,consulta externa,repetidas en personas de 60 anos o mas,2007-05-01,0,3,0,3,3
TIPUANI,consulta externa,repetidas en personas de 60 anos o mas,2007-05-01,5,6,5,6,11
TIQUIPAYA,consulta externa,repetidas en personas de 60 anos o mas,2007-05-01,15,11,15,11,26
TIRAQUE (CBBA),consulta externa,repetidas en personas de 60 anos o mas,2007-05-01,12,20,12,20,32
TITO YUPANQUI (PARQUIPUJIO),consulta externa,repetidas en personas de 60 anos o mas,2007-05-01,1,2,1,2,3
TOLATA,consulta externa,repetidas en personas de 60 anos o mas,2007-05-01,0,2,0,2,2
TOLEDO,consulta externa,repetidas en personas de 60 anos o mas,2007-05-01,2,0,2,0,2
TOMAVE,consulta externa,repetidas en personas de 60 anos o mas,2007-05-01,4,2,4,2,6
TOMINA,consulta externa,repetidas en personas de 60 anos o mas,2007-05-01,0,4,0,4,4
TORO TORO,consulta externa,repetidas en personas de 60 anos o mas,2007-05-01,2,7,2,7,9
TOTORA(CBBA),consulta externa,repetidas en personas de 60 anos o mas,2007-05-01,2,7,2,7,9
TOTORA(ORR),consulta externa,repetidas en personas de 60 anos o mas,2007-05-01,1,0,1,0,1
TRIGAL,consulta externa,repetidas en personas de 60 anos o mas,2007-05-01,2,3,2,3,5
TRINIDAD,consulta externa,repetidas en personas de 60 anos o mas,2007-05-01,187,205,187,205,392
TUPIZA,consulta externa,repetidas en personas de 60 anos o mas,2007-05-01,45,57,45,57,102
TURCO,consulta externa,repetidas en personas de 60 anos o mas,2007-05-01,0,2,0,2,2
UMALA,consulta externa,repetidas en personas de 60 anos o mas,2007-05-01,0,2,0,2,2
UNCIA,consulta externa,repetidas en personas de 60 anos o mas,2007-05-01,47,79,47,79,126
URIONDO (A. CONCEPCION),consulta externa,repetidas en personas de 60 anos o mas,2007-05-01,1,3,1,3,4
URUBICHA,consulta externa,repetidas en personas de 60 anos o mas,2007-05-01,1,1,1,1,2
UYUNI,consulta externa,repetidas en personas de 60 anos o mas,2007-05-01,70,60,70,60,130
VACAS,consulta externa,repetidas en personas de 60 anos o mas,2007-05-01,7,12,7,12,19
VALLEGRANDE,consulta externa,repetidas en personas de 60 anos o mas,2007-05-01,221,326,221,326,547
VIACHA,consulta externa,repetidas en personas de 60 anos o mas,2007-05-01,151,220,151,220,371
VILA VILA,consulta externa,repetidas en personas de 60 anos o mas,2007-05-01,1,0,1,0,1
VILLA MONTES,consulta externa,repetidas en personas de 60 anos o mas,2007-05-01,61,74,61,74,135
VILLA NUEVA (LOMA ALTA),consulta externa,repetidas en personas de 60 anos o mas,2007-05-01,3,2,3,2,5
VILLA RIVERO,consulta externa,repetidas en personas de 60 anos o mas,2007-05-01,3,6,3,6,9
VILLA SERRANO,consulta externa,repetidas en personas de 60 anos o mas,2007-05-01,0,6,0,6,6
VILLA TUNARI,consulta externa,repetidas en personas de 60 anos o mas,2007-05-01,9,3,9,3,12
VILLA VACA GUZMAN (MUYUPAMPA),consulta externa,repetidas en personas de 60 anos o mas,2007-05-01,4,3,4,3,7
VILLAZON,consulta externa,repetidas en personas de 60 anos o mas,2007-05-01,37,41,37,41,78
VINTO,consulta externa,repetidas en personas de 60 anos o mas,2007-05-01,1,1,1,1,2
VITICHI,consulta externa,repetidas en personas de 60 anos o mas,2007-05-01,21,9,21,9,30
WALDO BALLIVIAN,consulta externa,repetidas en personas de 60 anos o mas,2007-05-01,1,3,1,3,4
WARNES,consulta externa,repetidas en personas de 60 anos o mas,2007-05-01,2,5,2,5,7
YACO,consulta externa,repetidas en personas de 60 anos o mas,2007-05-01,1,1,1,1,2
YACUIBA,consulta externa,repetidas en personas de 60 anos o mas,2007-05-01,173,252,173,252,425
YAMPARAEZ,consulta externa,repetidas en personas de 60 anos o mas,2007-05-01,4,5,4,5,9
YANACACHI,consulta externa,repetidas en personas de 60 anos o mas,2007-05-01,1,0,1,0,1
YAPACANI,consulta externa,repetidas en personas de 60 anos o mas,2007-05-01,8,6,8,6,14
YOTALA,consulta externa,repetidas en personas de 60 anos o mas,2007-05-01,10,21,10,21,31
YUNCHARA,consulta externa,repetidas en personas de 60 anos o mas,2007-05-01,0,3,0,3,3
ZUDAÑEZ,consulta externa,repetidas en personas de 60 anos o mas,2007-05-01,1,3,1,3,4
ACACIO,consulta externa,repetidas en personas de 60 anos o mas,2007-06-01,0,7,0,7,7
ACHACACHI,consulta externa,repetidas en personas de 60 anos o mas,2007-06-01,29,24,29,24,53
ACHOCALLA,consulta externa,repetidas en personas de 60 anos o mas,2007-06-01,0,1,0,1,1
AIQUILE,consulta externa,repetidas en personas de 60 anos o mas,2007-06-01,38,54,38,54,92
ALALAY,consulta externa,repetidas en personas de 60 anos o mas,2007-06-01,1,1,1,1,2
ALCALA,consulta externa,repetidas en personas de 60 anos o mas,2007-06-01,1,1,1,1,2
ANCORAIMES,consulta externa,repetidas en personas de 60 anos o mas,2007-06-01,6,5,6,5,11
ANDAMARCA,consulta externa,repetidas en personas de 60 anos o mas,2007-06-01,2,3,2,3,5
ANZALDO,consulta externa,repetidas en personas de 60 anos o mas,2007-06-01,2,3,2,3,5
APOLO,consulta externa,repetidas en personas de 60 anos o mas,2007-06-01,4,13,4,13,17
ARAMPAMPA,consulta externa,repetidas en personas de 60 anos o mas,2007-06-01,5,4,5,4,9
ARANI,consulta externa,repetidas en personas de 60 anos o mas,2007-06-01,1,4,1,4,5
ARBIETO,consulta externa,repetidas en personas de 60 anos o mas,2007-06-01,5,7,5,7,12
ARQUE,consulta externa,repetidas en personas de 60 anos o mas,2007-06-01,0,1,0,1,1
ASCENCION DE GUARAYOS,consulta externa,repetidas en personas de 60 anos o mas,2007-06-01,9,8,9,8,17
ATOCHA,consulta externa,repetidas en personas de 60 anos o mas,2007-06-01,36,59,36,59,95
AUCAPATA,consulta externa,repetidas en personas de 60 anos o mas,2007-06-01,1,1,1,1,2
AYATA,consulta externa,repetidas en personas de 60 anos o mas,2007-06-01,0,1,0,1,1
AYO AYO,consulta externa,repetidas en personas de 60 anos o mas,2007-06-01,8,0,8,0,8
AYOPAYA (V. DE INDEPENDENCIA),consulta externa,repetidas en personas de 60 anos o mas,2007-06-01,6,7,6,7,13
AZURDUY,consulta externa,repetidas en personas de 60 anos o mas,2007-06-01,2,1,2,1,3
BATALLAS,consulta externa,repetidas en personas de 60 anos o mas,2007-06-01,2,1,2,1,3
BAURES,consulta externa,repetidas en personas de 60 anos o mas,2007-06-01,1,3,1,3,4
BELEN DE ANDAMARCA,consulta externa,repetidas en personas de 60 anos o mas,2007-06-01,0,1,0,1,1
BERMEJO,consulta externa,repetidas en personas de 60 anos o mas,2007-06-01,73,56,73,56,129
BETANZOS,consulta externa,repetidas en personas de 60 anos o mas,2007-06-01,64,91,64,91,155
BOLIVAR,consulta externa,repetidas en personas de 60 anos o mas,2007-06-01,0,1,0,1,1
BOYUIBE,consulta externa,repetidas en personas de 60 anos o mas,2007-06-01,1,3,1,3,4
BUENA VISTA,consulta externa,repetidas en personas de 60 anos o mas,2007-06-01,18,12,18,12,30
CABEZAS,consulta externa,repetidas en personas de 60 anos o mas,2007-06-01,2,5,2,5,7
CAIROMA,consulta externa,repetidas en personas de 60 anos o mas,2007-06-01,10,3,10,3,13
"CAIZA ""D""",consulta externa,repetidas en personas de 60 anos o mas,2007-06-01,0,10,0,10,10
CAJUATA,consulta externa,repetidas en personas de 60 anos o mas,2007-06-01,0,5,0,5,5
CALACOTO,consulta externa,repetidas en personas de 60 anos o mas,2007-06-01,3,7,3,7,10
CALAMARCA,consulta externa,repetidas en personas de 60 anos o mas,2007-06-01,1,0,1,0,1
CAMARGO,consulta externa,repetidas en personas de 60 anos o mas,2007-06-01,23,3,23,3,26
CAMATAQUI (C. VILLA ABECIA),consulta externa,repetidas en personas de 60 anos o mas,2007-06-01,2,6,2,6,8
CAMIRI,consulta externa,repetidas en personas de 60 anos o mas,2007-06-01,495,81,495,81,576
CAPINOTA,consulta externa,repetidas en personas de 60 anos o mas,2007-06-01,2,2,2,2,4
CAQUIAVIRI,consulta externa,repetidas en personas de 60 anos o mas,2007-06-01,4,6,4,6,10
CARACOLLO,consulta externa,repetidas en personas de 60 anos o mas,2007-06-01,6,6,6,6,12
CARANAVI,consulta externa,repetidas en personas de 60 anos o mas,2007-06-01,18,24,18,24,42
CARIPUYO,consulta externa,repetidas en personas de 60 anos o mas,2007-06-01,1,1,1,1,2
CATACORA,consulta externa,repetidas en personas de 60 anos o mas,2007-06-01,1,1,1,1,2
CHALLAPATA,consulta externa,repetidas en personas de 60 anos o mas,2007-06-01,8,16,8,16,24
CHARAGUA,consulta externa,repetidas en personas de 60 anos o mas,2007-06-01,5,0,5,0,5
CHARAÑA,consulta externa,repetidas en personas de 60 anos o mas,2007-06-01,1,3,1,3,4
CHAYANTA,consulta externa,repetidas en personas de 60 anos o mas,2007-06-01,4,4,4,4,8
CHIMORE,consulta externa,repetidas en personas de 60 anos o mas,2007-06-01,0,1,0,1,1
CHOQUE COTA,consulta externa,repetidas en personas de 60 anos o mas,2007-06-01,2,0,2,0,2
CHULUMANI (V. DE LA LIBERTAD),consulta externa,repetidas en personas de 60 anos o mas,2007-06-01,21,8,21,8,29
CHUMA,consulta externa,repetidas en personas de 60 anos o mas,2007-06-01,5,1,5,1,6
CLIZA,consulta externa,repetidas en personas de 60 anos o mas,2007-06-01,8,12,8,12,20
COBIJA,consulta externa,repetidas en personas de 60 anos o mas,2007-06-01,207,189,207,189,396
COCHABAMBA,consulta externa,repetidas en personas de 60 anos o mas,2007-06-01,7018,7828,7018,7828,14846
COIPASA,consulta externa,repetidas en personas de 60 anos o mas,2007-06-01,1,0,1,0,1
COLCAPIRHUA,consulta externa,repetidas en personas de 60 anos o mas,2007-06-01,53,109,53,109,162
"COLCHA ""K""",consulta externa,repetidas en personas de 60 anos o mas,2007-06-01,2,6,2,6,8
COLLANA,consulta externa,repetidas en personas de 60 anos o mas,2007-06-01,2,2,2,2,4
COLOMI,consulta externa,repetidas en personas de 60 anos o mas,2007-06-01,1,0,1,0,1
COLPA BELGICA,consulta externa,repetidas en personas de 60 anos o mas,2007-06-01,30,13,30,13,43
COLQUECHACA,consulta externa,repetidas en personas de 60 anos o mas,2007-06-01,4,3,4,3,7
COLQUENCHA,consulta externa,repetidas en personas de 60 anos o mas,2007-06-01,4,8,4,8,12
COLQUIRI,consulta externa,repetidas en personas de 60 anos o mas,2007-06-01,2,8,2,8,10
COMANCHE,consulta externa,repetidas en personas de 60 anos o mas,2007-06-01,3,0,3,0,3
COMARAPA,consulta externa,repetidas en personas de 60 anos o mas,2007-06-01,17,23,17,23,40
CONCEPCION,consulta externa,repetidas en personas de 60 anos o mas,2007-06-01,1,0,1,0,1
COPACABANA,consulta externa,repetidas en personas de 60 anos o mas,2007-06-01,2,1,2,1,3
CORIPATA,consulta externa,repetidas en personas de 60 anos o mas,2007-06-01,21,8,21,8,29
CORO CORO,consulta externa,repetidas en personas de 60 anos o mas,2007-06-01,0,1,0,1,1
COROICO,consulta externa,repetidas en personas de 60 anos o mas,2007-06-01,33,62,33,62,95
CORQUE,consulta externa,repetidas en personas de 60 anos o mas,2007-06-01,3,3,3,3,6
COTAGAITA,consulta externa,repetidas en personas de 60 anos o mas,2007-06-01,14,34,14,34,48
COTOCA,consulta externa,repetidas en personas de 60 anos o mas,2007-06-01,37,49,37,49,86
CUATRO CAÑADAS,consulta externa,repetidas en personas de 60 anos o mas,2007-06-01,33,42,33,42,75
CUCHUMUELA (V. G. VILLARROEL),consulta externa,repetidas en personas de 60 anos o mas,2007-06-01,2,1,2,1,3
CULPINA,consulta externa,repetidas en personas de 60 anos o mas,2007-06-01,1,4,1,4,5
CURVA,consulta externa,repetidas en personas de 60 anos o mas,2007-06-01,0,4,0,4,4
DESAGUADERO,consulta externa,repetidas en personas de 60 anos o mas,2007-06-01,3,0,3,0,3
EL ALTO,consulta externa,repetidas en personas de 60 anos o mas,2007-06-01,736,936,736,936,1672
EL CHORO,consulta externa,repetidas en personas de 60 anos o mas,2007-06-01,1,0,1,0,1
EL PUENTE(STC),consulta externa,repetidas en personas de 60 anos o mas,2007-06-01,4,3,4,3,7
EL TORNO,consulta externa,repetidas en personas de 60 anos o mas,2007-06-01,279,210,279,210,489
EL VILLAR,consulta externa,repetidas en personas de 60 anos o mas,2007-06-01,0,3,0,3,3
ENTRE RIOS,consulta externa,repetidas en personas de 60 anos o mas,2007-06-01,2,3,2,3,5
EUCALIPTUS,consulta externa,repetidas en personas de 60 anos o mas,2007-06-01,11,2,11,2,13
EXALTACION,consulta externa,repetidas en personas de 60 anos o mas,2007-06-01,4,4,4,4,8
FERNANDEZ ALONSO,consulta externa,repetidas en personas de 60 anos o mas,2007-06-01,1,3,1,3,4
FILADELFIA,consulta externa,repetidas en personas de 60 anos o mas,2007-06-01,1,1,1,1,2
GENERAL SAAVEDRA,consulta externa,repetidas en personas de 60 anos o mas,2007-06-01,0,2,0,2,2
GRAL. J.J. PEREZ (CHARAZANI),consulta externa,repetidas en personas de 60 anos o mas,2007-06-01,5,2,5,2,7
GUANAY,consulta externa,repetidas en personas de 60 anos o mas,2007-06-01,19,14,19,14,33
GUAQUI,consulta externa,repetidas en personas de 60 anos o mas,2007-06-01,4,5,4,5,9
GUAYARAMERIN,consulta externa,repetidas en personas de 60 anos o mas,2007-06-01,225,163,225,163,388
GUTIERREZ,consulta externa,repetidas en personas de 60 anos o mas,2007-06-01,13,3,13,3,16
HUACARETA,consulta externa,repetidas en personas de 60 anos o mas,2007-06-01,2,5,2,5,7
HUACHACALLA,consulta externa,repetidas en personas de 60 anos o mas,2007-06-01,0,3,0,3,3
HUANUNI,consulta externa,repetidas en personas de 60 anos o mas,2007-06-01,200,105,200,105,305
HUARACAJE,consulta externa,repetidas en personas de 60 anos o mas,2007-06-01,9,4,9,4,13
HUAYLLAMARCA,consulta externa,repetidas en personas de 60 anos o mas,2007-06-01,10,7,10,7,17
ICLA,consulta externa,repetidas en personas de 60 anos o mas,2007-06-01,0,2,0,2,2
INCAHUASI,consulta externa,repetidas en personas de 60 anos o mas,2007-06-01,1,0,1,0,1
INQUISIVI,consulta externa,repetidas en personas de 60 anos o mas,2007-06-01,1,2,1,2,3
IRUPANA (VILLA DE LANZA),consulta externa,repetidas en personas de 60 anos o mas,2007-06-01,6,6,6,6,12
IXIAMAS,consulta externa,repetidas en personas de 60 anos o mas,2007-06-01,2,0,2,0,2
JESUS DE MACHACA,consulta externa,repetidas en personas de 60 anos o mas,2007-06-01,7,11,7,11,18
LA GUARDIA,consulta externa,repetidas en personas de 60 anos o mas,2007-06-01,5,6,5,6,11
LA PAZ,consulta externa,repetidas en personas de 60 anos o mas,2007-06-01,8599,10658,8599,10658,19257
LAGUNILLAS,consulta externa,repetidas en personas de 60 anos o mas,2007-06-01,1,0,1,0,1
LAJA,consulta externa,repetidas en personas de 60 anos o mas,2007-06-01,2,2,2,2,4
LAS CARRERAS,consulta externa,repetidas en personas de 60 anos o mas,2007-06-01,1,7,1,7,8
LICOMA PAMPA,consulta externa,repetidas en personas de 60 anos o mas,2007-06-01,1,0,1,0,1
LLALLAGUA,consulta externa,repetidas en personas de 60 anos o mas,2007-06-01,55,58,55,58,113
LLICA,consulta externa,repetidas en personas de 60 anos o mas,2007-06-01,10,6,10,6,16
LORETO,consulta externa,repetidas en personas de 60 anos o mas,2007-06-01,2,9,2,9,11
LURIBAY,consulta externa,repetidas en personas de 60 anos o mas,2007-06-01,12,13,12,13,25
MACHACAMARCA,consulta externa,repetidas en personas de 60 anos o mas,2007-06-01,12,16,12,16,28
MACHARETI,consulta externa,repetidas en personas de 60 anos o mas,2007-06-01,10,8,10,8,18
MAGDALENA,consulta externa,repetidas en personas de 60 anos o mas,2007-06-01,57,75,57,75,132
MAIRANA,consulta externa,repetidas en personas de 60 anos o mas,2007-06-01,2,0,2,0,2
MALLA,consulta externa,repetidas en personas de 60 anos o mas,2007-06-01,1,3,1,3,4
MAPIRI,consulta externa,repetidas en personas de 60 anos o mas,2007-06-01,6,7,6,7,13
MECAPACA,consulta externa,repetidas en personas de 60 anos o mas,2007-06-01,5,5,5,5,10
MINEROS,consulta externa,repetidas en personas de 60 anos o mas,2007-06-01,0,1,0,1,1
MIZQUE,consulta externa,repetidas en personas de 60 anos o mas,2007-06-01,2,4,2,4,6
MOCOMOCO,consulta externa,repetidas en personas de 60 anos o mas,2007-06-01,2,7,2,7,9
MOJINETE,consulta externa,repetidas en personas de 60 anos o mas,2007-06-01,1,0,1,0,1
MOJOCOYA,consulta externa,repetidas en personas de 60 anos o mas,2007-06-01,2,2,2,2,4
MONTEAGUDO,consulta externa,repetidas en personas de 60 anos o mas,2007-06-01,76,105,76,105,181
MONTERO,consulta externa,repetidas en personas de 60 anos o mas,2007-06-01,678,782,678,782,1460
MORO MORO,consulta externa,repetidas en personas de 60 anos o mas,2007-06-01,3,1,3,1,4
MOROCHATA,consulta externa,repetidas en personas de 60 anos o mas,2007-06-01,8,13,8,13,21
OCURI,consulta externa,repetidas en personas de 60 anos o mas,2007-06-01,0,1,0,1,1
OKINAWA,consulta externa,repetidas en personas de 60 anos o mas,2007-06-01,18,18,18,18,36
OMEREQUE,consulta externa,repetidas en personas de 60 anos o mas,2007-06-01,0,3,0,3,3
ORURO,consulta externa,repetidas en personas de 60 anos o mas,2007-06-01,1473,1891,1473,1891,3364
PADCAYA,consulta externa,repetidas en personas de 60 anos o mas,2007-06-01,8,15,8,15,23
PADILLA,consulta externa,repetidas en personas de 60 anos o mas,2007-06-01,19,33,19,33,52
PAILON,consulta externa,repetidas en personas de 60 anos o mas,2007-06-01,2,1,2,1,3
PALCA,consulta externa,repetidas en personas de 60 anos o mas,2007-06-01,3,4,3,4,7
PALOS BLANCOS,consulta externa,repetidas en personas de 60 anos o mas,2007-06-01,3,0,3,0,3
PAMPA AULLAGAS,consulta externa,repetidas en personas de 60 anos o mas,2007-06-01,1,0,1,0,1
PAMPA GRANDE,consulta externa,repetidas en personas de 60 anos o mas,2007-06-01,2,6,2,6,8
PASORAPA,consulta externa,repetidas en personas de 60 anos o mas,2007-06-01,0,1,0,1,1
PATACAMAYA,consulta externa,repetidas en personas de 60 anos o mas,2007-06-01,2,2,2,2,4
PAZÑA,consulta externa,repetidas en personas de 60 anos o mas,2007-06-01,31,25,31,25,56
POCOATA,consulta externa,repetidas en personas de 60 anos o mas,2007-06-01,2,0,2,0,2
POCONA,consulta externa,repetidas en personas de 60 anos o mas,2007-06-01,2,4,2,4,6
POOPO,consulta externa,repetidas en personas de 60 anos o mas,2007-06-01,5,3,5,3,8
POROMA,consulta externa,repetidas en personas de 60 anos o mas,2007-06-01,3,8,3,8,11
PORTACHUELO,consulta externa,repetidas en personas de 60 anos o mas,2007-06-01,14,26,14,26,40
PORVENIR,consulta externa,repetidas en personas de 60 anos o mas,2007-06-01,6,2,6,2,8
POSTRER VALLE,consulta externa,repetidas en personas de 60 anos o mas,2007-06-01,1,0,1,0,1
POTOSI,consulta externa,repetidas en personas de 60 anos o mas,2007-06-01,919,1332,919,1332,2251
PUCARA,consulta externa,repetidas en personas de 60 anos o mas,2007-06-01,2,0,2,0,2
PUCARANI,consulta externa,repetidas en personas de 60 anos o mas,2007-06-01,8,2,8,2,10
PUERTO ACOSTA,consulta externa,repetidas en personas de 60 anos o mas,2007-06-01,19,11,19,11,30
PUERTO CARABUCO,consulta externa,repetidas en personas de 60 anos o mas,2007-06-01,2,1,2,1,3
PUERTO PEREZ,consulta externa,repetidas en personas de 60 anos o mas,2007-06-01,3,1,3,1,4
PUERTO QUIJARRO,consulta externa,repetidas en personas de 60 anos o mas,2007-06-01,3,6,3,6,9
PUERTO RICO,consulta externa,repetidas en personas de 60 anos o mas,2007-06-01,5,2,5,2,7
PUERTO SILES,consulta externa,repetidas en personas de 60 anos o mas,2007-06-01,7,3,7,3,10
PUERTO SUAREZ,consulta externa,repetidas en personas de 60 anos o mas,2007-06-01,10,12,10,12,22
PUERTO VILLARROEL,consulta externa,repetidas en personas de 60 anos o mas,2007-06-01,6,6,6,6,12
PUNA,consulta externa,repetidas en personas de 60 anos o mas,2007-06-01,4,12,4,12,16
PUNATA,consulta externa,repetidas en personas de 60 anos o mas,2007-06-01,101,131,101,131,232
QUIABAYA,consulta externa,repetidas en personas de 60 anos o mas,2007-06-01,0,2,0,2,2
QUILLACOLLO,consulta externa,repetidas en personas de 60 anos o mas,2007-06-01,306,443,306,443,749
QUIME,consulta externa,repetidas en personas de 60 anos o mas,2007-06-01,4,1,4,1,5
QUIRUSILLAS,consulta externa,repetidas en personas de 60 anos o mas,2007-06-01,5,1,5,1,6
RAVELO,consulta externa,repetidas en personas de 60 anos o mas,2007-06-01,3,3,3,3,6
REYES,consulta externa,repetidas en personas de 60 anos o mas,2007-06-01,32,50,32,50,82
RIBERALTA,consulta externa,repetidas en personas de 60 anos o mas,2007-06-01,6,11,6,11,17
ROBORE,consulta externa,repetidas en personas de 60 anos o mas,2007-06-01,16,23,16,23,39
RURRENABAQUE,consulta externa,repetidas en personas de 60 anos o mas,2007-06-01,82,88,82,88,170
SABAYA,consulta externa,repetidas en personas de 60 anos o mas,2007-06-01,1,1,1,1,2
SACABA,consulta externa,repetidas en personas de 60 anos o mas,2007-06-01,103,131,103,131,234
SACABAMBA,consulta externa,repetidas en personas de 60 anos o mas,2007-06-01,0,2,0,2,2
SACACA,consulta externa,repetidas en personas de 60 anos o mas,2007-06-01,1,0,1,0,1
SALINAS DE GARCI MENDOZA,consulta externa,repetidas en personas de 60 anos o mas,2007-06-01,3,1,3,1,4
SAMAIPATA,consulta externa,repetidas en personas de 60 anos o mas,2007-06-01,1,3,1,3,4
SAN AGUSTIN,consulta externa,repetidas en personas de 60 anos o mas,2007-06-01,1,0,1,0,1
SAN ANDRES,consulta externa,repetidas en personas de 60 anos o mas,2007-06-01,1,0,1,0,1
SAN ANDRES DE MACHACA,consulta externa,repetidas en personas de 60 anos o mas,2007-06-01,2,4,2,4,6
SAN ANTONIO DE ESMORUCO,consulta externa,repetidas en personas de 60 anos o mas,2007-06-01,1,0,1,0,1
SAN BENITO,consulta externa,repetidas en personas de 60 anos o mas,2007-06-01,3,8,3,8,11
SAN BORJA,consulta externa,repetidas en personas de 60 anos o mas,2007-06-01,54,63,54,63,117
SAN BUENA VENTURA,consulta externa,repetidas en personas de 60 anos o mas,2007-06-01,1,3,1,3,4
SAN CARLOS,consulta externa,repetidas en personas de 60 anos o mas,2007-06-01,31,31,31,31,62
SAN IGNACIO,consulta externa,repetidas en personas de 60 anos o mas,2007-06-01,73,95,73,95,168
SAN IGNACIO DE VELASCO,consulta externa,repetidas en personas de 60 anos o mas,2007-06-01,36,47,36,47,83
SAN JAVIER(STC),consulta externa,repetidas en personas de 60 anos o mas,2007-06-01,3,7,3,7,10
SAN JOAQUIN,consulta externa,repetidas en personas de 60 anos o mas,2007-06-01,3,3,3,3,6
SAN JOSE DE CHIQUITOS,consulta externa,repetidas en personas de 60 anos o mas,2007-06-01,3,4,3,4,7
SAN JUAN DE YAPACANI,consulta externa,repetidas en personas de 60 anos o mas,2007-06-01,5,3,5,3,8
SAN JULIAN,consulta externa,repetidas en personas de 60 anos o mas,2007-06-01,32,24,32,24,56
SAN LORENZO(TJA),consulta externa,repetidas en personas de 60 anos o mas,2007-06-01,11,16,11,16,27
SAN LUCAS,consulta externa,repetidas en personas de 60 anos o mas,2007-06-01,7,17,7,17,24
SAN MATIAS,consulta externa,repetidas en personas de 60 anos o mas,2007-06-01,1,0,1,0,1
SAN MIGUEL DE VELASCO,consulta externa,repetidas en personas de 60 anos o mas,2007-06-01,30,38,30,38,68
SAN PABLO DE LIPEZ,consulta externa,repetidas en personas de 60 anos o mas,2007-06-01,1,3,1,3,4
SAN PEDRO,consulta externa,repetidas en personas de 60 anos o mas,2007-06-01,16,8,16,8,24
SAN PEDRO DE BUENA VISTA,consulta externa,repetidas en personas de 60 anos o mas,2007-06-01,2,1,2,1,3
SAN PEDRO DE CURAHUARA,consulta externa,repetidas en personas de 60 anos o mas,2007-06-01,7,2,7,2,9
SAN PEDRO DE TIQUINA,consulta externa,repetidas en personas de 60 anos o mas,2007-06-01,2,4,2,4,6
SAN RAFAEL,consulta externa,repetidas en personas de 60 anos o mas,2007-06-01,1,0,1,0,1
SAN RAMON,consulta externa,repetidas en personas de 60 anos o mas,2007-06-01,28,58,28,58,86
SAN RAMON,consulta externa,repetidas en personas de 60 anos o mas,2007-06-01,10,18,10,18,28
SANTA ANA,consulta externa,repetidas en personas de 60 anos o mas,2007-06-01,38,57,38,57,95
SANTA CRUZ DE LA SIERRA,consulta externa,repetidas en personas de 60 anos o mas,2007-06-01,3071,5711,3071,5711,8782
SANTA ROSA DEL SARA,consulta externa,repetidas en personas de 60 anos o mas,2007-06-01,0,1,0,1,1
SANTIAGO DE CALLAPA,consulta externa,repetidas en personas de 60 anos o mas,2007-06-01,1,0,1,0,1
SANTIAGO DE HUARI,consulta externa,repetidas en personas de 60 anos o mas,2007-06-01,42,43,42,43,85
SANTIAGO DE MACHACA,consulta externa,repetidas en personas de 60 anos o mas,2007-06-01,1,0,1,0,1
SANTIVAÑES,consulta externa,repetidas en personas de 60 anos o mas,2007-06-01,3,9,3,9,12
SANTUARIO DE QUILLACAS,consulta externa,repetidas en personas de 60 anos o mas,2007-06-01,5,4,5,4,9
SAPAHAQUI,consulta externa,repetidas en personas de 60 anos o mas,2007-06-01,4,2,4,2,6
SENA,consulta externa,repetidas en personas de 60 anos o mas,2007-06-01,2,2,2,2,4
SICAYA,consulta externa,repetidas en personas de 60 anos o mas,2007-06-01,0,3,0,3,3
SIPE SIPE,consulta externa,repetidas en personas de 60 anos o mas,2007-06-01,13,17,13,17,30
SOPACHUY,consulta externa,repetidas en personas de 60 anos o mas,2007-06-01,5,3,5,3,8
SORACACHI,consulta externa,repetidas en personas de 60 anos o mas,2007-06-01,1,0,1,0,1
SORATA,consulta externa,repetidas en personas de 60 anos o mas,2007-06-01,1,0,1,0,1
SUCRE,consulta externa,repetidas en personas de 60 anos o mas,2007-06-01,1494,1717,1494,1717,3211
TACACHI,consulta externa,repetidas en personas de 60 anos o mas,2007-06-01,3,6,3,6,9
TACOBAMBA,consulta externa,repetidas en personas de 60 anos o mas,2007-06-01,1,2,1,2,3
TACOPAYA,consulta externa,repetidas en personas de 60 anos o mas,2007-06-01,1,1,1,1,2
TAHUA,consulta externa,repetidas en personas de 60 anos o mas,2007-06-01,2,0,2,0,2
TAPACARI,consulta externa,repetidas en personas de 60 anos o mas,2007-06-01,1,1,1,1,2
TARABUCO,consulta externa,repetidas en personas de 60 anos o mas,2007-06-01,15,33,15,33,48
TARACO,consulta externa,repetidas en personas de 60 anos o mas,2007-06-01,1,0,1,0,1
TARATA,consulta externa,repetidas en personas de 60 anos o mas,2007-06-01,1,4,1,4,5
TARIJA,consulta externa,repetidas en personas de 60 anos o mas,2007-06-01,1967,2747,1967,2747,4714
TARVITA,consulta externa,repetidas en personas de 60 anos o mas,2007-06-01,2,1,2,1,3
TEOPONTE,consulta externa,repetidas en personas de 60 anos o mas,2007-06-01,22,19,22,19,41
TIAWANACU,consulta externa,repetidas en personas de 60 anos o mas,2007-06-01,3,1,3,1,4
TINGUIPAYA,consulta externa,repetidas en personas de 60 anos o mas,2007-06-01,1,0,1,0,1
TIPUANI,consulta externa,repetidas en personas de 60 anos o mas,2007-06-01,5,6,5,6,11
TIQUIPAYA,consulta externa,repetidas en personas de 60 anos o mas,2007-06-01,6,12,6,12,18
TIRAQUE (CBBA),consulta externa,repetidas en personas de 60 anos o mas,2007-06-01,7,19,7,19,26
TITO YUPANQUI (PARQUIPUJIO),consulta externa,repetidas en personas de 60 anos o mas,2007-06-01,2,2,2,2,4
TOCO,consulta externa,repetidas en personas de 60 anos o mas,2007-06-01,0,3,0,3,3
TOLATA,consulta externa,repetidas en personas de 60 anos o mas,2007-06-01,6,10,6,10,16
TOLEDO,consulta externa,repetidas en personas de 60 anos o mas,2007-06-01,0,1,0,1,1
TOMAVE,consulta externa,repetidas en personas de 60 anos o mas,2007-06-01,3,7,3,7,10
TOMINA,consulta externa,repetidas en personas de 60 anos o mas,2007-06-01,3,3,3,3,6
TORO TORO,consulta externa,repetidas en personas de 60 anos o mas,2007-06-01,1,0,1,0,1
TOTORA(CBBA),consulta externa,repetidas en personas de 60 anos o mas,2007-06-01,2,5,2,5,7
TOTORA(ORR),consulta externa,repetidas en personas de 60 anos o mas,2007-06-01,0,1,0,1,1
TRIGAL,consulta externa,repetidas en personas de 60 anos o mas,2007-06-01,0,4,0,4,4
TRINIDAD,consulta externa,repetidas en personas de 60 anos o mas,2007-06-01,187,230,187,230,417
TUPIZA,consulta externa,repetidas en personas de 60 anos o mas,2007-06-01,47,84,47,84,131
TURCO,consulta externa,repetidas en personas de 60 anos o mas,2007-06-01,6,1,6,1,7
UMALA,consulta externa,repetidas en personas de 60 anos o mas,2007-06-01,1,1,1,1,2
UNCIA,consulta externa,repetidas en personas de 60 anos o mas,2007-06-01,33,64,33,64,97
URIONDO (A. CONCEPCION),consulta externa,repetidas en personas de 60 anos o mas,2007-06-01,0,2,0,2,2
UYUNI,consulta externa,repetidas en personas de 60 anos o mas,2007-06-01,44,44,44,44,88
VACAS,consulta externa,repetidas en personas de 60 anos o mas,2007-06-01,6,19,6,19,25
VALLEGRANDE,consulta externa,repetidas en personas de 60 anos o mas,2007-06-01,238,312,238,312,550
VIACHA,consulta externa,repetidas en personas de 60 anos o mas,2007-06-01,227,186,227,186,413
VILLA MONTES,consulta externa,repetidas en personas de 60 anos o mas,2007-06-01,75,73,75,73,148
VILLA NUEVA (LOMA ALTA),consulta externa,repetidas en personas de 60 anos o mas,2007-06-01,7,0,7,0,7
VILLA RIVERO,consulta externa,repetidas en personas de 60 anos o mas,2007-06-01,2,3,2,3,5
VILLA SERRANO,consulta externa,repetidas en personas de 60 anos o mas,2007-06-01,2,3,2,3,5
VILLA TUNARI,consulta externa,repetidas en personas de 60 anos o mas,2007-06-01,14,14,14,14,28
VILLA VACA GUZMAN (MUYUPAMPA),consulta externa,repetidas en personas de 60 anos o mas,2007-06-01,1,5,1,5,6
VILLAZON,consulta externa,repetidas en personas de 60 anos o mas,2007-06-01,27,43,27,43,70
VINTO,consulta externa,repetidas en personas de 60 anos o mas,2007-06-01,3,3,3,3,6
VITICHI,consulta externa,repetidas en personas de 60 anos o mas,2007-06-01,10,14,10,14,24
WALDO BALLIVIAN,consulta externa,repetidas en personas de 60 anos o mas,2007-06-01,1,1,1,1,2
WARNES,consulta externa,repetidas en personas de 60 anos o mas,2007-06-01,6,5,6,5,11
YACO,consulta externa,repetidas en personas de 60 anos o mas,2007-06-01,3,2,3,2,5
YACUIBA,consulta externa,repetidas en personas de 60 anos o mas,2007-06-01,171,284,171,284,455
YAMPARAEZ,consulta externa,repetidas en personas de 60 anos o mas,2007-06-01,8,5,8,5,13
YAPACANI,consulta externa,repetidas en personas de 60 anos o mas,2007-06-01,3,3,3,3,6
YOCALLA,consulta externa,repetidas en personas de 60 anos o mas,2007-06-01,1,1,1,1,2
YOTALA,consulta externa,repetidas en personas de 60 anos o mas,2007-06-01,8,322,8,322,330
YUNCHARA,consulta externa,repetidas en personas de 60 anos o mas,2007-06-01,1,1,1,1,2
ZUDAÑEZ,consulta externa,repetidas en personas de 60 anos o mas,2007-06-01,1,2,1,2,3
ACACIO,consulta externa,repetidas en personas de 60 anos o mas,2007-07-01,0,1,0,1,1
ACHACACHI,consulta externa,repetidas en personas de 60 anos o mas,2007-07-01,25,21,25,21,46
ACHOCALLA,consulta externa,repetidas en personas de 60 anos o mas,2007-07-01,0,3,0,3,3
AIQUILE,consulta externa,repetidas en personas de 60 anos o mas,2007-07-01,54,42,54,42,96
ALCALA,consulta externa,repetidas en personas de 60 anos o mas,2007-07-01,1,0,1,0,1
ANCORAIMES,consulta externa,repetidas en personas de 60 anos o mas,2007-07-01,5,2,5,2,7
ANDAMARCA,consulta externa,repetidas en personas de 60 anos o mas,2007-07-01,5,6,5,6,11
ANZALDO,consulta externa,repetidas en personas de 60 anos o mas,2007-07-01,0,2,0,2,2
APOLO,consulta externa,repetidas en personas de 60 anos o mas,2007-07-01,10,13,10,13,23
ARANI,consulta externa,repetidas en personas de 60 anos o mas,2007-07-01,3,7,3,7,10
ARBIETO,consulta externa,repetidas en personas de 60 anos o mas,2007-07-01,11,12,11,12,23
ASCENCION DE GUARAYOS,consulta externa,repetidas en personas de 60 anos o mas,2007-07-01,4,3,4,3,7
ATOCHA,consulta externa,repetidas en personas de 60 anos o mas,2007-07-01,39,48,39,48,87
AUCAPATA,consulta externa,repetidas en personas de 60 anos o mas,2007-07-01,2,2,2,2,4
AYATA,consulta externa,repetidas en personas de 60 anos o mas,2007-07-01,4,3,4,3,7
AYO AYO,consulta externa,repetidas en personas de 60 anos o mas,2007-07-01,4,2,4,2,6
AYOPAYA (V. DE INDEPENDENCIA),consulta externa,repetidas en personas de 60 anos o mas,2007-07-01,4,12,4,12,16
AZURDUY,consulta externa,repetidas en personas de 60 anos o mas,2007-07-01,0,1,0,1,1
BAURES,consulta externa,repetidas en personas de 60 anos o mas,2007-07-01,4,2,4,2,6
BELEN DE ANDAMARCA,consulta externa,repetidas en personas de 60 anos o mas,2007-07-01,6,1,6,1,7
BELEN DE URMIRI,consulta externa,repetidas en personas de 60 anos o mas,2007-07-01,1,0,1,0,1
BERMEJO,consulta externa,repetidas en personas de 60 anos o mas,2007-07-01,64,60,64,60,124
BETANZOS,consulta externa,repetidas en personas de 60 anos o mas,2007-07-01,57,103,57,103,160
BOLIVAR,consulta externa,repetidas en personas de 60 anos o mas,2007-07-01,1,0,1,0,1
BOYUIBE,consulta externa,repetidas en personas de 60 anos o mas,2007-07-01,0,2,0,2,2
BUENA VISTA,consulta externa,repetidas en personas de 60 anos o mas,2007-07-01,13,17,13,17,30
CABEZAS,consulta externa,repetidas en personas de 60 anos o mas,2007-07-01,11,4,11,4,15
CAIROMA,consulta externa,repetidas en personas de 60 anos o mas,2007-07-01,8,4,8,4,12
"CAIZA ""D""",consulta externa,repetidas en personas de 60 anos o mas,2007-07-01,16,3,16,3,19
CAJUATA,consulta externa,repetidas en personas de 60 anos o mas,2007-07-01,1,4,1,4,5
CALACOTO,consulta externa,repetidas en personas de 60 anos o mas,2007-07-01,5,2,5,2,7
CALAMARCA,consulta externa,repetidas en personas de 60 anos o mas,2007-07-01,6,4,6,4,10
CAMARGO,consulta externa,repetidas en personas de 60 anos o mas,2007-07-01,10,5,10,5,15
CAMATAQUI (C. VILLA ABECIA),consulta externa,repetidas en personas de 60 anos o mas,2007-07-01,6,6,6,6,12
CAMIRI,consulta externa,repetidas en personas de 60 anos o mas,2007-07-01,30,79,30,79,109
CAPINOTA,consulta externa,repetidas en personas de 60 anos o mas,2007-07-01,3,2,3,2,5
CAQUIAVIRI,consulta externa,repetidas en personas de 60 anos o mas,2007-07-01,3,3,3,3,6
CARACOLLO,consulta externa,repetidas en personas de 60 anos o mas,2007-07-01,10,11,10,11,21
CARANAVI,consulta externa,repetidas en personas de 60 anos o mas,2007-07-01,20,7,20,7,27
CARAPARI,consulta externa,repetidas en personas de 60 anos o mas,2007-07-01,2,2,2,2,4
CATACORA,consulta externa,repetidas en personas de 60 anos o mas,2007-07-01,0,1,0,1,1
CHALLAPATA,consulta externa,repetidas en personas de 60 anos o mas,2007-07-01,69,58,69,58,127
CHARAGUA,consulta externa,repetidas en personas de 60 anos o mas,2007-07-01,8,3,8,3,11
CHARAÑA,consulta externa,repetidas en personas de 60 anos o mas,2007-07-01,2,1,2,1,3
CHAYANTA,consulta externa,repetidas en personas de 60 anos o mas,2007-07-01,4,5,4,5,9
CHIMORE,consulta externa,repetidas en personas de 60 anos o mas,2007-07-01,5,1,5,1,6
CHOQUE COTA,consulta externa,repetidas en personas de 60 anos o mas,2007-07-01,2,2,2,2,4
CHULUMANI (V. DE LA LIBERTAD),consulta externa,repetidas en personas de 60 anos o mas,2007-07-01,18,29,18,29,47
CHUMA,consulta externa,repetidas en personas de 60 anos o mas,2007-07-01,4,3,4,3,7
CLIZA,consulta externa,repetidas en personas de 60 anos o mas,2007-07-01,15,10,15,10,25
COBIJA,consulta externa,repetidas en personas de 60 anos o mas,2007-07-01,30,80,30,80,110
COCHABAMBA,consulta externa,repetidas en personas de 60 anos o mas,2007-07-01,6058,8224,6058,8224,14282
COIPASA,consulta externa,repetidas en personas de 60 anos o mas,2007-07-01,0,1,0,1,1
COLCAPIRHUA,consulta externa,repetidas en personas de 60 anos o mas,2007-07-01,50,107,50,107,157
"COLCHA ""K""",consulta externa,repetidas en personas de 60 anos o mas,2007-07-01,2,1,2,1,3
COLLANA,consulta externa,repetidas en personas de 60 anos o mas,2007-07-01,1,3,1,3,4
COLOMI,consulta externa,repetidas en personas de 60 anos o mas,2007-07-01,2,1,2,1,3
COLPA BELGICA,consulta externa,repetidas en personas de 60 anos o mas,2007-07-01,47,20,47,20,67
COLQUECHACA,consulta externa,repetidas en personas de 60 anos o mas,2007-07-01,5,5,5,5,10
COLQUENCHA,consulta externa,repetidas en personas de 60 anos o mas,2007-07-01,3,3,3,3,6
COLQUIRI,consulta externa,repetidas en personas de 60 anos o mas,2007-07-01,7,10,7,10,17
COMANCHE,consulta externa,repetidas en personas de 60 anos o mas,2007-07-01,1,0,1,0,1
COMARAPA,consulta externa,repetidas en personas de 60 anos o mas,2007-07-01,6,10,6,10,16
CONCEPCION,consulta externa,repetidas en personas de 60 anos o mas,2007-07-01,1,1,1,1,2
COPACABANA,consulta externa,repetidas en personas de 60 anos o mas,2007-07-01,4,7,4,7,11
CORIPATA,consulta externa,repetidas en personas de 60 anos o mas,2007-07-01,6,2,6,2,8
CORO CORO,consulta externa,repetidas en personas de 60 anos o mas,2007-07-01,1,2,1,2,3
COROICO,consulta externa,repetidas en personas de 60 anos o mas,2007-07-01,36,68,36,68,104
CORQUE,consulta externa,repetidas en personas de 60 anos o mas,2007-07-01,5,3,5,3,8
COTAGAITA,consulta externa,repetidas en personas de 60 anos o mas,2007-07-01,6,29,6,29,35
COTOCA,consulta externa,repetidas en personas de 60 anos o mas,2007-07-01,15,31,15,31,46
CUATRO CAÑADAS,consulta externa,repetidas en personas de 60 anos o mas,2007-07-01,12,12,12,12,24
CUCHUMUELA (V. G. VILLARROEL),consulta externa,repetidas en personas de 60 anos o mas,2007-07-01,1,1,1,1,2
CUEVO,consulta externa,repetidas en personas de 60 anos o mas,2007-07-01,1,5,1,5,6
CULPINA,consulta externa,repetidas en personas de 60 anos o mas,2007-07-01,5,10,5,10,15
CURAHUARA DE CARANGAS,consulta externa,repetidas en personas de 60 anos o mas,2007-07-01,2,0,2,0,2
CURVA,consulta externa,repetidas en personas de 60 anos o mas,2007-07-01,0,7,0,7,7
DESAGUADERO,consulta externa,repetidas en personas de 60 anos o mas,2007-07-01,9,4,9,4,13
EL ALTO,consulta externa,repetidas en personas de 60 anos o mas,2007-07-01,1223,1360,1223,1360,2583
EL CHORO,consulta externa,repetidas en personas de 60 anos o mas,2007-07-01,13,7,13,7,20
EL PUENTE(STC),consulta externa,repetidas en personas de 60 anos o mas,2007-07-01,2,1,2,1,3
EL PUENTE(TJA),consulta externa,repetidas en personas de 60 anos o mas,2007-07-01,0,1,0,1,1
EL TORNO,consulta externa,repetidas en personas de 60 anos o mas,2007-07-01,210,205,210,205,415
EL VILLAR,consulta externa,repetidas en personas de 60 anos o mas,2007-07-01,4,5,4,5,9
ENTRE RIOS,consulta externa,repetidas en personas de 60 anos o mas,2007-07-01,3,6,3,6,9
ENTRE RIOS,consulta externa,repetidas en personas de 60 anos o mas,2007-07-01,0,1,0,1,1
ESCARA,consulta externa,repetidas en personas de 60 anos o mas,2007-07-01,0,1,0,1,1
EUCALIPTUS,consulta externa,repetidas en personas de 60 anos o mas,2007-07-01,4,7,4,7,11
EXALTACION,consulta externa,repetidas en personas de 60 anos o mas,2007-07-01,1,1,1,1,2
FERNANDEZ ALONSO,consulta externa,repetidas en personas de 60 anos o mas,2007-07-01,0,4,0,4,4
FILADELFIA,consulta externa,repetidas en personas de 60 anos o mas,2007-07-01,20,20,20,20,40
GRAL. J.J. PEREZ (CHARAZANI),consulta externa,repetidas en personas de 60 anos o mas,2007-07-01,3,4,3,4,7
GUANAY,consulta externa,repetidas en personas de 60 anos o mas,2007-07-01,17,13,17,13,30
GUAQUI,consulta externa,repetidas en personas de 60 anos o mas,2007-07-01,4,3,4,3,7
GUAYARAMERIN,consulta externa,repetidas en personas de 60 anos o mas,2007-07-01,94,120,94,120,214
GUTIERREZ,consulta externa,repetidas en personas de 60 anos o mas,2007-07-01,3,5,3,5,8
HUACARETA,consulta externa,repetidas en personas de 60 anos o mas,2007-07-01,8,5,8,5,13
HUACHACALLA,consulta externa,repetidas en personas de 60 anos o mas,2007-07-01,3,2,3,2,5
HUANUNI,consulta externa,repetidas en personas de 60 anos o mas,2007-07-01,105,217,105,217,322
HUARACAJE,consulta externa,repetidas en personas de 60 anos o mas,2007-07-01,5,1,5,1,6
HUAYLLAMARCA,consulta externa,repetidas en personas de 60 anos o mas,2007-07-01,0,4,0,4,4
ICHOCA,consulta externa,repetidas en personas de 60 anos o mas,2007-07-01,0,1,0,1,1
ICLA,consulta externa,repetidas en personas de 60 anos o mas,2007-07-01,0,2,0,2,2
INCAHUASI,consulta externa,repetidas en personas de 60 anos o mas,2007-07-01,3,2,3,2,5
INQUISIVI,consulta externa,repetidas en personas de 60 anos o mas,2007-07-01,3,0,3,0,3
IRUPANA (VILLA DE LANZA),consulta externa,repetidas en personas de 60 anos o mas,2007-07-01,10,5,10,5,15
IXIAMAS,consulta externa,repetidas en personas de 60 anos o mas,2007-07-01,0,1,0,1,1
JESUS DE MACHACA,consulta externa,repetidas en personas de 60 anos o mas,2007-07-01,11,12,11,12,23
LA ASUNTA,consulta externa,repetidas en personas de 60 anos o mas,2007-07-01,1,1,1,1,2
LA GUARDIA,consulta externa,repetidas en personas de 60 anos o mas,2007-07-01,6,6,6,6,12
LA PAZ,consulta externa,repetidas en personas de 60 anos o mas,2007-07-01,9535,12001,9535,12001,21536
LAGUNILLAS,consulta externa,repetidas en personas de 60 anos o mas,2007-07-01,0,3,0,3,3
LAJA,consulta externa,repetidas en personas de 60 anos o mas,2007-07-01,5,1,5,1,6
LAS CARRERAS,consulta externa,repetidas en personas de 60 anos o mas,2007-07-01,7,11,7,11,18
LICOMA PAMPA,consulta externa,repetidas en personas de 60 anos o mas,2007-07-01,1,1,1,1,2
LLALLAGUA,consulta externa,repetidas en personas de 60 anos o mas,2007-07-01,61,45,61,45,106
LLICA,consulta externa,repetidas en personas de 60 anos o mas,2007-07-01,6,4,6,4,10
LORETO,consulta externa,repetidas en personas de 60 anos o mas,2007-07-01,1,3,1,3,4
LURIBAY,consulta externa,repetidas en personas de 60 anos o mas,2007-07-01,5,9,5,9,14
MACHACAMARCA,consulta externa,repetidas en personas de 60 anos o mas,2007-07-01,40,35,40,35,75
MACHARETI,consulta externa,repetidas en personas de 60 anos o mas,2007-07-01,6,3,6,3,9
MAGDALENA,consulta externa,repetidas en personas de 60 anos o mas,2007-07-01,73,68,73,68,141
MAIRANA,consulta externa,repetidas en personas de 60 anos o mas,2007-07-01,0,2,0,2,2
MALLA,consulta externa,repetidas en personas de 60 anos o mas,2007-07-01,2,4,2,4,6
MAPIRI,consulta externa,repetidas en personas de 60 anos o mas,2007-07-01,3,4,3,4,7
MECAPACA,consulta externa,repetidas en personas de 60 anos o mas,2007-07-01,5,2,5,2,7
MINEROS,consulta externa,repetidas en personas de 60 anos o mas,2007-07-01,0,1,0,1,1
MIZQUE,consulta externa,repetidas en personas de 60 anos o mas,2007-07-01,2,4,2,4,6
MOCOMOCO,consulta externa,repetidas en personas de 60 anos o mas,2007-07-01,6,11,6,11,17
MOJOCOYA,consulta externa,repetidas en personas de 60 anos o mas,2007-07-01,5,13,5,13,18
MONTEAGUDO,consulta externa,repetidas en personas de 60 anos o mas,2007-07-01,96,129,96,129,225
MONTERO,consulta externa,repetidas en personas de 60 anos o mas,2007-07-01,426,505,426,505,931
MORO MORO,consulta externa,repetidas en personas de 60 anos o mas,2007-07-01,2,8,2,8,10
MOROCHATA,consulta externa,repetidas en personas de 60 anos o mas,2007-07-01,8,15,8,15,23
NACEBE (SANTA ROSA DEL ABUNA),consulta externa,repetidas en personas de 60 anos o mas,2007-07-01,0,1,0,1,1
OCURI,consulta externa,repetidas en personas de 60 anos o mas,2007-07-01,1,5,1,5,6
OKINAWA,consulta externa,repetidas en personas de 60 anos o mas,2007-07-01,24,10,24,10,34
OMEREQUE,consulta externa,repetidas en personas de 60 anos o mas,2007-07-01,1,1,1,1,2
ORURO,consulta externa,repetidas en personas de 60 anos o mas,2007-07-01,2018,1519,2018,1519,3537
PADCAYA,consulta externa,repetidas en personas de 60 anos o mas,2007-07-01,3,6,3,6,9
PADILLA,consulta externa,repetidas en personas de 60 anos o mas,2007-07-01,16,29,16,29,45
PALCA,consulta externa,repetidas en personas de 60 anos o mas,2007-07-01,9,5,9,5,14
PALOS BLANCOS,consulta externa,repetidas en personas de 60 anos o mas,2007-07-01,3,4,3,4,7
PAMPA AULLAGAS,consulta externa,repetidas en personas de 60 anos o mas,2007-07-01,1,0,1,0,1
PAMPA GRANDE,consulta externa,repetidas en personas de 60 anos o mas,2007-07-01,4,4,4,4,8
PATACAMAYA,consulta externa,repetidas en personas de 60 anos o mas,2007-07-01,1,1,1,1,2
PAZÑA,consulta externa,repetidas en personas de 60 anos o mas,2007-07-01,34,18,34,18,52
POCOATA,consulta externa,repetidas en personas de 60 anos o mas,2007-07-01,6,4,6,4,10
POCONA,consulta externa,repetidas en personas de 60 anos o mas,2007-07-01,1,3,1,3,4
POOPO,consulta externa,repetidas en personas de 60 anos o mas,2007-07-01,17,17,17,17,34
POROMA,consulta externa,repetidas en personas de 60 anos o mas,2007-07-01,2,3,2,3,5
PORONGO,consulta externa,repetidas en personas de 60 anos o mas,2007-07-01,1,1,1,1,2
PORTACHUELO,consulta externa,repetidas en personas de 60 anos o mas,2007-07-01,11,12,11,12,23
PORVENIR,consulta externa,repetidas en personas de 60 anos o mas,2007-07-01,1,2,1,2,3
POSTRER VALLE,consulta externa,repetidas en personas de 60 anos o mas,2007-07-01,1,1,1,1,2
POTOSI,consulta externa,repetidas en personas de 60 anos o mas,2007-07-01,932,1313,932,1313,2245
PUCARA,consulta externa,repetidas en personas de 60 anos o mas,2007-07-01,1,1,1,1,2
PUCARANI,consulta externa,repetidas en personas de 60 anos o mas,2007-07-01,4,0,4,0,4
PUERTO ACOSTA,consulta externa,repetidas en personas de 60 anos o mas,2007-07-01,5,6,5,6,11
PUERTO CARABUCO,consulta externa,repetidas en personas de 60 anos o mas,2007-07-01,4,4,4,4,8
PUERTO GONZALO MORENO,consulta externa,repetidas en personas de 60 anos o mas,2007-07-01,1,0,1,0,1
PUERTO PEREZ,consulta externa,repetidas en personas de 60 anos o mas,2007-07-01,1,3,1,3,4
PUERTO QUIJARRO,consulta externa,repetidas en personas de 60 anos o mas,2007-07-01,4,1,4,1,5
PUERTO RICO,consulta externa,repetidas en personas de 60 anos o mas,2007-07-01,1,2,1,2,3
PUERTO SUAREZ,consulta externa,repetidas en personas de 60 anos o mas,2007-07-01,9,11,9,11,20
PUERTO VILLARROEL,consulta externa,repetidas en personas de 60 anos o mas,2007-07-01,2,4,2,4,6
PUNA,consulta externa,repetidas en personas de 60 anos o mas,2007-07-01,9,13,9,13,22
PUNATA,consulta externa,repetidas en personas de 60 anos o mas,2007-07-01,101,137,101,137,238
QUIABAYA,consulta externa,repetidas en personas de 60 anos o mas,2007-07-01,0,1,0,1,1
QUILLACOLLO,consulta externa,repetidas en personas de 60 anos o mas,2007-07-01,318,455,318,455,773
QUIME,consulta externa,repetidas en personas de 60 anos o mas,2007-07-01,3,4,3,4,7
REYES,consulta externa,repetidas en personas de 60 anos o mas,2007-07-01,50,51,50,51,101
RIBERALTA,consulta externa,repetidas en personas de 60 anos o mas,2007-07-01,132,7,132,7,139
ROBORE,consulta externa,repetidas en personas de 60 anos o mas,2007-07-01,52,39,52,39,91
RURRENABAQUE,consulta externa,repetidas en personas de 60 anos o mas,2007-07-01,92,88,92,88,180
SABAYA,consulta externa,repetidas en personas de 60 anos o mas,2007-07-01,1,4,1,4,5
SACABA,consulta externa,repetidas en personas de 60 anos o mas,2007-07-01,111,150,111,150,261
SACABAMBA,consulta externa,repetidas en personas de 60 anos o mas,2007-07-01,1,8,1,8,9
SACACA,consulta externa,repetidas en personas de 60 anos o mas,2007-07-01,0,1,0,1,1
SAIPINA,consulta externa,repetidas en personas de 60 anos o mas,2007-07-01,1,2,1,2,3
SALINAS DE GARCI MENDOZA,consulta externa,repetidas en personas de 60 anos o mas,2007-07-01,7,11,7,11,18
SAMAIPATA,consulta externa,repetidas en personas de 60 anos o mas,2007-07-01,2,1,2,1,3
SAN AGUSTIN,consulta externa,repetidas en personas de 60 anos o mas,2007-07-01,2,0,2,0,2
SAN ANDRES DE MACHACA,consulta externa,repetidas en personas de 60 anos o mas,2007-07-01,2,3,2,3,5
SAN ANTONIO DE ESMORUCO,consulta externa,repetidas en personas de 60 anos o mas,2007-07-01,1,0,1,0,1
SAN ANTONIO DE LOMERIO,consulta externa,repetidas en personas de 60 anos o mas,2007-07-01,1,1,1,1,2
SAN BENITO,consulta externa,repetidas en personas de 60 anos o mas,2007-07-01,3,3,3,3,6
SAN BORJA,consulta externa,repetidas en personas de 60 anos o mas,2007-07-01,57,61,57,61,118
SAN BUENA VENTURA,consulta externa,repetidas en personas de 60 anos o mas,2007-07-01,6,6,6,6,12
SAN CARLOS,consulta externa,repetidas en personas de 60 anos o mas,2007-07-01,23,19,23,19,42
SAN IGNACIO,consulta externa,repetidas en personas de 60 anos o mas,2007-07-01,38,48,38,48,86
SAN IGNACIO DE VELASCO,consulta externa,repetidas en personas de 60 anos o mas,2007-07-01,45,35,45,35,80
SAN JAVIER(BNI),consulta externa,repetidas en personas de 60 anos o mas,2007-07-01,1,0,1,0,1
SAN JAVIER(STC),consulta externa,repetidas en personas de 60 anos o mas,2007-07-01,8,5,8,5,13
SAN JOAQUIN,consulta externa,repetidas en personas de 60 anos o mas,2007-07-01,66,67,66,67,133
SAN JOSE DE CHIQUITOS,consulta externa,repetidas en personas de 60 anos o mas,2007-07-01,5,5,5,5,10
SAN JUAN DE YAPACANI,consulta externa,repetidas en personas de 60 anos o mas,2007-07-01,13,11,13,11,24
SAN JULIAN,consulta externa,repetidas en personas de 60 anos o mas,2007-07-01,3,1,3,1,4
SAN LORENZO(TJA),consulta externa,repetidas en personas de 60 anos o mas,2007-07-01,5,18,5,18,23
SAN LUCAS,consulta externa,repetidas en personas de 60 anos o mas,2007-07-01,38,31,38,31,69
SAN MATIAS,consulta externa,repetidas en personas de 60 anos o mas,2007-07-01,2,0,2,0,2
SAN MIGUEL DE VELASCO,consulta externa,repetidas en personas de 60 anos o mas,2007-07-01,21,46,21,46,67
SAN PABLO DE LIPEZ,consulta externa,repetidas en personas de 60 anos o mas,2007-07-01,0,1,0,1,1
SAN PEDRO,consulta externa,repetidas en personas de 60 anos o mas,2007-07-01,7,3,7,3,10
SAN PEDRO DE BUENA VISTA,consulta externa,repetidas en personas de 60 anos o mas,2007-07-01,1,1,1,1,2
SAN PEDRO DE CURAHUARA,consulta externa,repetidas en personas de 60 anos o mas,2007-07-01,4,4,4,4,8
SAN PEDRO DE TIQUINA,consulta externa,repetidas en personas de 60 anos o mas,2007-07-01,6,6,6,6,12
SAN RAFAEL,consulta externa,repetidas en personas de 60 anos o mas,2007-07-01,3,1,3,1,4
SAN RAMON,consulta externa,repetidas en personas de 60 anos o mas,2007-07-01,14,18,14,18,32
SAN RAMON,consulta externa,repetidas en personas de 60 anos o mas,2007-07-01,26,26,26,26,52
SANTA ANA,consulta externa,repetidas en personas de 60 anos o mas,2007-07-01,43,49,43,49,92
SANTA CRUZ DE LA SIERRA,consulta externa,repetidas en personas de 60 anos o mas,2007-07-01,3496,5962,3496,5962,9458
SANTA ROSA DEL SARA,consulta externa,repetidas en personas de 60 anos o mas,2007-07-01,1,0,1,0,1
SANTIAGO DE CALLAPA,consulta externa,repetidas en personas de 60 anos o mas,2007-07-01,2,1,2,1,3
SANTIAGO DE HUARI,consulta externa,repetidas en personas de 60 anos o mas,2007-07-01,50,48,50,48,98
SANTIAGO DE MACHACA,consulta externa,repetidas en personas de 60 anos o mas,2007-07-01,2,2,2,2,4
SANTIVAÑES,consulta externa,repetidas en personas de 60 anos o mas,2007-07-01,3,6,3,6,9
SAPAHAQUI,consulta externa,repetidas en personas de 60 anos o mas,2007-07-01,2,1,2,1,3
SICA SICA (VILLA AROMA),consulta externa,repetidas en personas de 60 anos o mas,2007-07-01,3,1,3,1,4
SICAYA,consulta externa,repetidas en personas de 60 anos o mas,2007-07-01,0,4,0,4,4
SIPE SIPE,consulta externa,repetidas en personas de 60 anos o mas,2007-07-01,14,18,14,18,32
SOPACHUY,consulta externa,repetidas en personas de 60 anos o mas,2007-07-01,0,5,0,5,5
SORACACHI,consulta externa,repetidas en personas de 60 anos o mas,2007-07-01,5,1,5,1,6
SORATA,consulta externa,repetidas en personas de 60 anos o mas,2007-07-01,3,4,3,4,7
SUCRE,consulta externa,repetidas en personas de 60 anos o mas,2007-07-01,1725,2239,1725,2239,3964
TACACHI,consulta externa,repetidas en personas de 60 anos o mas,2007-07-01,5,4,5,4,9
TACACOMA,consulta externa,repetidas en personas de 60 anos o mas,2007-07-01,1,0,1,0,1
TACOPAYA,consulta externa,repetidas en personas de 60 anos o mas,2007-07-01,1,0,1,0,1
TAPACARI,consulta externa,repetidas en personas de 60 anos o mas,2007-07-01,1,1,1,1,2
TARABUCO,consulta externa,repetidas en personas de 60 anos o mas,2007-07-01,18,40,18,40,58
TARACO,consulta externa,repetidas en personas de 60 anos o mas,2007-07-01,1,1,1,1,2
TARATA,consulta externa,repetidas en personas de 60 anos o mas,2007-07-01,1,1,1,1,2
TARIJA,consulta externa,repetidas en personas de 60 anos o mas,2007-07-01,1923,2713,1923,2713,4636
TARVITA,consulta externa,repetidas en personas de 60 anos o mas,2007-07-01,1,8,1,8,9
TEOPONTE,consulta externa,repetidas en personas de 60 anos o mas,2007-07-01,12,11,12,11,23
TIAWANACU,consulta externa,repetidas en personas de 60 anos o mas,2007-07-01,2,4,2,4,6
TINGUIPAYA,consulta externa,repetidas en personas de 60 anos o mas,2007-07-01,1,1,1,1,2
TIPUANI,consulta externa,repetidas en personas de 60 anos o mas,2007-07-01,0,4,0,4,4
TIQUIPAYA,consulta externa,repetidas en personas de 60 anos o mas,2007-07-01,11,19,11,19,30
TIRAQUE (CBBA),consulta externa,repetidas en personas de 60 anos o mas,2007-07-01,8,16,8,16,24
TITO YUPANQUI (PARQUIPUJIO),consulta externa,repetidas en personas de 60 anos o mas,2007-07-01,1,2,1,2,3
TOCO,consulta externa,repetidas en personas de 60 anos o mas,2007-07-01,0,1,0,1,1
TODOS SANTOS,consulta externa,repetidas en personas de 60 anos o mas,2007-07-01,5,2,5,2,7
TOLATA,consulta externa,repetidas en personas de 60 anos o mas,2007-07-01,0,5,0,5,5
TOLEDO,consulta externa,repetidas en personas de 60 anos o mas,2007-07-01,4,2,4,2,6
TOMAVE,consulta externa,repetidas en personas de 60 anos o mas,2007-07-01,6,7,6,7,13
TOMINA,consulta externa,repetidas en personas de 60 anos o mas,2007-07-01,2,3,2,3,5
TORO TORO,consulta externa,repetidas en personas de 60 anos o mas,2007-07-01,1,0,1,0,1
TOTORA(CBBA),consulta externa,repetidas en personas de 60 anos o mas,2007-07-01,5,6,5,6,11
TOTORA(ORR),consulta externa,repetidas en personas de 60 anos o mas,2007-07-01,1,1,1,1,2
TRIGAL,consulta externa,repetidas en personas de 60 anos o mas,2007-07-01,2,2,2,2,4
TRINIDAD,consulta externa,repetidas en personas de 60 anos o mas,2007-07-01,242,263,242,263,505
TUPIZA,consulta externa,repetidas en personas de 60 anos o mas,2007-07-01,41,49,41,49,90
TURCO,consulta externa,repetidas en personas de 60 anos o mas,2007-07-01,15,6,15,6,21
UNCIA,consulta externa,repetidas en personas de 60 anos o mas,2007-07-01,50,81,50,81,131
URIONDO (A. CONCEPCION),consulta externa,repetidas en personas de 60 anos o mas,2007-07-01,5,11,5,11,16
URUBICHA,consulta externa,repetidas en personas de 60 anos o mas,2007-07-01,1,1,1,1,2
UYUNI,consulta externa,repetidas en personas de 60 anos o mas,2007-07-01,49,37,49,37,86
VACAS,consulta externa,repetidas en personas de 60 anos o mas,2007-07-01,11,24,11,24,35
VALLEGRANDE,consulta externa,repetidas en personas de 60 anos o mas,2007-07-01,273,401,273,401,674
VIACHA,consulta externa,repetidas en personas de 60 anos o mas,2007-07-01,152,265,152,265,417
VILLA MONTES,consulta externa,repetidas en personas de 60 anos o mas,2007-07-01,73,73,73,73,146
VILLA RIVERO,consulta externa,repetidas en personas de 60 anos o mas,2007-07-01,2,7,2,7,9
VILLA SERRANO,consulta externa,repetidas en personas de 60 anos o mas,2007-07-01,1,1,1,1,2
VILLA TUNARI,consulta externa,repetidas en personas de 60 anos o mas,2007-07-01,47,46,47,46,93
VILLA VACA GUZMAN (MUYUPAMPA),consulta externa,repetidas en personas de 60 anos o mas,2007-07-01,1,1,1,1,2
VILLAZON,consulta externa,repetidas en personas de 60 anos o mas,2007-07-01,39,57,39,57,96
VINTO,consulta externa,repetidas en personas de 60 anos o mas,2007-07-01,30,38,30,38,68
VITICHI,consulta externa,repetidas en personas de 60 anos o mas,2007-07-01,5,7,5,7,12
WARNES,consulta externa,repetidas en personas de 60 anos o mas,2007-07-01,3,4,3,4,7
YACO,consulta externa,repetidas en personas de 60 anos o mas,2007-07-01,1,0,1,0,1
YACUIBA,consulta externa,repetidas en personas de 60 anos o mas,2007-07-01,211,232,211,232,443
YAMPARAEZ,consulta externa,repetidas en personas de 60 anos o mas,2007-07-01,7,15,7,15,22
YANACACHI,consulta externa,repetidas en personas de 60 anos o mas,2007-07-01,2,0,2,0,2
YAPACANI,consulta externa,repetidas en personas de 60 anos o mas,2007-07-01,4,1,4,1,5
YOCALLA,consulta externa,repetidas en personas de 60 anos o mas,2007-07-01,0,3,0,3,3
YOTALA,consulta externa,repetidas en personas de 60 anos o mas,2007-07-01,5,20,5,20,25
YUNCHARA,consulta externa,repetidas en personas de 60 anos o mas,2007-07-01,0,3,0,3,3
ZUDAÑEZ,consulta externa,repetidas en personas de 60 anos o mas,2007-07-01,4,3,4,3,7
ACHACACHI,consulta externa,repetidas en personas de 60 anos o mas,2007-08-01,20,27,20,27,47
ACHOCALLA,consulta externa,repetidas en personas de 60 anos o mas,2007-08-01,8,2,8,2,10
AIQUILE,consulta externa,repetidas en personas de 60 anos o mas,2007-08-01,43,59,43,59,102
ALALAY,consulta externa,repetidas en personas de 60 anos o mas,2007-08-01,0,1,0,1,1
ANCORAIMES,consulta externa,repetidas en personas de 60 anos o mas,2007-08-01,4,6,4,6,10
ANDAMARCA,consulta externa,repetidas en personas de 60 anos o mas,2007-08-01,2,8,2,8,10
ANZALDO,consulta externa,repetidas en personas de 60 anos o mas,2007-08-01,2,2,2,2,4
APOLO,consulta externa,repetidas en personas de 60 anos o mas,2007-08-01,10,8,10,8,18
ARANI,consulta externa,repetidas en personas de 60 anos o mas,2007-08-01,6,12,6,12,18
ARBIETO,consulta externa,repetidas en personas de 60 anos o mas,2007-08-01,2,2,2,2,4
ASCENCION DE GUARAYOS,consulta externa,repetidas en personas de 60 anos o mas,2007-08-01,1,2,1,2,3
ATOCHA,consulta externa,repetidas en personas de 60 anos o mas,2007-08-01,35,45,35,45,80
AUCAPATA,consulta externa,repetidas en personas de 60 anos o mas,2007-08-01,1,2,1,2,3
AYATA,consulta externa,repetidas en personas de 60 anos o mas,2007-08-01,4,6,4,6,10
AYO AYO,consulta externa,repetidas en personas de 60 anos o mas,2007-08-01,1,2,1,2,3
AYOPAYA (V. DE INDEPENDENCIA),consulta externa,repetidas en personas de 60 anos o mas,2007-08-01,1,4,1,4,5
AZURDUY,consulta externa,repetidas en personas de 60 anos o mas,2007-08-01,1,0,1,0,1
BATALLAS,consulta externa,repetidas en personas de 60 anos o mas,2007-08-01,3,1,3,1,4
BAURES,consulta externa,repetidas en personas de 60 anos o mas,2007-08-01,6,3,6,3,9
BELEN DE ANDAMARCA,consulta externa,repetidas en personas de 60 anos o mas,2007-08-01,3,2,3,2,5
BELEN DE URMIRI,consulta externa,repetidas en personas de 60 anos o mas,2007-08-01,2,2,2,2,4
BERMEJO,consulta externa,repetidas en personas de 60 anos o mas,2007-08-01,68,47,68,47,115
BETANZOS,consulta externa,repetidas en personas de 60 anos o mas,2007-08-01,63,131,63,131,194
BOLIVAR,consulta externa,repetidas en personas de 60 anos o mas,2007-08-01,2,0,2,0,2
BOLPEBRA,consulta externa,repetidas en personas de 60 anos o mas,2007-08-01,1,0,1,0,1
BOYUIBE,consulta externa,repetidas en personas de 60 anos o mas,2007-08-01,0,4,0,4,4
BUENA VISTA,consulta externa,repetidas en personas de 60 anos o mas,2007-08-01,17,16,17,16,33
CABEZAS,consulta externa,repetidas en personas de 60 anos o mas,2007-08-01,4,6,4,6,10
CAIROMA,consulta externa,repetidas en personas de 60 anos o mas,2007-08-01,6,2,6,2,8
"CAIZA ""D""",consulta externa,repetidas en personas de 60 anos o mas,2007-08-01,4,17,4,17,21
CAJUATA,consulta externa,repetidas en personas de 60 anos o mas,2007-08-01,2,6,2,6,8
CALACOTO,consulta externa,repetidas en personas de 60 anos o mas,2007-08-01,1,4,1,4,5
CALAMARCA,consulta externa,repetidas en personas de 60 anos o mas,2007-08-01,7,1,7,1,8
CAMARGO,consulta externa,repetidas en personas de 60 anos o mas,2007-08-01,20,12,20,12,32
CAMATAQUI (C. VILLA ABECIA),consulta externa,repetidas en personas de 60 anos o mas,2007-08-01,3,9,3,9,12
CAMIRI,consulta externa,repetidas en personas de 60 anos o mas,2007-08-01,89,61,89,61,150
CAPINOTA,consulta externa,repetidas en personas de 60 anos o mas,2007-08-01,30,26,30,26,56
CAQUIAVIRI,consulta externa,repetidas en personas de 60 anos o mas,2007-08-01,5,0,5,0,5
CARACOLLO,consulta externa,repetidas en personas de 60 anos o mas,2007-08-01,24,9,24,9,33
CARANAVI,consulta externa,repetidas en personas de 60 anos o mas,2007-08-01,24,10,24,10,34
CATACORA,consulta externa,repetidas en personas de 60 anos o mas,2007-08-01,2,3,2,3,5
CHALLAPATA,consulta externa,repetidas en personas de 60 anos o mas,2007-08-01,59,60,59,60,119
CHARAGUA,consulta externa,repetidas en personas de 60 anos o mas,2007-08-01,16,5,16,5,21
CHAYANTA,consulta externa,repetidas en personas de 60 anos o mas,2007-08-01,2,4,2,4,6
CHIMORE,consulta externa,repetidas en personas de 60 anos o mas,2007-08-01,2,1,2,1,3
CHOQUE COTA,consulta externa,repetidas en personas de 60 anos o mas,2007-08-01,1,5,1,5,6
CHULUMANI (V. DE LA LIBERTAD),consulta externa,repetidas en personas de 60 anos o mas,2007-08-01,27,28,27,28,55
CHUMA,consulta externa,repetidas en personas de 60 anos o mas,2007-08-01,4,2,4,2,6
CLIZA,consulta externa,repetidas en personas de 60 anos o mas,2007-08-01,22,12,22,12,34
COBIJA,consulta externa,repetidas en personas de 60 anos o mas,2007-08-01,33,81,33,81,114
COCHABAMBA,consulta externa,repetidas en personas de 60 anos o mas,2007-08-01,6425,8181,6425,8181,14606
COLCAPIRHUA,consulta externa,repetidas en personas de 60 anos o mas,2007-08-01,64,136,64,136,200
"COLCHA ""K""",consulta externa,repetidas en personas de 60 anos o mas,2007-08-01,4,7,4,7,11
COLLANA,consulta externa,repetidas en personas de 60 anos o mas,2007-08-01,1,0,1,0,1
COLOMI,consulta externa,repetidas en personas de 60 anos o mas,2007-08-01,1,1,1,1,2
COLPA BELGICA,consulta externa,repetidas en personas de 60 anos o mas,2007-08-01,29,13,29,13,42
COLQUECHACA,consulta externa,repetidas en personas de 60 anos o mas,2007-08-01,0,7,0,7,7
COLQUENCHA,consulta externa,repetidas en personas de 60 anos o mas,2007-08-01,4,7,4,7,11
COLQUIRI,consulta externa,repetidas en personas de 60 anos o mas,2007-08-01,8,9,8,9,17
COMANCHE,consulta externa,repetidas en personas de 60 anos o mas,2007-08-01,2,3,2,3,5
COMARAPA,consulta externa,repetidas en personas de 60 anos o mas,2007-08-01,8,14,8,14,22
CONCEPCION,consulta externa,repetidas en personas de 60 anos o mas,2007-08-01,0,1,0,1,1
COPACABANA,consulta externa,repetidas en personas de 60 anos o mas,2007-08-01,4,8,4,8,12
CORIPATA,consulta externa,repetidas en personas de 60 anos o mas,2007-08-01,8,4,8,4,12
CORO CORO,consulta externa,repetidas en personas de 60 anos o mas,2007-08-01,3,2,3,2,5
COROICO,consulta externa,repetidas en personas de 60 anos o mas,2007-08-01,68,61,68,61,129
CORQUE,consulta externa,repetidas en personas de 60 anos o mas,2007-08-01,2,6,2,6,8
COTAGAITA,consulta externa,repetidas en personas de 60 anos o mas,2007-08-01,22,29,22,29,51
COTOCA,consulta externa,repetidas en personas de 60 anos o mas,2007-08-01,38,52,38,52,90
CUATRO CAÑADAS,consulta externa,repetidas en personas de 60 anos o mas,2007-08-01,1,0,1,0,1
CUCHUMUELA (V. G. VILLARROEL),consulta externa,repetidas en personas de 60 anos o mas,2007-08-01,2,1,2,1,3
CUEVO,consulta externa,repetidas en personas de 60 anos o mas,2007-08-01,0,2,0,2,2
CULPINA,consulta externa,repetidas en personas de 60 anos o mas,2007-08-01,2,2,2,2,4
CURAHUARA DE CARANGAS,consulta externa,repetidas en personas de 60 anos o mas,2007-08-01,1,0,1,0,1
DESAGUADERO,consulta externa,repetidas en personas de 60 anos o mas,2007-08-01,4,2,4,2,6
EL ALTO,consulta externa,repetidas en personas de 60 anos o mas,2007-08-01,1330,1439,1330,1439,2769
EL CHORO,consulta externa,repetidas en personas de 60 anos o mas,2007-08-01,1,7,1,7,8
EL PUENTE(STC),consulta externa,repetidas en personas de 60 anos o mas,2007-08-01,1,1,1,1,2
EL PUENTE(TJA),consulta externa,repetidas en personas de 60 anos o mas,2007-08-01,2,0,2,0,2
EL TORNO,consulta externa,repetidas en personas de 60 anos o mas,2007-08-01,238,294,238,294,532
EL VILLAR,consulta externa,repetidas en personas de 60 anos o mas,2007-08-01,1,5,1,5,6
ENTRE RIOS,consulta externa,repetidas en personas de 60 anos o mas,2007-08-01,3,2,3,2,5
ENTRE RIOS,consulta externa,repetidas en personas de 60 anos o mas,2007-08-01,0,1,0,1,1
EUCALIPTUS,consulta externa,repetidas en personas de 60 anos o mas,2007-08-01,4,2,4,2,6
EXALTACION,consulta externa,repetidas en personas de 60 anos o mas,2007-08-01,1,0,1,0,1
FERNANDEZ ALONSO,consulta externa,repetidas en personas de 60 anos o mas,2007-08-01,0,2,0,2,2
FILADELFIA,consulta externa,repetidas en personas de 60 anos o mas,2007-08-01,1,1,1,1,2
GENERAL SAAVEDRA,consulta externa,repetidas en personas de 60 anos o mas,2007-08-01,1,0,1,0,1
GRAL. J.J. PEREZ (CHARAZANI),consulta externa,repetidas en personas de 60 anos o mas,2007-08-01,2,2,2,2,4
GUANAY,consulta externa,repetidas en personas de 60 anos o mas,2007-08-01,17,10,17,10,27
GUAQUI,consulta externa,repetidas en personas de 60 anos o mas,2007-08-01,14,13,14,13,27
GUAYARAMERIN,consulta externa,repetidas en personas de 60 anos o mas,2007-08-01,169,156,169,156,325
GUTIERREZ,consulta externa,repetidas en personas de 60 anos o mas,2007-08-01,3,3,3,3,6
HUACARETA,consulta externa,repetidas en personas de 60 anos o mas,2007-08-01,7,13,7,13,20
HUACAYA (VILLA DE HUACAYA),consulta externa,repetidas en personas de 60 anos o mas,2007-08-01,1,1,1,1,2
HUANUNI,consulta externa,repetidas en personas de 60 anos o mas,2007-08-01,146,207,146,207,353
HUARACAJE,consulta externa,repetidas en personas de 60 anos o mas,2007-08-01,3,0,3,0,3
HUAYLLAMARCA,consulta externa,repetidas en personas de 60 anos o mas,2007-08-01,2,7,2,7,9
ICHOCA,consulta externa,repetidas en personas de 60 anos o mas,2007-08-01,0,3,0,3,3
ICLA,consulta externa,repetidas en personas de 60 anos o mas,2007-08-01,3,8,3,8,11
INCAHUASI,consulta externa,repetidas en personas de 60 anos o mas,2007-08-01,2,0,2,0,2
INGAVI (HUMAITA),consulta externa,repetidas en personas de 60 anos o mas,2007-08-01,4,2,4,2,6
INQUISIVI,consulta externa,repetidas en personas de 60 anos o mas,2007-08-01,2,0,2,0,2
IRUPANA (VILLA DE LANZA),consulta externa,repetidas en personas de 60 anos o mas,2007-08-01,10,14,10,14,24
IXIAMAS,consulta externa,repetidas en personas de 60 anos o mas,2007-08-01,4,1,4,1,5
JESUS DE MACHACA,consulta externa,repetidas en personas de 60 anos o mas,2007-08-01,12,18,12,18,30
LA ASUNTA,consulta externa,repetidas en personas de 60 anos o mas,2007-08-01,1,3,1,3,4
LA GUARDIA,consulta externa,repetidas en personas de 60 anos o mas,2007-08-01,7,10,7,10,17
LA PAZ,consulta externa,repetidas en personas de 60 anos o mas,2007-08-01,10845,14664,10845,14664,25509
LAGUNILLAS,consulta externa,repetidas en personas de 60 anos o mas,2007-08-01,1,1,1,1,2
LAJA,consulta externa,repetidas en personas de 60 anos o mas,2007-08-01,7,6,7,6,13
LAS CARRERAS,consulta externa,repetidas en personas de 60 anos o mas,2007-08-01,4,9,4,9,13
LICOMA PAMPA,consulta externa,repetidas en personas de 60 anos o mas,2007-08-01,4,0,4,0,4
LLALLAGUA,consulta externa,repetidas en personas de 60 anos o mas,2007-08-01,42,51,42,51,93
LLICA,consulta externa,repetidas en personas de 60 anos o mas,2007-08-01,10,1,10,1,11
LURIBAY,consulta externa,repetidas en personas de 60 anos o mas,2007-08-01,9,9,9,9,18
MACHACAMARCA,consulta externa,repetidas en personas de 60 anos o mas,2007-08-01,30,42,30,42,72
MACHARETI,consulta externa,repetidas en personas de 60 anos o mas,2007-08-01,17,20,17,20,37
MAGDALENA,consulta externa,repetidas en personas de 60 anos o mas,2007-08-01,46,78,46,78,124
MAIRANA,consulta externa,repetidas en personas de 60 anos o mas,2007-08-01,0,1,0,1,1
MALLA,consulta externa,repetidas en personas de 60 anos o mas,2007-08-01,5,0,5,0,5
MAPIRI,consulta externa,repetidas en personas de 60 anos o mas,2007-08-01,5,8,5,8,13
MECAPACA,consulta externa,repetidas en personas de 60 anos o mas,2007-08-01,9,5,9,5,14
MINEROS,consulta externa,repetidas en personas de 60 anos o mas,2007-08-01,1,0,1,0,1
MIZQUE,consulta externa,repetidas en personas de 60 anos o mas,2007-08-01,2,3,2,3,5
MOCOMOCO,consulta externa,repetidas en personas de 60 anos o mas,2007-08-01,3,8,3,8,11
MOJINETE,consulta externa,repetidas en personas de 60 anos o mas,2007-08-01,1,0,1,0,1
MOJOCOYA,consulta externa,repetidas en personas de 60 anos o mas,2007-08-01,9,13,9,13,22
MONTEAGUDO,consulta externa,repetidas en personas de 60 anos o mas,2007-08-01,91,101,91,101,192
MONTERO,consulta externa,repetidas en personas de 60 anos o mas,2007-08-01,202,287,202,287,489
MORO MORO,consulta externa,repetidas en personas de 60 anos o mas,2007-08-01,3,5,3,5,8
MOROCHATA,consulta externa,repetidas en personas de 60 anos o mas,2007-08-01,3,10,3,10,13
NACEBE (SANTA ROSA DEL ABUNA),consulta externa,repetidas en personas de 60 anos o mas,2007-08-01,1,0,1,0,1
OKINAWA,consulta externa,repetidas en personas de 60 anos o mas,2007-08-01,4,10,4,10,14
OMEREQUE,consulta externa,repetidas en personas de 60 anos o mas,2007-08-01,1,2,1,2,3
ORURO,consulta externa,repetidas en personas de 60 anos o mas,2007-08-01,1885,2250,1885,2250,4135
PADCAYA,consulta externa,repetidas en personas de 60 anos o mas,2007-08-01,1,9,1,9,10
PADILLA,consulta externa,repetidas en personas de 60 anos o mas,2007-08-01,13,29,13,29,42
PAILON,consulta externa,repetidas en personas de 60 anos o mas,2007-08-01,0,1,0,1,1
PALCA,consulta externa,repetidas en personas de 60 anos o mas,2007-08-01,14,9,14,9,23
PALOS BLANCOS,consulta externa,repetidas en personas de 60 anos o mas,2007-08-01,3,5,3,5,8
PAMPA AULLAGAS,consulta externa,repetidas en personas de 60 anos o mas,2007-08-01,1,0,1,0,1
PAMPA GRANDE,consulta externa,repetidas en personas de 60 anos o mas,2007-08-01,2,11,2,11,13
PAPEL PAMPA,consulta externa,repetidas en personas de 60 anos o mas,2007-08-01,2,1,2,1,3
PASORAPA,consulta externa,repetidas en personas de 60 anos o mas,2007-08-01,0,1,0,1,1
PAZÑA,consulta externa,repetidas en personas de 60 anos o mas,2007-08-01,18,14,18,14,32
POCOATA,consulta externa,repetidas en personas de 60 anos o mas,2007-08-01,0,4,0,4,4
POCONA,consulta externa,repetidas en personas de 60 anos o mas,2007-08-01,1,2,1,2,3
POOPO,consulta externa,repetidas en personas de 60 anos o mas,2007-08-01,16,11,16,11,27
PORCO,consulta externa,repetidas en personas de 60 anos o mas,2007-08-01,0,2,0,2,2
POROMA,consulta externa,repetidas en personas de 60 anos o mas,2007-08-01,7,4,7,4,11
PORTACHUELO,consulta externa,repetidas en personas de 60 anos o mas,2007-08-01,54,53,54,53,107
PORVENIR,consulta externa,repetidas en personas de 60 anos o mas,2007-08-01,4,1,4,1,5
POSTRER VALLE,consulta externa,repetidas en personas de 60 anos o mas,2007-08-01,3,1,3,1,4
POTOSI,consulta externa,repetidas en personas de 60 anos o mas,2007-08-01,1105,1441,1105,1441,2546
PRESTO,consulta externa,repetidas en personas de 60 anos o mas,2007-08-01,1,0,1,0,1
PUCARA,consulta externa,repetidas en personas de 60 anos o mas,2007-08-01,0,2,0,2,2
PUCARANI,consulta externa,repetidas en personas de 60 anos o mas,2007-08-01,5,6,5,6,11
PUERTO ACOSTA,consulta externa,repetidas en personas de 60 anos o mas,2007-08-01,3,3,3,3,6
PUERTO CARABUCO,consulta externa,repetidas en personas de 60 anos o mas,2007-08-01,2,3,2,3,5
PUERTO GONZALO MORENO,consulta externa,repetidas en personas de 60 anos o mas,2007-08-01,2,1,2,1,3
PUERTO PEREZ,consulta externa,repetidas en personas de 60 anos o mas,2007-08-01,0,8,0,8,8
PUERTO QUIJARRO,consulta externa,repetidas en personas de 60 anos o mas,2007-08-01,7,5,7,5,12
PUERTO RICO,consulta externa,repetidas en personas de 60 anos o mas,2007-08-01,3,3,3,3,6
PUERTO SILES,consulta externa,repetidas en personas de 60 anos o mas,2007-08-01,0,1,0,1,1
PUERTO SUAREZ,consulta externa,repetidas en personas de 60 anos o mas,2007-08-01,12,5,12,5,17
PUERTO VILLARROEL,consulta externa,repetidas en personas de 60 anos o mas,2007-08-01,7,5,7,5,12
PUNA,consulta externa,repetidas en personas de 60 anos o mas,2007-08-01,12,16,12,16,28
PUNATA,consulta externa,repetidas en personas de 60 anos o mas,2007-08-01,80,92,80,92,172
QUILLACOLLO,consulta externa,repetidas en personas de 60 anos o mas,2007-08-01,321,390,321,390,711
QUIME,consulta externa,repetidas en personas de 60 anos o mas,2007-08-01,6,1,6,1,7
QUIRUSILLAS,consulta externa,repetidas en personas de 60 anos o mas,2007-08-01,10,12,10,12,22
REYES,consulta externa,repetidas en personas de 60 anos o mas,2007-08-01,42,34,42,34,76
RIBERALTA,consulta externa,repetidas en personas de 60 anos o mas,2007-08-01,146,11,146,11,157
ROBORE,consulta externa,repetidas en personas de 60 anos o mas,2007-08-01,24,22,24,22,46
RURRENABAQUE,consulta externa,repetidas en personas de 60 anos o mas,2007-08-01,85,89,85,89,174
SABAYA,consulta externa,repetidas en personas de 60 anos o mas,2007-08-01,2,7,2,7,9
SACABA,consulta externa,repetidas en personas de 60 anos o mas,2007-08-01,160,131,160,131,291
SACABAMBA,consulta externa,repetidas en personas de 60 anos o mas,2007-08-01,5,5,5,5,10
SACACA,consulta externa,repetidas en personas de 60 anos o mas,2007-08-01,3,2,3,2,5
SAIPINA,consulta externa,repetidas en personas de 60 anos o mas,2007-08-01,7,34,7,34,41
SALINAS DE GARCI MENDOZA,consulta externa,repetidas en personas de 60 anos o mas,2007-08-01,3,3,3,3,6
SAMAIPATA,consulta externa,repetidas en personas de 60 anos o mas,2007-08-01,1,3,1,3,4
SAN AGUSTIN,consulta externa,repetidas en personas de 60 anos o mas,2007-08-01,1,1,1,1,2
SAN ANDRES,consulta externa,repetidas en personas de 60 anos o mas,2007-08-01,5,9,5,9,14
SAN ANDRES DE MACHACA,consulta externa,repetidas en personas de 60 anos o mas,2007-08-01,4,7,4,7,11
SAN ANTONIO DE LOMERIO,consulta externa,repetidas en personas de 60 anos o mas,2007-08-01,1,5,1,5,6
SAN BENITO,consulta externa,repetidas en personas de 60 anos o mas,2007-08-01,4,7,4,7,11
SAN BORJA,consulta externa,repetidas en personas de 60 anos o mas,2007-08-01,56,52,56,52,108
SAN BUENA VENTURA,consulta externa,repetidas en personas de 60 anos o mas,2007-08-01,5,4,5,4,9
SAN CARLOS,consulta externa,repetidas en personas de 60 anos o mas,2007-08-01,9,8,9,8,17
SAN IGNACIO,consulta externa,repetidas en personas de 60 anos o mas,2007-08-01,50,70,50,70,120
SAN IGNACIO DE VELASCO,consulta externa,repetidas en personas de 60 anos o mas,2007-08-01,76,79,76,79,155
SAN JAVIER(STC),consulta externa,repetidas en personas de 60 anos o mas,2007-08-01,5,2,5,2,7
SAN JOAQUIN,consulta externa,repetidas en personas de 60 anos o mas,2007-08-01,41,38,41,38,79
SAN JOSE DE CHIQUITOS,consulta externa,repetidas en personas de 60 anos o mas,2007-08-01,5,6,5,6,11
SAN JUAN DE YAPACANI,consulta externa,repetidas en personas de 60 anos o mas,2007-08-01,27,28,27,28,55
SAN JULIAN,consulta externa,repetidas en personas de 60 anos o mas,2007-08-01,5,2,5,2,7
SAN LORENZO(TJA),consulta externa,repetidas en personas de 60 anos o mas,2007-08-01,4,9,4,9,13
SAN LUCAS,consulta externa,repetidas en personas de 60 anos o mas,2007-08-01,31,50,31,50,81
SAN MATIAS,consulta externa,repetidas en personas de 60 anos o mas,2007-08-01,0,1,0,1,1
SAN MIGUEL DE VELASCO,consulta externa,repetidas en personas de 60 anos o mas,2007-08-01,22,51,22,51,73
SAN PABLO DE LIPEZ,consulta externa,repetidas en personas de 60 anos o mas,2007-08-01,0,4,0,4,4
SAN PEDRO,consulta externa,repetidas en personas de 60 anos o mas,2007-08-01,13,10,13,10,23
SAN PEDRO DE BUENA VISTA,consulta externa,repetidas en personas de 60 anos o mas,2007-08-01,0,1,0,1,1
SAN PEDRO DE CURAHUARA,consulta externa,repetidas en personas de 60 anos o mas,2007-08-01,11,5,11,5,16
SAN PEDRO DE QUEMES,consulta externa,repetidas en personas de 60 anos o mas,2007-08-01,1,2,1,2,3
SAN PEDRO DE TIQUINA,consulta externa,repetidas en personas de 60 anos o mas,2007-08-01,9,5,9,5,14
SAN PEDRO(PND),consulta externa,repetidas en personas de 60 anos o mas,2007-08-01,1,0,1,0,1
SAN RAFAEL,consulta externa,repetidas en personas de 60 anos o mas,2007-08-01,2,4,2,4,6
SAN RAMON,consulta externa,repetidas en personas de 60 anos o mas,2007-08-01,18,46,18,46,64
SAN RAMON,consulta externa,repetidas en personas de 60 anos o mas,2007-08-01,9,4,9,4,13
SANTA ANA,consulta externa,repetidas en personas de 60 anos o mas,2007-08-01,41,45,41,45,86
SANTA CRUZ DE LA SIERRA,consulta externa,repetidas en personas de 60 anos o mas,2007-08-01,3440,5335,3440,5335,8775
SANTA ROSA DEL SARA,consulta externa,repetidas en personas de 60 anos o mas,2007-08-01,2,1,2,1,3
SANTIAGO DE CALLAPA,consulta externa,repetidas en personas de 60 anos o mas,2007-08-01,5,1,5,1,6
SANTIAGO DE HUARI,consulta externa,repetidas en personas de 60 anos o mas,2007-08-01,27,9,27,9,36
SANTIAGO DE MACHACA,consulta externa,repetidas en personas de 60 anos o mas,2007-08-01,0,1,0,1,1
SANTIVAÑES,consulta externa,repetidas en personas de 60 anos o mas,2007-08-01,9,14,9,14,23
SAPAHAQUI,consulta externa,repetidas en personas de 60 anos o mas,2007-08-01,1,4,1,4,5
SENA,consulta externa,repetidas en personas de 60 anos o mas,2007-08-01,3,3,3,3,6
SICA SICA (VILLA AROMA),consulta externa,repetidas en personas de 60 anos o mas,2007-08-01,2,1,2,1,3
SICAYA,consulta externa,repetidas en personas de 60 anos o mas,2007-08-01,4,6,4,6,10
SIPE SIPE,consulta externa,repetidas en personas de 60 anos o mas,2007-08-01,9,22,9,22,31
SOPACHUY,consulta externa,repetidas en personas de 60 anos o mas,2007-08-01,4,6,4,6,10
SORATA,consulta externa,repetidas en personas de 60 anos o mas,2007-08-01,8,2,8,2,10
SUCRE,consulta externa,repetidas en personas de 60 anos o mas,2007-08-01,1904,2667,1904,2667,4571
TACACHI,consulta externa,repetidas en personas de 60 anos o mas,2007-08-01,0,3,0,3,3
TACOBAMBA,consulta externa,repetidas en personas de 60 anos o mas,2007-08-01,5,0,5,0,5
TAHUA,consulta externa,repetidas en personas de 60 anos o mas,2007-08-01,0,2,0,2,2
TAPACARI,consulta externa,repetidas en personas de 60 anos o mas,2007-08-01,1,1,1,1,2
TARABUCO,consulta externa,repetidas en personas de 60 anos o mas,2007-08-01,23,51,23,51,74
TARACO,consulta externa,repetidas en personas de 60 anos o mas,2007-08-01,4,4,4,4,8
TARATA,consulta externa,repetidas en personas de 60 anos o mas,2007-08-01,2,3,2,3,5
TARIJA,consulta externa,repetidas en personas de 60 anos o mas,2007-08-01,2133,3027,2133,3027,5160
TARVITA,consulta externa,repetidas en personas de 60 anos o mas,2007-08-01,3,2,3,2,5
TEOPONTE,consulta externa,repetidas en personas de 60 anos o mas,2007-08-01,14,16,14,16,30
TIPUANI,consulta externa,repetidas en personas de 60 anos o mas,2007-08-01,0,2,0,2,2
TIQUIPAYA,consulta externa,repetidas en personas de 60 anos o mas,2007-08-01,14,11,14,11,25
TIRAQUE (CBBA),consulta externa,repetidas en personas de 60 anos o mas,2007-08-01,7,19,7,19,26
TITO YUPANQUI (PARQUIPUJIO),consulta externa,repetidas en personas de 60 anos o mas,2007-08-01,4,1,4,1,5
TOCO,consulta externa,repetidas en personas de 60 anos o mas,2007-08-01,1,2,1,2,3
TODOS SANTOS,consulta externa,repetidas en personas de 60 anos o mas,2007-08-01,1,0,1,0,1
TOLATA,consulta externa,repetidas en personas de 60 anos o mas,2007-08-01,1,4,1,4,5
TOLEDO,consulta externa,repetidas en personas de 60 anos o mas,2007-08-01,3,0,3,0,3
TOMAVE,consulta externa,repetidas en personas de 60 anos o mas,2007-08-01,7,14,7,14,21
TOMINA,consulta externa,repetidas en personas de 60 anos o mas,2007-08-01,0,3,0,3,3
TORO TORO,consulta externa,repetidas en personas de 60 anos o mas,2007-08-01,6,1,6,1,7
TOTORA(CBBA),consulta externa,repetidas en personas de 60 anos o mas,2007-08-01,6,5,6,5,11
TOTORA(ORR),consulta externa,repetidas en personas de 60 anos o mas,2007-08-01,0,1,0,1,1
TRIGAL,consulta externa,repetidas en personas de 60 anos o mas,2007-08-01,3,6,3,6,9
TRINIDAD,consulta externa,repetidas en personas de 60 anos o mas,2007-08-01,276,254,276,254,530
TUPIZA,consulta externa,repetidas en personas de 60 anos o mas,2007-08-01,52,67,52,67,119
TURCO,consulta externa,repetidas en personas de 60 anos o mas,2007-08-01,0,1,0,1,1
UNCIA,consulta externa,repetidas en personas de 60 anos o mas,2007-08-01,214,264,214,264,478
URIONDO (A. CONCEPCION),consulta externa,repetidas en personas de 60 anos o mas,2007-08-01,0,2,0,2,2
URUBICHA,consulta externa,repetidas en personas de 60 anos o mas,2007-08-01,0,2,0,2,2
UYUNI,consulta externa,repetidas en personas de 60 anos o mas,2007-08-01,51,66,51,66,117
VACAS,consulta externa,repetidas en personas de 60 anos o mas,2007-08-01,9,32,9,32,41
VALLEGRANDE,consulta externa,repetidas en personas de 60 anos o mas,2007-08-01,277,321,277,321,598
VIACHA,consulta externa,repetidas en personas de 60 anos o mas,2007-08-01,306,277,306,277,583
VILA VILA,consulta externa,repetidas en personas de 60 anos o mas,2007-08-01,0,2,0,2,2
VILLA MONTES,consulta externa,repetidas en personas de 60 anos o mas,2007-08-01,84,77,84,77,161
VILLA NUEVA (LOMA ALTA),consulta externa,repetidas en personas de 60 anos o mas,2007-08-01,1,1,1,1,2
VILLA RIVERO,consulta externa,repetidas en personas de 60 anos o mas,2007-08-01,4,0,4,0,4
VILLA SERRANO,consulta externa,repetidas en personas de 60 anos o mas,2007-08-01,1,2,1,2,3
VILLA TUNARI,consulta externa,repetidas en personas de 60 anos o mas,2007-08-01,27,27,27,27,54
VILLA VACA GUZMAN (MUYUPAMPA),consulta externa,repetidas en personas de 60 anos o mas,2007-08-01,1,19,1,19,20
VILLAZON,consulta externa,repetidas en personas de 60 anos o mas,2007-08-01,42,49,42,49,91
VINTO,consulta externa,repetidas en personas de 60 anos o mas,2007-08-01,20,44,20,44,64
VITICHI,consulta externa,repetidas en personas de 60 anos o mas,2007-08-01,2,4,2,4,6
WALDO BALLIVIAN,consulta externa,repetidas en personas de 60 anos o mas,2007-08-01,1,0,1,0,1
WARNES,consulta externa,repetidas en personas de 60 anos o mas,2007-08-01,7,5,7,5,12
YACO,consulta externa,repetidas en personas de 60 anos o mas,2007-08-01,0,1,0,1,1
YACUIBA,consulta externa,repetidas en personas de 60 anos o mas,2007-08-01,184,259,184,259,443
YAMPARAEZ,consulta externa,repetidas en personas de 60 anos o mas,2007-08-01,5,7,5,7,12
YANACACHI,consulta externa,repetidas en personas de 60 anos o mas,2007-08-01,9,2,9,2,11
YAPACANI,consulta externa,repetidas en personas de 60 anos o mas,2007-08-01,3,1,3,1,4
YOCALLA,consulta externa,repetidas en personas de 60 anos o mas,2007-08-01,4,4,4,4,8
YOTALA,consulta externa,repetidas en personas de 60 anos o mas,2007-08-01,18,23,18,23,41
YUNCHARA,consulta externa,repetidas en personas de 60 anos o mas,2007-08-01,5,1,5,1,6
ZUDAÑEZ,consulta externa,repetidas en personas de 60 anos o mas,2007-08-01,4,4,4,4,8
ACACIO,consulta externa,repetidas en personas de 60 anos o mas,2007-09-01,0,1,0,1,1
ACHACACHI,consulta externa,repetidas en personas de 60 anos o mas,2007-09-01,34,18,34,18,52
ACHOCALLA,consulta externa,repetidas en personas de 60 anos o mas,2007-09-01,2,2,2,2,4
AIQUILE,consulta externa,repetidas en personas de 60 anos o mas,2007-09-01,48,50,48,50,98
ANCORAIMES,consulta externa,repetidas en personas de 60 anos o mas,2007-09-01,1,2,1,2,3
ANDAMARCA,consulta externa,repetidas en personas de 60 anos o mas,2007-09-01,2,1,2,1,3
ANTEQUERA,consulta externa,repetidas en personas de 60 anos o mas,2007-09-01,0,1,0,1,1
ANZALDO,consulta externa,repetidas en personas de 60 anos o mas,2007-09-01,1,2,1,2,3
APOLO,consulta externa,repetidas en personas de 60 anos o mas,2007-09-01,11,3,11,3,14
ARANI,consulta externa,repetidas en personas de 60 anos o mas,2007-09-01,4,9,4,9,13
ARBIETO,consulta externa,repetidas en personas de 60 anos o mas,2007-09-01,1,3,1,3,4
ARQUE,consulta externa,repetidas en personas de 60 anos o mas,2007-09-01,0,1,0,1,1
ASCENCION DE GUARAYOS,consulta externa,repetidas en personas de 60 anos o mas,2007-09-01,5,2,5,2,7
ATOCHA,consulta externa,repetidas en personas de 60 anos o mas,2007-09-01,21,30,21,30,51
AUCAPATA,consulta externa,repetidas en personas de 60 anos o mas,2007-09-01,0,4,0,4,4
AYOPAYA (V. DE INDEPENDENCIA),consulta externa,repetidas en personas de 60 anos o mas,2007-09-01,8,5,8,5,13
BATALLAS,consulta externa,repetidas en personas de 60 anos o mas,2007-09-01,3,4,3,4,7
BAURES,consulta externa,repetidas en personas de 60 anos o mas,2007-09-01,9,1,9,1,10
BELEN DE ANDAMARCA,consulta externa,repetidas en personas de 60 anos o mas,2007-09-01,2,3,2,3,5
BELEN DE URMIRI,consulta externa,repetidas en personas de 60 anos o mas,2007-09-01,3,1,3,1,4
BERMEJO,consulta externa,repetidas en personas de 60 anos o mas,2007-09-01,44,42,44,42,86
BETANZOS,consulta externa,repetidas en personas de 60 anos o mas,2007-09-01,66,96,66,96,162
BOLIVAR,consulta externa,repetidas en personas de 60 anos o mas,2007-09-01,2,1,2,1,3
BOLPEBRA,consulta externa,repetidas en personas de 60 anos o mas,2007-09-01,1,0,1,0,1
BOYUIBE,consulta externa,repetidas en personas de 60 anos o mas,2007-09-01,5,7,5,7,12
BUENA VISTA,consulta externa,repetidas en personas de 60 anos o mas,2007-09-01,4,6,4,6,10
CABEZAS,consulta externa,repetidas en personas de 60 anos o mas,2007-09-01,0,3,0,3,3
CAIROMA,consulta externa,repetidas en personas de 60 anos o mas,2007-09-01,5,1,5,1,6
"CAIZA ""D""",consulta externa,repetidas en personas de 60 anos o mas,2007-09-01,3,4,3,4,7
CAJUATA,consulta externa,repetidas en personas de 60 anos o mas,2007-09-01,2,0,2,0,2
CALACOTO,consulta externa,repetidas en personas de 60 anos o mas,2007-09-01,3,2,3,2,5
CALAMARCA,consulta externa,repetidas en personas de 60 anos o mas,2007-09-01,7,1,7,1,8
CAMARGO,consulta externa,repetidas en personas de 60 anos o mas,2007-09-01,8,7,8,7,15
CAMATAQUI (C. VILLA ABECIA),consulta externa,repetidas en personas de 60 anos o mas,2007-09-01,4,5,4,5,9
CAMIRI,consulta externa,repetidas en personas de 60 anos o mas,2007-09-01,40,93,40,93,133
CAPINOTA,consulta externa,repetidas en personas de 60 anos o mas,2007-09-01,17,16,17,16,33
CAQUIAVIRI,consulta externa,repetidas en personas de 60 anos o mas,2007-09-01,3,1,3,1,4
CARACOLLO,consulta externa,repetidas en personas de 60 anos o mas,2007-09-01,19,20,19,20,39
CARANAVI,consulta externa,repetidas en personas de 60 anos o mas,2007-09-01,26,8,26,8,34
CARAPARI,consulta externa,repetidas en personas de 60 anos o mas,2007-09-01,0,2,0,2,2
CHACARILLA,consulta externa,repetidas en personas de 60 anos o mas,2007-09-01,1,0,1,0,1
CHALLAPATA,consulta externa,repetidas en personas de 60 anos o mas,2007-09-01,72,57,72,57,129
CHAQUI,consulta externa,repetidas en personas de 60 anos o mas,2007-09-01,4,0,4,0,4
CHARAGUA,consulta externa,repetidas en personas de 60 anos o mas,2007-09-01,7,7,7,7,14
CHARAÑA,consulta externa,repetidas en personas de 60 anos o mas,2007-09-01,1,1,1,1,2
CHAYANTA,consulta externa,repetidas en personas de 60 anos o mas,2007-09-01,2,8,2,8,10
CHIMORE,consulta externa,repetidas en personas de 60 anos o mas,2007-09-01,4,1,4,1,5
CHIPAYA,consulta externa,repetidas en personas de 60 anos o mas,2007-09-01,1,0,1,0,1
CHOQUE COTA,consulta externa,repetidas en personas de 60 anos o mas,2007-09-01,2,0,2,0,2
CHULUMANI (V. DE LA LIBERTAD),consulta externa,repetidas en personas de 60 anos o mas,2007-09-01,29,28,29,28,57
CHUMA,consulta externa,repetidas en personas de 60 anos o mas,2007-09-01,3,2,3,2,5
CLIZA,consulta externa,repetidas en personas de 60 anos o mas,2007-09-01,9,14,9,14,23
COBIJA,consulta externa,repetidas en personas de 60 anos o mas,2007-09-01,34,42,34,42,76
COCHABAMBA,consulta externa,repetidas en personas de 60 anos o mas,2007-09-01,5489,7130,5489,7130,12619
COLCAPIRHUA,consulta externa,repetidas en personas de 60 anos o mas,2007-09-01,70,132,70,132,202
"COLCHA ""K""",consulta externa,repetidas en personas de 60 anos o mas,2007-09-01,10,13,10,13,23
COLOMI,consulta externa,repetidas en personas de 60 anos o mas,2007-09-01,1,1,1,1,2
COLPA BELGICA,consulta externa,repetidas en personas de 60 anos o mas,2007-09-01,10,3,10,3,13
COLQUECHACA,consulta externa,repetidas en personas de 60 anos o mas,2007-09-01,2,2,2,2,4
COLQUENCHA,consulta externa,repetidas en personas de 60 anos o mas,2007-09-01,0,7,0,7,7
COLQUIRI,consulta externa,repetidas en personas de 60 anos o mas,2007-09-01,5,3,5,3,8
COMANCHE,consulta externa,repetidas en personas de 60 anos o mas,2007-09-01,1,1,1,1,2
COMARAPA,consulta externa,repetidas en personas de 60 anos o mas,2007-09-01,16,24,16,24,40
CONCEPCION,consulta externa,repetidas en personas de 60 anos o mas,2007-09-01,5,0,5,0,5
COPACABANA,consulta externa,repetidas en personas de 60 anos o mas,2007-09-01,4,4,4,4,8
CORIPATA,consulta externa,repetidas en personas de 60 anos o mas,2007-09-01,4,3,4,3,7
CORO CORO,consulta externa,repetidas en personas de 60 anos o mas,2007-09-01,0,1,0,1,1
COROICO,consulta externa,repetidas en personas de 60 anos o mas,2007-09-01,57,65,57,65,122
CORQUE,consulta externa,repetidas en personas de 60 anos o mas,2007-09-01,3,6,3,6,9
COTAGAITA,consulta externa,repetidas en personas de 60 anos o mas,2007-09-01,12,25,12,25,37
COTOCA,consulta externa,repetidas en personas de 60 anos o mas,2007-09-01,2,7,2,7,9
CUATRO CAÑADAS,consulta externa,repetidas en personas de 60 anos o mas,2007-09-01,20,26,20,26,46
CUCHUMUELA (V. G. VILLARROEL),consulta externa,repetidas en personas de 60 anos o mas,2007-09-01,2,2,2,2,4
CUEVO,consulta externa,repetidas en personas de 60 anos o mas,2007-09-01,0,4,0,4,4
CULPINA,consulta externa,repetidas en personas de 60 anos o mas,2007-09-01,1,0,1,0,1
CURAHUARA DE CARANGAS,consulta externa,repetidas en personas de 60 anos o mas,2007-09-01,2,1,2,1,3
CURVA,consulta externa,repetidas en personas de 60 anos o mas,2007-09-01,0,1,0,1,1
DESAGUADERO,consulta externa,repetidas en personas de 60 anos o mas,2007-09-01,1,0,1,0,1
EL ALTO,consulta externa,repetidas en personas de 60 anos o mas,2007-09-01,1310,1466,1310,1466,2776
EL CHORO,consulta externa,repetidas en personas de 60 anos o mas,2007-09-01,1,0,1,0,1
EL PUENTE(STC),consulta externa,repetidas en personas de 60 anos o mas,2007-09-01,2,1,2,1,3
EL PUENTE(TJA),consulta externa,repetidas en personas de 60 anos o mas,2007-09-01,1,5,1,5,6
EL TORNO,consulta externa,repetidas en personas de 60 anos o mas,2007-09-01,242,259,242,259,501
EL VILLAR,consulta externa,repetidas en personas de 60 anos o mas,2007-09-01,0,4,0,4,4
ENTRE RIOS,consulta externa,repetidas en personas de 60 anos o mas,2007-09-01,4,6,4,6,10
ENTRE RIOS,consulta externa,repetidas en personas de 60 anos o mas,2007-09-01,0,2,0,2,2
ESCARA,consulta externa,repetidas en personas de 60 anos o mas,2007-09-01,0,1,0,1,1
EUCALIPTUS,consulta externa,repetidas en personas de 60 anos o mas,2007-09-01,4,3,4,3,7
EXALTACION,consulta externa,repetidas en personas de 60 anos o mas,2007-09-01,1,0,1,0,1
FERNANDEZ ALONSO,consulta externa,repetidas en personas de 60 anos o mas,2007-09-01,0,1,0,1,1
FILADELFIA,consulta externa,repetidas en personas de 60 anos o mas,2007-09-01,21,20,21,20,41
GRAL. J.J. PEREZ (CHARAZANI),consulta externa,repetidas en personas de 60 anos o mas,2007-09-01,3,8,3,8,11
GUANAY,consulta externa,repetidas en personas de 60 anos o mas,2007-09-01,7,8,7,8,15
GUAQUI,consulta externa,repetidas en personas de 60 anos o mas,2007-09-01,17,3,17,3,20
GUAYARAMERIN,consulta externa,repetidas en personas de 60 anos o mas,2007-09-01,166,121,166,121,287
GUTIERREZ,consulta externa,repetidas en personas de 60 anos o mas,2007-09-01,4,1,4,1,5
HUACARETA,consulta externa,repetidas en personas de 60 anos o mas,2007-09-01,10,13,10,13,23
HUACHACALLA,consulta externa,repetidas en personas de 60 anos o mas,2007-09-01,3,5,3,5,8
HUANUNI,consulta externa,repetidas en personas de 60 anos o mas,2007-09-01,123,145,123,145,268
HUARACAJE,consulta externa,repetidas en personas de 60 anos o mas,2007-09-01,0,2,0,2,2
HUAYLLAMARCA,consulta externa,repetidas en personas de 60 anos o mas,2007-09-01,1,1,1,1,2
ICHOCA,consulta externa,repetidas en personas de 60 anos o mas,2007-09-01,0,4,0,4,4
ICLA,consulta externa,repetidas en personas de 60 anos o mas,2007-09-01,0,1,0,1,1
INCAHUASI,consulta externa,repetidas en personas de 60 anos o mas,2007-09-01,0,1,0,1,1
INQUISIVI,consulta externa,repetidas en personas de 60 anos o mas,2007-09-01,1,1,1,1,2
IRUPANA (VILLA DE LANZA),consulta externa,repetidas en personas de 60 anos o mas,2007-09-01,4,8,4,8,12
IXIAMAS,consulta externa,repetidas en personas de 60 anos o mas,2007-09-01,1,0,1,0,1
JESUS DE MACHACA,consulta externa,repetidas en personas de 60 anos o mas,2007-09-01,14,16,14,16,30
LA ASUNTA,consulta externa,repetidas en personas de 60 anos o mas,2007-09-01,2,3,2,3,5
LA GUARDIA,consulta externa,repetidas en personas de 60 anos o mas,2007-09-01,8,6,8,6,14
LA PAZ,consulta externa,repetidas en personas de 60 anos o mas,2007-09-01,9697,13141,9697,13141,22838
LAGUNILLAS,consulta externa,repetidas en personas de 60 anos o mas,2007-09-01,3,2,3,2,5
LAJA,consulta externa,repetidas en personas de 60 anos o mas,2007-09-01,8,3,8,3,11
LAS CARRERAS,consulta externa,repetidas en personas de 60 anos o mas,2007-09-01,6,11,6,11,17
LICOMA PAMPA,consulta externa,repetidas en personas de 60 anos o mas,2007-09-01,1,1,1,1,2
LLALLAGUA,consulta externa,repetidas en personas de 60 anos o mas,2007-09-01,65,86,65,86,151
LLICA,consulta externa,repetidas en personas de 60 anos o mas,2007-09-01,9,8,9,8,17
LORETO,consulta externa,repetidas en personas de 60 anos o mas,2007-09-01,2,1,2,1,3
LURIBAY,consulta externa,repetidas en personas de 60 anos o mas,2007-09-01,12,7,12,7,19
MACHACAMARCA,consulta externa,repetidas en personas de 60 anos o mas,2007-09-01,22,34,22,34,56
MACHARETI,consulta externa,repetidas en personas de 60 anos o mas,2007-09-01,3,6,3,6,9
MAGDALENA,consulta externa,repetidas en personas de 60 anos o mas,2007-09-01,51,62,51,62,113
MALLA,consulta externa,repetidas en personas de 60 anos o mas,2007-09-01,2,0,2,0,2
MAPIRI,consulta externa,repetidas en personas de 60 anos o mas,2007-09-01,3,3,3,3,6
MECAPACA,consulta externa,repetidas en personas de 60 anos o mas,2007-09-01,5,11,5,11,16
MINEROS,consulta externa,repetidas en personas de 60 anos o mas,2007-09-01,2,3,2,3,5
MIZQUE,consulta externa,repetidas en personas de 60 anos o mas,2007-09-01,1,2,1,2,3
MOCOMOCO,consulta externa,repetidas en personas de 60 anos o mas,2007-09-01,4,5,4,5,9
MOJINETE,consulta externa,repetidas en personas de 60 anos o mas,2007-09-01,1,1,1,1,2
MOJOCOYA,consulta externa,repetidas en personas de 60 anos o mas,2007-09-01,6,2,6,2,8
MONTEAGUDO,consulta externa,repetidas en personas de 60 anos o mas,2007-09-01,114,135,114,135,249
MONTERO,consulta externa,repetidas en personas de 60 anos o mas,2007-09-01,362,524,362,524,886
MORO MORO,consulta externa,repetidas en personas de 60 anos o mas,2007-09-01,3,0,3,0,3
MOROCHATA,consulta externa,repetidas en personas de 60 anos o mas,2007-09-01,14,15,14,15,29
NUEVO MANOA (NUEVA ESPERANZA),consulta externa,repetidas en personas de 60 anos o mas,2007-09-01,3,0,3,0,3
OKINAWA,consulta externa,repetidas en personas de 60 anos o mas,2007-09-01,25,21,25,21,46
OMEREQUE,consulta externa,repetidas en personas de 60 anos o mas,2007-09-01,0,1,0,1,1
ORURO,consulta externa,repetidas en personas de 60 anos o mas,2007-09-01,1679,1990,1679,1990,3669
PADCAYA,consulta externa,repetidas en personas de 60 anos o mas,2007-09-01,8,4,8,4,12
PADILLA,consulta externa,repetidas en personas de 60 anos o mas,2007-09-01,24,27,24,27,51
PAILON,consulta externa,repetidas en personas de 60 anos o mas,2007-09-01,1,2,1,2,3
PALCA,consulta externa,repetidas en personas de 60 anos o mas,2007-09-01,6,12,6,12,18
PALOS BLANCOS,consulta externa,repetidas en personas de 60 anos o mas,2007-09-01,9,6,9,6,15
PAMPA AULLAGAS,consulta externa,repetidas en personas de 60 anos o mas,2007-09-01,1,0,1,0,1
PAMPA GRANDE,consulta externa,repetidas en personas de 60 anos o mas,2007-09-01,1,1,1,1,2
PATACAMAYA,consulta externa,repetidas en personas de 60 anos o mas,2007-09-01,1,1,1,1,2
PAZÑA,consulta externa,repetidas en personas de 60 anos o mas,2007-09-01,11,15,11,15,26
PELECHUCO,consulta externa,repetidas en personas de 60 anos o mas,2007-09-01,1,0,1,0,1
POCOATA,consulta externa,repetidas en personas de 60 anos o mas,2007-09-01,3,1,3,1,4
POCONA,consulta externa,repetidas en personas de 60 anos o mas,2007-09-01,1,2,1,2,3
POOPO,consulta externa,repetidas en personas de 60 anos o mas,2007-09-01,17,12,17,12,29
POROMA,consulta externa,repetidas en personas de 60 anos o mas,2007-09-01,5,3,5,3,8
PORTACHUELO,consulta externa,repetidas en personas de 60 anos o mas,2007-09-01,21,26,21,26,47
POTOSI,consulta externa,repetidas en personas de 60 anos o mas,2007-09-01,909,1252,909,1252,2161
PUCARA,consulta externa,repetidas en personas de 60 anos o mas,2007-09-01,1,7,1,7,8
PUCARANI,consulta externa,repetidas en personas de 60 anos o mas,2007-09-01,2,4,2,4,6
PUERTO ACOSTA,consulta externa,repetidas en personas de 60 anos o mas,2007-09-01,23,20,23,20,43
PUERTO CARABUCO,consulta externa,repetidas en personas de 60 anos o mas,2007-09-01,9,3,9,3,12
PUERTO GONZALO MORENO,consulta externa,repetidas en personas de 60 anos o mas,2007-09-01,4,1,4,1,5
PUERTO PEREZ,consulta externa,repetidas en personas de 60 anos o mas,2007-09-01,3,6,3,6,9
PUERTO QUIJARRO,consulta externa,repetidas en personas de 60 anos o mas,2007-09-01,3,2,3,2,5
PUERTO RICO,consulta externa,repetidas en personas de 60 anos o mas,2007-09-01,9,1,9,1,10
PUERTO SILES,consulta externa,repetidas en personas de 60 anos o mas,2007-09-01,6,4,6,4,10
PUERTO SUAREZ,consulta externa,repetidas en personas de 60 anos o mas,2007-09-01,5,9,5,9,14
PUERTO VILLARROEL,consulta externa,repetidas en personas de 60 anos o mas,2007-09-01,2,3,2,3,5
PUNA,consulta externa,repetidas en personas de 60 anos o mas,2007-09-01,7,7,7,7,14
PUNATA,consulta externa,repetidas en personas de 60 anos o mas,2007-09-01,88,98,88,98,186
QUILLACOLLO,consulta externa,repetidas en personas de 60 anos o mas,2007-09-01,339,302,339,302,641
QUIME,consulta externa,repetidas en personas de 60 anos o mas,2007-09-01,2,2,2,2,4
QUIRUSILLAS,consulta externa,repetidas en personas de 60 anos o mas,2007-09-01,4,7,4,7,11
RAVELO,consulta externa,repetidas en personas de 60 anos o mas,2007-09-01,0,1,0,1,1
REYES,consulta externa,repetidas en personas de 60 anos o mas,2007-09-01,70,54,70,54,124
RIBERALTA,consulta externa,repetidas en personas de 60 anos o mas,2007-09-01,71,7,71,7,78
ROBORE,consulta externa,repetidas en personas de 60 anos o mas,2007-09-01,27,26,27,26,53
RURRENABAQUE,consulta externa,repetidas en personas de 60 anos o mas,2007-09-01,94,82,94,82,176
SABAYA,consulta externa,repetidas en personas de 60 anos o mas,2007-09-01,4,8,4,8,12
SACABA,consulta externa,repetidas en personas de 60 anos o mas,2007-09-01,100,117,100,117,217
SACABAMBA,consulta externa,repetidas en personas de 60 anos o mas,2007-09-01,1,6,1,6,7
SACACA,consulta externa,repetidas en personas de 60 anos o mas,2007-09-01,2,5,2,5,7
SAIPINA,consulta externa,repetidas en personas de 60 anos o mas,2007-09-01,7,21,7,21,28
SALINAS DE GARCI MENDOZA,consulta externa,repetidas en personas de 60 anos o mas,2007-09-01,9,10,9,10,19
SAMAIPATA,consulta externa,repetidas en personas de 60 anos o mas,2007-09-01,0,3,0,3,3
SAN AGUSTIN,consulta externa,repetidas en personas de 60 anos o mas,2007-09-01,2,1,2,1,3
SAN ANDRES,consulta externa,repetidas en personas de 60 anos o mas,2007-09-01,0,1,0,1,1
SAN ANDRES DE MACHACA,consulta externa,repetidas en personas de 60 anos o mas,2007-09-01,0,2,0,2,2
SAN ANTONIO DE ESMORUCO,consulta externa,repetidas en personas de 60 anos o mas,2007-09-01,1,0,1,0,1
SAN BENITO,consulta externa,repetidas en personas de 60 anos o mas,2007-09-01,9,10,9,10,19
SAN BORJA,consulta externa,repetidas en personas de 60 anos o mas,2007-09-01,64,69,64,69,133
SAN BUENA VENTURA,consulta externa,repetidas en personas de 60 anos o mas,2007-09-01,7,0,7,0,7
SAN CARLOS,consulta externa,repetidas en personas de 60 anos o mas,2007-09-01,19,15,19,15,34
SAN IGNACIO,consulta externa,repetidas en personas de 60 anos o mas,2007-09-01,73,62,73,62,135
SAN IGNACIO DE VELASCO,consulta externa,repetidas en personas de 60 anos o mas,2007-09-01,28,33,28,33,61
SAN JAVIER(STC),consulta externa,repetidas en personas de 60 anos o mas,2007-09-01,6,7,6,7,13
SAN JOAQUIN,consulta externa,repetidas en personas de 60 anos o mas,2007-09-01,10,7,10,7,17
SAN JOSE DE CHIQUITOS,consulta externa,repetidas en personas de 60 anos o mas,2007-09-01,4,18,4,18,22
SAN JUAN DE YAPACANI,consulta externa,repetidas en personas de 60 anos o mas,2007-09-01,0,4,0,4,4
SAN JULIAN,consulta externa,repetidas en personas de 60 anos o mas,2007-09-01,0,5,0,5,5
SAN LORENZO(PND),consulta externa,repetidas en personas de 60 anos o mas,2007-09-01,2,0,2,0,2
SAN LORENZO(TJA),consulta externa,repetidas en personas de 60 anos o mas,2007-09-01,2,11,2,11,13
SAN LUCAS,consulta externa,repetidas en personas de 60 anos o mas,2007-09-01,24,41,24,41,65
SAN MATIAS,consulta externa,repetidas en personas de 60 anos o mas,2007-09-01,1,0,1,0,1
SAN MIGUEL DE VELASCO,consulta externa,repetidas en personas de 60 anos o mas,2007-09-01,19,44,19,44,63
SAN PABLO DE LIPEZ,consulta externa,repetidas en personas de 60 anos o mas,2007-09-01,0,1,0,1,1
SAN PEDRO,consulta externa,repetidas en personas de 60 anos o mas,2007-09-01,12,4,12,4,16
SAN PEDRO DE CURAHUARA,consulta externa,repetidas en personas de 60 anos o mas,2007-09-01,11,1,11,1,12
SAN PEDRO DE TIQUINA,consulta externa,repetidas en personas de 60 anos o mas,2007-09-01,1,1,1,1,2
SAN PEDRO(PND),consulta externa,repetidas en personas de 60 anos o mas,2007-09-01,1,0,1,0,1
SAN RAFAEL,consulta externa,repetidas en personas de 60 anos o mas,2007-09-01,0,2,0,2,2
SAN RAMON,consulta externa,repetidas en personas de 60 anos o mas,2007-09-01,24,20,24,20,44
SANTA ANA,consulta externa,repetidas en personas de 60 anos o mas,2007-09-01,41,44,41,44,85
SANTA CRUZ DE LA SIERRA,consulta externa,repetidas en personas de 60 anos o mas,2007-09-01,3305,4811,3305,4811,8116
SANTA ROSA,consulta externa,repetidas en personas de 60 anos o mas,2007-09-01,0,1,0,1,1
SANTIAGO DE CALLAPA,consulta externa,repetidas en personas de 60 anos o mas,2007-09-01,1,0,1,0,1
SANTIAGO DE HUARI,consulta externa,repetidas en personas de 60 anos o mas,2007-09-01,12,16,12,16,28
SANTIAGO DE MACHACA,consulta externa,repetidas en personas de 60 anos o mas,2007-09-01,0,1,0,1,1
SANTIVAÑES,consulta externa,repetidas en personas de 60 anos o mas,2007-09-01,5,11,5,11,16
SANTUARIO DE QUILLACAS,consulta externa,repetidas en personas de 60 anos o mas,2007-09-01,1,2,1,2,3
SAPAHAQUI,consulta externa,repetidas en personas de 60 anos o mas,2007-09-01,1,5,1,5,6
SICAYA,consulta externa,repetidas en personas de 60 anos o mas,2007-09-01,2,0,2,0,2
SIPE SIPE,consulta externa,repetidas en personas de 60 anos o mas,2007-09-01,6,25,6,25,31
SOPACHUY,consulta externa,repetidas en personas de 60 anos o mas,2007-09-01,4,8,4,8,12
SORACACHI,consulta externa,repetidas en personas de 60 anos o mas,2007-09-01,0,1,0,1,1
SORATA,consulta externa,repetidas en personas de 60 anos o mas,2007-09-01,1,3,1,3,4
SUCRE,consulta externa,repetidas en personas de 60 anos o mas,2007-09-01,2327,3350,2327,3350,5677
TACACHI,consulta externa,repetidas en personas de 60 anos o mas,2007-09-01,4,8,4,8,12
TACOBAMBA,consulta externa,repetidas en personas de 60 anos o mas,2007-09-01,3,6,3,6,9
TACOPAYA,consulta externa,repetidas en personas de 60 anos o mas,2007-09-01,0,2,0,2,2
TAHUA,consulta externa,repetidas en personas de 60 anos o mas,2007-09-01,1,4,1,4,5
TAPACARI,consulta externa,repetidas en personas de 60 anos o mas,2007-09-01,3,7,3,7,10
TARABUCO,consulta externa,repetidas en personas de 60 anos o mas,2007-09-01,19,44,19,44,63
TARACO,consulta externa,repetidas en personas de 60 anos o mas,2007-09-01,1,2,1,2,3
TARATA,consulta externa,repetidas en personas de 60 anos o mas,2007-09-01,0,1,0,1,1
TARIJA,consulta externa,repetidas en personas de 60 anos o mas,2007-09-01,2037,2802,2037,2802,4839
TARVITA,consulta externa,repetidas en personas de 60 anos o mas,2007-09-01,2,6,2,6,8
TEOPONTE,consulta externa,repetidas en personas de 60 anos o mas,2007-09-01,21,9,21,9,30
TIAWANACU,consulta externa,repetidas en personas de 60 anos o mas,2007-09-01,1,1,1,1,2
TINGUIPAYA,consulta externa,repetidas en personas de 60 anos o mas,2007-09-01,1,1,1,1,2
TIPUANI,consulta externa,repetidas en personas de 60 anos o mas,2007-09-01,4,4,4,4,8
TIQUIPAYA,consulta externa,repetidas en personas de 60 anos o mas,2007-09-01,10,10,10,10,20
TIRAQUE (CBBA),consulta externa,repetidas en personas de 60 anos o mas,2007-09-01,18,11,18,11,29
TITO YUPANQUI (PARQUIPUJIO),consulta externa,repetidas en personas de 60 anos o mas,2007-09-01,3,1,3,1,4
TOCO,consulta externa,repetidas en personas de 60 anos o mas,2007-09-01,3,1,3,1,4
TOLATA,consulta externa,repetidas en personas de 60 anos o mas,2007-09-01,15,27,15,27,42
TOLEDO,consulta externa,repetidas en personas de 60 anos o mas,2007-09-01,1,1,1,1,2
TOMAVE,consulta externa,repetidas en personas de 60 anos o mas,2007-09-01,7,4,7,4,11
TOMINA,consulta externa,repetidas en personas de 60 anos o mas,2007-09-01,13,9,13,9,22
TORO TORO,consulta externa,repetidas en personas de 60 anos o mas,2007-09-01,1,2,1,2,3
TOTORA(CBBA),consulta externa,repetidas en personas de 60 anos o mas,2007-09-01,1,1,1,1,2
TRIGAL,consulta externa,repetidas en personas de 60 anos o mas,2007-09-01,4,3,4,3,7
TRINIDAD,consulta externa,repetidas en personas de 60 anos o mas,2007-09-01,264,290,264,290,554
TUPIZA,consulta externa,repetidas en personas de 60 anos o mas,2007-09-01,56,59,56,59,115
UNCIA,consulta externa,repetidas en personas de 60 anos o mas,2007-09-01,86,130,86,130,216
URIONDO (A. CONCEPCION),consulta externa,repetidas en personas de 60 anos o mas,2007-09-01,4,1,4,1,5
URUBICHA,consulta externa,repetidas en personas de 60 anos o mas,2007-09-01,0,3,0,3,3
UYUNI,consulta externa,repetidas en personas de 60 anos o mas,2007-09-01,31,49,31,49,80
VACAS,consulta externa,repetidas en personas de 60 anos o mas,2007-09-01,13,22,13,22,35
VALLEGRANDE,consulta externa,repetidas en personas de 60 anos o mas,2007-09-01,249,359,249,359,608
VIACHA,consulta externa,repetidas en personas de 60 anos o mas,2007-09-01,280,287,280,287,567
VILA VILA,consulta externa,repetidas en personas de 60 anos o mas,2007-09-01,0,1,0,1,1
VILLA MONTES,consulta externa,repetidas en personas de 60 anos o mas,2007-09-01,77,76,77,76,153
VILLA NUEVA (LOMA ALTA),consulta externa,repetidas en personas de 60 anos o mas,2007-09-01,2,1,2,1,3
VILLA RIVERO,consulta externa,repetidas en personas de 60 anos o mas,2007-09-01,4,3,4,3,7
VILLA SERRANO,consulta externa,repetidas en personas de 60 anos o mas,2007-09-01,0,3,0,3,3
VILLA TUNARI,consulta externa,repetidas en personas de 60 anos o mas,2007-09-01,9,6,9,6,15
VILLA VACA GUZMAN (MUYUPAMPA),consulta externa,repetidas en personas de 60 anos o mas,2007-09-01,3,4,3,4,7
VILLAZON,consulta externa,repetidas en personas de 60 anos o mas,2007-09-01,70,91,70,91,161
VINTO,consulta externa,repetidas en personas de 60 anos o mas,2007-09-01,30,44,30,44,74
VITICHI,consulta externa,repetidas en personas de 60 anos o mas,2007-09-01,4,16,4,16,20
WALDO BALLIVIAN,consulta externa,repetidas en personas de 60 anos o mas,2007-09-01,0,1,0,1,1
WARNES,consulta externa,repetidas en personas de 60 anos o mas,2007-09-01,12,16,12,16,28
YACO,consulta externa,repetidas en personas de 60 anos o mas,2007-09-01,7,10,7,10,17
YACUIBA,consulta externa,repetidas en personas de 60 anos o mas,2007-09-01,174,255,174,255,429
YAMPARAEZ,consulta externa,repetidas en personas de 60 anos o mas,2007-09-01,4,4,4,4,8
YANACACHI,consulta externa,repetidas en personas de 60 anos o mas,2007-09-01,3,6,3,6,9
YAPACANI,consulta externa,repetidas en personas de 60 anos o mas,2007-09-01,0,1,0,1,1
YOCALLA,consulta externa,repetidas en personas de 60 anos o mas,2007-09-01,4,6,4,6,10
YOTALA,consulta externa,repetidas en personas de 60 anos o mas,2007-09-01,11,12,11,12,23
YUNCHARA,consulta externa,repetidas en personas de 60 anos o mas,2007-09-01,1,1,1,1,2
ZUDAÑEZ,consulta externa,repetidas en personas de 60 anos o mas,2007-09-01,2,1,2,1,3
ACACIO,consulta externa,repetidas en personas de 60 anos o mas,2007-10-01,0,2,0,2,2
ACHACACHI,consulta externa,repetidas en personas de 60 anos o mas,2007-10-01,31,23,31,23,54
ACHOCALLA,consulta externa,repetidas en personas de 60 anos o mas,2007-10-01,1,0,1,0,1
AIQUILE,consulta externa,repetidas en personas de 60 anos o mas,2007-10-01,38,51,38,51,89
ALCALA,consulta externa,repetidas en personas de 60 anos o mas,2007-10-01,3,1,3,1,4
ANCORAIMES,consulta externa,repetidas en personas de 60 anos o mas,2007-10-01,15,1,15,1,16
ANDAMARCA,consulta externa,repetidas en personas de 60 anos o mas,2007-10-01,6,1,6,1,7
ANTEQUERA,consulta externa,repetidas en personas de 60 anos o mas,2007-10-01,1,0,1,0,1
ANZALDO,consulta externa,repetidas en personas de 60 anos o mas,2007-10-01,2,2,2,2,4
APOLO,consulta externa,repetidas en personas de 60 anos o mas,2007-10-01,7,8,7,8,15
ARAMPAMPA,consulta externa,repetidas en personas de 60 anos o mas,2007-10-01,0,2,0,2,2
ARANI,consulta externa,repetidas en personas de 60 anos o mas,2007-10-01,0,5,0,5,5
ARBIETO,consulta externa,repetidas en personas de 60 anos o mas,2007-10-01,1,9,1,9,10
ARQUE,consulta externa,repetidas en personas de 60 anos o mas,2007-10-01,0,2,0,2,2
ATOCHA,consulta externa,repetidas en personas de 60 anos o mas,2007-10-01,26,36,26,36,62
AUCAPATA,consulta externa,repetidas en personas de 60 anos o mas,2007-10-01,0,2,0,2,2
AYATA,consulta externa,repetidas en personas de 60 anos o mas,2007-10-01,3,3,3,3,6
AYO AYO,consulta externa,repetidas en personas de 60 anos o mas,2007-10-01,2,0,2,0,2
AYOPAYA (V. DE INDEPENDENCIA),consulta externa,repetidas en personas de 60 anos o mas,2007-10-01,6,15,6,15,21
AZURDUY,consulta externa,repetidas en personas de 60 anos o mas,2007-10-01,0,2,0,2,2
BATALLAS,consulta externa,repetidas en personas de 60 anos o mas,2007-10-01,5,5,5,5,10
BAURES,consulta externa,repetidas en personas de 60 anos o mas,2007-10-01,2,5,2,5,7
BELEN DE ANDAMARCA,consulta externa,repetidas en personas de 60 anos o mas,2007-10-01,3,2,3,2,5
BELEN DE URMIRI,consulta externa,repetidas en personas de 60 anos o mas,2007-10-01,1,3,1,3,4
BELLA FLOR,consulta externa,repetidas en personas de 60 anos o mas,2007-10-01,0,1,0,1,1
BERMEJO,consulta externa,repetidas en personas de 60 anos o mas,2007-10-01,41,34,41,34,75
BETANZOS,consulta externa,repetidas en personas de 60 anos o mas,2007-10-01,29,58,29,58,87
BOYUIBE,consulta externa,repetidas en personas de 60 anos o mas,2007-10-01,0,1,0,1,1
BUENA VISTA,consulta externa,repetidas en personas de 60 anos o mas,2007-10-01,18,19,18,19,37
CABEZAS,consulta externa,repetidas en personas de 60 anos o mas,2007-10-01,1,2,1,2,3
CAIROMA,consulta externa,repetidas en personas de 60 anos o mas,2007-10-01,9,2,9,2,11
"CAIZA ""D""",consulta externa,repetidas en personas de 60 anos o mas,2007-10-01,1,7,1,7,8
CAJUATA,consulta externa,repetidas en personas de 60 anos o mas,2007-10-01,0,1,0,1,1
CALACOTO,consulta externa,repetidas en personas de 60 anos o mas,2007-10-01,2,6,2,6,8
CALAMARCA,consulta externa,repetidas en personas de 60 anos o mas,2007-10-01,2,10,2,10,12
CAMARGO,consulta externa,repetidas en personas de 60 anos o mas,2007-10-01,12,15,12,15,27
CAMATAQUI (C. VILLA ABECIA),consulta externa,repetidas en personas de 60 anos o mas,2007-10-01,2,7,2,7,9
CAMIRI,consulta externa,repetidas en personas de 60 anos o mas,2007-10-01,52,95,52,95,147
CAPINOTA,consulta externa,repetidas en personas de 60 anos o mas,2007-10-01,20,15,20,15,35
CAQUIAVIRI,consulta externa,repetidas en personas de 60 anos o mas,2007-10-01,2,3,2,3,5
CARACOLLO,consulta externa,repetidas en personas de 60 anos o mas,2007-10-01,11,13,11,13,24
CARANAVI,consulta externa,repetidas en personas de 60 anos o mas,2007-10-01,16,7,16,7,23
CARAPARI,consulta externa,repetidas en personas de 60 anos o mas,2007-10-01,4,3,4,3,7
CARMEN RIVERO TORREZ,consulta externa,repetidas en personas de 60 anos o mas,2007-10-01,1,0,1,0,1
CATACORA,consulta externa,repetidas en personas de 60 anos o mas,2007-10-01,1,0,1,0,1
CHACARILLA,consulta externa,repetidas en personas de 60 anos o mas,2007-10-01,1,3,1,3,4
CHALLAPATA,consulta externa,repetidas en personas de 60 anos o mas,2007-10-01,71,56,71,56,127
CHARAGUA,consulta externa,repetidas en personas de 60 anos o mas,2007-10-01,4,4,4,4,8
CHARAÑA,consulta externa,repetidas en personas de 60 anos o mas,2007-10-01,3,1,3,1,4
CHAYANTA,consulta externa,repetidas en personas de 60 anos o mas,2007-10-01,4,12,4,12,16
CHIMORE,consulta externa,repetidas en personas de 60 anos o mas,2007-10-01,2,0,2,0,2
CHOQUE COTA,consulta externa,repetidas en personas de 60 anos o mas,2007-10-01,0,2,0,2,2
CHULUMANI (V. DE LA LIBERTAD),consulta externa,repetidas en personas de 60 anos o mas,2007-10-01,29,23,29,23,52
CHUMA,consulta externa,repetidas en personas de 60 anos o mas,2007-10-01,3,7,3,7,10
CLIZA,consulta externa,repetidas en personas de 60 anos o mas,2007-10-01,16,26,16,26,42
COBIJA,consulta externa,repetidas en personas de 60 anos o mas,2007-10-01,107,188,107,188,295
COCHABAMBA,consulta externa,repetidas en personas de 60 anos o mas,2007-10-01,6723,9204,6723,9204,15927
COLCAPIRHUA,consulta externa,repetidas en personas de 60 anos o mas,2007-10-01,81,144,81,144,225
"COLCHA ""K""",consulta externa,repetidas en personas de 60 anos o mas,2007-10-01,12,11,12,11,23
COLLANA,consulta externa,repetidas en personas de 60 anos o mas,2007-10-01,9,4,9,4,13
COLPA BELGICA,consulta externa,repetidas en personas de 60 anos o mas,2007-10-01,11,15,11,15,26
COLQUENCHA,consulta externa,repetidas en personas de 60 anos o mas,2007-10-01,3,4,3,4,7
COLQUIRI,consulta externa,repetidas en personas de 60 anos o mas,2007-10-01,9,7,9,7,16
COMANCHE,consulta externa,repetidas en personas de 60 anos o mas,2007-10-01,2,3,2,3,5
COMARAPA,consulta externa,repetidas en personas de 60 anos o mas,2007-10-01,19,20,19,20,39
COMBAYA,consulta externa,repetidas en personas de 60 anos o mas,2007-10-01,1,0,1,0,1
CONCEPCION,consulta externa,repetidas en personas de 60 anos o mas,2007-10-01,0,21,0,21,21
COPACABANA,consulta externa,repetidas en personas de 60 anos o mas,2007-10-01,0,2,0,2,2
CORIPATA,consulta externa,repetidas en personas de 60 anos o mas,2007-10-01,4,1,4,1,5
CORO CORO,consulta externa,repetidas en personas de 60 anos o mas,2007-10-01,6,3,6,3,9
COROICO,consulta externa,repetidas en personas de 60 anos o mas,2007-10-01,68,80,68,80,148
CORQUE,consulta externa,repetidas en personas de 60 anos o mas,2007-10-01,5,4,5,4,9
COTAGAITA,consulta externa,repetidas en personas de 60 anos o mas,2007-10-01,10,17,10,17,27
COTOCA,consulta externa,repetidas en personas de 60 anos o mas,2007-10-01,40,34,40,34,74
CUATRO CAÑADAS,consulta externa,repetidas en personas de 60 anos o mas,2007-10-01,1,3,1,3,4
CUCHUMUELA (V. G. VILLARROEL),consulta externa,repetidas en personas de 60 anos o mas,2007-10-01,1,0,1,0,1
CUEVO,consulta externa,repetidas en personas de 60 anos o mas,2007-10-01,2,5,2,5,7
CULPINA,consulta externa,repetidas en personas de 60 anos o mas,2007-10-01,1,2,1,2,3
CURAHUARA DE CARANGAS,consulta externa,repetidas en personas de 60 anos o mas,2007-10-01,0,2,0,2,2
DESAGUADERO,consulta externa,repetidas en personas de 60 anos o mas,2007-10-01,2,2,2,2,4
EL ALTO,consulta externa,repetidas en personas de 60 anos o mas,2007-10-01,1558,1574,1558,1574,3132
EL PUENTE(STC),consulta externa,repetidas en personas de 60 anos o mas,2007-10-01,2,3,2,3,5
EL PUENTE(TJA),consulta externa,repetidas en personas de 60 anos o mas,2007-10-01,0,2,0,2,2
EL TORNO,consulta externa,repetidas en personas de 60 anos o mas,2007-10-01,33,108,33,108,141
EL VILLAR,consulta externa,repetidas en personas de 60 anos o mas,2007-10-01,2,3,2,3,5
ENTRE RIOS,consulta externa,repetidas en personas de 60 anos o mas,2007-10-01,1,2,1,2,3
ENTRE RIOS,consulta externa,repetidas en personas de 60 anos o mas,2007-10-01,2,1,2,1,3
EUCALIPTUS,consulta externa,repetidas en personas de 60 anos o mas,2007-10-01,6,3,6,3,9
EXALTACION,consulta externa,repetidas en personas de 60 anos o mas,2007-10-01,3,1,3,1,4
FERNANDEZ ALONSO,consulta externa,repetidas en personas de 60 anos o mas,2007-10-01,1,1,1,1,2
FILADELFIA,consulta externa,repetidas en personas de 60 anos o mas,2007-10-01,3,4,3,4,7
GENERAL SAAVEDRA,consulta externa,repetidas en personas de 60 anos o mas,2007-10-01,1,0,1,0,1
GRAL. J.J. PEREZ (CHARAZANI),consulta externa,repetidas en personas de 60 anos o mas,2007-10-01,8,26,8,26,34
GUANAY,consulta externa,repetidas en personas de 60 anos o mas,2007-10-01,14,14,14,14,28
GUAQUI,consulta externa,repetidas en personas de 60 anos o mas,2007-10-01,18,7,18,7,25
GUAYARAMERIN,consulta externa,repetidas en personas de 60 anos o mas,2007-10-01,149,156,149,156,305
GUTIERREZ,consulta externa,repetidas en personas de 60 anos o mas,2007-10-01,3,0,3,0,3
HUACARETA,consulta externa,repetidas en personas de 60 anos o mas,2007-10-01,12,10,12,10,22
HUACAYA (VILLA DE HUACAYA),consulta externa,repetidas en personas de 60 anos o mas,2007-10-01,1,0,1,0,1
HUANUNI,consulta externa,repetidas en personas de 60 anos o mas,2007-10-01,152,219,152,219,371
HUARACAJE,consulta externa,repetidas en personas de 60 anos o mas,2007-10-01,0,2,0,2,2
ICHOCA,consulta externa,repetidas en personas de 60 anos o mas,2007-10-01,1,0,1,0,1
ICLA,consulta externa,repetidas en personas de 60 anos o mas,2007-10-01,3,9,3,9,12
INGAVI (HUMAITA),consulta externa,repetidas en personas de 60 anos o mas,2007-10-01,1,1,1,1,2
INQUISIVI,consulta externa,repetidas en personas de 60 anos o mas,2007-10-01,4,1,4,1,5
IRUPANA (VILLA DE LANZA),consulta externa,repetidas en personas de 60 anos o mas,2007-10-01,9,8,9,8,17
IXIAMAS,consulta externa,repetidas en personas de 60 anos o mas,2007-10-01,1,0,1,0,1
JESUS DE MACHACA,consulta externa,repetidas en personas de 60 anos o mas,2007-10-01,20,19,20,19,39
LA ASUNTA,consulta externa,repetidas en personas de 60 anos o mas,2007-10-01,6,5,6,5,11
LA GUARDIA,consulta externa,repetidas en personas de 60 anos o mas,2007-10-01,19,11,19,11,30
LA PAZ,consulta externa,repetidas en personas de 60 anos o mas,2007-10-01,11262,15169,11262,15169,26431
LAGUNILLAS,consulta externa,repetidas en personas de 60 anos o mas,2007-10-01,1,1,1,1,2
LAJA,consulta externa,repetidas en personas de 60 anos o mas,2007-10-01,4,3,4,3,7
LAS CARRERAS,consulta externa,repetidas en personas de 60 anos o mas,2007-10-01,4,10,4,10,14
LLALLAGUA,consulta externa,repetidas en personas de 60 anos o mas,2007-10-01,108,142,108,142,250
LLICA,consulta externa,repetidas en personas de 60 anos o mas,2007-10-01,8,2,8,2,10
LORETO,consulta externa,repetidas en personas de 60 anos o mas,2007-10-01,4,7,4,7,11
LURIBAY,consulta externa,repetidas en personas de 60 anos o mas,2007-10-01,10,9,10,9,19
MACHACAMARCA,consulta externa,repetidas en personas de 60 anos o mas,2007-10-01,44,55,44,55,99
MACHARETI,consulta externa,repetidas en personas de 60 anos o mas,2007-10-01,29,22,29,22,51
MAGDALENA,consulta externa,repetidas en personas de 60 anos o mas,2007-10-01,57,90,57,90,147
MALLA,consulta externa,repetidas en personas de 60 anos o mas,2007-10-01,5,1,5,1,6
MAPIRI,consulta externa,repetidas en personas de 60 anos o mas,2007-10-01,4,3,4,3,7
MECAPACA,consulta externa,repetidas en personas de 60 anos o mas,2007-10-01,12,6,12,6,18
MIZQUE,consulta externa,repetidas en personas de 60 anos o mas,2007-10-01,1,3,1,3,4
MOCOMOCO,consulta externa,repetidas en personas de 60 anos o mas,2007-10-01,11,8,11,8,19
MOJOCOYA,consulta externa,repetidas en personas de 60 anos o mas,2007-10-01,4,5,4,5,9
MONTEAGUDO,consulta externa,repetidas en personas de 60 anos o mas,2007-10-01,75,124,75,124,199
MONTERO,consulta externa,repetidas en personas de 60 anos o mas,2007-10-01,53,83,53,83,136
MORO MORO,consulta externa,repetidas en personas de 60 anos o mas,2007-10-01,1,1,1,1,2
MOROCHATA,consulta externa,repetidas en personas de 60 anos o mas,2007-10-01,9,10,9,10,19
NACEBE (SANTA ROSA DEL ABUNA),consulta externa,repetidas en personas de 60 anos o mas,2007-10-01,0,1,0,1,1
NUEVO MANOA (NUEVA ESPERANZA),consulta externa,repetidas en personas de 60 anos o mas,2007-10-01,0,1,0,1,1
OCURI,consulta externa,repetidas en personas de 60 anos o mas,2007-10-01,1,0,1,0,1
OKINAWA,consulta externa,repetidas en personas de 60 anos o mas,2007-10-01,5,4,5,4,9
OMEREQUE,consulta externa,repetidas en personas de 60 anos o mas,2007-10-01,2,6,2,6,8
ORURO,consulta externa,repetidas en personas de 60 anos o mas,2007-10-01,2101,2591,2101,2591,4692
PADCAYA,consulta externa,repetidas en personas de 60 anos o mas,2007-10-01,7,8,7,8,15
PADILLA,consulta externa,repetidas en personas de 60 anos o mas,2007-10-01,17,29,17,29,46
PAILON,consulta externa,repetidas en personas de 60 anos o mas,2007-10-01,1,1,1,1,2
PALCA,consulta externa,repetidas en personas de 60 anos o mas,2007-10-01,13,7,13,7,20
PALOS BLANCOS,consulta externa,repetidas en personas de 60 anos o mas,2007-10-01,1,0,1,0,1
PAMPA GRANDE,consulta externa,repetidas en personas de 60 anos o mas,2007-10-01,2,7,2,7,9
PASORAPA,consulta externa,repetidas en personas de 60 anos o mas,2007-10-01,2,1,2,1,3
PATACAMAYA,consulta externa,repetidas en personas de 60 anos o mas,2007-10-01,1,2,1,2,3
PAZÑA,consulta externa,repetidas en personas de 60 anos o mas,2007-10-01,16,25,16,25,41
POCOATA,consulta externa,repetidas en personas de 60 anos o mas,2007-10-01,1,0,1,0,1
POCONA,consulta externa,repetidas en personas de 60 anos o mas,2007-10-01,0,1,0,1,1
POOPO,consulta externa,repetidas en personas de 60 anos o mas,2007-10-01,11,18,11,18,29
POROMA,consulta externa,repetidas en personas de 60 anos o mas,2007-10-01,3,4,3,4,7
PORONGO,consulta externa,repetidas en personas de 60 anos o mas,2007-10-01,1,0,1,0,1
PORTACHUELO,consulta externa,repetidas en personas de 60 anos o mas,2007-10-01,22,27,22,27,49
PORVENIR,consulta externa,repetidas en personas de 60 anos o mas,2007-10-01,3,1,3,1,4
POSTRER VALLE,consulta externa,repetidas en personas de 60 anos o mas,2007-10-01,2,4,2,4,6
POTOSI,consulta externa,repetidas en personas de 60 anos o mas,2007-10-01,1068,1617,1068,1617,2685
PRESTO,consulta externa,repetidas en personas de 60 anos o mas,2007-10-01,1,0,1,0,1
PUCARA,consulta externa,repetidas en personas de 60 anos o mas,2007-10-01,2,8,2,8,10
PUCARANI,consulta externa,repetidas en personas de 60 anos o mas,2007-10-01,8,4,8,4,12
PUERTO ACOSTA,consulta externa,repetidas en personas de 60 anos o mas,2007-10-01,41,19,41,19,60
PUERTO CARABUCO,consulta externa,repetidas en personas de 60 anos o mas,2007-10-01,2,4,2,4,6
PUERTO GONZALO MORENO,consulta externa,repetidas en personas de 60 anos o mas,2007-10-01,1,1,1,1,2
PUERTO PEREZ,consulta externa,repetidas en personas de 60 anos o mas,2007-10-01,4,4,4,4,8
PUERTO QUIJARRO,consulta externa,repetidas en personas de 60 anos o mas,2007-10-01,3,4,3,4,7
PUERTO RICO,consulta externa,repetidas en personas de 60 anos o mas,2007-10-01,6,9,6,9,15
PUERTO SILES,consulta externa,repetidas en personas de 60 anos o mas,2007-10-01,0,3,0,3,3
PUERTO SUAREZ,consulta externa,repetidas en personas de 60 anos o mas,2007-10-01,14,17,14,17,31
PUERTO VILLARROEL,consulta externa,repetidas en personas de 60 anos o mas,2007-10-01,9,5,9,5,14
PUNA,consulta externa,repetidas en personas de 60 anos o mas,2007-10-01,5,11,5,11,16
PUNATA,consulta externa,repetidas en personas de 60 anos o mas,2007-10-01,85,138,85,138,223
QUIABAYA,consulta externa,repetidas en personas de 60 anos o mas,2007-10-01,2,4,2,4,6
QUILLACOLLO,consulta externa,repetidas en personas de 60 anos o mas,2007-10-01,345,541,345,541,886
QUIME,consulta externa,repetidas en personas de 60 anos o mas,2007-10-01,1,1,1,1,2
QUIRUSILLAS,consulta externa,repetidas en personas de 60 anos o mas,2007-10-01,5,5,5,5,10
RAVELO,consulta externa,repetidas en personas de 60 anos o mas,2007-10-01,1,0,1,0,1
REYES,consulta externa,repetidas en personas de 60 anos o mas,2007-10-01,68,56,68,56,124
RIBERALTA,consulta externa,repetidas en personas de 60 anos o mas,2007-10-01,168,11,168,11,179
ROBORE,consulta externa,repetidas en personas de 60 anos o mas,2007-10-01,60,61,60,61,121
RURRENABAQUE,consulta externa,repetidas en personas de 60 anos o mas,2007-10-01,116,79,116,79,195
SABAYA,consulta externa,repetidas en personas de 60 anos o mas,2007-10-01,2,1,2,1,3
SACABA,consulta externa,repetidas en personas de 60 anos o mas,2007-10-01,102,155,102,155,257
SACABAMBA,consulta externa,repetidas en personas de 60 anos o mas,2007-10-01,7,13,7,13,20
SAIPINA,consulta externa,repetidas en personas de 60 anos o mas,2007-10-01,1,0,1,0,1
SALINAS DE GARCI MENDOZA,consulta externa,repetidas en personas de 60 anos o mas,2007-10-01,7,8,7,8,15
SAMAIPATA,consulta externa,repetidas en personas de 60 anos o mas,2007-10-01,3,3,3,3,6
SAN AGUSTIN,consulta externa,repetidas en personas de 60 anos o mas,2007-10-01,1,2,1,2,3
SAN ANDRES,consulta externa,repetidas en personas de 60 anos o mas,2007-10-01,2,4,2,4,6
SAN ANDRES DE MACHACA,consulta externa,repetidas en personas de 60 anos o mas,2007-10-01,3,4,3,4,7
SAN ANTONIO DE ESMORUCO,consulta externa,repetidas en personas de 60 anos o mas,2007-10-01,1,1,1,1,2
SAN ANTONIO DE LOMERIO,consulta externa,repetidas en personas de 60 anos o mas,2007-10-01,1,1,1,1,2
SAN BENITO,consulta externa,repetidas en personas de 60 anos o mas,2007-10-01,14,10,14,10,24
SAN BORJA,consulta externa,repetidas en personas de 60 anos o mas,2007-10-01,36,63,36,63,99
SAN BUENA VENTURA,consulta externa,repetidas en personas de 60 anos o mas,2007-10-01,5,7,5,7,12
SAN CARLOS,consulta externa,repetidas en personas de 60 anos o mas,2007-10-01,17,18,17,18,35
SAN IGNACIO,consulta externa,repetidas en personas de 60 anos o mas,2007-10-01,63,70,63,70,133
SAN IGNACIO DE VELASCO,consulta externa,repetidas en personas de 60 anos o mas,2007-10-01,56,55,56,55,111
SAN JAVIER(BNI),consulta externa,repetidas en personas de 60 anos o mas,2007-10-01,2,0,2,0,2
SAN JAVIER(STC),consulta externa,repetidas en personas de 60 anos o mas,2007-10-01,5,6,5,6,11
SAN JOAQUIN,consulta externa,repetidas en personas de 60 anos o mas,2007-10-01,6,6,6,6,12
SAN JOSE DE CHIQUITOS,consulta externa,repetidas en personas de 60 anos o mas,2007-10-01,4,12,4,12,16
SAN JUAN DE YAPACANI,consulta externa,repetidas en personas de 60 anos o mas,2007-10-01,8,17,8,17,25
SAN JULIAN,consulta externa,repetidas en personas de 60 anos o mas,2007-10-01,3,5,3,5,8
SAN LORENZO(PND),consulta externa,repetidas en personas de 60 anos o mas,2007-10-01,1,0,1,0,1
SAN LORENZO(TJA),consulta externa,repetidas en personas de 60 anos o mas,2007-10-01,3,10,3,10,13
SAN LUCAS,consulta externa,repetidas en personas de 60 anos o mas,2007-10-01,32,54,32,54,86
SAN MATIAS,consulta externa,repetidas en personas de 60 anos o mas,2007-10-01,1,0,1,0,1
SAN MIGUEL DE VELASCO,consulta externa,repetidas en personas de 60 anos o mas,2007-10-01,29,42,29,42,71
SAN PABLO DE LIPEZ,consulta externa,repetidas en personas de 60 anos o mas,2007-10-01,1,4,1,4,5
SAN PEDRO,consulta externa,repetidas en personas de 60 anos o mas,2007-10-01,10,9,10,9,19
SAN PEDRO DE CURAHUARA,consulta externa,repetidas en personas de 60 anos o mas,2007-10-01,4,4,4,4,8
SAN PEDRO DE QUEMES,consulta externa,repetidas en personas de 60 anos o mas,2007-10-01,0,1,0,1,1
SAN PEDRO DE TIQUINA,consulta externa,repetidas en personas de 60 anos o mas,2007-10-01,0,2,0,2,2
SAN PEDRO(PND),consulta externa,repetidas en personas de 60 anos o mas,2007-10-01,1,0,1,0,1
SAN RAFAEL,consulta externa,repetidas en personas de 60 anos o mas,2007-10-01,0,2,0,2,2
SAN RAMON,consulta externa,repetidas en personas de 60 anos o mas,2007-10-01,0,8,0,8,8
SANTA ANA,consulta externa,repetidas en personas de 60 anos o mas,2007-10-01,54,66,54,66,120
SANTA CRUZ DE LA SIERRA,consulta externa,repetidas en personas de 60 anos o mas,2007-10-01,3568,5989,3568,5989,9557
SANTA ROSA,consulta externa,repetidas en personas de 60 anos o mas,2007-10-01,13,7,13,7,20
SANTA ROSA DEL SARA,consulta externa,repetidas en personas de 60 anos o mas,2007-10-01,6,2,6,2,8
SANTIAGO DE HUARI,consulta externa,repetidas en personas de 60 anos o mas,2007-10-01,21,30,21,30,51
SANTIAGO DE MACHACA,consulta externa,repetidas en personas de 60 anos o mas,2007-10-01,1,1,1,1,2
SANTIVAÑES,consulta externa,repetidas en personas de 60 anos o mas,2007-10-01,12,14,12,14,26
SANTUARIO DE QUILLACAS,consulta externa,repetidas en personas de 60 anos o mas,2007-10-01,2,0,2,0,2
SAPAHAQUI,consulta externa,repetidas en personas de 60 anos o mas,2007-10-01,0,4,0,4,4
SICA SICA (VILLA AROMA),consulta externa,repetidas en personas de 60 anos o mas,2007-10-01,3,2,3,2,5
SICAYA,consulta externa,repetidas en personas de 60 anos o mas,2007-10-01,0,1,0,1,1
SIPE SIPE,consulta externa,repetidas en personas de 60 anos o mas,2007-10-01,12,34,12,34,46
SOPACHUY,consulta externa,repetidas en personas de 60 anos o mas,2007-10-01,0,1,0,1,1
SORACACHI,consulta externa,repetidas en personas de 60 anos o mas,2007-10-01,1,1,1,1,2
SORATA,consulta externa,repetidas en personas de 60 anos o mas,2007-10-01,2,2,2,2,4
SUCRE,consulta externa,repetidas en personas de 60 anos o mas,2007-10-01,1225,1833,1225,1833,3058
TACACHI,consulta externa,repetidas en personas de 60 anos o mas,2007-10-01,3,5,3,5,8
TACOBAMBA,consulta externa,repetidas en personas de 60 anos o mas,2007-10-01,1,0,1,0,1
TACOPAYA,consulta externa,repetidas en personas de 60 anos o mas,2007-10-01,0,1,0,1,1
TAHUA,consulta externa,repetidas en personas de 60 anos o mas,2007-10-01,1,2,1,2,3
TAPACARI,consulta externa,repetidas en personas de 60 anos o mas,2007-10-01,1,2,1,2,3
TARABUCO,consulta externa,repetidas en personas de 60 anos o mas,2007-10-01,12,60,12,60,72
TARACO,consulta externa,repetidas en personas de 60 anos o mas,2007-10-01,0,2,0,2,2
TARATA,consulta externa,repetidas en personas de 60 anos o mas,2007-10-01,1,3,1,3,4
TARIJA,consulta externa,repetidas en personas de 60 anos o mas,2007-10-01,2335,3090,2335,3090,5425
TARVITA,consulta externa,repetidas en personas de 60 anos o mas,2007-10-01,4,6,4,6,10
TEOPONTE,consulta externa,repetidas en personas de 60 anos o mas,2007-10-01,16,16,16,16,32
TIQUIPAYA,consulta externa,repetidas en personas de 60 anos o mas,2007-10-01,6,11,6,11,17
TIRAQUE (CBBA),consulta externa,repetidas en personas de 60 anos o mas,2007-10-01,15,22,15,22,37
TITO YUPANQUI (PARQUIPUJIO),consulta externa,repetidas en personas de 60 anos o mas,2007-10-01,0,6,0,6,6
TOCO,consulta externa,repetidas en personas de 60 anos o mas,2007-10-01,2,1,2,1,3
TODOS SANTOS,consulta externa,repetidas en personas de 60 anos o mas,2007-10-01,3,1,3,1,4
TOLATA,consulta externa,repetidas en personas de 60 anos o mas,2007-10-01,10,11,10,11,21
TOLEDO,consulta externa,repetidas en personas de 60 anos o mas,2007-10-01,2,1,2,1,3
TOMAVE,consulta externa,repetidas en personas de 60 anos o mas,2007-10-01,7,11,7,11,18
TOMINA,consulta externa,repetidas en personas de 60 anos o mas,2007-10-01,1,3,1,3,4
TORO TORO,consulta externa,repetidas en personas de 60 anos o mas,2007-10-01,0,1,0,1,1
TOTORA(CBBA),consulta externa,repetidas en personas de 60 anos o mas,2007-10-01,3,5,3,5,8
TOTORA(ORR),consulta externa,repetidas en personas de 60 anos o mas,2007-10-01,1,1,1,1,2
TRIGAL,consulta externa,repetidas en personas de 60 anos o mas,2007-10-01,4,3,4,3,7
TRINIDAD,consulta externa,repetidas en personas de 60 anos o mas,2007-10-01,282,316,282,316,598
TUPIZA,consulta externa,repetidas en personas de 60 anos o mas,2007-10-01,51,64,51,64,115
TURCO,consulta externa,repetidas en personas de 60 anos o mas,2007-10-01,2,0,2,0,2
UNCIA,consulta externa,repetidas en personas de 60 anos o mas,2007-10-01,49,85,49,85,134
URIONDO (A. CONCEPCION),consulta externa,repetidas en personas de 60 anos o mas,2007-10-01,9,31,9,31,40
UYUNI,consulta externa,repetidas en personas de 60 anos o mas,2007-10-01,45,39,45,39,84
VACAS,consulta externa,repetidas en personas de 60 anos o mas,2007-10-01,19,25,19,25,44
VALLEGRANDE,consulta externa,repetidas en personas de 60 anos o mas,2007-10-01,300,407,300,407,707
VIACHA,consulta externa,repetidas en personas de 60 anos o mas,2007-10-01,261,245,261,245,506
VILA VILA,consulta externa,repetidas en personas de 60 anos o mas,2007-10-01,0,1,0,1,1
VILLA MONTES,consulta externa,repetidas en personas de 60 anos o mas,2007-10-01,66,103,66,103,169
VILLA NUEVA (LOMA ALTA),consulta externa,repetidas en personas de 60 anos o mas,2007-10-01,2,1,2,1,3
VILLA RIVERO,consulta externa,repetidas en personas de 60 anos o mas,2007-10-01,5,0,5,0,5
VILLA SERRANO,consulta externa,repetidas en personas de 60 anos o mas,2007-10-01,0,1,0,1,1
VILLA TUNARI,consulta externa,repetidas en personas de 60 anos o mas,2007-10-01,77,45,77,45,122
VILLA VACA GUZMAN (MUYUPAMPA),consulta externa,repetidas en personas de 60 anos o mas,2007-10-01,9,5,9,5,14
VILLAZON,consulta externa,repetidas en personas de 60 anos o mas,2007-10-01,31,68,31,68,99
VINTO,consulta externa,repetidas en personas de 60 anos o mas,2007-10-01,39,52,39,52,91
VITICHI,consulta externa,repetidas en personas de 60 anos o mas,2007-10-01,8,15,8,15,23
WALDO BALLIVIAN,consulta externa,repetidas en personas de 60 anos o mas,2007-10-01,0,1,0,1,1
WARNES,consulta externa,repetidas en personas de 60 anos o mas,2007-10-01,12,16,12,16,28
YACO,consulta externa,repetidas en personas de 60 anos o mas,2007-10-01,1,4,1,4,5
YACUIBA,consulta externa,repetidas en personas de 60 anos o mas,2007-10-01,134,204,134,204,338
YAMPARAEZ,consulta externa,repetidas en personas de 60 anos o mas,2007-10-01,11,6,11,6,17
YANACACHI,consulta externa,repetidas en personas de 60 anos o mas,2007-10-01,0,3,0,3,3
YAPACANI,consulta externa,repetidas en personas de 60 anos o mas,2007-10-01,0,2,0,2,2
YOCALLA,consulta externa,repetidas en personas de 60 anos o mas,2007-10-01,1,0,1,0,1
YOTALA,consulta externa,repetidas en personas de 60 anos o mas,2007-10-01,9,15,9,15,24
ZUDAÑEZ,consulta externa,repetidas en personas de 60 anos o mas,2007-10-01,2,1,2,1,3
ACACIO,consulta externa,repetidas en personas de 60 anos o mas,2007-11-01,0,1,0,1,1
ACHACACHI,consulta externa,repetidas en personas de 60 anos o mas,2007-11-01,12,27,12,27,39
ACHOCALLA,consulta externa,repetidas en personas de 60 anos o mas,2007-11-01,7,3,7,3,10
AIQUILE,consulta externa,repetidas en personas de 60 anos o mas,2007-11-01,53,49,53,49,102
ALCALA,consulta externa,repetidas en personas de 60 anos o mas,2007-11-01,0,3,0,3,3
ANCORAIMES,consulta externa,repetidas en personas de 60 anos o mas,2007-11-01,1,16,1,16,17
ANDAMARCA,consulta externa,repetidas en personas de 60 anos o mas,2007-11-01,1,1,1,1,2
ANZALDO,consulta externa,repetidas en personas de 60 anos o mas,2007-11-01,2,1,2,1,3
APOLO,consulta externa,repetidas en personas de 60 anos o mas,2007-11-01,3,7,3,7,10
ARAMPAMPA,consulta externa,repetidas en personas de 60 anos o mas,2007-11-01,0,1,0,1,1
ARBIETO,consulta externa,repetidas en personas de 60 anos o mas,2007-11-01,1,5,1,5,6
ARQUE,consulta externa,repetidas en personas de 60 anos o mas,2007-11-01,0,2,0,2,2
ASCENCION DE GUARAYOS,consulta externa,repetidas en personas de 60 anos o mas,2007-11-01,5,4,5,4,9
ATOCHA,consulta externa,repetidas en personas de 60 anos o mas,2007-11-01,22,41,22,41,63
AUCAPATA,consulta externa,repetidas en personas de 60 anos o mas,2007-11-01,1,0,1,0,1
AYATA,consulta externa,repetidas en personas de 60 anos o mas,2007-11-01,0,1,0,1,1
AYO AYO,consulta externa,repetidas en personas de 60 anos o mas,2007-11-01,1,1,1,1,2
AYOPAYA (V. DE INDEPENDENCIA),consulta externa,repetidas en personas de 60 anos o mas,2007-11-01,0,1,0,1,1
AZURDUY,consulta externa,repetidas en personas de 60 anos o mas,2007-11-01,1,3,1,3,4
BATALLAS,consulta externa,repetidas en personas de 60 anos o mas,2007-11-01,2,2,2,2,4
BAURES,consulta externa,repetidas en personas de 60 anos o mas,2007-11-01,3,9,3,9,12
BELEN DE ANDAMARCA,consulta externa,repetidas en personas de 60 anos o mas,2007-11-01,1,3,1,3,4
BELEN DE URMIRI,consulta externa,repetidas en personas de 60 anos o mas,2007-11-01,0,1,0,1,1
BERMEJO,consulta externa,repetidas en personas de 60 anos o mas,2007-11-01,60,49,60,49,109
BETANZOS,consulta externa,repetidas en personas de 60 anos o mas,2007-11-01,63,79,63,79,142
BOLIVAR,consulta externa,repetidas en personas de 60 anos o mas,2007-11-01,0,1,0,1,1
BOYUIBE,consulta externa,repetidas en personas de 60 anos o mas,2007-11-01,7,9,7,9,16
BUENA VISTA,consulta externa,repetidas en personas de 60 anos o mas,2007-11-01,9,17,9,17,26
CABEZAS,consulta externa,repetidas en personas de 60 anos o mas,2007-11-01,1,0,1,0,1
CAIROMA,consulta externa,repetidas en personas de 60 anos o mas,2007-11-01,9,1,9,1,10
"CAIZA ""D""",consulta externa,repetidas en personas de 60 anos o mas,2007-11-01,6,8,6,8,14
CAJUATA,consulta externa,repetidas en personas de 60 anos o mas,2007-11-01,0,2,0,2,2
CALACOTO,consulta externa,repetidas en personas de 60 anos o mas,2007-11-01,2,1,2,1,3
CALAMARCA,consulta externa,repetidas en personas de 60 anos o mas,2007-11-01,2,3,2,3,5
CAMARGO,consulta externa,repetidas en personas de 60 anos o mas,2007-11-01,8,17,8,17,25
CAMATAQUI (C. VILLA ABECIA),consulta externa,repetidas en personas de 60 anos o mas,2007-11-01,2,6,2,6,8
CAMIRI,consulta externa,repetidas en personas de 60 anos o mas,2007-11-01,71,104,71,104,175
CAPINOTA,consulta externa,repetidas en personas de 60 anos o mas,2007-11-01,32,37,32,37,69
CAQUIAVIRI,consulta externa,repetidas en personas de 60 anos o mas,2007-11-01,3,0,3,0,3
CARACOLLO,consulta externa,repetidas en personas de 60 anos o mas,2007-11-01,13,6,13,6,19
CARANAVI,consulta externa,repetidas en personas de 60 anos o mas,2007-11-01,23,9,23,9,32
CARAPARI,consulta externa,repetidas en personas de 60 anos o mas,2007-11-01,1,1,1,1,2
CARIPUYO,consulta externa,repetidas en personas de 60 anos o mas,2007-11-01,0,1,0,1,1
CATACORA,consulta externa,repetidas en personas de 60 anos o mas,2007-11-01,2,1,2,1,3
CHALLAPATA,consulta externa,repetidas en personas de 60 anos o mas,2007-11-01,69,57,69,57,126
CHAQUI,consulta externa,repetidas en personas de 60 anos o mas,2007-11-01,0,2,0,2,2
CHARAGUA,consulta externa,repetidas en personas de 60 anos o mas,2007-11-01,5,4,5,4,9
CHARAÑA,consulta externa,repetidas en personas de 60 anos o mas,2007-11-01,1,0,1,0,1
CHAYANTA,consulta externa,repetidas en personas de 60 anos o mas,2007-11-01,2,6,2,6,8
CHIMORE,consulta externa,repetidas en personas de 60 anos o mas,2007-11-01,2,1,2,1,3
CHIPAYA,consulta externa,repetidas en personas de 60 anos o mas,2007-11-01,1,1,1,1,2
CHOQUE COTA,consulta externa,repetidas en personas de 60 anos o mas,2007-11-01,2,1,2,1,3
CHULUMANI (V. DE LA LIBERTAD),consulta externa,repetidas en personas de 60 anos o mas,2007-11-01,25,20,25,20,45
CHUMA,consulta externa,repetidas en personas de 60 anos o mas,2007-11-01,2,3,2,3,5
CLIZA,consulta externa,repetidas en personas de 60 anos o mas,2007-11-01,7,7,7,7,14
COBIJA,consulta externa,repetidas en personas de 60 anos o mas,2007-11-01,114,180,114,180,294
COCHABAMBA,consulta externa,repetidas en personas de 60 anos o mas,2007-11-01,5789,5917,5789,5917,11706
COLCAPIRHUA,consulta externa,repetidas en personas de 60 anos o mas,2007-11-01,50,91,50,91,141
"COLCHA ""K""",consulta externa,repetidas en personas de 60 anos o mas,2007-11-01,7,2,7,2,9
COLLANA,consulta externa,repetidas en personas de 60 anos o mas,2007-11-01,3,2,3,2,5
COLOMI,consulta externa,repetidas en personas de 60 anos o mas,2007-11-01,0,4,0,4,4
COLPA BELGICA,consulta externa,repetidas en personas de 60 anos o mas,2007-11-01,7,4,7,4,11
COLQUECHACA,consulta externa,repetidas en personas de 60 anos o mas,2007-11-01,7,7,7,7,14
COLQUENCHA,consulta externa,repetidas en personas de 60 anos o mas,2007-11-01,1,7,1,7,8
COLQUIRI,consulta externa,repetidas en personas de 60 anos o mas,2007-11-01,7,4,7,4,11
COMANCHE,consulta externa,repetidas en personas de 60 anos o mas,2007-11-01,2,3,2,3,5
COMARAPA,consulta externa,repetidas en personas de 60 anos o mas,2007-11-01,24,38,24,38,62
COMBAYA,consulta externa,repetidas en personas de 60 anos o mas,2007-11-01,1,0,1,0,1
CONCEPCION,consulta externa,repetidas en personas de 60 anos o mas,2007-11-01,2,4,2,4,6
COPACABANA,consulta externa,repetidas en personas de 60 anos o mas,2007-11-01,0,2,0,2,2
CORIPATA,consulta externa,repetidas en personas de 60 anos o mas,2007-11-01,1,1,1,1,2
CORO CORO,consulta externa,repetidas en personas de 60 anos o mas,2007-11-01,2,5,2,5,7
COROICO,consulta externa,repetidas en personas de 60 anos o mas,2007-11-01,66,63,66,63,129
CORQUE,consulta externa,repetidas en personas de 60 anos o mas,2007-11-01,6,6,6,6,12
COTAGAITA,consulta externa,repetidas en personas de 60 anos o mas,2007-11-01,9,25,9,25,34
COTOCA,consulta externa,repetidas en personas de 60 anos o mas,2007-11-01,23,37,23,37,60
CUATRO CAÑADAS,consulta externa,repetidas en personas de 60 anos o mas,2007-11-01,13,12,13,12,25
CUCHUMUELA (V. G. VILLARROEL),consulta externa,repetidas en personas de 60 anos o mas,2007-11-01,6,3,6,3,9
CUEVO,consulta externa,repetidas en personas de 60 anos o mas,2007-11-01,6,9,6,9,15
CULPINA,consulta externa,repetidas en personas de 60 anos o mas,2007-11-01,0,1,0,1,1
CURAHUARA DE CARANGAS,consulta externa,repetidas en personas de 60 anos o mas,2007-11-01,2,0,2,0,2
DESAGUADERO,consulta externa,repetidas en personas de 60 anos o mas,2007-11-01,2,0,2,0,2
EL ALTO,consulta externa,repetidas en personas de 60 anos o mas,2007-11-01,1450,1645,1450,1645,3095
EL CHORO,consulta externa,repetidas en personas de 60 anos o mas,2007-11-01,3,1,3,1,4
EL PUENTE(STC),consulta externa,repetidas en personas de 60 anos o mas,2007-11-01,3,4,3,4,7
EL PUENTE(TJA),consulta externa,repetidas en personas de 60 anos o mas,2007-11-01,3,5,3,5,8
EL TORNO,consulta externa,repetidas en personas de 60 anos o mas,2007-11-01,62,70,62,70,132
EL VILLAR,consulta externa,repetidas en personas de 60 anos o mas,2007-11-01,2,2,2,2,4
ENTRE RIOS,consulta externa,repetidas en personas de 60 anos o mas,2007-11-01,3,7,3,7,10
ENTRE RIOS,consulta externa,repetidas en personas de 60 anos o mas,2007-11-01,0,3,0,3,3
ESCARA,consulta externa,repetidas en personas de 60 anos o mas,2007-11-01,1,1,1,1,2
EUCALIPTUS,consulta externa,repetidas en personas de 60 anos o mas,2007-11-01,0,3,0,3,3
FERNANDEZ ALONSO,consulta externa,repetidas en personas de 60 anos o mas,2007-11-01,0,1,0,1,1
GENERAL SAAVEDRA,consulta externa,repetidas en personas de 60 anos o mas,2007-11-01,1,1,1,1,2
GRAL. J.J. PEREZ (CHARAZANI),consulta externa,repetidas en personas de 60 anos o mas,2007-11-01,0,2,0,2,2
GUANAY,consulta externa,repetidas en personas de 60 anos o mas,2007-11-01,17,9,17,9,26
GUAQUI,consulta externa,repetidas en personas de 60 anos o mas,2007-11-01,15,3,15,3,18
GUAYARAMERIN,consulta externa,repetidas en personas de 60 anos o mas,2007-11-01,33,42,33,42,75
GUTIERREZ,consulta externa,repetidas en personas de 60 anos o mas,2007-11-01,5,2,5,2,7
HUACARETA,consulta externa,repetidas en personas de 60 anos o mas,2007-11-01,15,9,15,9,24
HUACHACALLA,consulta externa,repetidas en personas de 60 anos o mas,2007-11-01,0,2,0,2,2
HUANUNI,consulta externa,repetidas en personas de 60 anos o mas,2007-11-01,226,214,226,214,440
HUARACAJE,consulta externa,repetidas en personas de 60 anos o mas,2007-11-01,6,0,6,0,6
HUAYLLAMARCA,consulta externa,repetidas en personas de 60 anos o mas,2007-11-01,1,0,1,0,1
ICLA,consulta externa,repetidas en personas de 60 anos o mas,2007-11-01,6,4,6,4,10
INCAHUASI,consulta externa,repetidas en personas de 60 anos o mas,2007-11-01,0,1,0,1,1
INGAVI (HUMAITA),consulta externa,repetidas en personas de 60 anos o mas,2007-11-01,0,1,0,1,1
INQUISIVI,consulta externa,repetidas en personas de 60 anos o mas,2007-11-01,3,1,3,1,4
IRUPANA (VILLA DE LANZA),consulta externa,repetidas en personas de 60 anos o mas,2007-11-01,5,10,5,10,15
IXIAMAS,consulta externa,repetidas en personas de 60 anos o mas,2007-11-01,0,1,0,1,1
JESUS DE MACHACA,consulta externa,repetidas en personas de 60 anos o mas,2007-11-01,20,27,20,27,47
LA GUARDIA,consulta externa,repetidas en personas de 60 anos o mas,2007-11-01,10,16,10,16,26
LA PAZ,consulta externa,repetidas en personas de 60 anos o mas,2007-11-01,10555,14687,10555,14687,25242
LAGUNILLAS,consulta externa,repetidas en personas de 60 anos o mas,2007-11-01,0,2,0,2,2
LAJA,consulta externa,repetidas en personas de 60 anos o mas,2007-11-01,4,3,4,3,7
LAS CARRERAS,consulta externa,repetidas en personas de 60 anos o mas,2007-11-01,4,4,4,4,8
LLALLAGUA,consulta externa,repetidas en personas de 60 anos o mas,2007-11-01,81,115,81,115,196
LLICA,consulta externa,repetidas en personas de 60 anos o mas,2007-11-01,5,1,5,1,6
LORETO,consulta externa,repetidas en personas de 60 anos o mas,2007-11-01,5,4,5,4,9
LURIBAY,consulta externa,repetidas en personas de 60 anos o mas,2007-11-01,19,11,19,11,30
MACHACAMARCA,consulta externa,repetidas en personas de 60 anos o mas,2007-11-01,22,25,22,25,47
MACHARETI,consulta externa,repetidas en personas de 60 anos o mas,2007-11-01,5,1,5,1,6
MAGDALENA,consulta externa,repetidas en personas de 60 anos o mas,2007-11-01,73,103,73,103,176
MAPIRI,consulta externa,repetidas en personas de 60 anos o mas,2007-11-01,3,8,3,8,11
MECAPACA,consulta externa,repetidas en personas de 60 anos o mas,2007-11-01,4,4,4,4,8
MINEROS,consulta externa,repetidas en personas de 60 anos o mas,2007-11-01,1,0,1,0,1
MIZQUE,consulta externa,repetidas en personas de 60 anos o mas,2007-11-01,1,1,1,1,2
MOCOMOCO,consulta externa,repetidas en personas de 60 anos o mas,2007-11-01,3,4,3,4,7
MOJINETE,consulta externa,repetidas en personas de 60 anos o mas,2007-11-01,0,1,0,1,1
MOJOCOYA,consulta externa,repetidas en personas de 60 anos o mas,2007-11-01,6,2,6,2,8
MONTEAGUDO,consulta externa,repetidas en personas de 60 anos o mas,2007-11-01,44,54,44,54,98
MONTERO,consulta externa,repetidas en personas de 60 anos o mas,2007-11-01,362,377,362,377,739
MORO MORO,consulta externa,repetidas en personas de 60 anos o mas,2007-11-01,0,1,0,1,1
MOROCHATA,consulta externa,repetidas en personas de 60 anos o mas,2007-11-01,12,12,12,12,24
NACEBE (SANTA ROSA DEL ABUNA),consulta externa,repetidas en personas de 60 anos o mas,2007-11-01,1,1,1,1,2
NAZACARA DE PACAJES,consulta externa,repetidas en personas de 60 anos o mas,2007-11-01,0,1,0,1,1
NUEVO MANOA (NUEVA ESPERANZA),consulta externa,repetidas en personas de 60 anos o mas,2007-11-01,3,0,3,0,3
OKINAWA,consulta externa,repetidas en personas de 60 anos o mas,2007-11-01,23,19,23,19,42
OMEREQUE,consulta externa,repetidas en personas de 60 anos o mas,2007-11-01,0,3,0,3,3
ORURO,consulta externa,repetidas en personas de 60 anos o mas,2007-11-01,1876,2144,1876,2144,4020
PADCAYA,consulta externa,repetidas en personas de 60 anos o mas,2007-11-01,6,18,6,18,24
PADILLA,consulta externa,repetidas en personas de 60 anos o mas,2007-11-01,28,40,28,40,68
PALCA,consulta externa,repetidas en personas de 60 anos o mas,2007-11-01,9,10,9,10,19
PALOS BLANCOS,consulta externa,repetidas en personas de 60 anos o mas,2007-11-01,2,1,2,1,3
PAMPA GRANDE,consulta externa,repetidas en personas de 60 anos o mas,2007-11-01,4,7,4,7,11
PAPEL PAMPA,consulta externa,repetidas en personas de 60 anos o mas,2007-11-01,1,0,1,0,1
PATACAMAYA,consulta externa,repetidas en personas de 60 anos o mas,2007-11-01,3,2,3,2,5
PAZÑA,consulta externa,repetidas en personas de 60 anos o mas,2007-11-01,9,12,9,12,21
POCOATA,consulta externa,repetidas en personas de 60 anos o mas,2007-11-01,1,1,1,1,2
POOPO,consulta externa,repetidas en personas de 60 anos o mas,2007-11-01,6,6,6,6,12
POROMA,consulta externa,repetidas en personas de 60 anos o mas,2007-11-01,8,7,8,7,15
PORTACHUELO,consulta externa,repetidas en personas de 60 anos o mas,2007-11-01,31,26,31,26,57
PORVENIR,consulta externa,repetidas en personas de 60 anos o mas,2007-11-01,3,1,3,1,4
POSTRER VALLE,consulta externa,repetidas en personas de 60 anos o mas,2007-11-01,6,5,6,5,11
POTOSI,consulta externa,repetidas en personas de 60 anos o mas,2007-11-01,1089,1341,1089,1341,2430
PRESTO,consulta externa,repetidas en personas de 60 anos o mas,2007-11-01,0,1,0,1,1
PUCARA,consulta externa,repetidas en personas de 60 anos o mas,2007-11-01,4,11,4,11,15
PUCARANI,consulta externa,repetidas en personas de 60 anos o mas,2007-11-01,1,3,1,3,4
PUERTO ACOSTA,consulta externa,repetidas en personas de 60 anos o mas,2007-11-01,32,16,32,16,48
PUERTO CARABUCO,consulta externa,repetidas en personas de 60 anos o mas,2007-11-01,3,5,3,5,8
PUERTO GONZALO MORENO,consulta externa,repetidas en personas de 60 anos o mas,2007-11-01,3,4,3,4,7
PUERTO PEREZ,consulta externa,repetidas en personas de 60 anos o mas,2007-11-01,1,4,1,4,5
PUERTO QUIJARRO,consulta externa,repetidas en personas de 60 anos o mas,2007-11-01,4,4,4,4,8
PUERTO RICO,consulta externa,repetidas en personas de 60 anos o mas,2007-11-01,5,0,5,0,5
PUERTO SUAREZ,consulta externa,repetidas en personas de 60 anos o mas,2007-11-01,8,7,8,7,15
PUERTO VILLARROEL,consulta externa,repetidas en personas de 60 anos o mas,2007-11-01,2,3,2,3,5
PUNA,consulta externa,repetidas en personas de 60 anos o mas,2007-11-01,12,14,12,14,26
PUNATA,consulta externa,repetidas en personas de 60 anos o mas,2007-11-01,66,103,66,103,169
QUIABAYA,consulta externa,repetidas en personas de 60 anos o mas,2007-11-01,1,0,1,0,1
QUILLACOLLO,consulta externa,repetidas en personas de 60 anos o mas,2007-11-01,299,431,299,431,730
QUIME,consulta externa,repetidas en personas de 60 anos o mas,2007-11-01,1,1,1,1,2
QUIRUSILLAS,consulta externa,repetidas en personas de 60 anos o mas,2007-11-01,5,14,5,14,19
RAVELO,consulta externa,repetidas en personas de 60 anos o mas,2007-11-01,1,2,1,2,3
REYES,consulta externa,repetidas en personas de 60 anos o mas,2007-11-01,73,70,73,70,143
RIBERALTA,consulta externa,repetidas en personas de 60 anos o mas,2007-11-01,141,18,141,18,159
ROBORE,consulta externa,repetidas en personas de 60 anos o mas,2007-11-01,19,23,19,23,42
RURRENABAQUE,consulta externa,repetidas en personas de 60 anos o mas,2007-11-01,62,75,62,75,137
SABAYA,consulta externa,repetidas en personas de 60 anos o mas,2007-11-01,4,0,4,0,4
SACABA,consulta externa,repetidas en personas de 60 anos o mas,2007-11-01,88,118,88,118,206
SACABAMBA,consulta externa,repetidas en personas de 60 anos o mas,2007-11-01,2,6,2,6,8
SACACA,consulta externa,repetidas en personas de 60 anos o mas,2007-11-01,0,2,0,2,2
SAIPINA,consulta externa,repetidas en personas de 60 anos o mas,2007-11-01,20,37,20,37,57
SALINAS DE GARCI MENDOZA,consulta externa,repetidas en personas de 60 anos o mas,2007-11-01,4,10,4,10,14
SAMAIPATA,consulta externa,repetidas en personas de 60 anos o mas,2007-11-01,1,8,1,8,9
SAN AGUSTIN,consulta externa,repetidas en personas de 60 anos o mas,2007-11-01,0,1,0,1,1
SAN ANDRES,consulta externa,repetidas en personas de 60 anos o mas,2007-11-01,2,2,2,2,4
SAN ANDRES DE MACHACA,consulta externa,repetidas en personas de 60 anos o mas,2007-11-01,4,7,4,7,11
SAN ANTONIO DE ESMORUCO,consulta externa,repetidas en personas de 60 anos o mas,2007-11-01,1,1,1,1,2
SAN ANTONIO DE LOMERIO,consulta externa,repetidas en personas de 60 anos o mas,2007-11-01,1,0,1,0,1
SAN BENITO,consulta externa,repetidas en personas de 60 anos o mas,2007-11-01,7,6,7,6,13
SAN BORJA,consulta externa,repetidas en personas de 60 anos o mas,2007-11-01,55,80,55,80,135
SAN BUENA VENTURA,consulta externa,repetidas en personas de 60 anos o mas,2007-11-01,6,5,6,5,11
SAN CARLOS,consulta externa,repetidas en personas de 60 anos o mas,2007-11-01,12,14,12,14,26
SAN IGNACIO,consulta externa,repetidas en personas de 60 anos o mas,2007-11-01,49,67,49,67,116
SAN IGNACIO DE VELASCO,consulta externa,repetidas en personas de 60 anos o mas,2007-11-01,73,78,73,78,151
SAN JAVIER(STC),consulta externa,repetidas en personas de 60 anos o mas,2007-11-01,1,3,1,3,4
SAN JOAQUIN,consulta externa,repetidas en personas de 60 anos o mas,2007-11-01,12,5,12,5,17
SAN JOSE DE CHIQUITOS,consulta externa,repetidas en personas de 60 anos o mas,2007-11-01,5,6,5,6,11
SAN JUAN DE YAPACANI,consulta externa,repetidas en personas de 60 anos o mas,2007-11-01,8,12,8,12,20
SAN JULIAN,consulta externa,repetidas en personas de 60 anos o mas,2007-11-01,2,3,2,3,5
SAN LORENZO(PND),consulta externa,repetidas en personas de 60 anos o mas,2007-11-01,1,0,1,0,1
SAN LORENZO(TJA),consulta externa,repetidas en personas de 60 anos o mas,2007-11-01,9,9,9,9,18
SAN LUCAS,consulta externa,repetidas en personas de 60 anos o mas,2007-11-01,28,47,28,47,75
SAN MATIAS,consulta externa,repetidas en personas de 60 anos o mas,2007-11-01,0,3,0,3,3
SAN MIGUEL DE VELASCO,consulta externa,repetidas en personas de 60 anos o mas,2007-11-01,40,54,40,54,94
SAN PABLO DE LIPEZ,consulta externa,repetidas en personas de 60 anos o mas,2007-11-01,3,2,3,2,5
SAN PEDRO,consulta externa,repetidas en personas de 60 anos o mas,2007-11-01,18,6,18,6,24
SAN PEDRO DE CURAHUARA,consulta externa,repetidas en personas de 60 anos o mas,2007-11-01,5,0,5,0,5
SAN PEDRO DE TIQUINA,consulta externa,repetidas en personas de 60 anos o mas,2007-11-01,4,4,4,4,8
SAN RAMON,consulta externa,repetidas en personas de 60 anos o mas,2007-11-01,4,33,4,33,37
SAN RAMON,consulta externa,repetidas en personas de 60 anos o mas,2007-11-01,30,38,30,38,68
SANTA ANA,consulta externa,repetidas en personas de 60 anos o mas,2007-11-01,51,68,51,68,119
SANTA CRUZ DE LA SIERRA,consulta externa,repetidas en personas de 60 anos o mas,2007-11-01,3244,5504,3244,5504,8748
SANTA ROSA DEL SARA,consulta externa,repetidas en personas de 60 anos o mas,2007-11-01,3,1,3,1,4
SANTIAGO DE CALLAPA,consulta externa,repetidas en personas de 60 anos o mas,2007-11-01,2,3,2,3,5
SANTIAGO DE HUARI,consulta externa,repetidas en personas de 60 anos o mas,2007-11-01,15,29,15,29,44
SANTIAGO DE MACHACA,consulta externa,repetidas en personas de 60 anos o mas,2007-11-01,0,1,0,1,1
SANTIVAÑES,consulta externa,repetidas en personas de 60 anos o mas,2007-11-01,8,9,8,9,17
SAPAHAQUI,consulta externa,repetidas en personas de 60 anos o mas,2007-11-01,1,1,1,1,2
SENA,consulta externa,repetidas en personas de 60 anos o mas,2007-11-01,2,3,2,3,5
SICA SICA (VILLA AROMA),consulta externa,repetidas en personas de 60 anos o mas,2007-11-01,1,2,1,2,3
SICAYA,consulta externa,repetidas en personas de 60 anos o mas,2007-11-01,4,7,4,7,11
SIPE SIPE,consulta externa,repetidas en personas de 60 anos o mas,2007-11-01,10,29,10,29,39
SOPACHUY,consulta externa,repetidas en personas de 60 anos o mas,2007-11-01,3,3,3,3,6
SORACACHI,consulta externa,repetidas en personas de 60 anos o mas,2007-11-01,2,1,2,1,3
SORATA,consulta externa,repetidas en personas de 60 anos o mas,2007-11-01,5,1,5,1,6
SUCRE,consulta externa,repetidas en personas de 60 anos o mas,2007-11-01,1539,2245,1539,2245,3784
TACACHI,consulta externa,repetidas en personas de 60 anos o mas,2007-11-01,4,3,4,3,7
TACOBAMBA,consulta externa,repetidas en personas de 60 anos o mas,2007-11-01,1,2,1,2,3
TAHUA,consulta externa,repetidas en personas de 60 anos o mas,2007-11-01,3,4,3,4,7
TAPACARI,consulta externa,repetidas en personas de 60 anos o mas,2007-11-01,1,3,1,3,4
TARABUCO,consulta externa,repetidas en personas de 60 anos o mas,2007-11-01,21,40,21,40,61
TARACO,consulta externa,repetidas en personas de 60 anos o mas,2007-11-01,0,1,0,1,1
TARATA,consulta externa,repetidas en personas de 60 anos o mas,2007-11-01,2,0,2,0,2
TARIJA,consulta externa,repetidas en personas de 60 anos o mas,2007-11-01,1936,2865,1936,2865,4801
TARVITA,consulta externa,repetidas en personas de 60 anos o mas,2007-11-01,0,12,0,12,12
TEOPONTE,consulta externa,repetidas en personas de 60 anos o mas,2007-11-01,4,1,4,1,5
TIAWANACU,consulta externa,repetidas en personas de 60 anos o mas,2007-11-01,2,1,2,1,3
TIQUIPAYA,consulta externa,repetidas en personas de 60 anos o mas,2007-11-01,10,16,10,16,26
TIRAQUE (CBBA),consulta externa,repetidas en personas de 60 anos o mas,2007-11-01,15,18,15,18,33
TITO YUPANQUI (PARQUIPUJIO),consulta externa,repetidas en personas de 60 anos o mas,2007-11-01,2,2,2,2,4
TOCO,consulta externa,repetidas en personas de 60 anos o mas,2007-11-01,1,2,1,2,3
TOLATA,consulta externa,repetidas en personas de 60 anos o mas,2007-11-01,1,1,1,1,2
TOLEDO,consulta externa,repetidas en personas de 60 anos o mas,2007-11-01,3,3,3,3,6
TOMAVE,consulta externa,repetidas en personas de 60 anos o mas,2007-11-01,1,2,1,2,3
TOMINA,consulta externa,repetidas en personas de 60 anos o mas,2007-11-01,2,3,2,3,5
TORO TORO,consulta externa,repetidas en personas de 60 anos o mas,2007-11-01,1,2,1,2,3
TOTORA(CBBA),consulta externa,repetidas en personas de 60 anos o mas,2007-11-01,3,8,3,8,11
TOTORA(ORR),consulta externa,repetidas en personas de 60 anos o mas,2007-11-01,1,12,1,12,13
TRIGAL,consulta externa,repetidas en personas de 60 anos o mas,2007-11-01,3,5,3,5,8
TRINIDAD,consulta externa,repetidas en personas de 60 anos o mas,2007-11-01,292,323,292,323,615
TUPIZA,consulta externa,repetidas en personas de 60 anos o mas,2007-11-01,63,72,63,72,135
UNCIA,consulta externa,repetidas en personas de 60 anos o mas,2007-11-01,43,77,43,77,120
URIONDO (A. CONCEPCION),consulta externa,repetidas en personas de 60 anos o mas,2007-11-01,2,12,2,12,14
UYUNI,consulta externa,repetidas en personas de 60 anos o mas,2007-11-01,47,50,47,50,97
VACAS,consulta externa,repetidas en personas de 60 anos o mas,2007-11-01,22,16,22,16,38
VALLEGRANDE,consulta externa,repetidas en personas de 60 anos o mas,2007-11-01,284,374,284,374,658
VIACHA,consulta externa,repetidas en personas de 60 anos o mas,2007-11-01,168,211,168,211,379
VILA VILA,consulta externa,repetidas en personas de 60 anos o mas,2007-11-01,0,1,0,1,1
VILLA MONTES,consulta externa,repetidas en personas de 60 anos o mas,2007-11-01,59,44,59,44,103
VILLA NUEVA (LOMA ALTA),consulta externa,repetidas en personas de 60 anos o mas,2007-11-01,4,2,4,2,6
VILLA RIVERO,consulta externa,repetidas en personas de 60 anos o mas,2007-11-01,1,1,1,1,2
VILLA SERRANO,consulta externa,repetidas en personas de 60 anos o mas,2007-11-01,0,4,0,4,4
VILLA TUNARI,consulta externa,repetidas en personas de 60 anos o mas,2007-11-01,72,67,72,67,139
VILLA VACA GUZMAN (MUYUPAMPA),consulta externa,repetidas en personas de 60 anos o mas,2007-11-01,0,5,0,5,5
VILLAZON,consulta externa,repetidas en personas de 60 anos o mas,2007-11-01,51,91,51,91,142
VINTO,consulta externa,repetidas en personas de 60 anos o mas,2007-11-01,23,42,23,42,65
VITICHI,consulta externa,repetidas en personas de 60 anos o mas,2007-11-01,10,13,10,13,23
WALDO BALLIVIAN,consulta externa,repetidas en personas de 60 anos o mas,2007-11-01,0,1,0,1,1
WARNES,consulta externa,repetidas en personas de 60 anos o mas,2007-11-01,13,26,13,26,39
YACO,consulta externa,repetidas en personas de 60 anos o mas,2007-11-01,5,1,5,1,6
YACUIBA,consulta externa,repetidas en personas de 60 anos o mas,2007-11-01,129,259,129,259,388
YAMPARAEZ,consulta externa,repetidas en personas de 60 anos o mas,2007-11-01,8,5,8,5,13
YANACACHI,consulta externa,repetidas en personas de 60 anos o mas,2007-11-01,2,0,2,0,2
YAPACANI,consulta externa,repetidas en personas de 60 anos o mas,2007-11-01,0,1,0,1,1
YOCALLA,consulta externa,repetidas en personas de 60 anos o mas,2007-11-01,2,2,2,2,4
YOTALA,consulta externa,repetidas en personas de 60 anos o mas,2007-11-01,8,3,8,3,11
YUNCHARA,consulta externa,repetidas en personas de 60 anos o mas,2007-11-01,3,2,3,2,5
ZUDAÑEZ,consulta externa,repetidas en personas de 60 anos o mas,2007-11-01,5,6,5,6,11
ACHACACHI,consulta externa,repetidas en personas de 60 anos o mas,2007-12-01,15,29,15,29,44
ACHOCALLA,consulta externa,repetidas en personas de 60 anos o mas,2007-12-01,0,1,0,1,1
AIQUILE,consulta externa,repetidas en personas de 60 anos o mas,2007-12-01,26,38,26,38,64
ALCALA,consulta externa,repetidas en personas de 60 anos o mas,2007-12-01,1,1,1,1,2
ANCORAIMES,consulta externa,repetidas en personas de 60 anos o mas,2007-12-01,9,6,9,6,15
ANDAMARCA,consulta externa,repetidas en personas de 60 anos o mas,2007-12-01,1,1,1,1,2
ANTEQUERA,consulta externa,repetidas en personas de 60 anos o mas,2007-12-01,2,3,2,3,5
APOLO,consulta externa,repetidas en personas de 60 anos o mas,2007-12-01,6,5,6,5,11
ARANI,consulta externa,repetidas en personas de 60 anos o mas,2007-12-01,0,2,0,2,2
ARBIETO,consulta externa,repetidas en personas de 60 anos o mas,2007-12-01,5,10,5,10,15
ARQUE,consulta externa,repetidas en personas de 60 anos o mas,2007-12-01,0,2,0,2,2
ASCENCION DE GUARAYOS,consulta externa,repetidas en personas de 60 anos o mas,2007-12-01,1,3,1,3,4
ATOCHA,consulta externa,repetidas en personas de 60 anos o mas,2007-12-01,16,41,16,41,57
AUCAPATA,consulta externa,repetidas en personas de 60 anos o mas,2007-12-01,1,0,1,0,1
AYO AYO,consulta externa,repetidas en personas de 60 anos o mas,2007-12-01,0,2,0,2,2
AYOPAYA (V. DE INDEPENDENCIA),consulta externa,repetidas en personas de 60 anos o mas,2007-12-01,1,3,1,3,4
AZURDUY,consulta externa,repetidas en personas de 60 anos o mas,2007-12-01,0,1,0,1,1
BAURES,consulta externa,repetidas en personas de 60 anos o mas,2007-12-01,0,3,0,3,3
BELEN DE ANDAMARCA,consulta externa,repetidas en personas de 60 anos o mas,2007-12-01,2,0,2,0,2
BELEN DE URMIRI,consulta externa,repetidas en personas de 60 anos o mas,2007-12-01,1,0,1,0,1
BERMEJO,consulta externa,repetidas en personas de 60 anos o mas,2007-12-01,162,39,162,39,201
BETANZOS,consulta externa,repetidas en personas de 60 anos o mas,2007-12-01,37,49,37,49,86
BOLIVAR,consulta externa,repetidas en personas de 60 anos o mas,2007-12-01,0,4,0,4,4
BOLPEBRA,consulta externa,repetidas en personas de 60 anos o mas,2007-12-01,1,0,1,0,1
BOYUIBE,consulta externa,repetidas en personas de 60 anos o mas,2007-12-01,2,8,2,8,10
BUENA VISTA,consulta externa,repetidas en personas de 60 anos o mas,2007-12-01,18,15,18,15,33
CABEZAS,consulta externa,repetidas en personas de 60 anos o mas,2007-12-01,0,1,0,1,1
CAIROMA,consulta externa,repetidas en personas de 60 anos o mas,2007-12-01,13,2,13,2,15
"CAIZA ""D""",consulta externa,repetidas en personas de 60 anos o mas,2007-12-01,0,11,0,11,11
CAJUATA,consulta externa,repetidas en personas de 60 anos o mas,2007-12-01,2,2,2,2,4
CALACOTO,consulta externa,repetidas en personas de 60 anos o mas,2007-12-01,20,33,20,33,53
CALAMARCA,consulta externa,repetidas en personas de 60 anos o mas,2007-12-01,2,4,2,4,6
CAMARGO,consulta externa,repetidas en personas de 60 anos o mas,2007-12-01,19,35,19,35,54
CAMATAQUI (C. VILLA ABECIA),consulta externa,repetidas en personas de 60 anos o mas,2007-12-01,3,2,3,2,5
CAMIRI,consulta externa,repetidas en personas de 60 anos o mas,2007-12-01,53,115,53,115,168
CAPINOTA,consulta externa,repetidas en personas de 60 anos o mas,2007-12-01,27,23,27,23,50
CAQUIAVIRI,consulta externa,repetidas en personas de 60 anos o mas,2007-12-01,0,2,0,2,2
CARACOLLO,consulta externa,repetidas en personas de 60 anos o mas,2007-12-01,11,8,11,8,19
CARANAVI,consulta externa,repetidas en personas de 60 anos o mas,2007-12-01,28,18,28,18,46
CARAPARI,consulta externa,repetidas en personas de 60 anos o mas,2007-12-01,2,7,2,7,9
CATACORA,consulta externa,repetidas en personas de 60 anos o mas,2007-12-01,6,4,6,4,10
CHALLAPATA,consulta externa,repetidas en personas de 60 anos o mas,2007-12-01,56,47,56,47,103
CHAQUI,consulta externa,repetidas en personas de 60 anos o mas,2007-12-01,1,3,1,3,4
CHARAGUA,consulta externa,repetidas en personas de 60 anos o mas,2007-12-01,4,1,4,1,5
CHAYANTA,consulta externa,repetidas en personas de 60 anos o mas,2007-12-01,0,1,0,1,1
CHOQUE COTA,consulta externa,repetidas en personas de 60 anos o mas,2007-12-01,1,2,1,2,3
CHULUMANI (V. DE LA LIBERTAD),consulta externa,repetidas en personas de 60 anos o mas,2007-12-01,22,21,22,21,43
CHUMA,consulta externa,repetidas en personas de 60 anos o mas,2007-12-01,2,10,2,10,12
CLIZA,consulta externa,repetidas en personas de 60 anos o mas,2007-12-01,4,7,4,7,11
COBIJA,consulta externa,repetidas en personas de 60 anos o mas,2007-12-01,124,163,124,163,287
COCHABAMBA,consulta externa,repetidas en personas de 60 anos o mas,2007-12-01,5421,7281,5421,7281,12702
COLCAPIRHUA,consulta externa,repetidas en personas de 60 anos o mas,2007-12-01,46,77,46,77,123
"COLCHA ""K""",consulta externa,repetidas en personas de 60 anos o mas,2007-12-01,5,3,5,3,8
COLLANA,consulta externa,repetidas en personas de 60 anos o mas,2007-12-01,3,3,3,3,6
COLOMI,consulta externa,repetidas en personas de 60 anos o mas,2007-12-01,0,1,0,1,1
COLPA BELGICA,consulta externa,repetidas en personas de 60 anos o mas,2007-12-01,19,14,19,14,33
COLQUECHACA,consulta externa,repetidas en personas de 60 anos o mas,2007-12-01,0,1,0,1,1
COLQUENCHA,consulta externa,repetidas en personas de 60 anos o mas,2007-12-01,1,1,1,1,2
COLQUIRI,consulta externa,repetidas en personas de 60 anos o mas,2007-12-01,10,1,10,1,11
COMANCHE,consulta externa,repetidas en personas de 60 anos o mas,2007-12-01,2,1,2,1,3
COMARAPA,consulta externa,repetidas en personas de 60 anos o mas,2007-12-01,22,22,22,22,44
CONCEPCION,consulta externa,repetidas en personas de 60 anos o mas,2007-12-01,3,0,3,0,3
COPACABANA,consulta externa,repetidas en personas de 60 anos o mas,2007-12-01,0,1,0,1,1
CORIPATA,consulta externa,repetidas en personas de 60 anos o mas,2007-12-01,2,0,2,0,2
CORO CORO,consulta externa,repetidas en personas de 60 anos o mas,2007-12-01,2,3,2,3,5
COROICO,consulta externa,repetidas en personas de 60 anos o mas,2007-12-01,61,67,61,67,128
CORQUE,consulta externa,repetidas en personas de 60 anos o mas,2007-12-01,8,10,8,10,18
COTAGAITA,consulta externa,repetidas en personas de 60 anos o mas,2007-12-01,8,14,8,14,22
COTOCA,consulta externa,repetidas en personas de 60 anos o mas,2007-12-01,31,26,31,26,57
CUATRO CAÑADAS,consulta externa,repetidas en personas de 60 anos o mas,2007-12-01,22,27,22,27,49
CUCHUMUELA (V. G. VILLARROEL),consulta externa,repetidas en personas de 60 anos o mas,2007-12-01,0,1,0,1,1
CUEVO,consulta externa,repetidas en personas de 60 anos o mas,2007-12-01,7,8,7,8,15
CULPINA,consulta externa,repetidas en personas de 60 anos o mas,2007-12-01,2,1,2,1,3
CURAHUARA DE CARANGAS,consulta externa,repetidas en personas de 60 anos o mas,2007-12-01,0,1,0,1,1
CURVA,consulta externa,repetidas en personas de 60 anos o mas,2007-12-01,0,1,0,1,1
DESAGUADERO,consulta externa,repetidas en personas de 60 anos o mas,2007-12-01,3,0,3,0,3
EL ALTO,consulta externa,repetidas en personas de 60 anos o mas,2007-12-01,1283,1400,1283,1400,2683
EL CHORO,consulta externa,repetidas en personas de 60 anos o mas,2007-12-01,0,3,0,3,3
EL PUENTE(STC),consulta externa,repetidas en personas de 60 anos o mas,2007-12-01,0,4,0,4,4
EL PUENTE(TJA),consulta externa,repetidas en personas de 60 anos o mas,2007-12-01,4,7,4,7,11
EL TORNO,consulta externa,repetidas en personas de 60 anos o mas,2007-12-01,42,41,42,41,83
EL VILLAR,consulta externa,repetidas en personas de 60 anos o mas,2007-12-01,0,3,0,3,3
ENTRE RIOS,consulta externa,repetidas en personas de 60 anos o mas,2007-12-01,5,3,5,3,8
EUCALIPTUS,consulta externa,repetidas en personas de 60 anos o mas,2007-12-01,6,0,6,0,6
FERNANDEZ ALONSO,consulta externa,repetidas en personas de 60 anos o mas,2007-12-01,1,1,1,1,2
FILADELFIA,consulta externa,repetidas en personas de 60 anos o mas,2007-12-01,3,2,3,2,5
GRAL. J.J. PEREZ (CHARAZANI),consulta externa,repetidas en personas de 60 anos o mas,2007-12-01,1,3,1,3,4
GUANAY,consulta externa,repetidas en personas de 60 anos o mas,2007-12-01,22,25,22,25,47
GUAQUI,consulta externa,repetidas en personas de 60 anos o mas,2007-12-01,12,6,12,6,18
GUAYARAMERIN,consulta externa,repetidas en personas de 60 anos o mas,2007-12-01,741,1086,741,1086,1827
GUTIERREZ,consulta externa,repetidas en personas de 60 anos o mas,2007-12-01,11,5,11,5,16
HUACARETA,consulta externa,repetidas en personas de 60 anos o mas,2007-12-01,9,7,9,7,16
HUACHACALLA,consulta externa,repetidas en personas de 60 anos o mas,2007-12-01,8,3,8,3,11
HUANUNI,consulta externa,repetidas en personas de 60 anos o mas,2007-12-01,117,108,117,108,225
HUARACAJE,consulta externa,repetidas en personas de 60 anos o mas,2007-12-01,2,0,2,0,2
HUAYLLAMARCA,consulta externa,repetidas en personas de 60 anos o mas,2007-12-01,1,2,1,2,3
ICHOCA,consulta externa,repetidas en personas de 60 anos o mas,2007-12-01,0,2,0,2,2
ICLA,consulta externa,repetidas en personas de 60 anos o mas,2007-12-01,0,1,0,1,1
INGAVI (HUMAITA),consulta externa,repetidas en personas de 60 anos o mas,2007-12-01,1,1,1,1,2
INQUISIVI,consulta externa,repetidas en personas de 60 anos o mas,2007-12-01,1,0,1,0,1
IRUPANA (VILLA DE LANZA),consulta externa,repetidas en personas de 60 anos o mas,2007-12-01,3,4,3,4,7
IXIAMAS,consulta externa,repetidas en personas de 60 anos o mas,2007-12-01,0,1,0,1,1
JESUS DE MACHACA,consulta externa,repetidas en personas de 60 anos o mas,2007-12-01,24,31,24,31,55
LA ASUNTA,consulta externa,repetidas en personas de 60 anos o mas,2007-12-01,1,2,1,2,3
LA GUARDIA,consulta externa,repetidas en personas de 60 anos o mas,2007-12-01,14,8,14,8,22
LA PAZ,consulta externa,repetidas en personas de 60 anos o mas,2007-12-01,8990,13558,8990,13558,22548
LAGUNILLAS,consulta externa,repetidas en personas de 60 anos o mas,2007-12-01,1,2,1,2,3
LAJA,consulta externa,repetidas en personas de 60 anos o mas,2007-12-01,11,7,11,7,18
LAS CARRERAS,consulta externa,repetidas en personas de 60 anos o mas,2007-12-01,3,1,3,1,4
LICOMA PAMPA,consulta externa,repetidas en personas de 60 anos o mas,2007-12-01,1,1,1,1,2
LLALLAGUA,consulta externa,repetidas en personas de 60 anos o mas,2007-12-01,1,5,1,5,6
LLICA,consulta externa,repetidas en personas de 60 anos o mas,2007-12-01,1,3,1,3,4
LORETO,consulta externa,repetidas en personas de 60 anos o mas,2007-12-01,2,2,2,2,4
LURIBAY,consulta externa,repetidas en personas de 60 anos o mas,2007-12-01,7,6,7,6,13
MACHACAMARCA,consulta externa,repetidas en personas de 60 anos o mas,2007-12-01,5,10,5,10,15
MACHARETI,consulta externa,repetidas en personas de 60 anos o mas,2007-12-01,2,4,2,4,6
MAGDALENA,consulta externa,repetidas en personas de 60 anos o mas,2007-12-01,30,35,30,35,65
MAPIRI,consulta externa,repetidas en personas de 60 anos o mas,2007-12-01,0,3,0,3,3
MECAPACA,consulta externa,repetidas en personas de 60 anos o mas,2007-12-01,6,4,6,4,10
MIZQUE,consulta externa,repetidas en personas de 60 anos o mas,2007-12-01,1,6,1,6,7
MOCOMOCO,consulta externa,repetidas en personas de 60 anos o mas,2007-12-01,0,1,0,1,1
MOJINETE,consulta externa,repetidas en personas de 60 anos o mas,2007-12-01,0,1,0,1,1
MOJOCOYA,consulta externa,repetidas en personas de 60 anos o mas,2007-12-01,4,3,4,3,7
MONTEAGUDO,consulta externa,repetidas en personas de 60 anos o mas,2007-12-01,84,109,84,109,193
MONTERO,consulta externa,repetidas en personas de 60 anos o mas,2007-12-01,561,618,561,618,1179
MORO MORO,consulta externa,repetidas en personas de 60 anos o mas,2007-12-01,5,4,5,4,9
MOROCHATA,consulta externa,repetidas en personas de 60 anos o mas,2007-12-01,12,16,12,16,28
NACEBE (SANTA ROSA DEL ABUNA),consulta externa,repetidas en personas de 60 anos o mas,2007-12-01,1,5,1,5,6
OCURI,consulta externa,repetidas en personas de 60 anos o mas,2007-12-01,0,6,0,6,6
OKINAWA,consulta externa,repetidas en personas de 60 anos o mas,2007-12-01,4,6,4,6,10
OMEREQUE,consulta externa,repetidas en personas de 60 anos o mas,2007-12-01,4,3,4,3,7
ORURO,consulta externa,repetidas en personas de 60 anos o mas,2007-12-01,1703,2028,1703,2028,3731
PADCAYA,consulta externa,repetidas en personas de 60 anos o mas,2007-12-01,12,10,12,10,22
PADILLA,consulta externa,repetidas en personas de 60 anos o mas,2007-12-01,19,31,19,31,50
PALCA,consulta externa,repetidas en personas de 60 anos o mas,2007-12-01,10,4,10,4,14
PALOS BLANCOS,consulta externa,repetidas en personas de 60 anos o mas,2007-12-01,1,1,1,1,2
PAMPA GRANDE,consulta externa,repetidas en personas de 60 anos o mas,2007-12-01,0,1,0,1,1
PAPEL PAMPA,consulta externa,repetidas en personas de 60 anos o mas,2007-12-01,2,1,2,1,3
PATACAMAYA,consulta externa,repetidas en personas de 60 anos o mas,2007-12-01,0,1,0,1,1
PAZÑA,consulta externa,repetidas en personas de 60 anos o mas,2007-12-01,13,9,13,9,22
POCONA,consulta externa,repetidas en personas de 60 anos o mas,2007-12-01,2,2,2,2,4
POOPO,consulta externa,repetidas en personas de 60 anos o mas,2007-12-01,7,4,7,4,11
PORCO,consulta externa,repetidas en personas de 60 anos o mas,2007-12-01,0,2,0,2,2
POROMA,consulta externa,repetidas en personas de 60 anos o mas,2007-12-01,2,0,2,0,2
PORTACHUELO,consulta externa,repetidas en personas de 60 anos o mas,2007-12-01,12,16,12,16,28
PORVENIR,consulta externa,repetidas en personas de 60 anos o mas,2007-12-01,1,1,1,1,2
POSTRER VALLE,consulta externa,repetidas en personas de 60 anos o mas,2007-12-01,3,0,3,0,3
POTOSI,consulta externa,repetidas en personas de 60 anos o mas,2007-12-01,942,1111,942,1111,2053
PUCARA,consulta externa,repetidas en personas de 60 anos o mas,2007-12-01,2,12,2,12,14
PUCARANI,consulta externa,repetidas en personas de 60 anos o mas,2007-12-01,7,1,7,1,8
PUERTO ACOSTA,consulta externa,repetidas en personas de 60 anos o mas,2007-12-01,23,16,23,16,39
PUERTO CARABUCO,consulta externa,repetidas en personas de 60 anos o mas,2007-12-01,2,7,2,7,9
PUERTO GONZALO MORENO,consulta externa,repetidas en personas de 60 anos o mas,2007-12-01,4,0,4,0,4
PUERTO PEREZ,consulta externa,repetidas en personas de 60 anos o mas,2007-12-01,3,3,3,3,6
PUERTO QUIJARRO,consulta externa,repetidas en personas de 60 anos o mas,2007-12-01,6,2,6,2,8
PUERTO RICO,consulta externa,repetidas en personas de 60 anos o mas,2007-12-01,1,1,1,1,2
PUERTO SUAREZ,consulta externa,repetidas en personas de 60 anos o mas,2007-12-01,17,12,17,12,29
PUERTO VILLARROEL,consulta externa,repetidas en personas de 60 anos o mas,2007-12-01,4,2,4,2,6
PUNA,consulta externa,repetidas en personas de 60 anos o mas,2007-12-01,13,12,13,12,25
PUNATA,consulta externa,repetidas en personas de 60 anos o mas,2007-12-01,77,100,77,100,177
QUILLACOLLO,consulta externa,repetidas en personas de 60 anos o mas,2007-12-01,281,359,281,359,640
QUIRUSILLAS,consulta externa,repetidas en personas de 60 anos o mas,2007-12-01,2,1,2,1,3
REYES,consulta externa,repetidas en personas de 60 anos o mas,2007-12-01,91,47,91,47,138
RIBERALTA,consulta externa,repetidas en personas de 60 anos o mas,2007-12-01,2,5,2,5,7
ROBORE,consulta externa,repetidas en personas de 60 anos o mas,2007-12-01,27,16,27,16,43
RURRENABAQUE,consulta externa,repetidas en personas de 60 anos o mas,2007-12-01,71,73,71,73,144
SABAYA,consulta externa,repetidas en personas de 60 anos o mas,2007-12-01,0,2,0,2,2
SACABA,consulta externa,repetidas en personas de 60 anos o mas,2007-12-01,63,105,63,105,168
SACABAMBA,consulta externa,repetidas en personas de 60 anos o mas,2007-12-01,0,5,0,5,5
SACACA,consulta externa,repetidas en personas de 60 anos o mas,2007-12-01,0,1,0,1,1
SAIPINA,consulta externa,repetidas en personas de 60 anos o mas,2007-12-01,0,5,0,5,5
SALINAS DE GARCI MENDOZA,consulta externa,repetidas en personas de 60 anos o mas,2007-12-01,4,7,4,7,11
SAN AGUSTIN,consulta externa,repetidas en personas de 60 anos o mas,2007-12-01,1,0,1,0,1
SAN ANDRES DE MACHACA,consulta externa,repetidas en personas de 60 anos o mas,2007-12-01,3,4,3,4,7
SAN ANTONIO DE LOMERIO,consulta externa,repetidas en personas de 60 anos o mas,2007-12-01,1,1,1,1,2
SAN BENITO,consulta externa,repetidas en personas de 60 anos o mas,2007-12-01,4,4,4,4,8
SAN BORJA,consulta externa,repetidas en personas de 60 anos o mas,2007-12-01,37,52,37,52,89
SAN BUENA VENTURA,consulta externa,repetidas en personas de 60 anos o mas,2007-12-01,1,3,1,3,4
SAN CARLOS,consulta externa,repetidas en personas de 60 anos o mas,2007-12-01,6,8,6,8,14
SAN IGNACIO,consulta externa,repetidas en personas de 60 anos o mas,2007-12-01,42,38,42,38,80
SAN IGNACIO DE VELASCO,consulta externa,repetidas en personas de 60 anos o mas,2007-12-01,39,41,39,41,80
SAN JAVIER(STC),consulta externa,repetidas en personas de 60 anos o mas,2007-12-01,3,10,3,10,13
SAN JOAQUIN,consulta externa,repetidas en personas de 60 anos o mas,2007-12-01,14,7,14,7,21
SAN JOSE DE CHIQUITOS,consulta externa,repetidas en personas de 60 anos o mas,2007-12-01,5,7,5,7,12
SAN JUAN DE YAPACANI,consulta externa,repetidas en personas de 60 anos o mas,2007-12-01,11,5,11,5,16
SAN JULIAN,consulta externa,repetidas en personas de 60 anos o mas,2007-12-01,3,11,3,11,14
SAN LORENZO(PND),consulta externa,repetidas en personas de 60 anos o mas,2007-12-01,0,1,0,1,1
SAN LORENZO(TJA),consulta externa,repetidas en personas de 60 anos o mas,2007-12-01,1,3,1,3,4
SAN LUCAS,consulta externa,repetidas en personas de 60 anos o mas,2007-12-01,20,31,20,31,51
SAN MIGUEL DE VELASCO,consulta externa,repetidas en personas de 60 anos o mas,2007-12-01,37,78,37,78,115
SAN PABLO DE LIPEZ,consulta externa,repetidas en personas de 60 anos o mas,2007-12-01,1,11,1,11,12
SAN PEDRO,consulta externa,repetidas en personas de 60 anos o mas,2007-12-01,8,9,8,9,17
SAN PEDRO DE BUENA VISTA,consulta externa,repetidas en personas de 60 anos o mas,2007-12-01,1,0,1,0,1
SAN PEDRO DE CURAHUARA,consulta externa,repetidas en personas de 60 anos o mas,2007-12-01,4,7,4,7,11
SAN PEDRO DE TIQUINA,consulta externa,repetidas en personas de 60 anos o mas,2007-12-01,3,7,3,7,10
SAN RAFAEL,consulta externa,repetidas en personas de 60 anos o mas,2007-12-01,0,1,0,1,1
SAN RAMON,consulta externa,repetidas en personas de 60 anos o mas,2007-12-01,17,27,17,27,44
SAN RAMON,consulta externa,repetidas en personas de 60 anos o mas,2007-12-01,7,46,7,46,53
SANTA ANA,consulta externa,repetidas en personas de 60 anos o mas,2007-12-01,43,48,43,48,91
SANTA CRUZ DE LA SIERRA,consulta externa,repetidas en personas de 60 anos o mas,2007-12-01,3569,5400,3569,5400,8969
SANTA ROSA DEL SARA,consulta externa,repetidas en personas de 60 anos o mas,2007-12-01,3,3,3,3,6
SANTIAGO DE CALLAPA,consulta externa,repetidas en personas de 60 anos o mas,2007-12-01,0,3,0,3,3
SANTIAGO DE HUARI,consulta externa,repetidas en personas de 60 anos o mas,2007-12-01,1,8,1,8,9
SANTIAGO DE MACHACA,consulta externa,repetidas en personas de 60 anos o mas,2007-12-01,1,2,1,2,3
SANTIVAÑES,consulta externa,repetidas en personas de 60 anos o mas,2007-12-01,1,0,1,0,1
SAPAHAQUI,consulta externa,repetidas en personas de 60 anos o mas,2007-12-01,3,0,3,0,3
SICA SICA (VILLA AROMA),consulta externa,repetidas en personas de 60 anos o mas,2007-12-01,0,2,0,2,2
SICAYA,consulta externa,repetidas en personas de 60 anos o mas,2007-12-01,0,1,0,1,1
SIPE SIPE,consulta externa,repetidas en personas de 60 anos o mas,2007-12-01,4,17,4,17,21
SORACACHI,consulta externa,repetidas en personas de 60 anos o mas,2007-12-01,0,1,0,1,1
SUCRE,consulta externa,repetidas en personas de 60 anos o mas,2007-12-01,1202,1585,1202,1585,2787
TACACHI,consulta externa,repetidas en personas de 60 anos o mas,2007-12-01,0,1,0,1,1
TACOBAMBA,consulta externa,repetidas en personas de 60 anos o mas,2007-12-01,0,1,0,1,1
TACOPAYA,consulta externa,repetidas en personas de 60 anos o mas,2007-12-01,0,1,0,1,1
TAPACARI,consulta externa,repetidas en personas de 60 anos o mas,2007-12-01,0,1,0,1,1
TARABUCO,consulta externa,repetidas en personas de 60 anos o mas,2007-12-01,23,34,23,34,57
TARACO,consulta externa,repetidas en personas de 60 anos o mas,2007-12-01,1,0,1,0,1
TARATA,consulta externa,repetidas en personas de 60 anos o mas,2007-12-01,1,4,1,4,5
TARIJA,consulta externa,repetidas en personas de 60 anos o mas,2007-12-01,1999,2246,1999,2246,4245
TARVITA,consulta externa,repetidas en personas de 60 anos o mas,2007-12-01,1,3,1,3,4
TEOPONTE,consulta externa,repetidas en personas de 60 anos o mas,2007-12-01,12,5,12,5,17
TIPUANI,consulta externa,repetidas en personas de 60 anos o mas,2007-12-01,1,0,1,0,1
TIQUIPAYA,consulta externa,repetidas en personas de 60 anos o mas,2007-12-01,8,15,8,15,23
TIRAQUE (CBBA),consulta externa,repetidas en personas de 60 anos o mas,2007-12-01,11,9,11,9,20
TITO YUPANQUI (PARQUIPUJIO),consulta externa,repetidas en personas de 60 anos o mas,2007-12-01,4,4,4,4,8
TOCO,consulta externa,repetidas en personas de 60 anos o mas,2007-12-01,1,2,1,2,3
TODOS SANTOS,consulta externa,repetidas en personas de 60 anos o mas,2007-12-01,0,2,0,2,2
TOLATA,consulta externa,repetidas en personas de 60 anos o mas,2007-12-01,0,1,0,1,1
TOLEDO,consulta externa,repetidas en personas de 60 anos o mas,2007-12-01,2,3,2,3,5
TOMAVE,consulta externa,repetidas en personas de 60 anos o mas,2007-12-01,6,4,6,4,10
TOMINA,consulta externa,repetidas en personas de 60 anos o mas,2007-12-01,6,2,6,2,8
TORO TORO,consulta externa,repetidas en personas de 60 anos o mas,2007-12-01,0,1,0,1,1
TOTORA(CBBA),consulta externa,repetidas en personas de 60 anos o mas,2007-12-01,0,3,0,3,3
TRIGAL,consulta externa,repetidas en personas de 60 anos o mas,2007-12-01,4,3,4,3,7
TRINIDAD,consulta externa,repetidas en personas de 60 anos o mas,2007-12-01,416,362,416,362,778
TUPIZA,consulta externa,repetidas en personas de 60 anos o mas,2007-12-01,50,60,50,60,110
UYUNI,consulta externa,repetidas en personas de 60 anos o mas,2007-12-01,57,46,57,46,103
VACAS,consulta externa,repetidas en personas de 60 anos o mas,2007-12-01,16,16,16,16,32
VALLEGRANDE,consulta externa,repetidas en personas de 60 anos o mas,2007-12-01,244,270,244,270,514
VIACHA,consulta externa,repetidas en personas de 60 anos o mas,2007-12-01,166,173,166,173,339
VILLA MONTES,consulta externa,repetidas en personas de 60 anos o mas,2007-12-01,68,55,68,55,123
VILLA NUEVA (LOMA ALTA),consulta externa,repetidas en personas de 60 anos o mas,2007-12-01,1,1,1,1,2
VILLA RIVERO,consulta externa,repetidas en personas de 60 anos o mas,2007-12-01,1,2,1,2,3
VILLA SERRANO,consulta externa,repetidas en personas de 60 anos o mas,2007-12-01,1,2,1,2,3
VILLA TUNARI,consulta externa,repetidas en personas de 60 anos o mas,2007-12-01,49,30,49,30,79
VILLA VACA GUZMAN (MUYUPAMPA),consulta externa,repetidas en personas de 60 anos o mas,2007-12-01,2,2,2,2,4
VILLAZON,consulta externa,repetidas en personas de 60 anos o mas,2007-12-01,26,53,26,53,79
VINTO,consulta externa,repetidas en personas de 60 anos o mas,2007-12-01,7,8,7,8,15
VITICHI,consulta externa,repetidas en personas de 60 anos o mas,2007-12-01,5,9,5,9,14
WARNES,consulta externa,repetidas en personas de 60 anos o mas,2007-12-01,11,21,11,21,32
YACO,consulta externa,repetidas en personas de 60 anos o mas,2007-12-01,1,4,1,4,5
YACUIBA,consulta externa,repetidas en personas de 60 anos o mas,2007-12-01,166,245,166,245,411
YAMPARAEZ,consulta externa,repetidas en personas de 60 anos o mas,2007-12-01,7,11,7,11,18
YANACACHI,consulta externa,repetidas en personas de 60 anos o mas,2007-12-01,2,1,2,1,3
YAPACANI,consulta externa,repetidas en personas de 60 anos o mas,2007-12-01,8,3,8,3,11
YOCALLA,consulta externa,repetidas en personas de 60 anos o mas,2007-12-01,1,2,1,2,3
YOTALA,consulta externa,repetidas en personas de 60 anos o mas,2007-12-01,7,14,7,14,21
YUNCHARA,consulta externa,repetidas en personas de 60 anos o mas,2007-12-01,4,0,4,0,4
ZUDAÑEZ,consulta externa,repetidas en personas de 60 anos o mas,2007-12-01,0,1,0,1,1
