municipality,group,variable,month,Implante subdérmico: Usuarias Nuevas,Implante subdérmico: Usuarias Nuevas1,Implante subdérmico: Usuarias Nuevas2,Implante subdérmico: Usuarias Nuevas3,Implante subdérmico: Usuarias Nuevas4,TOTAL
ACHACACHI,"anticoncepcion, prevencion de its y de cancer de cuello uterino",implante subdermico: usuarias nuevas,2016-01-01,0,0,0,1,0,1
ACHOCALLA,"anticoncepcion, prevencion de its y de cancer de cuello uterino",implante subdermico: usuarias nuevas,2016-01-01,0,0,10,0,1,11
AIQUILE,"anticoncepcion, prevencion de its y de cancer de cuello uterino",implante subdermico: usuarias nuevas,2016-01-01,0,5,19,3,0,27
ALTO BENI,"anticoncepcion, prevencion de its y de cancer de cuello uterino",implante subdermico: usuarias nuevas,2016-01-01,0,0,4,1,0,5
ANTEQUERA,"anticoncepcion, prevencion de its y de cancer de cuello uterino",implante subdermico: usuarias nuevas,2016-01-01,0,0,4,2,0,6
APOLO,"anticoncepcion, prevencion de its y de cancer de cuello uterino",implante subdermico: usuarias nuevas,2016-01-01,1,2,3,4,0,10
ATOCHA,"anticoncepcion, prevencion de its y de cancer de cuello uterino",implante subdermico: usuarias nuevas,2016-01-01,0,1,4,1,0,6
AYATA,"anticoncepcion, prevencion de its y de cancer de cuello uterino",implante subdermico: usuarias nuevas,2016-01-01,0,1,2,2,0,5
AYOPAYA (V. DE INDEPENDENCIA),"anticoncepcion, prevencion de its y de cancer de cuello uterino",implante subdermico: usuarias nuevas,2016-01-01,0,1,13,2,0,16
BELLA FLOR,"anticoncepcion, prevencion de its y de cancer de cuello uterino",implante subdermico: usuarias nuevas,2016-01-01,0,0,1,0,0,1
BETANZOS,"anticoncepcion, prevencion de its y de cancer de cuello uterino",implante subdermico: usuarias nuevas,2016-01-01,0,1,1,0,0,2
BOLIVAR,"anticoncepcion, prevencion de its y de cancer de cuello uterino",implante subdermico: usuarias nuevas,2016-01-01,0,0,1,0,0,1
CAMARGO,"anticoncepcion, prevencion de its y de cancer de cuello uterino",implante subdermico: usuarias nuevas,2016-01-01,0,1,4,2,0,7
CAPINOTA,"anticoncepcion, prevencion de its y de cancer de cuello uterino",implante subdermico: usuarias nuevas,2016-01-01,0,1,6,1,0,8
CARACOLLO,"anticoncepcion, prevencion de its y de cancer de cuello uterino",implante subdermico: usuarias nuevas,2016-01-01,0,3,1,0,0,4
CARAPARI,"anticoncepcion, prevencion de its y de cancer de cuello uterino",implante subdermico: usuarias nuevas,2016-01-01,0,1,0,0,0,1
CHALLAPATA,"anticoncepcion, prevencion de its y de cancer de cuello uterino",implante subdermico: usuarias nuevas,2016-01-01,0,1,3,0,0,4
CHULUMANI (V. DE LA LIBERTAD),"anticoncepcion, prevencion de its y de cancer de cuello uterino",implante subdermico: usuarias nuevas,2016-01-01,0,0,2,0,0,2
CKOCHAS,"anticoncepcion, prevencion de its y de cancer de cuello uterino",implante subdermico: usuarias nuevas,2016-01-01,0,1,7,1,0,9
COBIJA,"anticoncepcion, prevencion de its y de cancer de cuello uterino",implante subdermico: usuarias nuevas,2016-01-01,3,7,7,0,0,17
COCHABAMBA,"anticoncepcion, prevencion de its y de cancer de cuello uterino",implante subdermico: usuarias nuevas,2016-01-01,1,28,142,30,0,201
CORIPATA,"anticoncepcion, prevencion de its y de cancer de cuello uterino",implante subdermico: usuarias nuevas,2016-01-01,0,0,1,1,0,2
COROICO,"anticoncepcion, prevencion de its y de cancer de cuello uterino",implante subdermico: usuarias nuevas,2016-01-01,0,0,1,0,0,1
CORQUE,"anticoncepcion, prevencion de its y de cancer de cuello uterino",implante subdermico: usuarias nuevas,2016-01-01,0,0,1,0,0,1
COTAGAITA,"anticoncepcion, prevencion de its y de cancer de cuello uterino",implante subdermico: usuarias nuevas,2016-01-01,0,0,3,0,0,3
CULPINA,"anticoncepcion, prevencion de its y de cancer de cuello uterino",implante subdermico: usuarias nuevas,2016-01-01,0,0,8,1,0,9
CURVA,"anticoncepcion, prevencion de its y de cancer de cuello uterino",implante subdermico: usuarias nuevas,2016-01-01,0,0,2,0,0,2
EL ALTO,"anticoncepcion, prevencion de its y de cancer de cuello uterino",implante subdermico: usuarias nuevas,2016-01-01,0,20,131,45,0,196
EL CHORO,"anticoncepcion, prevencion de its y de cancer de cuello uterino",implante subdermico: usuarias nuevas,2016-01-01,0,0,1,0,0,1
EL PUENTE(STC),"anticoncepcion, prevencion de its y de cancer de cuello uterino",implante subdermico: usuarias nuevas,2016-01-01,0,6,6,0,0,12
EL TORNO,"anticoncepcion, prevencion de its y de cancer de cuello uterino",implante subdermico: usuarias nuevas,2016-01-01,0,9,51,5,0,65
ENTRE RIOS TRJ,"anticoncepcion, prevencion de its y de cancer de cuello uterino",implante subdermico: usuarias nuevas,2016-01-01,0,2,6,2,0,10
FERNANDEZ ALONSO,"anticoncepcion, prevencion de its y de cancer de cuello uterino",implante subdermico: usuarias nuevas,2016-01-01,0,0,1,1,0,2
FILADELFIA,"anticoncepcion, prevencion de its y de cancer de cuello uterino",implante subdermico: usuarias nuevas,2016-01-01,0,0,6,4,0,10
GUANAY,"anticoncepcion, prevencion de its y de cancer de cuello uterino",implante subdermico: usuarias nuevas,2016-01-01,0,0,1,1,0,2
GUAYARAMERIN,"anticoncepcion, prevencion de its y de cancer de cuello uterino",implante subdermico: usuarias nuevas,2016-01-01,0,1,0,0,0,1
HUANUNI,"anticoncepcion, prevencion de its y de cancer de cuello uterino",implante subdermico: usuarias nuevas,2016-01-01,0,0,18,4,0,22
HUARACAJE,"anticoncepcion, prevencion de its y de cancer de cuello uterino",implante subdermico: usuarias nuevas,2016-01-01,0,0,2,0,0,2
HUAYLLAMARCA,"anticoncepcion, prevencion de its y de cancer de cuello uterino",implante subdermico: usuarias nuevas,2016-01-01,0,0,1,0,0,1
ICLA,"anticoncepcion, prevencion de its y de cancer de cuello uterino",implante subdermico: usuarias nuevas,2016-01-01,0,0,2,0,0,2
INCAHUASI,"anticoncepcion, prevencion de its y de cancer de cuello uterino",implante subdermico: usuarias nuevas,2016-01-01,0,3,0,0,0,3
LA GUARDIA,"anticoncepcion, prevencion de its y de cancer de cuello uterino",implante subdermico: usuarias nuevas,2016-01-01,0,2,8,0,0,10
LA PAZ,"anticoncepcion, prevencion de its y de cancer de cuello uterino",implante subdermico: usuarias nuevas,2016-01-01,0,19,104,48,0,171
LAS CARRERAS,"anticoncepcion, prevencion de its y de cancer de cuello uterino",implante subdermico: usuarias nuevas,2016-01-01,0,1,7,0,0,8
LLALLAGUA,"anticoncepcion, prevencion de its y de cancer de cuello uterino",implante subdermico: usuarias nuevas,2016-01-01,0,2,16,1,0,19
LORETO,"anticoncepcion, prevencion de its y de cancer de cuello uterino",implante subdermico: usuarias nuevas,2016-01-01,0,2,1,0,0,3
MACHACAMARCA,"anticoncepcion, prevencion de its y de cancer de cuello uterino",implante subdermico: usuarias nuevas,2016-01-01,0,1,3,1,0,5
MACHARETI,"anticoncepcion, prevencion de its y de cancer de cuello uterino",implante subdermico: usuarias nuevas,2016-01-01,0,0,2,0,0,2
MAGDALENA,"anticoncepcion, prevencion de its y de cancer de cuello uterino",implante subdermico: usuarias nuevas,2016-01-01,0,1,4,0,0,5
MAPIRI,"anticoncepcion, prevencion de its y de cancer de cuello uterino",implante subdermico: usuarias nuevas,2016-01-01,0,0,1,0,0,1
MECAPACA,"anticoncepcion, prevencion de its y de cancer de cuello uterino",implante subdermico: usuarias nuevas,2016-01-01,0,0,2,1,0,3
MIZQUE,"anticoncepcion, prevencion de its y de cancer de cuello uterino",implante subdermico: usuarias nuevas,2016-01-01,0,4,11,2,0,17
MOCOMOCO,"anticoncepcion, prevencion de its y de cancer de cuello uterino",implante subdermico: usuarias nuevas,2016-01-01,0,0,2,0,0,2
MONTEAGUDO,"anticoncepcion, prevencion de its y de cancer de cuello uterino",implante subdermico: usuarias nuevas,2016-01-01,0,4,11,1,0,16
ORURO,"anticoncepcion, prevencion de its y de cancer de cuello uterino",implante subdermico: usuarias nuevas,2016-01-01,0,4,71,9,1,85
PADILLA,"anticoncepcion, prevencion de its y de cancer de cuello uterino",implante subdermico: usuarias nuevas,2016-01-01,0,0,4,0,0,4
PALCA,"anticoncepcion, prevencion de its y de cancer de cuello uterino",implante subdermico: usuarias nuevas,2016-01-01,0,1,8,2,0,11
PALOS BLANCOS,"anticoncepcion, prevencion de its y de cancer de cuello uterino",implante subdermico: usuarias nuevas,2016-01-01,0,4,10,2,0,16
PAMPA AULLAGAS,"anticoncepcion, prevencion de its y de cancer de cuello uterino",implante subdermico: usuarias nuevas,2016-01-01,0,0,2,0,0,2
POCOATA,"anticoncepcion, prevencion de its y de cancer de cuello uterino",implante subdermico: usuarias nuevas,2016-01-01,0,1,1,0,0,2
POCONA,"anticoncepcion, prevencion de its y de cancer de cuello uterino",implante subdermico: usuarias nuevas,2016-01-01,0,1,3,0,0,4
POTOSI,"anticoncepcion, prevencion de its y de cancer de cuello uterino",implante subdermico: usuarias nuevas,2016-01-01,0,13,44,11,0,68
PRESTO,"anticoncepcion, prevencion de its y de cancer de cuello uterino",implante subdermico: usuarias nuevas,2016-01-01,0,0,1,0,0,1
PUCARANI,"anticoncepcion, prevencion de its y de cancer de cuello uterino",implante subdermico: usuarias nuevas,2016-01-01,0,1,2,1,0,4
PUERTO GONZALO MORENO,"anticoncepcion, prevencion de its y de cancer de cuello uterino",implante subdermico: usuarias nuevas,2016-01-01,0,3,1,0,0,4
PUERTO VILLARROEL,"anticoncepcion, prevencion de its y de cancer de cuello uterino",implante subdermico: usuarias nuevas,2016-01-01,0,3,0,0,0,3
PUNA,"anticoncepcion, prevencion de its y de cancer de cuello uterino",implante subdermico: usuarias nuevas,2016-01-01,0,1,4,1,0,6
QUILLACOLLO,"anticoncepcion, prevencion de its y de cancer de cuello uterino",implante subdermico: usuarias nuevas,2016-01-01,0,1,17,0,0,18
RIBERALTA,"anticoncepcion, prevencion de its y de cancer de cuello uterino",implante subdermico: usuarias nuevas,2016-01-01,3,23,42,3,0,71
RURRENABAQUE,"anticoncepcion, prevencion de its y de cancer de cuello uterino",implante subdermico: usuarias nuevas,2016-01-01,0,2,14,0,0,16
SABAYA,"anticoncepcion, prevencion de its y de cancer de cuello uterino",implante subdermico: usuarias nuevas,2016-01-01,0,1,1,1,0,3
SACABA,"anticoncepcion, prevencion de its y de cancer de cuello uterino",implante subdermico: usuarias nuevas,2016-01-01,0,8,20,8,0,36
SALINAS DE GARCI MENDOZA,"anticoncepcion, prevencion de its y de cancer de cuello uterino",implante subdermico: usuarias nuevas,2016-01-01,0,0,4,0,0,4
SAN BORJA,"anticoncepcion, prevencion de its y de cancer de cuello uterino",implante subdermico: usuarias nuevas,2016-01-01,0,1,6,0,0,7
SAN CARLOS,"anticoncepcion, prevencion de its y de cancer de cuello uterino",implante subdermico: usuarias nuevas,2016-01-01,0,18,29,4,0,51
SAN IGNACIO,"anticoncepcion, prevencion de its y de cancer de cuello uterino",implante subdermico: usuarias nuevas,2016-01-01,0,1,2,0,0,3
SAN JOAQUIN,"anticoncepcion, prevencion de its y de cancer de cuello uterino",implante subdermico: usuarias nuevas,2016-01-01,0,1,0,0,0,1
SAN JULIAN,"anticoncepcion, prevencion de its y de cancer de cuello uterino",implante subdermico: usuarias nuevas,2016-01-01,0,18,41,0,0,59
SAN LUCAS,"anticoncepcion, prevencion de its y de cancer de cuello uterino",implante subdermico: usuarias nuevas,2016-01-01,0,1,2,0,0,3
SANTA CRUZ DE LA SIERRA,"anticoncepcion, prevencion de its y de cancer de cuello uterino",implante subdermico: usuarias nuevas,2016-01-01,0,18,387,106,0,511
SANTIAGO DE HUARI,"anticoncepcion, prevencion de its y de cancer de cuello uterino",implante subdermico: usuarias nuevas,2016-01-01,0,0,3,0,0,3
SOPACHUY,"anticoncepcion, prevencion de its y de cancer de cuello uterino",implante subdermico: usuarias nuevas,2016-01-01,0,1,3,0,0,4
SORATA,"anticoncepcion, prevencion de its y de cancer de cuello uterino",implante subdermico: usuarias nuevas,2016-01-01,0,1,5,1,0,7
SUCRE,"anticoncepcion, prevencion de its y de cancer de cuello uterino",implante subdermico: usuarias nuevas,2016-01-01,0,22,108,18,0,148
TAPACARI,"anticoncepcion, prevencion de its y de cancer de cuello uterino",implante subdermico: usuarias nuevas,2016-01-01,0,1,6,0,0,7
TARABUCO,"anticoncepcion, prevencion de its y de cancer de cuello uterino",implante subdermico: usuarias nuevas,2016-01-01,0,2,2,2,0,6
TARIJA,"anticoncepcion, prevencion de its y de cancer de cuello uterino",implante subdermico: usuarias nuevas,2016-01-01,0,0,1,0,0,1
TEOPONTE,"anticoncepcion, prevencion de its y de cancer de cuello uterino",implante subdermico: usuarias nuevas,2016-01-01,0,2,4,2,0,8
TIAWANACU,"anticoncepcion, prevencion de its y de cancer de cuello uterino",implante subdermico: usuarias nuevas,2016-01-01,0,0,1,0,0,1
TINGUIPAYA,"anticoncepcion, prevencion de its y de cancer de cuello uterino",implante subdermico: usuarias nuevas,2016-01-01,0,0,1,2,0,3
TIPUANI,"anticoncepcion, prevencion de its y de cancer de cuello uterino",implante subdermico: usuarias nuevas,2016-01-01,0,0,2,2,0,4
TOLATA,"anticoncepcion, prevencion de its y de cancer de cuello uterino",implante subdermico: usuarias nuevas,2016-01-01,0,0,7,0,0,7
TOLEDO,"anticoncepcion, prevencion de its y de cancer de cuello uterino",implante subdermico: usuarias nuevas,2016-01-01,0,0,3,0,0,3
TOMINA,"anticoncepcion, prevencion de its y de cancer de cuello uterino",implante subdermico: usuarias nuevas,2016-01-01,0,0,1,0,0,1
TOTORA(CBBA),"anticoncepcion, prevencion de its y de cancer de cuello uterino",implante subdermico: usuarias nuevas,2016-01-01,0,2,4,2,0,8
TRINIDAD,"anticoncepcion, prevencion de its y de cancer de cuello uterino",implante subdermico: usuarias nuevas,2016-01-01,0,5,49,0,0,54
TUPIZA,"anticoncepcion, prevencion de its y de cancer de cuello uterino",implante subdermico: usuarias nuevas,2016-01-01,0,6,19,2,0,27
TURCO,"anticoncepcion, prevencion de its y de cancer de cuello uterino",implante subdermico: usuarias nuevas,2016-01-01,0,0,3,0,0,3
URIONDO (A. CONCEPCION),"anticoncepcion, prevencion de its y de cancer de cuello uterino",implante subdermico: usuarias nuevas,2016-01-01,0,1,1,0,0,2
VIACHA,"anticoncepcion, prevencion de its y de cancer de cuello uterino",implante subdermico: usuarias nuevas,2016-01-01,0,1,0,0,0,1
VILLA SERRANO,"anticoncepcion, prevencion de its y de cancer de cuello uterino",implante subdermico: usuarias nuevas,2016-01-01,0,3,7,1,0,11
VILLA TUNARI,"anticoncepcion, prevencion de its y de cancer de cuello uterino",implante subdermico: usuarias nuevas,2016-01-01,0,7,10,6,0,23
VILLA VACA GUZMAN (MUYUPAMPA),"anticoncepcion, prevencion de its y de cancer de cuello uterino",implante subdermico: usuarias nuevas,2016-01-01,0,0,1,0,0,1
VINTO,"anticoncepcion, prevencion de its y de cancer de cuello uterino",implante subdermico: usuarias nuevas,2016-01-01,0,0,1,0,0,1
WARNES,"anticoncepcion, prevencion de its y de cancer de cuello uterino",implante subdermico: usuarias nuevas,2016-01-01,3,0,13,0,0,16
YACUIBA,"anticoncepcion, prevencion de its y de cancer de cuello uterino",implante subdermico: usuarias nuevas,2016-01-01,0,0,1,0,0,1
YANACACHI,"anticoncepcion, prevencion de its y de cancer de cuello uterino",implante subdermico: usuarias nuevas,2016-01-01,0,0,2,1,0,3
YOTALA,"anticoncepcion, prevencion de its y de cancer de cuello uterino",implante subdermico: usuarias nuevas,2016-01-01,0,3,3,0,0,6
ZUDAÑEZ,"anticoncepcion, prevencion de its y de cancer de cuello uterino",implante subdermico: usuarias nuevas,2016-01-01,0,0,3,0,0,3
ACHACACHI,"anticoncepcion, prevencion de its y de cancer de cuello uterino",implante subdermico: usuarias nuevas,2016-02-01,0,0,0,1,0,1
ACHOCALLA,"anticoncepcion, prevencion de its y de cancer de cuello uterino",implante subdermico: usuarias nuevas,2016-02-01,0,1,4,0,0,5
AIQUILE,"anticoncepcion, prevencion de its y de cancer de cuello uterino",implante subdermico: usuarias nuevas,2016-02-01,0,1,7,0,0,8
ALTO BENI,"anticoncepcion, prevencion de its y de cancer de cuello uterino",implante subdermico: usuarias nuevas,2016-02-01,0,0,1,0,0,1
ANDAMARCA,"anticoncepcion, prevencion de its y de cancer de cuello uterino",implante subdermico: usuarias nuevas,2016-02-01,0,0,1,0,0,1
ANTEQUERA,"anticoncepcion, prevencion de its y de cancer de cuello uterino",implante subdermico: usuarias nuevas,2016-02-01,0,0,6,0,0,6
APOLO,"anticoncepcion, prevencion de its y de cancer de cuello uterino",implante subdermico: usuarias nuevas,2016-02-01,0,0,4,0,0,4
ARBIETO,"anticoncepcion, prevencion de its y de cancer de cuello uterino",implante subdermico: usuarias nuevas,2016-02-01,0,0,9,6,0,15
AYOPAYA (V. DE INDEPENDENCIA),"anticoncepcion, prevencion de its y de cancer de cuello uterino",implante subdermico: usuarias nuevas,2016-02-01,0,2,11,2,0,15
BELLA FLOR,"anticoncepcion, prevencion de its y de cancer de cuello uterino",implante subdermico: usuarias nuevas,2016-02-01,0,0,3,0,0,3
BUENA VISTA,"anticoncepcion, prevencion de its y de cancer de cuello uterino",implante subdermico: usuarias nuevas,2016-02-01,0,5,11,1,0,17
CAJUATA,"anticoncepcion, prevencion de its y de cancer de cuello uterino",implante subdermico: usuarias nuevas,2016-02-01,0,0,3,0,0,3
CAMARGO,"anticoncepcion, prevencion de its y de cancer de cuello uterino",implante subdermico: usuarias nuevas,2016-02-01,0,2,0,0,0,2
CAMATAQUI (C. VILLA ABECIA),"anticoncepcion, prevencion de its y de cancer de cuello uterino",implante subdermico: usuarias nuevas,2016-02-01,0,0,1,0,0,1
CAPINOTA,"anticoncepcion, prevencion de its y de cancer de cuello uterino",implante subdermico: usuarias nuevas,2016-02-01,0,1,4,0,0,5
CARACOLLO,"anticoncepcion, prevencion de its y de cancer de cuello uterino",implante subdermico: usuarias nuevas,2016-02-01,0,2,5,2,0,9
CHALLAPATA,"anticoncepcion, prevencion de its y de cancer de cuello uterino",implante subdermico: usuarias nuevas,2016-02-01,0,0,3,1,0,4
CKOCHAS,"anticoncepcion, prevencion de its y de cancer de cuello uterino",implante subdermico: usuarias nuevas,2016-02-01,0,1,9,4,0,14
CLIZA,"anticoncepcion, prevencion de its y de cancer de cuello uterino",implante subdermico: usuarias nuevas,2016-02-01,0,0,3,0,0,3
COBIJA,"anticoncepcion, prevencion de its y de cancer de cuello uterino",implante subdermico: usuarias nuevas,2016-02-01,0,7,4,0,0,11
COCHABAMBA,"anticoncepcion, prevencion de its y de cancer de cuello uterino",implante subdermico: usuarias nuevas,2016-02-01,0,12,159,35,0,206
COLCAPIRHUA,"anticoncepcion, prevencion de its y de cancer de cuello uterino",implante subdermico: usuarias nuevas,2016-02-01,0,0,6,0,0,6
CORIPATA,"anticoncepcion, prevencion de its y de cancer de cuello uterino",implante subdermico: usuarias nuevas,2016-02-01,0,0,1,0,0,1
COTAGAITA,"anticoncepcion, prevencion de its y de cancer de cuello uterino",implante subdermico: usuarias nuevas,2016-02-01,0,0,3,1,0,4
CUATRO CAÑADAS,"anticoncepcion, prevencion de its y de cancer de cuello uterino",implante subdermico: usuarias nuevas,2016-02-01,0,4,16,7,0,27
CULPINA,"anticoncepcion, prevencion de its y de cancer de cuello uterino",implante subdermico: usuarias nuevas,2016-02-01,0,2,10,3,0,15
EL ALTO,"anticoncepcion, prevencion de its y de cancer de cuello uterino",implante subdermico: usuarias nuevas,2016-02-01,0,26,153,108,0,287
EL TORNO,"anticoncepcion, prevencion de its y de cancer de cuello uterino",implante subdermico: usuarias nuevas,2016-02-01,0,16,49,5,0,70
ENTRE RIOS TRJ,"anticoncepcion, prevencion de its y de cancer de cuello uterino",implante subdermico: usuarias nuevas,2016-02-01,0,1,2,0,0,3
ESMERALDA,"anticoncepcion, prevencion de its y de cancer de cuello uterino",implante subdermico: usuarias nuevas,2016-02-01,0,1,3,1,0,5
EUREKA (SANTOS MERCADO),"anticoncepcion, prevencion de its y de cancer de cuello uterino",implante subdermico: usuarias nuevas,2016-02-01,0,1,1,0,0,2
FILADELFIA,"anticoncepcion, prevencion de its y de cancer de cuello uterino",implante subdermico: usuarias nuevas,2016-02-01,0,1,3,0,0,4
GUAYARAMERIN,"anticoncepcion, prevencion de its y de cancer de cuello uterino",implante subdermico: usuarias nuevas,2016-02-01,0,1,0,1,0,2
HUANUNI,"anticoncepcion, prevencion de its y de cancer de cuello uterino",implante subdermico: usuarias nuevas,2016-02-01,0,0,15,3,0,18
HUARACAJE,"anticoncepcion, prevencion de its y de cancer de cuello uterino",implante subdermico: usuarias nuevas,2016-02-01,0,1,0,0,0,1
ICLA,"anticoncepcion, prevencion de its y de cancer de cuello uterino",implante subdermico: usuarias nuevas,2016-02-01,0,0,4,1,0,5
INCAHUASI,"anticoncepcion, prevencion de its y de cancer de cuello uterino",implante subdermico: usuarias nuevas,2016-02-01,0,0,5,3,0,8
INGAVI (HUMAITA),"anticoncepcion, prevencion de its y de cancer de cuello uterino",implante subdermico: usuarias nuevas,2016-02-01,0,0,6,3,0,9
LA GUARDIA,"anticoncepcion, prevencion de its y de cancer de cuello uterino",implante subdermico: usuarias nuevas,2016-02-01,0,2,8,0,0,10
LA PAZ,"anticoncepcion, prevencion de its y de cancer de cuello uterino",implante subdermico: usuarias nuevas,2016-02-01,0,13,145,34,0,192
LAS CARRERAS,"anticoncepcion, prevencion de its y de cancer de cuello uterino",implante subdermico: usuarias nuevas,2016-02-01,0,1,4,1,0,6
LLALLAGUA,"anticoncepcion, prevencion de its y de cancer de cuello uterino",implante subdermico: usuarias nuevas,2016-02-01,0,2,9,3,0,14
MACHACAMARCA,"anticoncepcion, prevencion de its y de cancer de cuello uterino",implante subdermico: usuarias nuevas,2016-02-01,0,0,1,0,0,1
MACHARETI,"anticoncepcion, prevencion de its y de cancer de cuello uterino",implante subdermico: usuarias nuevas,2016-02-01,0,0,1,0,0,1
MAGDALENA,"anticoncepcion, prevencion de its y de cancer de cuello uterino",implante subdermico: usuarias nuevas,2016-02-01,0,1,2,0,0,3
MAPIRI,"anticoncepcion, prevencion de its y de cancer de cuello uterino",implante subdermico: usuarias nuevas,2016-02-01,0,1,3,1,0,5
MIZQUE,"anticoncepcion, prevencion de its y de cancer de cuello uterino",implante subdermico: usuarias nuevas,2016-02-01,0,1,15,3,0,19
MOCOMOCO,"anticoncepcion, prevencion de its y de cancer de cuello uterino",implante subdermico: usuarias nuevas,2016-02-01,0,1,0,1,0,2
MOJOCOYA,"anticoncepcion, prevencion de its y de cancer de cuello uterino",implante subdermico: usuarias nuevas,2016-02-01,0,0,1,0,0,1
MONTEAGUDO,"anticoncepcion, prevencion de its y de cancer de cuello uterino",implante subdermico: usuarias nuevas,2016-02-01,0,3,5,1,0,9
ORURO,"anticoncepcion, prevencion de its y de cancer de cuello uterino",implante subdermico: usuarias nuevas,2016-02-01,0,7,45,3,1,56
PADILLA,"anticoncepcion, prevencion de its y de cancer de cuello uterino",implante subdermico: usuarias nuevas,2016-02-01,0,2,13,0,0,15
PAILON,"anticoncepcion, prevencion de its y de cancer de cuello uterino",implante subdermico: usuarias nuevas,2016-02-01,0,0,14,0,0,14
PAMPA AULLAGAS,"anticoncepcion, prevencion de its y de cancer de cuello uterino",implante subdermico: usuarias nuevas,2016-02-01,0,0,0,1,0,1
PAZÑA,"anticoncepcion, prevencion de its y de cancer de cuello uterino",implante subdermico: usuarias nuevas,2016-02-01,0,0,1,0,0,1
POCOATA,"anticoncepcion, prevencion de its y de cancer de cuello uterino",implante subdermico: usuarias nuevas,2016-02-01,0,0,0,1,0,1
PORTACHUELO,"anticoncepcion, prevencion de its y de cancer de cuello uterino",implante subdermico: usuarias nuevas,2016-02-01,0,0,1,0,0,1
POTOSI,"anticoncepcion, prevencion de its y de cancer de cuello uterino",implante subdermico: usuarias nuevas,2016-02-01,0,4,57,3,0,64
PRESTO,"anticoncepcion, prevencion de its y de cancer de cuello uterino",implante subdermico: usuarias nuevas,2016-02-01,0,0,2,2,0,4
PUCARANI,"anticoncepcion, prevencion de its y de cancer de cuello uterino",implante subdermico: usuarias nuevas,2016-02-01,0,0,2,0,0,2
PUERTO GONZALO MORENO,"anticoncepcion, prevencion de its y de cancer de cuello uterino",implante subdermico: usuarias nuevas,2016-02-01,0,0,3,0,0,3
PUNA,"anticoncepcion, prevencion de its y de cancer de cuello uterino",implante subdermico: usuarias nuevas,2016-02-01,0,2,1,3,0,6
QUILLACOLLO,"anticoncepcion, prevencion de its y de cancer de cuello uterino",implante subdermico: usuarias nuevas,2016-02-01,0,9,12,6,0,27
RIBERALTA,"anticoncepcion, prevencion de its y de cancer de cuello uterino",implante subdermico: usuarias nuevas,2016-02-01,1,41,68,2,0,112
RURRENABAQUE,"anticoncepcion, prevencion de its y de cancer de cuello uterino",implante subdermico: usuarias nuevas,2016-02-01,0,6,10,3,0,19
SACABA,"anticoncepcion, prevencion de its y de cancer de cuello uterino",implante subdermico: usuarias nuevas,2016-02-01,0,1,14,5,0,20
SACACA,"anticoncepcion, prevencion de its y de cancer de cuello uterino",implante subdermico: usuarias nuevas,2016-02-01,0,0,5,1,0,6
SALINAS DE GARCI MENDOZA,"anticoncepcion, prevencion de its y de cancer de cuello uterino",implante subdermico: usuarias nuevas,2016-02-01,0,0,2,0,0,2
SAN ANDRES,"anticoncepcion, prevencion de its y de cancer de cuello uterino",implante subdermico: usuarias nuevas,2016-02-01,0,1,4,1,0,6
SAN BUENA VENTURA,"anticoncepcion, prevencion de its y de cancer de cuello uterino",implante subdermico: usuarias nuevas,2016-02-01,0,0,3,2,0,5
SAN CARLOS,"anticoncepcion, prevencion de its y de cancer de cuello uterino",implante subdermico: usuarias nuevas,2016-02-01,0,0,0,1,0,1
SAN JOAQUIN,"anticoncepcion, prevencion de its y de cancer de cuello uterino",implante subdermico: usuarias nuevas,2016-02-01,0,0,1,0,0,1
SAN JOSE DE CHIQUITOS,"anticoncepcion, prevencion de its y de cancer de cuello uterino",implante subdermico: usuarias nuevas,2016-02-01,0,1,0,0,0,1
SAN JULIAN,"anticoncepcion, prevencion de its y de cancer de cuello uterino",implante subdermico: usuarias nuevas,2016-02-01,0,18,39,18,0,75
SAN LORENZO(PND),"anticoncepcion, prevencion de its y de cancer de cuello uterino",implante subdermico: usuarias nuevas,2016-02-01,0,0,1,0,0,1
SAN LUCAS,"anticoncepcion, prevencion de its y de cancer de cuello uterino",implante subdermico: usuarias nuevas,2016-02-01,0,1,2,0,0,3
SANTA CRUZ DE LA SIERRA,"anticoncepcion, prevencion de its y de cancer de cuello uterino",implante subdermico: usuarias nuevas,2016-02-01,0,8,156,52,0,216
SANTIAGO DE HUARI,"anticoncepcion, prevencion de its y de cancer de cuello uterino",implante subdermico: usuarias nuevas,2016-02-01,0,1,1,0,0,2
SIPE SIPE,"anticoncepcion, prevencion de its y de cancer de cuello uterino",implante subdermico: usuarias nuevas,2016-02-01,0,0,3,0,0,3
SOPACHUY,"anticoncepcion, prevencion de its y de cancer de cuello uterino",implante subdermico: usuarias nuevas,2016-02-01,0,0,3,0,0,3
SORATA,"anticoncepcion, prevencion de its y de cancer de cuello uterino",implante subdermico: usuarias nuevas,2016-02-01,0,0,2,1,0,3
SUCRE,"anticoncepcion, prevencion de its y de cancer de cuello uterino",implante subdermico: usuarias nuevas,2016-02-01,0,22,104,8,1,135
TAPACARI,"anticoncepcion, prevencion de its y de cancer de cuello uterino",implante subdermico: usuarias nuevas,2016-02-01,0,0,3,0,0,3
TARABUCO,"anticoncepcion, prevencion de its y de cancer de cuello uterino",implante subdermico: usuarias nuevas,2016-02-01,0,0,7,2,0,9
TARIJA,"anticoncepcion, prevencion de its y de cancer de cuello uterino",implante subdermico: usuarias nuevas,2016-02-01,0,3,13,0,0,16
TARVITA,"anticoncepcion, prevencion de its y de cancer de cuello uterino",implante subdermico: usuarias nuevas,2016-02-01,0,1,0,0,0,1
TEOPONTE,"anticoncepcion, prevencion de its y de cancer de cuello uterino",implante subdermico: usuarias nuevas,2016-02-01,0,2,2,0,0,4
TIAWANACU,"anticoncepcion, prevencion de its y de cancer de cuello uterino",implante subdermico: usuarias nuevas,2016-02-01,0,1,2,0,0,3
TINGUIPAYA,"anticoncepcion, prevencion de its y de cancer de cuello uterino",implante subdermico: usuarias nuevas,2016-02-01,0,0,0,2,0,2
TIPUANI,"anticoncepcion, prevencion de its y de cancer de cuello uterino",implante subdermico: usuarias nuevas,2016-02-01,0,0,2,0,0,2
TIRAQUE (CBBA),"anticoncepcion, prevencion de its y de cancer de cuello uterino",implante subdermico: usuarias nuevas,2016-02-01,0,0,1,1,0,2
TOLATA,"anticoncepcion, prevencion de its y de cancer de cuello uterino",implante subdermico: usuarias nuevas,2016-02-01,0,0,1,2,0,3
TOLEDO,"anticoncepcion, prevencion de its y de cancer de cuello uterino",implante subdermico: usuarias nuevas,2016-02-01,0,0,1,0,0,1
TOTORA(CBBA),"anticoncepcion, prevencion de its y de cancer de cuello uterino",implante subdermico: usuarias nuevas,2016-02-01,0,0,3,1,0,4
TRINIDAD,"anticoncepcion, prevencion de its y de cancer de cuello uterino",implante subdermico: usuarias nuevas,2016-02-01,1,5,33,1,0,40
TUPIZA,"anticoncepcion, prevencion de its y de cancer de cuello uterino",implante subdermico: usuarias nuevas,2016-02-01,0,0,7,0,0,7
TURCO,"anticoncepcion, prevencion de its y de cancer de cuello uterino",implante subdermico: usuarias nuevas,2016-02-01,0,1,0,2,0,3
URIONDO (A. CONCEPCION),"anticoncepcion, prevencion de its y de cancer de cuello uterino",implante subdermico: usuarias nuevas,2016-02-01,0,1,1,0,0,2
VIACHA,"anticoncepcion, prevencion de its y de cancer de cuello uterino",implante subdermico: usuarias nuevas,2016-02-01,0,1,8,5,3,17
VILLA SERRANO,"anticoncepcion, prevencion de its y de cancer de cuello uterino",implante subdermico: usuarias nuevas,2016-02-01,0,2,3,2,0,7
VILLA TUNARI,"anticoncepcion, prevencion de its y de cancer de cuello uterino",implante subdermico: usuarias nuevas,2016-02-01,0,6,2,3,0,11
VILLA VACA GUZMAN (MUYUPAMPA),"anticoncepcion, prevencion de its y de cancer de cuello uterino",implante subdermico: usuarias nuevas,2016-02-01,0,0,2,0,0,2
VINTO,"anticoncepcion, prevencion de its y de cancer de cuello uterino",implante subdermico: usuarias nuevas,2016-02-01,0,2,12,0,0,14
VITICHI,"anticoncepcion, prevencion de its y de cancer de cuello uterino",implante subdermico: usuarias nuevas,2016-02-01,0,0,1,0,0,1
YOTALA,"anticoncepcion, prevencion de its y de cancer de cuello uterino",implante subdermico: usuarias nuevas,2016-02-01,0,0,0,2,0,2
ZUDAÑEZ,"anticoncepcion, prevencion de its y de cancer de cuello uterino",implante subdermico: usuarias nuevas,2016-02-01,0,0,0,1,0,1
ACHACACHI,"anticoncepcion, prevencion de its y de cancer de cuello uterino",implante subdermico: usuarias nuevas,2016-03-01,0,0,2,1,0,3
ACHOCALLA,"anticoncepcion, prevencion de its y de cancer de cuello uterino",implante subdermico: usuarias nuevas,2016-03-01,0,1,9,1,0,11
AIQUILE,"anticoncepcion, prevencion de its y de cancer de cuello uterino",implante subdermico: usuarias nuevas,2016-03-01,0,0,10,2,0,12
ALTO BENI,"anticoncepcion, prevencion de its y de cancer de cuello uterino",implante subdermico: usuarias nuevas,2016-03-01,0,0,7,1,0,8
ANTEQUERA,"anticoncepcion, prevencion de its y de cancer de cuello uterino",implante subdermico: usuarias nuevas,2016-03-01,0,0,6,0,0,6
APOLO,"anticoncepcion, prevencion de its y de cancer de cuello uterino",implante subdermico: usuarias nuevas,2016-03-01,0,0,3,0,0,3
ATOCHA,"anticoncepcion, prevencion de its y de cancer de cuello uterino",implante subdermico: usuarias nuevas,2016-03-01,0,0,3,0,0,3
AYATA,"anticoncepcion, prevencion de its y de cancer de cuello uterino",implante subdermico: usuarias nuevas,2016-03-01,0,1,0,0,0,1
AYOPAYA (V. DE INDEPENDENCIA),"anticoncepcion, prevencion de its y de cancer de cuello uterino",implante subdermico: usuarias nuevas,2016-03-01,0,1,12,0,0,13
BAURES,"anticoncepcion, prevencion de its y de cancer de cuello uterino",implante subdermico: usuarias nuevas,2016-03-01,0,0,2,2,0,4
BELLA FLOR,"anticoncepcion, prevencion de its y de cancer de cuello uterino",implante subdermico: usuarias nuevas,2016-03-01,0,2,9,1,0,12
BERMEJO,"anticoncepcion, prevencion de its y de cancer de cuello uterino",implante subdermico: usuarias nuevas,2016-03-01,0,5,38,6,0,49
BETANZOS,"anticoncepcion, prevencion de its y de cancer de cuello uterino",implante subdermico: usuarias nuevas,2016-03-01,0,2,5,2,0,9
BOLPEBRA,"anticoncepcion, prevencion de its y de cancer de cuello uterino",implante subdermico: usuarias nuevas,2016-03-01,0,0,1,0,0,1
"CAIZA ""D""","anticoncepcion, prevencion de its y de cancer de cuello uterino",implante subdermico: usuarias nuevas,2016-03-01,0,2,19,4,0,25
CALAMARCA,"anticoncepcion, prevencion de its y de cancer de cuello uterino",implante subdermico: usuarias nuevas,2016-03-01,0,4,8,0,0,12
CAMARGO,"anticoncepcion, prevencion de its y de cancer de cuello uterino",implante subdermico: usuarias nuevas,2016-03-01,0,2,4,1,0,7
CAMATAQUI (C. VILLA ABECIA),"anticoncepcion, prevencion de its y de cancer de cuello uterino",implante subdermico: usuarias nuevas,2016-03-01,0,0,1,0,0,1
CAPINOTA,"anticoncepcion, prevencion de its y de cancer de cuello uterino",implante subdermico: usuarias nuevas,2016-03-01,0,1,5,0,0,6
CARACOLLO,"anticoncepcion, prevencion de its y de cancer de cuello uterino",implante subdermico: usuarias nuevas,2016-03-01,0,1,7,2,0,10
CHALLAPATA,"anticoncepcion, prevencion de its y de cancer de cuello uterino",implante subdermico: usuarias nuevas,2016-03-01,0,1,7,0,0,8
CHULUMANI (V. DE LA LIBERTAD),"anticoncepcion, prevencion de its y de cancer de cuello uterino",implante subdermico: usuarias nuevas,2016-03-01,0,1,9,2,0,12
CLIZA,"anticoncepcion, prevencion de its y de cancer de cuello uterino",implante subdermico: usuarias nuevas,2016-03-01,0,1,7,0,0,8
COBIJA,"anticoncepcion, prevencion de its y de cancer de cuello uterino",implante subdermico: usuarias nuevas,2016-03-01,1,5,14,2,0,22
COCAPATA,"anticoncepcion, prevencion de its y de cancer de cuello uterino",implante subdermico: usuarias nuevas,2016-03-01,0,1,2,1,0,4
COCHABAMBA,"anticoncepcion, prevencion de its y de cancer de cuello uterino",implante subdermico: usuarias nuevas,2016-03-01,0,14,275,27,1,317
COLCAPIRHUA,"anticoncepcion, prevencion de its y de cancer de cuello uterino",implante subdermico: usuarias nuevas,2016-03-01,0,3,14,5,0,22
COLOMI,"anticoncepcion, prevencion de its y de cancer de cuello uterino",implante subdermico: usuarias nuevas,2016-03-01,0,1,2,0,0,3
CORIPATA,"anticoncepcion, prevencion de its y de cancer de cuello uterino",implante subdermico: usuarias nuevas,2016-03-01,0,1,2,0,0,3
CORQUE,"anticoncepcion, prevencion de its y de cancer de cuello uterino",implante subdermico: usuarias nuevas,2016-03-01,0,0,1,1,0,2
COTAGAITA,"anticoncepcion, prevencion de its y de cancer de cuello uterino",implante subdermico: usuarias nuevas,2016-03-01,0,0,1,1,0,2
CULPINA,"anticoncepcion, prevencion de its y de cancer de cuello uterino",implante subdermico: usuarias nuevas,2016-03-01,0,2,5,2,0,9
CURVA,"anticoncepcion, prevencion de its y de cancer de cuello uterino",implante subdermico: usuarias nuevas,2016-03-01,0,0,1,0,0,1
EL ALTO,"anticoncepcion, prevencion de its y de cancer de cuello uterino",implante subdermico: usuarias nuevas,2016-03-01,0,27,171,55,0,253
EL TORNO,"anticoncepcion, prevencion de its y de cancer de cuello uterino",implante subdermico: usuarias nuevas,2016-03-01,0,10,43,4,0,57
ENTRE RIOS TRJ,"anticoncepcion, prevencion de its y de cancer de cuello uterino",implante subdermico: usuarias nuevas,2016-03-01,0,1,5,0,0,6
ESCOMA,"anticoncepcion, prevencion de its y de cancer de cuello uterino",implante subdermico: usuarias nuevas,2016-03-01,0,0,1,0,0,1
EUCALIPTUS,"anticoncepcion, prevencion de its y de cancer de cuello uterino",implante subdermico: usuarias nuevas,2016-03-01,0,0,1,0,0,1
EUREKA (SANTOS MERCADO),"anticoncepcion, prevencion de its y de cancer de cuello uterino",implante subdermico: usuarias nuevas,2016-03-01,0,0,1,0,0,1
GENERAL SAAVEDRA,"anticoncepcion, prevencion de its y de cancer de cuello uterino",implante subdermico: usuarias nuevas,2016-03-01,0,0,1,0,0,1
GUAYARAMERIN,"anticoncepcion, prevencion de its y de cancer de cuello uterino",implante subdermico: usuarias nuevas,2016-03-01,0,0,1,0,0,1
HUANUNI,"anticoncepcion, prevencion de its y de cancer de cuello uterino",implante subdermico: usuarias nuevas,2016-03-01,0,1,14,5,0,20
HUAYLLAMARCA,"anticoncepcion, prevencion de its y de cancer de cuello uterino",implante subdermico: usuarias nuevas,2016-03-01,0,0,2,0,0,2
ICLA,"anticoncepcion, prevencion de its y de cancer de cuello uterino",implante subdermico: usuarias nuevas,2016-03-01,0,0,0,2,0,2
INCAHUASI,"anticoncepcion, prevencion de its y de cancer de cuello uterino",implante subdermico: usuarias nuevas,2016-03-01,0,0,6,1,0,7
INGAVI (HUMAITA),"anticoncepcion, prevencion de its y de cancer de cuello uterino",implante subdermico: usuarias nuevas,2016-03-01,0,0,1,0,0,1
LA GUARDIA,"anticoncepcion, prevencion de its y de cancer de cuello uterino",implante subdermico: usuarias nuevas,2016-03-01,0,0,9,2,0,11
LA PAZ,"anticoncepcion, prevencion de its y de cancer de cuello uterino",implante subdermico: usuarias nuevas,2016-03-01,2,34,151,31,0,218
LAJA,"anticoncepcion, prevencion de its y de cancer de cuello uterino",implante subdermico: usuarias nuevas,2016-03-01,0,1,17,0,0,18
LAS CARRERAS,"anticoncepcion, prevencion de its y de cancer de cuello uterino",implante subdermico: usuarias nuevas,2016-03-01,0,3,9,2,0,14
LLALLAGUA,"anticoncepcion, prevencion de its y de cancer de cuello uterino",implante subdermico: usuarias nuevas,2016-03-01,0,3,14,4,0,21
MACHACAMARCA,"anticoncepcion, prevencion de its y de cancer de cuello uterino",implante subdermico: usuarias nuevas,2016-03-01,0,0,6,1,0,7
MACHARETI,"anticoncepcion, prevencion de its y de cancer de cuello uterino",implante subdermico: usuarias nuevas,2016-03-01,0,0,1,1,0,2
MAGDALENA,"anticoncepcion, prevencion de its y de cancer de cuello uterino",implante subdermico: usuarias nuevas,2016-03-01,0,0,1,0,0,1
MIZQUE,"anticoncepcion, prevencion de its y de cancer de cuello uterino",implante subdermico: usuarias nuevas,2016-03-01,0,5,12,1,0,18
MOCOMOCO,"anticoncepcion, prevencion de its y de cancer de cuello uterino",implante subdermico: usuarias nuevas,2016-03-01,0,1,2,0,0,3
MOJOCOYA,"anticoncepcion, prevencion de its y de cancer de cuello uterino",implante subdermico: usuarias nuevas,2016-03-01,0,0,0,1,0,1
MONTEAGUDO,"anticoncepcion, prevencion de its y de cancer de cuello uterino",implante subdermico: usuarias nuevas,2016-03-01,0,2,11,3,0,16
ORURO,"anticoncepcion, prevencion de its y de cancer de cuello uterino",implante subdermico: usuarias nuevas,2016-03-01,1,8,50,4,0,63
PADILLA,"anticoncepcion, prevencion de its y de cancer de cuello uterino",implante subdermico: usuarias nuevas,2016-03-01,0,3,13,1,0,17
PALCA,"anticoncepcion, prevencion de its y de cancer de cuello uterino",implante subdermico: usuarias nuevas,2016-03-01,0,0,1,0,0,1
PALOS BLANCOS,"anticoncepcion, prevencion de its y de cancer de cuello uterino",implante subdermico: usuarias nuevas,2016-03-01,0,1,1,0,0,2
PAMPA AULLAGAS,"anticoncepcion, prevencion de its y de cancer de cuello uterino",implante subdermico: usuarias nuevas,2016-03-01,0,0,1,0,0,1
POCOATA,"anticoncepcion, prevencion de its y de cancer de cuello uterino",implante subdermico: usuarias nuevas,2016-03-01,0,0,1,0,0,1
POTOSI,"anticoncepcion, prevencion de its y de cancer de cuello uterino",implante subdermico: usuarias nuevas,2016-03-01,0,10,80,7,0,97
PRESTO,"anticoncepcion, prevencion de its y de cancer de cuello uterino",implante subdermico: usuarias nuevas,2016-03-01,0,0,4,1,0,5
PUCARANI,"anticoncepcion, prevencion de its y de cancer de cuello uterino",implante subdermico: usuarias nuevas,2016-03-01,0,0,5,1,0,6
PUERTO GONZALO MORENO,"anticoncepcion, prevencion de its y de cancer de cuello uterino",implante subdermico: usuarias nuevas,2016-03-01,0,2,1,1,0,4
PUERTO RICO,"anticoncepcion, prevencion de its y de cancer de cuello uterino",implante subdermico: usuarias nuevas,2016-03-01,0,1,1,0,0,2
PUNA,"anticoncepcion, prevencion de its y de cancer de cuello uterino",implante subdermico: usuarias nuevas,2016-03-01,0,0,2,0,0,2
QUILLACOLLO,"anticoncepcion, prevencion de its y de cancer de cuello uterino",implante subdermico: usuarias nuevas,2016-03-01,0,3,4,0,0,7
RIBERALTA,"anticoncepcion, prevencion de its y de cancer de cuello uterino",implante subdermico: usuarias nuevas,2016-03-01,3,39,49,1,0,92
ROBORE,"anticoncepcion, prevencion de its y de cancer de cuello uterino",implante subdermico: usuarias nuevas,2016-03-01,0,0,1,0,0,1
RURRENABAQUE,"anticoncepcion, prevencion de its y de cancer de cuello uterino",implante subdermico: usuarias nuevas,2016-03-01,0,1,6,1,0,8
SABAYA,"anticoncepcion, prevencion de its y de cancer de cuello uterino",implante subdermico: usuarias nuevas,2016-03-01,0,0,1,0,0,1
SACABA,"anticoncepcion, prevencion de its y de cancer de cuello uterino",implante subdermico: usuarias nuevas,2016-03-01,0,1,20,13,0,34
SACACA,"anticoncepcion, prevencion de its y de cancer de cuello uterino",implante subdermico: usuarias nuevas,2016-03-01,0,0,1,0,0,1
SAN ANDRES,"anticoncepcion, prevencion de its y de cancer de cuello uterino",implante subdermico: usuarias nuevas,2016-03-01,0,0,2,3,0,5
SAN BUENA VENTURA,"anticoncepcion, prevencion de its y de cancer de cuello uterino",implante subdermico: usuarias nuevas,2016-03-01,0,0,2,1,0,3
SAN CARLOS,"anticoncepcion, prevencion de its y de cancer de cuello uterino",implante subdermico: usuarias nuevas,2016-03-01,0,8,22,7,0,37
SAN IGNACIO,"anticoncepcion, prevencion de its y de cancer de cuello uterino",implante subdermico: usuarias nuevas,2016-03-01,0,0,0,1,0,1
SAN JULIAN,"anticoncepcion, prevencion de its y de cancer de cuello uterino",implante subdermico: usuarias nuevas,2016-03-01,0,8,23,9,0,40
SAN LORENZO(PND),"anticoncepcion, prevencion de its y de cancer de cuello uterino",implante subdermico: usuarias nuevas,2016-03-01,0,2,0,0,0,2
SAN LORENZO(TJA),"anticoncepcion, prevencion de its y de cancer de cuello uterino",implante subdermico: usuarias nuevas,2016-03-01,0,0,1,0,0,1
SAN LUCAS,"anticoncepcion, prevencion de its y de cancer de cuello uterino",implante subdermico: usuarias nuevas,2016-03-01,0,0,3,1,0,4
SANTA CRUZ DE LA SIERRA,"anticoncepcion, prevencion de its y de cancer de cuello uterino",implante subdermico: usuarias nuevas,2016-03-01,4,47,106,61,0,218
SANTIAGO DE HUARI,"anticoncepcion, prevencion de its y de cancer de cuello uterino",implante subdermico: usuarias nuevas,2016-03-01,0,0,5,0,0,5
SANTIAGO DE MACHACA,"anticoncepcion, prevencion de its y de cancer de cuello uterino",implante subdermico: usuarias nuevas,2016-03-01,0,0,1,0,0,1
SENA,"anticoncepcion, prevencion de its y de cancer de cuello uterino",implante subdermico: usuarias nuevas,2016-03-01,1,2,1,0,0,4
SICA SICA (VILLA AROMA),"anticoncepcion, prevencion de its y de cancer de cuello uterino",implante subdermico: usuarias nuevas,2016-03-01,0,1,2,0,0,3
SOPACHUY,"anticoncepcion, prevencion de its y de cancer de cuello uterino",implante subdermico: usuarias nuevas,2016-03-01,0,0,4,0,0,4
SORATA,"anticoncepcion, prevencion de its y de cancer de cuello uterino",implante subdermico: usuarias nuevas,2016-03-01,0,0,3,2,0,5
SUCRE,"anticoncepcion, prevencion de its y de cancer de cuello uterino",implante subdermico: usuarias nuevas,2016-03-01,0,21,120,14,0,155
TAPACARI,"anticoncepcion, prevencion de its y de cancer de cuello uterino",implante subdermico: usuarias nuevas,2016-03-01,0,0,4,2,0,6
TARABUCO,"anticoncepcion, prevencion de its y de cancer de cuello uterino",implante subdermico: usuarias nuevas,2016-03-01,0,0,5,2,0,7
TARIJA,"anticoncepcion, prevencion de its y de cancer de cuello uterino",implante subdermico: usuarias nuevas,2016-03-01,0,1,0,0,0,1
TEOPONTE,"anticoncepcion, prevencion de its y de cancer de cuello uterino",implante subdermico: usuarias nuevas,2016-03-01,0,0,3,0,0,3
TIAWANACU,"anticoncepcion, prevencion de its y de cancer de cuello uterino",implante subdermico: usuarias nuevas,2016-03-01,0,0,1,0,0,1
TINGUIPAYA,"anticoncepcion, prevencion de its y de cancer de cuello uterino",implante subdermico: usuarias nuevas,2016-03-01,0,0,1,2,0,3
TIPUANI,"anticoncepcion, prevencion de its y de cancer de cuello uterino",implante subdermico: usuarias nuevas,2016-03-01,0,1,3,2,0,6
TIQUIPAYA,"anticoncepcion, prevencion de its y de cancer de cuello uterino",implante subdermico: usuarias nuevas,2016-03-01,0,1,9,0,0,10
TIRAQUE (CBBA),"anticoncepcion, prevencion de its y de cancer de cuello uterino",implante subdermico: usuarias nuevas,2016-03-01,0,0,1,0,0,1
TODOS SANTOS,"anticoncepcion, prevencion de its y de cancer de cuello uterino",implante subdermico: usuarias nuevas,2016-03-01,0,0,1,0,0,1
TOLATA,"anticoncepcion, prevencion de its y de cancer de cuello uterino",implante subdermico: usuarias nuevas,2016-03-01,0,1,11,0,0,12
TOLEDO,"anticoncepcion, prevencion de its y de cancer de cuello uterino",implante subdermico: usuarias nuevas,2016-03-01,0,0,4,0,0,4
TOMINA,"anticoncepcion, prevencion de its y de cancer de cuello uterino",implante subdermico: usuarias nuevas,2016-03-01,0,1,3,0,0,4
TOTORA(CBBA),"anticoncepcion, prevencion de its y de cancer de cuello uterino",implante subdermico: usuarias nuevas,2016-03-01,0,2,7,1,0,10
TRINIDAD,"anticoncepcion, prevencion de its y de cancer de cuello uterino",implante subdermico: usuarias nuevas,2016-03-01,1,4,21,2,0,28
TUPIZA,"anticoncepcion, prevencion de its y de cancer de cuello uterino",implante subdermico: usuarias nuevas,2016-03-01,0,4,7,1,0,12
TURCO,"anticoncepcion, prevencion de its y de cancer de cuello uterino",implante subdermico: usuarias nuevas,2016-03-01,0,1,0,0,0,1
URIONDO (A. CONCEPCION),"anticoncepcion, prevencion de its y de cancer de cuello uterino",implante subdermico: usuarias nuevas,2016-03-01,0,1,11,0,0,12
UYUNI,"anticoncepcion, prevencion de its y de cancer de cuello uterino",implante subdermico: usuarias nuevas,2016-03-01,0,0,3,0,0,3
VIACHA,"anticoncepcion, prevencion de its y de cancer de cuello uterino",implante subdermico: usuarias nuevas,2016-03-01,0,2,4,1,0,7
VILLA SERRANO,"anticoncepcion, prevencion de its y de cancer de cuello uterino",implante subdermico: usuarias nuevas,2016-03-01,0,1,3,1,0,5
VILLA TUNARI,"anticoncepcion, prevencion de its y de cancer de cuello uterino",implante subdermico: usuarias nuevas,2016-03-01,0,6,2,3,0,11
VILLA VACA GUZMAN (MUYUPAMPA),"anticoncepcion, prevencion de its y de cancer de cuello uterino",implante subdermico: usuarias nuevas,2016-03-01,0,1,4,0,0,5
VILLAZON,"anticoncepcion, prevencion de its y de cancer de cuello uterino",implante subdermico: usuarias nuevas,2016-03-01,0,0,4,3,0,7
VINTO,"anticoncepcion, prevencion de its y de cancer de cuello uterino",implante subdermico: usuarias nuevas,2016-03-01,0,3,9,6,0,18
VITICHI,"anticoncepcion, prevencion de its y de cancer de cuello uterino",implante subdermico: usuarias nuevas,2016-03-01,0,0,6,4,0,10
YAMPARAEZ,"anticoncepcion, prevencion de its y de cancer de cuello uterino",implante subdermico: usuarias nuevas,2016-03-01,0,0,1,0,0,1
YOTALA,"anticoncepcion, prevencion de its y de cancer de cuello uterino",implante subdermico: usuarias nuevas,2016-03-01,0,0,1,0,0,1
ZUDAÑEZ,"anticoncepcion, prevencion de its y de cancer de cuello uterino",implante subdermico: usuarias nuevas,2016-03-01,0,2,2,0,0,4
ACHACACHI,"anticoncepcion, prevencion de its y de cancer de cuello uterino",implante subdermico: usuarias nuevas,2016-04-01,0,0,1,0,0,1
ACHOCALLA,"anticoncepcion, prevencion de its y de cancer de cuello uterino",implante subdermico: usuarias nuevas,2016-04-01,0,2,2,0,0,4
ALTO BENI,"anticoncepcion, prevencion de its y de cancer de cuello uterino",implante subdermico: usuarias nuevas,2016-04-01,0,0,4,0,0,4
ANDAMARCA,"anticoncepcion, prevencion de its y de cancer de cuello uterino",implante subdermico: usuarias nuevas,2016-04-01,0,0,3,0,0,3
ANTEQUERA,"anticoncepcion, prevencion de its y de cancer de cuello uterino",implante subdermico: usuarias nuevas,2016-04-01,0,0,3,1,0,4
APOLO,"anticoncepcion, prevencion de its y de cancer de cuello uterino",implante subdermico: usuarias nuevas,2016-04-01,0,0,1,1,0,2
ASCENCION DE GUARAYOS,"anticoncepcion, prevencion de its y de cancer de cuello uterino",implante subdermico: usuarias nuevas,2016-04-01,1,4,25,4,0,34
ATOCHA,"anticoncepcion, prevencion de its y de cancer de cuello uterino",implante subdermico: usuarias nuevas,2016-04-01,0,0,1,1,0,2
AYOPAYA (V. DE INDEPENDENCIA),"anticoncepcion, prevencion de its y de cancer de cuello uterino",implante subdermico: usuarias nuevas,2016-04-01,0,0,5,0,0,5
BATALLAS,"anticoncepcion, prevencion de its y de cancer de cuello uterino",implante subdermico: usuarias nuevas,2016-04-01,0,2,9,1,0,12
BAURES,"anticoncepcion, prevencion de its y de cancer de cuello uterino",implante subdermico: usuarias nuevas,2016-04-01,0,0,2,0,0,2
BELLA FLOR,"anticoncepcion, prevencion de its y de cancer de cuello uterino",implante subdermico: usuarias nuevas,2016-04-01,0,0,2,0,0,2
BERMEJO,"anticoncepcion, prevencion de its y de cancer de cuello uterino",implante subdermico: usuarias nuevas,2016-04-01,0,0,3,0,0,3
CAJUATA,"anticoncepcion, prevencion de its y de cancer de cuello uterino",implante subdermico: usuarias nuevas,2016-04-01,1,2,34,4,0,41
CAMARGO,"anticoncepcion, prevencion de its y de cancer de cuello uterino",implante subdermico: usuarias nuevas,2016-04-01,0,0,1,0,0,1
CAMATAQUI (C. VILLA ABECIA),"anticoncepcion, prevencion de its y de cancer de cuello uterino",implante subdermico: usuarias nuevas,2016-04-01,0,1,1,0,0,2
CAPINOTA,"anticoncepcion, prevencion de its y de cancer de cuello uterino",implante subdermico: usuarias nuevas,2016-04-01,0,7,15,2,0,24
CARACOLLO,"anticoncepcion, prevencion de its y de cancer de cuello uterino",implante subdermico: usuarias nuevas,2016-04-01,0,1,5,1,0,7
CARIPUYO,"anticoncepcion, prevencion de its y de cancer de cuello uterino",implante subdermico: usuarias nuevas,2016-04-01,0,4,3,0,0,7
CHALLAPATA,"anticoncepcion, prevencion de its y de cancer de cuello uterino",implante subdermico: usuarias nuevas,2016-04-01,0,0,10,1,0,11
CHULUMANI (V. DE LA LIBERTAD),"anticoncepcion, prevencion de its y de cancer de cuello uterino",implante subdermico: usuarias nuevas,2016-04-01,0,1,10,1,0,12
CHUQUIHUTA AYLLU JUCUMANI,"anticoncepcion, prevencion de its y de cancer de cuello uterino",implante subdermico: usuarias nuevas,2016-04-01,0,0,1,0,0,1
CKOCHAS,"anticoncepcion, prevencion de its y de cancer de cuello uterino",implante subdermico: usuarias nuevas,2016-04-01,0,0,2,0,0,2
CLIZA,"anticoncepcion, prevencion de its y de cancer de cuello uterino",implante subdermico: usuarias nuevas,2016-04-01,0,1,9,0,0,10
COBIJA,"anticoncepcion, prevencion de its y de cancer de cuello uterino",implante subdermico: usuarias nuevas,2016-04-01,2,5,5,0,0,12
COCAPATA,"anticoncepcion, prevencion de its y de cancer de cuello uterino",implante subdermico: usuarias nuevas,2016-04-01,0,0,2,0,0,2
COCHABAMBA,"anticoncepcion, prevencion de its y de cancer de cuello uterino",implante subdermico: usuarias nuevas,2016-04-01,1,6,85,23,1,116
COLCAPIRHUA,"anticoncepcion, prevencion de its y de cancer de cuello uterino",implante subdermico: usuarias nuevas,2016-04-01,0,3,37,2,0,42
COLOMI,"anticoncepcion, prevencion de its y de cancer de cuello uterino",implante subdermico: usuarias nuevas,2016-04-01,0,1,3,0,0,4
CORIPATA,"anticoncepcion, prevencion de its y de cancer de cuello uterino",implante subdermico: usuarias nuevas,2016-04-01,0,2,3,1,0,6
CORQUE,"anticoncepcion, prevencion de its y de cancer de cuello uterino",implante subdermico: usuarias nuevas,2016-04-01,0,1,4,0,0,5
COTAGAITA,"anticoncepcion, prevencion de its y de cancer de cuello uterino",implante subdermico: usuarias nuevas,2016-04-01,0,0,1,0,0,1
CULPINA,"anticoncepcion, prevencion de its y de cancer de cuello uterino",implante subdermico: usuarias nuevas,2016-04-01,0,0,2,0,0,2
EL ALTO,"anticoncepcion, prevencion de its y de cancer de cuello uterino",implante subdermico: usuarias nuevas,2016-04-01,0,18,129,46,0,193
EL CHORO,"anticoncepcion, prevencion de its y de cancer de cuello uterino",implante subdermico: usuarias nuevas,2016-04-01,0,0,2,0,0,2
EL TORNO,"anticoncepcion, prevencion de its y de cancer de cuello uterino",implante subdermico: usuarias nuevas,2016-04-01,0,1,5,1,0,7
ENTRE RIOS TRJ,"anticoncepcion, prevencion de its y de cancer de cuello uterino",implante subdermico: usuarias nuevas,2016-04-01,0,1,9,2,0,12
ENTRE RIOS CBBA,"anticoncepcion, prevencion de its y de cancer de cuello uterino",implante subdermico: usuarias nuevas,2016-04-01,0,0,5,1,0,6
ESCOMA,"anticoncepcion, prevencion de its y de cancer de cuello uterino",implante subdermico: usuarias nuevas,2016-04-01,0,0,3,0,0,3
ESMERALDA,"anticoncepcion, prevencion de its y de cancer de cuello uterino",implante subdermico: usuarias nuevas,2016-04-01,0,0,1,0,0,1
EUCALIPTUS,"anticoncepcion, prevencion de its y de cancer de cuello uterino",implante subdermico: usuarias nuevas,2016-04-01,0,0,2,0,0,2
FILADELFIA,"anticoncepcion, prevencion de its y de cancer de cuello uterino",implante subdermico: usuarias nuevas,2016-04-01,1,2,2,0,0,5
GUAQUI,"anticoncepcion, prevencion de its y de cancer de cuello uterino",implante subdermico: usuarias nuevas,2016-04-01,0,1,4,2,0,7
GUAYARAMERIN,"anticoncepcion, prevencion de its y de cancer de cuello uterino",implante subdermico: usuarias nuevas,2016-04-01,0,0,9,0,0,9
HUANUNI,"anticoncepcion, prevencion de its y de cancer de cuello uterino",implante subdermico: usuarias nuevas,2016-04-01,0,0,3,1,0,4
HUAYLLAMARCA,"anticoncepcion, prevencion de its y de cancer de cuello uterino",implante subdermico: usuarias nuevas,2016-04-01,0,0,1,0,0,1
ICLA,"anticoncepcion, prevencion de its y de cancer de cuello uterino",implante subdermico: usuarias nuevas,2016-04-01,0,0,0,1,1,2
INCAHUASI,"anticoncepcion, prevencion de its y de cancer de cuello uterino",implante subdermico: usuarias nuevas,2016-04-01,0,0,3,0,0,3
IRUPANA (VILLA DE LANZA),"anticoncepcion, prevencion de its y de cancer de cuello uterino",implante subdermico: usuarias nuevas,2016-04-01,0,1,3,4,0,8
LA ASUNTA,"anticoncepcion, prevencion de its y de cancer de cuello uterino",implante subdermico: usuarias nuevas,2016-04-01,0,1,46,0,0,47
LA GUARDIA,"anticoncepcion, prevencion de its y de cancer de cuello uterino",implante subdermico: usuarias nuevas,2016-04-01,0,6,14,2,0,22
LA PAZ,"anticoncepcion, prevencion de its y de cancer de cuello uterino",implante subdermico: usuarias nuevas,2016-04-01,0,22,138,40,0,200
LAJA,"anticoncepcion, prevencion de its y de cancer de cuello uterino",implante subdermico: usuarias nuevas,2016-04-01,0,0,3,0,0,3
LAS CARRERAS,"anticoncepcion, prevencion de its y de cancer de cuello uterino",implante subdermico: usuarias nuevas,2016-04-01,0,4,1,1,0,6
LLALLAGUA,"anticoncepcion, prevencion de its y de cancer de cuello uterino",implante subdermico: usuarias nuevas,2016-04-01,0,3,16,1,0,20
MACHACAMARCA,"anticoncepcion, prevencion de its y de cancer de cuello uterino",implante subdermico: usuarias nuevas,2016-04-01,0,2,4,0,0,6
MACHARETI,"anticoncepcion, prevencion de its y de cancer de cuello uterino",implante subdermico: usuarias nuevas,2016-04-01,0,1,1,0,0,2
MAGDALENA,"anticoncepcion, prevencion de its y de cancer de cuello uterino",implante subdermico: usuarias nuevas,2016-04-01,0,0,1,0,0,1
MECAPACA,"anticoncepcion, prevencion de its y de cancer de cuello uterino",implante subdermico: usuarias nuevas,2016-04-01,0,0,1,0,0,1
MIZQUE,"anticoncepcion, prevencion de its y de cancer de cuello uterino",implante subdermico: usuarias nuevas,2016-04-01,0,1,6,0,0,7
MOCOMOCO,"anticoncepcion, prevencion de its y de cancer de cuello uterino",implante subdermico: usuarias nuevas,2016-04-01,0,1,0,0,0,1
MOJOCOYA,"anticoncepcion, prevencion de its y de cancer de cuello uterino",implante subdermico: usuarias nuevas,2016-04-01,0,1,2,0,0,3
MONTEAGUDO,"anticoncepcion, prevencion de its y de cancer de cuello uterino",implante subdermico: usuarias nuevas,2016-04-01,0,1,5,1,0,7
ORURO,"anticoncepcion, prevencion de its y de cancer de cuello uterino",implante subdermico: usuarias nuevas,2016-04-01,0,6,36,3,0,45
PADILLA,"anticoncepcion, prevencion de its y de cancer de cuello uterino",implante subdermico: usuarias nuevas,2016-04-01,0,3,11,1,0,15
PAILON,"anticoncepcion, prevencion de its y de cancer de cuello uterino",implante subdermico: usuarias nuevas,2016-04-01,0,1,5,0,0,6
PAMPA AULLAGAS,"anticoncepcion, prevencion de its y de cancer de cuello uterino",implante subdermico: usuarias nuevas,2016-04-01,0,0,1,0,0,1
PAZÑA,"anticoncepcion, prevencion de its y de cancer de cuello uterino",implante subdermico: usuarias nuevas,2016-04-01,0,0,4,0,0,4
POTOSI,"anticoncepcion, prevencion de its y de cancer de cuello uterino",implante subdermico: usuarias nuevas,2016-04-01,0,13,69,25,0,107
PRESTO,"anticoncepcion, prevencion de its y de cancer de cuello uterino",implante subdermico: usuarias nuevas,2016-04-01,0,0,5,4,0,9
PUCARANI,"anticoncepcion, prevencion de its y de cancer de cuello uterino",implante subdermico: usuarias nuevas,2016-04-01,0,1,1,0,0,2
PUERTO GONZALO MORENO,"anticoncepcion, prevencion de its y de cancer de cuello uterino",implante subdermico: usuarias nuevas,2016-04-01,0,3,1,0,0,4
PUERTO RICO,"anticoncepcion, prevencion de its y de cancer de cuello uterino",implante subdermico: usuarias nuevas,2016-04-01,0,4,0,0,0,4
PUERTO VILLARROEL,"anticoncepcion, prevencion de its y de cancer de cuello uterino",implante subdermico: usuarias nuevas,2016-04-01,0,1,6,3,0,10
PUNA,"anticoncepcion, prevencion de its y de cancer de cuello uterino",implante subdermico: usuarias nuevas,2016-04-01,0,5,12,3,0,20
QUILLACOLLO,"anticoncepcion, prevencion de its y de cancer de cuello uterino",implante subdermico: usuarias nuevas,2016-04-01,0,1,18,6,0,25
RIBERALTA,"anticoncepcion, prevencion de its y de cancer de cuello uterino",implante subdermico: usuarias nuevas,2016-04-01,3,20,31,3,0,57
ROBORE,"anticoncepcion, prevencion de its y de cancer de cuello uterino",implante subdermico: usuarias nuevas,2016-04-01,0,0,1,0,0,1
RURRENABAQUE,"anticoncepcion, prevencion de its y de cancer de cuello uterino",implante subdermico: usuarias nuevas,2016-04-01,0,1,3,1,0,5
SABAYA,"anticoncepcion, prevencion de its y de cancer de cuello uterino",implante subdermico: usuarias nuevas,2016-04-01,0,0,1,0,0,1
SACABA,"anticoncepcion, prevencion de its y de cancer de cuello uterino",implante subdermico: usuarias nuevas,2016-04-01,0,0,3,2,0,5
SACACA,"anticoncepcion, prevencion de its y de cancer de cuello uterino",implante subdermico: usuarias nuevas,2016-04-01,0,1,13,0,0,14
SALINAS DE GARCI MENDOZA,"anticoncepcion, prevencion de its y de cancer de cuello uterino",implante subdermico: usuarias nuevas,2016-04-01,0,0,1,0,0,1
SAN BORJA,"anticoncepcion, prevencion de its y de cancer de cuello uterino",implante subdermico: usuarias nuevas,2016-04-01,0,2,0,0,0,2
SAN CARLOS,"anticoncepcion, prevencion de its y de cancer de cuello uterino",implante subdermico: usuarias nuevas,2016-04-01,1,3,10,5,0,19
SAN IGNACIO,"anticoncepcion, prevencion de its y de cancer de cuello uterino",implante subdermico: usuarias nuevas,2016-04-01,0,1,1,1,0,3
SAN JUAN DE YAPACANI,"anticoncepcion, prevencion de its y de cancer de cuello uterino",implante subdermico: usuarias nuevas,2016-04-01,0,0,3,0,0,3
SAN JULIAN,"anticoncepcion, prevencion de its y de cancer de cuello uterino",implante subdermico: usuarias nuevas,2016-04-01,0,10,30,0,0,40
SAN LORENZO(PND),"anticoncepcion, prevencion de its y de cancer de cuello uterino",implante subdermico: usuarias nuevas,2016-04-01,0,1,0,0,0,1
SAN LUCAS,"anticoncepcion, prevencion de its y de cancer de cuello uterino",implante subdermico: usuarias nuevas,2016-04-01,0,2,2,1,0,5
SAN PEDRO,"anticoncepcion, prevencion de its y de cancer de cuello uterino",implante subdermico: usuarias nuevas,2016-04-01,0,1,21,1,0,23
SANTA ANA,"anticoncepcion, prevencion de its y de cancer de cuello uterino",implante subdermico: usuarias nuevas,2016-04-01,0,0,1,0,0,1
SANTA CRUZ DE LA SIERRA,"anticoncepcion, prevencion de its y de cancer de cuello uterino",implante subdermico: usuarias nuevas,2016-04-01,0,65,167,60,0,292
SANTIAGO DE HUARI,"anticoncepcion, prevencion de its y de cancer de cuello uterino",implante subdermico: usuarias nuevas,2016-04-01,0,1,3,0,0,4
SANTIAGO DE MACHACA,"anticoncepcion, prevencion de its y de cancer de cuello uterino",implante subdermico: usuarias nuevas,2016-04-01,0,0,2,0,0,2
SANTUARIO DE QUILLACAS,"anticoncepcion, prevencion de its y de cancer de cuello uterino",implante subdermico: usuarias nuevas,2016-04-01,0,0,1,0,0,1
SENA,"anticoncepcion, prevencion de its y de cancer de cuello uterino",implante subdermico: usuarias nuevas,2016-04-01,0,1,5,3,0,9
SICA SICA (VILLA AROMA),"anticoncepcion, prevencion de its y de cancer de cuello uterino",implante subdermico: usuarias nuevas,2016-04-01,0,1,5,0,0,6
SOPACHUY,"anticoncepcion, prevencion de its y de cancer de cuello uterino",implante subdermico: usuarias nuevas,2016-04-01,0,0,1,1,0,2
SORATA,"anticoncepcion, prevencion de its y de cancer de cuello uterino",implante subdermico: usuarias nuevas,2016-04-01,0,0,5,1,0,6
SUCRE,"anticoncepcion, prevencion de its y de cancer de cuello uterino",implante subdermico: usuarias nuevas,2016-04-01,0,30,176,18,0,224
TAPACARI,"anticoncepcion, prevencion de its y de cancer de cuello uterino",implante subdermico: usuarias nuevas,2016-04-01,0,1,7,1,0,9
TARABUCO,"anticoncepcion, prevencion de its y de cancer de cuello uterino",implante subdermico: usuarias nuevas,2016-04-01,0,1,8,1,0,10
TARATA,"anticoncepcion, prevencion de its y de cancer de cuello uterino",implante subdermico: usuarias nuevas,2016-04-01,0,0,0,1,0,1
TARIJA,"anticoncepcion, prevencion de its y de cancer de cuello uterino",implante subdermico: usuarias nuevas,2016-04-01,0,16,128,8,0,152
TARVITA,"anticoncepcion, prevencion de its y de cancer de cuello uterino",implante subdermico: usuarias nuevas,2016-04-01,0,1,0,0,0,1
TIAWANACU,"anticoncepcion, prevencion de its y de cancer de cuello uterino",implante subdermico: usuarias nuevas,2016-04-01,0,0,1,0,0,1
TINGUIPAYA,"anticoncepcion, prevencion de its y de cancer de cuello uterino",implante subdermico: usuarias nuevas,2016-04-01,0,1,1,0,0,2
TIPUANI,"anticoncepcion, prevencion de its y de cancer de cuello uterino",implante subdermico: usuarias nuevas,2016-04-01,0,0,8,1,0,9
TIQUIPAYA,"anticoncepcion, prevencion de its y de cancer de cuello uterino",implante subdermico: usuarias nuevas,2016-04-01,0,1,1,0,0,2
TOLEDO,"anticoncepcion, prevencion de its y de cancer de cuello uterino",implante subdermico: usuarias nuevas,2016-04-01,0,1,5,0,0,6
TOMINA,"anticoncepcion, prevencion de its y de cancer de cuello uterino",implante subdermico: usuarias nuevas,2016-04-01,0,0,5,0,0,5
TOTORA(CBBA),"anticoncepcion, prevencion de its y de cancer de cuello uterino",implante subdermico: usuarias nuevas,2016-04-01,0,1,8,0,0,9
TRINIDAD,"anticoncepcion, prevencion de its y de cancer de cuello uterino",implante subdermico: usuarias nuevas,2016-04-01,0,4,30,4,0,38
TUPIZA,"anticoncepcion, prevencion de its y de cancer de cuello uterino",implante subdermico: usuarias nuevas,2016-04-01,0,2,20,4,0,26
TURCO,"anticoncepcion, prevencion de its y de cancer de cuello uterino",implante subdermico: usuarias nuevas,2016-04-01,0,0,0,1,0,1
URIONDO (A. CONCEPCION),"anticoncepcion, prevencion de its y de cancer de cuello uterino",implante subdermico: usuarias nuevas,2016-04-01,0,0,1,0,0,1
VIACHA,"anticoncepcion, prevencion de its y de cancer de cuello uterino",implante subdermico: usuarias nuevas,2016-04-01,0,0,7,0,0,7
VILLA CHARCAS,"anticoncepcion, prevencion de its y de cancer de cuello uterino",implante subdermico: usuarias nuevas,2016-04-01,0,1,5,1,0,7
VILLA SERRANO,"anticoncepcion, prevencion de its y de cancer de cuello uterino",implante subdermico: usuarias nuevas,2016-04-01,0,1,1,0,0,2
VILLA VACA GUZMAN (MUYUPAMPA),"anticoncepcion, prevencion de its y de cancer de cuello uterino",implante subdermico: usuarias nuevas,2016-04-01,0,2,9,1,0,12
VILLAZON,"anticoncepcion, prevencion de its y de cancer de cuello uterino",implante subdermico: usuarias nuevas,2016-04-01,0,0,5,1,0,6
VINTO,"anticoncepcion, prevencion de its y de cancer de cuello uterino",implante subdermico: usuarias nuevas,2016-04-01,0,0,3,0,0,3
VITICHI,"anticoncepcion, prevencion de its y de cancer de cuello uterino",implante subdermico: usuarias nuevas,2016-04-01,0,0,4,0,0,4
WARNES,"anticoncepcion, prevencion de its y de cancer de cuello uterino",implante subdermico: usuarias nuevas,2016-04-01,0,5,20,3,0,28
YANACACHI,"anticoncepcion, prevencion de its y de cancer de cuello uterino",implante subdermico: usuarias nuevas,2016-04-01,0,0,2,2,0,4
YAPACANI,"anticoncepcion, prevencion de its y de cancer de cuello uterino",implante subdermico: usuarias nuevas,2016-04-01,0,0,3,0,0,3
YOCALLA,"anticoncepcion, prevencion de its y de cancer de cuello uterino",implante subdermico: usuarias nuevas,2016-04-01,0,0,6,3,0,9
YOTALA,"anticoncepcion, prevencion de its y de cancer de cuello uterino",implante subdermico: usuarias nuevas,2016-04-01,0,0,2,0,0,2
ACACIO,"anticoncepcion, prevencion de its y de cancer de cuello uterino",implante subdermico: usuarias nuevas,2016-05-01,0,1,1,0,0,2
ACHACACHI,"anticoncepcion, prevencion de its y de cancer de cuello uterino",implante subdermico: usuarias nuevas,2016-05-01,0,1,0,0,0,1
ACHOCALLA,"anticoncepcion, prevencion de its y de cancer de cuello uterino",implante subdermico: usuarias nuevas,2016-05-01,0,0,10,1,0,11
AIQUILE,"anticoncepcion, prevencion de its y de cancer de cuello uterino",implante subdermico: usuarias nuevas,2016-05-01,0,10,12,1,0,23
ANTEQUERA,"anticoncepcion, prevencion de its y de cancer de cuello uterino",implante subdermico: usuarias nuevas,2016-05-01,0,0,1,0,0,1
APOLO,"anticoncepcion, prevencion de its y de cancer de cuello uterino",implante subdermico: usuarias nuevas,2016-05-01,0,1,0,0,0,1
ATOCHA,"anticoncepcion, prevencion de its y de cancer de cuello uterino",implante subdermico: usuarias nuevas,2016-05-01,0,1,7,0,0,8
AYATA,"anticoncepcion, prevencion de its y de cancer de cuello uterino",implante subdermico: usuarias nuevas,2016-05-01,0,0,2,0,0,2
AYOPAYA (V. DE INDEPENDENCIA),"anticoncepcion, prevencion de its y de cancer de cuello uterino",implante subdermico: usuarias nuevas,2016-05-01,0,0,2,0,0,2
BATALLAS,"anticoncepcion, prevencion de its y de cancer de cuello uterino",implante subdermico: usuarias nuevas,2016-05-01,0,0,1,1,0,2
BELLA FLOR,"anticoncepcion, prevencion de its y de cancer de cuello uterino",implante subdermico: usuarias nuevas,2016-05-01,0,0,3,0,0,3
BERMEJO,"anticoncepcion, prevencion de its y de cancer de cuello uterino",implante subdermico: usuarias nuevas,2016-05-01,0,0,3,1,0,4
BETANZOS,"anticoncepcion, prevencion de its y de cancer de cuello uterino",implante subdermico: usuarias nuevas,2016-05-01,0,1,2,0,0,3
CABEZAS,"anticoncepcion, prevencion de its y de cancer de cuello uterino",implante subdermico: usuarias nuevas,2016-05-01,0,5,32,2,0,39
"CAIZA ""D""","anticoncepcion, prevencion de its y de cancer de cuello uterino",implante subdermico: usuarias nuevas,2016-05-01,0,2,7,0,0,9
CAMARGO,"anticoncepcion, prevencion de its y de cancer de cuello uterino",implante subdermico: usuarias nuevas,2016-05-01,0,1,0,0,0,1
CAMATAQUI (C. VILLA ABECIA),"anticoncepcion, prevencion de its y de cancer de cuello uterino",implante subdermico: usuarias nuevas,2016-05-01,0,1,1,0,0,2
CAPINOTA,"anticoncepcion, prevencion de its y de cancer de cuello uterino",implante subdermico: usuarias nuevas,2016-05-01,0,0,10,1,0,11
CARIPUYO,"anticoncepcion, prevencion de its y de cancer de cuello uterino",implante subdermico: usuarias nuevas,2016-05-01,0,1,1,0,0,2
CHALLAPATA,"anticoncepcion, prevencion de its y de cancer de cuello uterino",implante subdermico: usuarias nuevas,2016-05-01,0,0,4,0,0,4
CHAYANTA,"anticoncepcion, prevencion de its y de cancer de cuello uterino",implante subdermico: usuarias nuevas,2016-05-01,0,0,1,0,0,1
CHULUMANI (V. DE LA LIBERTAD),"anticoncepcion, prevencion de its y de cancer de cuello uterino",implante subdermico: usuarias nuevas,2016-05-01,0,0,5,3,0,8
CHUMA,"anticoncepcion, prevencion de its y de cancer de cuello uterino",implante subdermico: usuarias nuevas,2016-05-01,0,1,0,3,0,4
CLIZA,"anticoncepcion, prevencion de its y de cancer de cuello uterino",implante subdermico: usuarias nuevas,2016-05-01,0,0,10,0,0,10
COBIJA,"anticoncepcion, prevencion de its y de cancer de cuello uterino",implante subdermico: usuarias nuevas,2016-05-01,0,3,5,0,0,8
COCAPATA,"anticoncepcion, prevencion de its y de cancer de cuello uterino",implante subdermico: usuarias nuevas,2016-05-01,0,0,3,1,0,4
COCHABAMBA,"anticoncepcion, prevencion de its y de cancer de cuello uterino",implante subdermico: usuarias nuevas,2016-05-01,0,6,65,21,0,92
COLCAPIRHUA,"anticoncepcion, prevencion de its y de cancer de cuello uterino",implante subdermico: usuarias nuevas,2016-05-01,0,1,3,0,0,4
COLOMI,"anticoncepcion, prevencion de its y de cancer de cuello uterino",implante subdermico: usuarias nuevas,2016-05-01,0,0,3,0,0,3
CORIPATA,"anticoncepcion, prevencion de its y de cancer de cuello uterino",implante subdermico: usuarias nuevas,2016-05-01,0,0,2,0,0,2
COROICO,"anticoncepcion, prevencion de its y de cancer de cuello uterino",implante subdermico: usuarias nuevas,2016-05-01,0,0,1,0,0,1
CORQUE,"anticoncepcion, prevencion de its y de cancer de cuello uterino",implante subdermico: usuarias nuevas,2016-05-01,0,0,3,0,0,3
COTAGAITA,"anticoncepcion, prevencion de its y de cancer de cuello uterino",implante subdermico: usuarias nuevas,2016-05-01,0,3,8,0,0,11
CULPINA,"anticoncepcion, prevencion de its y de cancer de cuello uterino",implante subdermico: usuarias nuevas,2016-05-01,0,0,4,2,0,6
CURVA,"anticoncepcion, prevencion de its y de cancer de cuello uterino",implante subdermico: usuarias nuevas,2016-05-01,0,0,1,0,0,1
EL ALTO,"anticoncepcion, prevencion de its y de cancer de cuello uterino",implante subdermico: usuarias nuevas,2016-05-01,0,17,162,48,0,227
EL TORNO,"anticoncepcion, prevencion de its y de cancer de cuello uterino",implante subdermico: usuarias nuevas,2016-05-01,0,0,3,0,0,3
ENTRE RIOS TRJ,"anticoncepcion, prevencion de its y de cancer de cuello uterino",implante subdermico: usuarias nuevas,2016-05-01,0,3,6,0,0,9
ENTRE RIOS CBBA,"anticoncepcion, prevencion de its y de cancer de cuello uterino",implante subdermico: usuarias nuevas,2016-05-01,0,1,22,1,0,24
ESCOMA,"anticoncepcion, prevencion de its y de cancer de cuello uterino",implante subdermico: usuarias nuevas,2016-05-01,0,0,2,0,0,2
EUCALIPTUS,"anticoncepcion, prevencion de its y de cancer de cuello uterino",implante subdermico: usuarias nuevas,2016-05-01,0,0,1,2,0,3
EUREKA (SANTOS MERCADO),"anticoncepcion, prevencion de its y de cancer de cuello uterino",implante subdermico: usuarias nuevas,2016-05-01,0,0,1,0,0,1
FILADELFIA,"anticoncepcion, prevencion de its y de cancer de cuello uterino",implante subdermico: usuarias nuevas,2016-05-01,0,0,2,1,0,3
GUAYARAMERIN,"anticoncepcion, prevencion de its y de cancer de cuello uterino",implante subdermico: usuarias nuevas,2016-05-01,1,22,48,10,0,81
HUACARETA,"anticoncepcion, prevencion de its y de cancer de cuello uterino",implante subdermico: usuarias nuevas,2016-05-01,0,1,13,0,0,14
HUANUNI,"anticoncepcion, prevencion de its y de cancer de cuello uterino",implante subdermico: usuarias nuevas,2016-05-01,0,1,7,1,0,9
HUAYLLAMARCA,"anticoncepcion, prevencion de its y de cancer de cuello uterino",implante subdermico: usuarias nuevas,2016-05-01,0,0,1,0,0,1
ICHOCA,"anticoncepcion, prevencion de its y de cancer de cuello uterino",implante subdermico: usuarias nuevas,2016-05-01,0,0,1,0,0,1
ICLA,"anticoncepcion, prevencion de its y de cancer de cuello uterino",implante subdermico: usuarias nuevas,2016-05-01,0,0,2,1,0,3
INCAHUASI,"anticoncepcion, prevencion de its y de cancer de cuello uterino",implante subdermico: usuarias nuevas,2016-05-01,0,0,2,0,0,2
IRUPANA (VILLA DE LANZA),"anticoncepcion, prevencion de its y de cancer de cuello uterino",implante subdermico: usuarias nuevas,2016-05-01,0,1,9,1,0,11
LA ASUNTA,"anticoncepcion, prevencion de its y de cancer de cuello uterino",implante subdermico: usuarias nuevas,2016-05-01,0,5,24,1,0,30
LA GUARDIA,"anticoncepcion, prevencion de its y de cancer de cuello uterino",implante subdermico: usuarias nuevas,2016-05-01,0,2,7,0,0,9
LA PAZ,"anticoncepcion, prevencion de its y de cancer de cuello uterino",implante subdermico: usuarias nuevas,2016-05-01,0,24,140,26,0,190
LAS CARRERAS,"anticoncepcion, prevencion de its y de cancer de cuello uterino",implante subdermico: usuarias nuevas,2016-05-01,0,1,4,1,0,6
LLALLAGUA,"anticoncepcion, prevencion de its y de cancer de cuello uterino",implante subdermico: usuarias nuevas,2016-05-01,0,2,19,4,0,25
MACHARETI,"anticoncepcion, prevencion de its y de cancer de cuello uterino",implante subdermico: usuarias nuevas,2016-05-01,0,0,1,0,0,1
MAPIRI,"anticoncepcion, prevencion de its y de cancer de cuello uterino",implante subdermico: usuarias nuevas,2016-05-01,0,1,7,1,0,9
MIZQUE,"anticoncepcion, prevencion de its y de cancer de cuello uterino",implante subdermico: usuarias nuevas,2016-05-01,0,1,4,2,0,7
MOCOMOCO,"anticoncepcion, prevencion de its y de cancer de cuello uterino",implante subdermico: usuarias nuevas,2016-05-01,0,0,2,0,0,2
MOJOCOYA,"anticoncepcion, prevencion de its y de cancer de cuello uterino",implante subdermico: usuarias nuevas,2016-05-01,0,1,3,0,0,4
MONTEAGUDO,"anticoncepcion, prevencion de its y de cancer de cuello uterino",implante subdermico: usuarias nuevas,2016-05-01,0,3,0,0,0,3
ORURO,"anticoncepcion, prevencion de its y de cancer de cuello uterino",implante subdermico: usuarias nuevas,2016-05-01,0,8,75,7,0,90
PADILLA,"anticoncepcion, prevencion de its y de cancer de cuello uterino",implante subdermico: usuarias nuevas,2016-05-01,0,2,5,1,0,8
PAILON,"anticoncepcion, prevencion de its y de cancer de cuello uterino",implante subdermico: usuarias nuevas,2016-05-01,0,0,18,1,0,19
PALCA,"anticoncepcion, prevencion de its y de cancer de cuello uterino",implante subdermico: usuarias nuevas,2016-05-01,0,0,1,0,0,1
PAMPA AULLAGAS,"anticoncepcion, prevencion de its y de cancer de cuello uterino",implante subdermico: usuarias nuevas,2016-05-01,0,1,0,0,0,1
PASORAPA,"anticoncepcion, prevencion de its y de cancer de cuello uterino",implante subdermico: usuarias nuevas,2016-05-01,0,0,1,0,0,1
PAZÑA,"anticoncepcion, prevencion de its y de cancer de cuello uterino",implante subdermico: usuarias nuevas,2016-05-01,0,0,1,0,0,1
POCOATA,"anticoncepcion, prevencion de its y de cancer de cuello uterino",implante subdermico: usuarias nuevas,2016-05-01,0,0,0,1,0,1
POJO (CBBA),"anticoncepcion, prevencion de its y de cancer de cuello uterino",implante subdermico: usuarias nuevas,2016-05-01,0,1,0,0,0,1
PORCO,"anticoncepcion, prevencion de its y de cancer de cuello uterino",implante subdermico: usuarias nuevas,2016-05-01,0,0,0,2,0,2
POTOSI,"anticoncepcion, prevencion de its y de cancer de cuello uterino",implante subdermico: usuarias nuevas,2016-05-01,0,10,52,24,0,86
PRESTO,"anticoncepcion, prevencion de its y de cancer de cuello uterino",implante subdermico: usuarias nuevas,2016-05-01,0,0,3,0,0,3
PUCARANI,"anticoncepcion, prevencion de its y de cancer de cuello uterino",implante subdermico: usuarias nuevas,2016-05-01,0,1,1,0,0,2
PUERTO GONZALO MORENO,"anticoncepcion, prevencion de its y de cancer de cuello uterino",implante subdermico: usuarias nuevas,2016-05-01,0,0,1,1,0,2
PUERTO QUIJARRO,"anticoncepcion, prevencion de its y de cancer de cuello uterino",implante subdermico: usuarias nuevas,2016-05-01,0,2,8,0,0,10
PUERTO RICO,"anticoncepcion, prevencion de its y de cancer de cuello uterino",implante subdermico: usuarias nuevas,2016-05-01,0,1,0,0,0,1
PUERTO VILLARROEL,"anticoncepcion, prevencion de its y de cancer de cuello uterino",implante subdermico: usuarias nuevas,2016-05-01,0,0,1,0,0,1
PUNA,"anticoncepcion, prevencion de its y de cancer de cuello uterino",implante subdermico: usuarias nuevas,2016-05-01,1,4,9,3,0,17
QUIABAYA,"anticoncepcion, prevencion de its y de cancer de cuello uterino",implante subdermico: usuarias nuevas,2016-05-01,0,2,11,3,2,18
QUILLACOLLO,"anticoncepcion, prevencion de its y de cancer de cuello uterino",implante subdermico: usuarias nuevas,2016-05-01,0,0,7,0,0,7
RIBERALTA,"anticoncepcion, prevencion de its y de cancer de cuello uterino",implante subdermico: usuarias nuevas,2016-05-01,2,23,22,0,0,47
ROBORE,"anticoncepcion, prevencion de its y de cancer de cuello uterino",implante subdermico: usuarias nuevas,2016-05-01,0,0,18,3,0,21
RURRENABAQUE,"anticoncepcion, prevencion de its y de cancer de cuello uterino",implante subdermico: usuarias nuevas,2016-05-01,0,0,3,0,0,3
SABAYA,"anticoncepcion, prevencion de its y de cancer de cuello uterino",implante subdermico: usuarias nuevas,2016-05-01,0,0,1,0,0,1
SACABA,"anticoncepcion, prevencion de its y de cancer de cuello uterino",implante subdermico: usuarias nuevas,2016-05-01,0,0,20,14,0,34
SALINAS DE GARCI MENDOZA,"anticoncepcion, prevencion de its y de cancer de cuello uterino",implante subdermico: usuarias nuevas,2016-05-01,0,0,3,1,0,4
SAN BORJA,"anticoncepcion, prevencion de its y de cancer de cuello uterino",implante subdermico: usuarias nuevas,2016-05-01,0,7,27,5,0,39
SAN BUENA VENTURA,"anticoncepcion, prevencion de its y de cancer de cuello uterino",implante subdermico: usuarias nuevas,2016-05-01,0,1,0,0,0,1
SAN CARLOS,"anticoncepcion, prevencion de its y de cancer de cuello uterino",implante subdermico: usuarias nuevas,2016-05-01,2,2,21,3,0,28
SAN IGNACIO,"anticoncepcion, prevencion de its y de cancer de cuello uterino",implante subdermico: usuarias nuevas,2016-05-01,0,7,2,0,0,9
SAN JOAQUIN,"anticoncepcion, prevencion de its y de cancer de cuello uterino",implante subdermico: usuarias nuevas,2016-05-01,0,0,1,0,0,1
SAN JULIAN,"anticoncepcion, prevencion de its y de cancer de cuello uterino",implante subdermico: usuarias nuevas,2016-05-01,0,0,15,1,0,16
SAN LORENZO(PND),"anticoncepcion, prevencion de its y de cancer de cuello uterino",implante subdermico: usuarias nuevas,2016-05-01,0,1,2,0,0,3
SAN LUCAS,"anticoncepcion, prevencion de its y de cancer de cuello uterino",implante subdermico: usuarias nuevas,2016-05-01,0,0,6,2,0,8
SANTA CRUZ DE LA SIERRA,"anticoncepcion, prevencion de its y de cancer de cuello uterino",implante subdermico: usuarias nuevas,2016-05-01,0,67,173,84,0,324
SENA,"anticoncepcion, prevencion de its y de cancer de cuello uterino",implante subdermico: usuarias nuevas,2016-05-01,0,2,0,0,0,2
SICA SICA (VILLA AROMA),"anticoncepcion, prevencion de its y de cancer de cuello uterino",implante subdermico: usuarias nuevas,2016-05-01,0,1,6,0,0,7
SOPACHUY,"anticoncepcion, prevencion de its y de cancer de cuello uterino",implante subdermico: usuarias nuevas,2016-05-01,0,1,5,1,0,7
SORATA,"anticoncepcion, prevencion de its y de cancer de cuello uterino",implante subdermico: usuarias nuevas,2016-05-01,0,0,3,1,0,4
SUCRE,"anticoncepcion, prevencion de its y de cancer de cuello uterino",implante subdermico: usuarias nuevas,2016-05-01,0,42,183,28,0,253
TAPACARI,"anticoncepcion, prevencion de its y de cancer de cuello uterino",implante subdermico: usuarias nuevas,2016-05-01,0,3,5,1,0,9
TARABUCO,"anticoncepcion, prevencion de its y de cancer de cuello uterino",implante subdermico: usuarias nuevas,2016-05-01,0,0,5,1,0,6
TARATA,"anticoncepcion, prevencion de its y de cancer de cuello uterino",implante subdermico: usuarias nuevas,2016-05-01,0,0,1,0,0,1
TARIJA,"anticoncepcion, prevencion de its y de cancer de cuello uterino",implante subdermico: usuarias nuevas,2016-05-01,0,6,47,53,0,106
TARVITA,"anticoncepcion, prevencion de its y de cancer de cuello uterino",implante subdermico: usuarias nuevas,2016-05-01,0,2,0,0,0,2
TIAWANACU,"anticoncepcion, prevencion de its y de cancer de cuello uterino",implante subdermico: usuarias nuevas,2016-05-01,0,5,8,4,0,17
TINGUIPAYA,"anticoncepcion, prevencion de its y de cancer de cuello uterino",implante subdermico: usuarias nuevas,2016-05-01,0,0,2,0,0,2
TIPUANI,"anticoncepcion, prevencion de its y de cancer de cuello uterino",implante subdermico: usuarias nuevas,2016-05-01,0,1,4,0,0,5
TIQUIPAYA,"anticoncepcion, prevencion de its y de cancer de cuello uterino",implante subdermico: usuarias nuevas,2016-05-01,0,1,2,0,0,3
TIRAQUE (CBBA),"anticoncepcion, prevencion de its y de cancer de cuello uterino",implante subdermico: usuarias nuevas,2016-05-01,0,0,1,0,0,1
TOLEDO,"anticoncepcion, prevencion de its y de cancer de cuello uterino",implante subdermico: usuarias nuevas,2016-05-01,0,0,1,0,0,1
TORO TORO,"anticoncepcion, prevencion de its y de cancer de cuello uterino",implante subdermico: usuarias nuevas,2016-05-01,0,3,6,0,0,9
TRINIDAD,"anticoncepcion, prevencion de its y de cancer de cuello uterino",implante subdermico: usuarias nuevas,2016-05-01,0,5,47,0,0,52
TUPIZA,"anticoncepcion, prevencion de its y de cancer de cuello uterino",implante subdermico: usuarias nuevas,2016-05-01,0,3,20,5,0,28
TURCO,"anticoncepcion, prevencion de its y de cancer de cuello uterino",implante subdermico: usuarias nuevas,2016-05-01,0,0,1,0,0,1
URIONDO (A. CONCEPCION),"anticoncepcion, prevencion de its y de cancer de cuello uterino",implante subdermico: usuarias nuevas,2016-05-01,0,2,1,0,0,3
VIACHA,"anticoncepcion, prevencion de its y de cancer de cuello uterino",implante subdermico: usuarias nuevas,2016-05-01,0,2,12,4,0,18
VILLA CHARCAS,"anticoncepcion, prevencion de its y de cancer de cuello uterino",implante subdermico: usuarias nuevas,2016-05-01,0,0,2,1,0,3
VILLA SERRANO,"anticoncepcion, prevencion de its y de cancer de cuello uterino",implante subdermico: usuarias nuevas,2016-05-01,0,2,5,0,0,7
VILLA TUNARI,"anticoncepcion, prevencion de its y de cancer de cuello uterino",implante subdermico: usuarias nuevas,2016-05-01,0,3,4,6,0,13
VILLA VACA GUZMAN (MUYUPAMPA),"anticoncepcion, prevencion de its y de cancer de cuello uterino",implante subdermico: usuarias nuevas,2016-05-01,0,1,2,1,0,4
VILLAZON,"anticoncepcion, prevencion de its y de cancer de cuello uterino",implante subdermico: usuarias nuevas,2016-05-01,0,2,13,2,0,17
VINTO,"anticoncepcion, prevencion de its y de cancer de cuello uterino",implante subdermico: usuarias nuevas,2016-05-01,0,0,6,0,0,6
VITICHI,"anticoncepcion, prevencion de its y de cancer de cuello uterino",implante subdermico: usuarias nuevas,2016-05-01,0,0,2,2,0,4
WARNES,"anticoncepcion, prevencion de its y de cancer de cuello uterino",implante subdermico: usuarias nuevas,2016-05-01,1,13,14,1,0,29
YAMPARAEZ,"anticoncepcion, prevencion de its y de cancer de cuello uterino",implante subdermico: usuarias nuevas,2016-05-01,0,2,1,2,0,5
YOTALA,"anticoncepcion, prevencion de its y de cancer de cuello uterino",implante subdermico: usuarias nuevas,2016-05-01,0,1,3,2,0,6
ZUDAÑEZ,"anticoncepcion, prevencion de its y de cancer de cuello uterino",implante subdermico: usuarias nuevas,2016-05-01,0,1,2,0,0,3
ACACIO,"anticoncepcion, prevencion de its y de cancer de cuello uterino",implante subdermico: usuarias nuevas,2016-06-01,0,2,0,1,0,3
ACHACACHI,"anticoncepcion, prevencion de its y de cancer de cuello uterino",implante subdermico: usuarias nuevas,2016-06-01,0,0,1,0,0,1
ACHOCALLA,"anticoncepcion, prevencion de its y de cancer de cuello uterino",implante subdermico: usuarias nuevas,2016-06-01,0,0,11,2,0,13
AIQUILE,"anticoncepcion, prevencion de its y de cancer de cuello uterino",implante subdermico: usuarias nuevas,2016-06-01,0,6,13,0,0,19
ALTO BENI,"anticoncepcion, prevencion de its y de cancer de cuello uterino",implante subdermico: usuarias nuevas,2016-06-01,0,0,3,0,0,3
ANTEQUERA,"anticoncepcion, prevencion de its y de cancer de cuello uterino",implante subdermico: usuarias nuevas,2016-06-01,0,0,3,1,0,4
APOLO,"anticoncepcion, prevencion de its y de cancer de cuello uterino",implante subdermico: usuarias nuevas,2016-06-01,0,1,6,2,0,9
ASCENCION DE GUARAYOS,"anticoncepcion, prevencion de its y de cancer de cuello uterino",implante subdermico: usuarias nuevas,2016-06-01,0,0,5,15,0,20
ATOCHA,"anticoncepcion, prevencion de its y de cancer de cuello uterino",implante subdermico: usuarias nuevas,2016-06-01,0,1,0,1,0,2
AYATA,"anticoncepcion, prevencion de its y de cancer de cuello uterino",implante subdermico: usuarias nuevas,2016-06-01,0,0,2,1,0,3
AYOPAYA (V. DE INDEPENDENCIA),"anticoncepcion, prevencion de its y de cancer de cuello uterino",implante subdermico: usuarias nuevas,2016-06-01,0,3,7,1,0,11
BELLA FLOR,"anticoncepcion, prevencion de its y de cancer de cuello uterino",implante subdermico: usuarias nuevas,2016-06-01,0,1,1,0,0,2
BERMEJO,"anticoncepcion, prevencion de its y de cancer de cuello uterino",implante subdermico: usuarias nuevas,2016-06-01,0,1,4,0,0,5
BETANZOS,"anticoncepcion, prevencion de its y de cancer de cuello uterino",implante subdermico: usuarias nuevas,2016-06-01,0,0,2,2,0,4
BUENA VISTA,"anticoncepcion, prevencion de its y de cancer de cuello uterino",implante subdermico: usuarias nuevas,2016-06-01,0,5,9,0,0,14
"CAIZA ""D""","anticoncepcion, prevencion de its y de cancer de cuello uterino",implante subdermico: usuarias nuevas,2016-06-01,0,0,1,1,0,2
CALAMARCA,"anticoncepcion, prevencion de its y de cancer de cuello uterino",implante subdermico: usuarias nuevas,2016-06-01,1,3,4,0,0,8
CAMARGO,"anticoncepcion, prevencion de its y de cancer de cuello uterino",implante subdermico: usuarias nuevas,2016-06-01,0,1,5,0,0,6
CAMATAQUI (C. VILLA ABECIA),"anticoncepcion, prevencion de its y de cancer de cuello uterino",implante subdermico: usuarias nuevas,2016-06-01,0,0,1,0,0,1
CAPINOTA,"anticoncepcion, prevencion de its y de cancer de cuello uterino",implante subdermico: usuarias nuevas,2016-06-01,0,3,6,1,0,10
CARAPARI,"anticoncepcion, prevencion de its y de cancer de cuello uterino",implante subdermico: usuarias nuevas,2016-06-01,0,0,9,0,0,9
CATACORA,"anticoncepcion, prevencion de its y de cancer de cuello uterino",implante subdermico: usuarias nuevas,2016-06-01,0,0,1,0,0,1
CHALLAPATA,"anticoncepcion, prevencion de its y de cancer de cuello uterino",implante subdermico: usuarias nuevas,2016-06-01,0,2,9,2,0,13
CHAYANTA,"anticoncepcion, prevencion de its y de cancer de cuello uterino",implante subdermico: usuarias nuevas,2016-06-01,0,0,5,1,0,6
CHIMORE,"anticoncepcion, prevencion de its y de cancer de cuello uterino",implante subdermico: usuarias nuevas,2016-06-01,0,0,5,0,0,5
CHUA COCANI,"anticoncepcion, prevencion de its y de cancer de cuello uterino",implante subdermico: usuarias nuevas,2016-06-01,0,0,3,0,0,3
CHULUMANI (V. DE LA LIBERTAD),"anticoncepcion, prevencion de its y de cancer de cuello uterino",implante subdermico: usuarias nuevas,2016-06-01,0,1,9,1,0,11
CHUMA,"anticoncepcion, prevencion de its y de cancer de cuello uterino",implante subdermico: usuarias nuevas,2016-06-01,0,1,2,1,0,4
CKOCHAS,"anticoncepcion, prevencion de its y de cancer de cuello uterino",implante subdermico: usuarias nuevas,2016-06-01,0,1,8,8,0,17
CLIZA,"anticoncepcion, prevencion de its y de cancer de cuello uterino",implante subdermico: usuarias nuevas,2016-06-01,0,0,7,0,0,7
COBIJA,"anticoncepcion, prevencion de its y de cancer de cuello uterino",implante subdermico: usuarias nuevas,2016-06-01,1,10,29,3,0,43
COCAPATA,"anticoncepcion, prevencion de its y de cancer de cuello uterino",implante subdermico: usuarias nuevas,2016-06-01,0,3,1,2,0,6
COCHABAMBA,"anticoncepcion, prevencion de its y de cancer de cuello uterino",implante subdermico: usuarias nuevas,2016-06-01,0,28,429,63,0,520
COLCAPIRHUA,"anticoncepcion, prevencion de its y de cancer de cuello uterino",implante subdermico: usuarias nuevas,2016-06-01,0,1,18,4,0,23
COLOMI,"anticoncepcion, prevencion de its y de cancer de cuello uterino",implante subdermico: usuarias nuevas,2016-06-01,0,0,2,0,0,2
CORIPATA,"anticoncepcion, prevencion de its y de cancer de cuello uterino",implante subdermico: usuarias nuevas,2016-06-01,0,1,5,1,0,7
CORQUE,"anticoncepcion, prevencion de its y de cancer de cuello uterino",implante subdermico: usuarias nuevas,2016-06-01,0,0,2,0,0,2
COTAGAITA,"anticoncepcion, prevencion de its y de cancer de cuello uterino",implante subdermico: usuarias nuevas,2016-06-01,0,0,2,1,0,3
CULPINA,"anticoncepcion, prevencion de its y de cancer de cuello uterino",implante subdermico: usuarias nuevas,2016-06-01,0,7,5,3,0,15
CURVA,"anticoncepcion, prevencion de its y de cancer de cuello uterino",implante subdermico: usuarias nuevas,2016-06-01,0,0,2,0,0,2
EL ALTO,"anticoncepcion, prevencion de its y de cancer de cuello uterino",implante subdermico: usuarias nuevas,2016-06-01,0,14,75,38,0,127
EL CHORO,"anticoncepcion, prevencion de its y de cancer de cuello uterino",implante subdermico: usuarias nuevas,2016-06-01,0,0,1,0,0,1
EL TORNO,"anticoncepcion, prevencion de its y de cancer de cuello uterino",implante subdermico: usuarias nuevas,2016-06-01,0,4,25,7,0,36
EL VILLAR,"anticoncepcion, prevencion de its y de cancer de cuello uterino",implante subdermico: usuarias nuevas,2016-06-01,0,1,0,0,0,1
ENTRE RIOS TRJ,"anticoncepcion, prevencion de its y de cancer de cuello uterino",implante subdermico: usuarias nuevas,2016-06-01,0,4,3,0,0,7
ENTRE RIOS CBBA,"anticoncepcion, prevencion de its y de cancer de cuello uterino",implante subdermico: usuarias nuevas,2016-06-01,0,2,7,2,0,11
ESCOMA,"anticoncepcion, prevencion de its y de cancer de cuello uterino",implante subdermico: usuarias nuevas,2016-06-01,0,0,2,0,0,2
EUCALIPTUS,"anticoncepcion, prevencion de its y de cancer de cuello uterino",implante subdermico: usuarias nuevas,2016-06-01,0,0,1,0,0,1
EUREKA (SANTOS MERCADO),"anticoncepcion, prevencion de its y de cancer de cuello uterino",implante subdermico: usuarias nuevas,2016-06-01,0,0,3,0,0,3
FILADELFIA,"anticoncepcion, prevencion de its y de cancer de cuello uterino",implante subdermico: usuarias nuevas,2016-06-01,0,1,3,0,0,4
GRAL. J.J. PEREZ (CHARAZANI),"anticoncepcion, prevencion de its y de cancer de cuello uterino",implante subdermico: usuarias nuevas,2016-06-01,0,1,5,0,0,6
GUAYARAMERIN,"anticoncepcion, prevencion de its y de cancer de cuello uterino",implante subdermico: usuarias nuevas,2016-06-01,1,0,2,0,0,3
HUANUNI,"anticoncepcion, prevencion de its y de cancer de cuello uterino",implante subdermico: usuarias nuevas,2016-06-01,0,1,8,4,0,13
HUARINA,"anticoncepcion, prevencion de its y de cancer de cuello uterino",implante subdermico: usuarias nuevas,2016-06-01,0,0,1,0,0,1
ICLA,"anticoncepcion, prevencion de its y de cancer de cuello uterino",implante subdermico: usuarias nuevas,2016-06-01,0,2,1,0,0,3
INCAHUASI,"anticoncepcion, prevencion de its y de cancer de cuello uterino",implante subdermico: usuarias nuevas,2016-06-01,0,0,3,0,0,3
INGAVI (HUMAITA),"anticoncepcion, prevencion de its y de cancer de cuello uterino",implante subdermico: usuarias nuevas,2016-06-01,0,3,6,0,0,9
IRUPANA (VILLA DE LANZA),"anticoncepcion, prevencion de its y de cancer de cuello uterino",implante subdermico: usuarias nuevas,2016-06-01,0,0,12,1,0,13
LA ASUNTA,"anticoncepcion, prevencion de its y de cancer de cuello uterino",implante subdermico: usuarias nuevas,2016-06-01,0,4,10,1,0,15
LA PAZ,"anticoncepcion, prevencion de its y de cancer de cuello uterino",implante subdermico: usuarias nuevas,2016-06-01,0,15,160,181,0,356
LAS CARRERAS,"anticoncepcion, prevencion de its y de cancer de cuello uterino",implante subdermico: usuarias nuevas,2016-06-01,0,1,2,0,0,3
LLALLAGUA,"anticoncepcion, prevencion de its y de cancer de cuello uterino",implante subdermico: usuarias nuevas,2016-06-01,0,1,15,4,0,20
MACHACAMARCA,"anticoncepcion, prevencion de its y de cancer de cuello uterino",implante subdermico: usuarias nuevas,2016-06-01,0,0,1,0,0,1
MAGDALENA,"anticoncepcion, prevencion de its y de cancer de cuello uterino",implante subdermico: usuarias nuevas,2016-06-01,0,0,5,0,0,5
MAPIRI,"anticoncepcion, prevencion de its y de cancer de cuello uterino",implante subdermico: usuarias nuevas,2016-06-01,0,3,12,2,0,17
MECAPACA,"anticoncepcion, prevencion de its y de cancer de cuello uterino",implante subdermico: usuarias nuevas,2016-06-01,0,1,0,0,0,1
MIZQUE,"anticoncepcion, prevencion de its y de cancer de cuello uterino",implante subdermico: usuarias nuevas,2016-06-01,0,3,7,0,0,10
MOCOMOCO,"anticoncepcion, prevencion de its y de cancer de cuello uterino",implante subdermico: usuarias nuevas,2016-06-01,0,0,3,0,0,3
MOJOCOYA,"anticoncepcion, prevencion de its y de cancer de cuello uterino",implante subdermico: usuarias nuevas,2016-06-01,0,0,1,0,0,1
MONTEAGUDO,"anticoncepcion, prevencion de its y de cancer de cuello uterino",implante subdermico: usuarias nuevas,2016-06-01,0,4,0,0,0,4
ORURO,"anticoncepcion, prevencion de its y de cancer de cuello uterino",implante subdermico: usuarias nuevas,2016-06-01,0,15,61,21,0,97
PADILLA,"anticoncepcion, prevencion de its y de cancer de cuello uterino",implante subdermico: usuarias nuevas,2016-06-01,0,1,7,0,0,8
PAILON,"anticoncepcion, prevencion de its y de cancer de cuello uterino",implante subdermico: usuarias nuevas,2016-06-01,0,0,5,0,0,5
PALOS BLANCOS,"anticoncepcion, prevencion de its y de cancer de cuello uterino",implante subdermico: usuarias nuevas,2016-06-01,0,3,8,2,0,13
PAMPA AULLAGAS,"anticoncepcion, prevencion de its y de cancer de cuello uterino",implante subdermico: usuarias nuevas,2016-06-01,0,0,0,1,0,1
PASORAPA,"anticoncepcion, prevencion de its y de cancer de cuello uterino",implante subdermico: usuarias nuevas,2016-06-01,0,0,1,0,0,1
PAZÑA,"anticoncepcion, prevencion de its y de cancer de cuello uterino",implante subdermico: usuarias nuevas,2016-06-01,0,0,1,1,0,2
POCOATA,"anticoncepcion, prevencion de its y de cancer de cuello uterino",implante subdermico: usuarias nuevas,2016-06-01,0,1,2,3,0,6
POOPO,"anticoncepcion, prevencion de its y de cancer de cuello uterino",implante subdermico: usuarias nuevas,2016-06-01,0,0,4,0,0,4
POROMA,"anticoncepcion, prevencion de its y de cancer de cuello uterino",implante subdermico: usuarias nuevas,2016-06-01,0,2,13,3,0,18
PORVENIR,"anticoncepcion, prevencion de its y de cancer de cuello uterino",implante subdermico: usuarias nuevas,2016-06-01,0,0,1,0,0,1
POTOSI,"anticoncepcion, prevencion de its y de cancer de cuello uterino",implante subdermico: usuarias nuevas,2016-06-01,0,8,51,10,0,69
PRESTO,"anticoncepcion, prevencion de its y de cancer de cuello uterino",implante subdermico: usuarias nuevas,2016-06-01,0,0,2,0,0,2
PUCARANI,"anticoncepcion, prevencion de its y de cancer de cuello uterino",implante subdermico: usuarias nuevas,2016-06-01,0,0,1,0,0,1
PUERTO GONZALO MORENO,"anticoncepcion, prevencion de its y de cancer de cuello uterino",implante subdermico: usuarias nuevas,2016-06-01,0,4,1,0,0,5
PUERTO RICO,"anticoncepcion, prevencion de its y de cancer de cuello uterino",implante subdermico: usuarias nuevas,2016-06-01,0,1,1,0,0,2
PUERTO VILLARROEL,"anticoncepcion, prevencion de its y de cancer de cuello uterino",implante subdermico: usuarias nuevas,2016-06-01,0,1,14,1,0,16
PUNA,"anticoncepcion, prevencion de its y de cancer de cuello uterino",implante subdermico: usuarias nuevas,2016-06-01,0,0,1,0,0,1
QUILLACOLLO,"anticoncepcion, prevencion de its y de cancer de cuello uterino",implante subdermico: usuarias nuevas,2016-06-01,0,2,12,0,0,14
RIBERALTA,"anticoncepcion, prevencion de its y de cancer de cuello uterino",implante subdermico: usuarias nuevas,2016-06-01,1,19,29,1,0,50
RURRENABAQUE,"anticoncepcion, prevencion de its y de cancer de cuello uterino",implante subdermico: usuarias nuevas,2016-06-01,0,2,15,3,0,20
SABAYA,"anticoncepcion, prevencion de its y de cancer de cuello uterino",implante subdermico: usuarias nuevas,2016-06-01,0,0,2,0,0,2
SACABA,"anticoncepcion, prevencion de its y de cancer de cuello uterino",implante subdermico: usuarias nuevas,2016-06-01,0,0,4,0,0,4
SACACA,"anticoncepcion, prevencion de its y de cancer de cuello uterino",implante subdermico: usuarias nuevas,2016-06-01,0,0,9,0,0,9
SALINAS DE GARCI MENDOZA,"anticoncepcion, prevencion de its y de cancer de cuello uterino",implante subdermico: usuarias nuevas,2016-06-01,0,0,2,1,0,3
SAN BORJA,"anticoncepcion, prevencion de its y de cancer de cuello uterino",implante subdermico: usuarias nuevas,2016-06-01,0,0,12,0,0,12
SAN BUENA VENTURA,"anticoncepcion, prevencion de its y de cancer de cuello uterino",implante subdermico: usuarias nuevas,2016-06-01,0,0,4,0,0,4
SAN CARLOS,"anticoncepcion, prevencion de its y de cancer de cuello uterino",implante subdermico: usuarias nuevas,2016-06-01,0,4,11,6,0,21
SAN IGNACIO,"anticoncepcion, prevencion de its y de cancer de cuello uterino",implante subdermico: usuarias nuevas,2016-06-01,0,1,4,0,0,5
SAN JULIAN,"anticoncepcion, prevencion de its y de cancer de cuello uterino",implante subdermico: usuarias nuevas,2016-06-01,0,1,0,0,0,1
SAN LORENZO(TJA),"anticoncepcion, prevencion de its y de cancer de cuello uterino",implante subdermico: usuarias nuevas,2016-06-01,0,0,7,1,0,8
SAN LUCAS,"anticoncepcion, prevencion de its y de cancer de cuello uterino",implante subdermico: usuarias nuevas,2016-06-01,0,3,2,2,0,7
SAN PEDRO,"anticoncepcion, prevencion de its y de cancer de cuello uterino",implante subdermico: usuarias nuevas,2016-06-01,0,2,2,1,0,5
SANTA CRUZ DE LA SIERRA,"anticoncepcion, prevencion de its y de cancer de cuello uterino",implante subdermico: usuarias nuevas,2016-06-01,0,63,170,170,0,403
SANTIAGO DE CALLAPA,"anticoncepcion, prevencion de its y de cancer de cuello uterino",implante subdermico: usuarias nuevas,2016-06-01,0,1,1,1,0,3
SANTIAGO DE HUARI,"anticoncepcion, prevencion de its y de cancer de cuello uterino",implante subdermico: usuarias nuevas,2016-06-01,0,0,2,0,0,2
SANTUARIO DE QUILLACAS,"anticoncepcion, prevencion de its y de cancer de cuello uterino",implante subdermico: usuarias nuevas,2016-06-01,0,0,3,1,0,4
SENA,"anticoncepcion, prevencion de its y de cancer de cuello uterino",implante subdermico: usuarias nuevas,2016-06-01,2,1,4,0,0,7
SICA SICA (VILLA AROMA),"anticoncepcion, prevencion de its y de cancer de cuello uterino",implante subdermico: usuarias nuevas,2016-06-01,0,1,1,0,0,2
SIPE SIPE,"anticoncepcion, prevencion de its y de cancer de cuello uterino",implante subdermico: usuarias nuevas,2016-06-01,0,1,1,0,0,2
SOPACHUY,"anticoncepcion, prevencion de its y de cancer de cuello uterino",implante subdermico: usuarias nuevas,2016-06-01,0,0,6,1,0,7
SORATA,"anticoncepcion, prevencion de its y de cancer de cuello uterino",implante subdermico: usuarias nuevas,2016-06-01,0,1,2,0,0,3
SUCRE,"anticoncepcion, prevencion de its y de cancer de cuello uterino",implante subdermico: usuarias nuevas,2016-06-01,1,24,182,22,0,229
TACACOMA,"anticoncepcion, prevencion de its y de cancer de cuello uterino",implante subdermico: usuarias nuevas,2016-06-01,0,0,5,0,0,5
TAPACARI,"anticoncepcion, prevencion de its y de cancer de cuello uterino",implante subdermico: usuarias nuevas,2016-06-01,0,1,3,4,0,8
TARABUCO,"anticoncepcion, prevencion de its y de cancer de cuello uterino",implante subdermico: usuarias nuevas,2016-06-01,0,0,6,2,0,8
TARIJA,"anticoncepcion, prevencion de its y de cancer de cuello uterino",implante subdermico: usuarias nuevas,2016-06-01,0,14,91,26,2,133
TARVITA,"anticoncepcion, prevencion de its y de cancer de cuello uterino",implante subdermico: usuarias nuevas,2016-06-01,0,1,5,0,0,6
TIAWANACU,"anticoncepcion, prevencion de its y de cancer de cuello uterino",implante subdermico: usuarias nuevas,2016-06-01,0,2,1,2,0,5
TIPUANI,"anticoncepcion, prevencion de its y de cancer de cuello uterino",implante subdermico: usuarias nuevas,2016-06-01,0,0,6,1,0,7
TIQUIPAYA,"anticoncepcion, prevencion de its y de cancer de cuello uterino",implante subdermico: usuarias nuevas,2016-06-01,0,1,3,0,0,4
TOLEDO,"anticoncepcion, prevencion de its y de cancer de cuello uterino",implante subdermico: usuarias nuevas,2016-06-01,0,0,2,1,0,3
TORO TORO,"anticoncepcion, prevencion de its y de cancer de cuello uterino",implante subdermico: usuarias nuevas,2016-06-01,0,2,7,0,0,9
TRINIDAD,"anticoncepcion, prevencion de its y de cancer de cuello uterino",implante subdermico: usuarias nuevas,2016-06-01,0,21,47,2,0,70
TUPIZA,"anticoncepcion, prevencion de its y de cancer de cuello uterino",implante subdermico: usuarias nuevas,2016-06-01,0,5,20,9,0,34
TURCO,"anticoncepcion, prevencion de its y de cancer de cuello uterino",implante subdermico: usuarias nuevas,2016-06-01,0,1,0,1,0,2
URIONDO (A. CONCEPCION),"anticoncepcion, prevencion de its y de cancer de cuello uterino",implante subdermico: usuarias nuevas,2016-06-01,0,2,2,0,0,4
VIACHA,"anticoncepcion, prevencion de its y de cancer de cuello uterino",implante subdermico: usuarias nuevas,2016-06-01,0,2,64,6,0,72
VILLA CHARCAS,"anticoncepcion, prevencion de its y de cancer de cuello uterino",implante subdermico: usuarias nuevas,2016-06-01,0,2,6,2,0,10
VILLA SERRANO,"anticoncepcion, prevencion de its y de cancer de cuello uterino",implante subdermico: usuarias nuevas,2016-06-01,0,1,4,1,0,6
VILLA TUNARI,"anticoncepcion, prevencion de its y de cancer de cuello uterino",implante subdermico: usuarias nuevas,2016-06-01,0,7,10,6,0,23
VILLA VACA GUZMAN (MUYUPAMPA),"anticoncepcion, prevencion de its y de cancer de cuello uterino",implante subdermico: usuarias nuevas,2016-06-01,0,2,4,0,0,6
VILLAZON,"anticoncepcion, prevencion de its y de cancer de cuello uterino",implante subdermico: usuarias nuevas,2016-06-01,0,4,24,6,0,34
VINTO,"anticoncepcion, prevencion de its y de cancer de cuello uterino",implante subdermico: usuarias nuevas,2016-06-01,0,0,7,4,1,12
VITICHI,"anticoncepcion, prevencion de its y de cancer de cuello uterino",implante subdermico: usuarias nuevas,2016-06-01,0,1,1,2,0,4
WARNES,"anticoncepcion, prevencion de its y de cancer de cuello uterino",implante subdermico: usuarias nuevas,2016-06-01,0,3,20,4,0,27
YANACACHI,"anticoncepcion, prevencion de its y de cancer de cuello uterino",implante subdermico: usuarias nuevas,2016-06-01,0,0,2,0,0,2
YAPACANI,"anticoncepcion, prevencion de its y de cancer de cuello uterino",implante subdermico: usuarias nuevas,2016-06-01,0,0,3,0,0,3
YOTALA,"anticoncepcion, prevencion de its y de cancer de cuello uterino",implante subdermico: usuarias nuevas,2016-06-01,0,0,4,0,0,4
ZUDAÑEZ,"anticoncepcion, prevencion de its y de cancer de cuello uterino",implante subdermico: usuarias nuevas,2016-06-01,0,1,1,0,0,2
ACACIO,"anticoncepcion, prevencion de its y de cancer de cuello uterino",implante subdermico: usuarias nuevas,2016-07-01,0,0,2,1,0,3
ACHACACHI,"anticoncepcion, prevencion de its y de cancer de cuello uterino",implante subdermico: usuarias nuevas,2016-07-01,0,0,4,0,0,4
ACHOCALLA,"anticoncepcion, prevencion de its y de cancer de cuello uterino",implante subdermico: usuarias nuevas,2016-07-01,0,0,13,3,0,16
AIQUILE,"anticoncepcion, prevencion de its y de cancer de cuello uterino",implante subdermico: usuarias nuevas,2016-07-01,0,5,11,1,0,17
ALTO BENI,"anticoncepcion, prevencion de its y de cancer de cuello uterino",implante subdermico: usuarias nuevas,2016-07-01,0,0,5,4,0,9
ANTEQUERA,"anticoncepcion, prevencion de its y de cancer de cuello uterino",implante subdermico: usuarias nuevas,2016-07-01,0,0,2,0,0,2
APOLO,"anticoncepcion, prevencion de its y de cancer de cuello uterino",implante subdermico: usuarias nuevas,2016-07-01,0,2,7,5,0,14
ATOCHA,"anticoncepcion, prevencion de its y de cancer de cuello uterino",implante subdermico: usuarias nuevas,2016-07-01,0,0,2,0,0,2
AYOPAYA (V. DE INDEPENDENCIA),"anticoncepcion, prevencion de its y de cancer de cuello uterino",implante subdermico: usuarias nuevas,2016-07-01,0,0,2,1,0,3
BATALLAS,"anticoncepcion, prevencion de its y de cancer de cuello uterino",implante subdermico: usuarias nuevas,2016-07-01,0,0,4,2,0,6
BAURES,"anticoncepcion, prevencion de its y de cancer de cuello uterino",implante subdermico: usuarias nuevas,2016-07-01,0,0,1,0,0,1
BELLA FLOR,"anticoncepcion, prevencion de its y de cancer de cuello uterino",implante subdermico: usuarias nuevas,2016-07-01,0,0,1,0,0,1
BETANZOS,"anticoncepcion, prevencion de its y de cancer de cuello uterino",implante subdermico: usuarias nuevas,2016-07-01,0,1,5,3,0,9
"CAIZA ""D""","anticoncepcion, prevencion de its y de cancer de cuello uterino",implante subdermico: usuarias nuevas,2016-07-01,0,0,0,1,0,1
CALAMARCA,"anticoncepcion, prevencion de its y de cancer de cuello uterino",implante subdermico: usuarias nuevas,2016-07-01,0,0,1,0,0,1
CAMARGO,"anticoncepcion, prevencion de its y de cancer de cuello uterino",implante subdermico: usuarias nuevas,2016-07-01,0,1,4,0,0,5
CAMATAQUI (C. VILLA ABECIA),"anticoncepcion, prevencion de its y de cancer de cuello uterino",implante subdermico: usuarias nuevas,2016-07-01,0,2,1,0,0,3
CAMIRI,"anticoncepcion, prevencion de its y de cancer de cuello uterino",implante subdermico: usuarias nuevas,2016-07-01,0,2,3,0,0,5
CAPINOTA,"anticoncepcion, prevencion de its y de cancer de cuello uterino",implante subdermico: usuarias nuevas,2016-07-01,0,2,5,1,0,8
CARACOLLO,"anticoncepcion, prevencion de its y de cancer de cuello uterino",implante subdermico: usuarias nuevas,2016-07-01,0,2,10,0,0,12
CHALLAPATA,"anticoncepcion, prevencion de its y de cancer de cuello uterino",implante subdermico: usuarias nuevas,2016-07-01,0,0,1,0,0,1
CHAYANTA,"anticoncepcion, prevencion de its y de cancer de cuello uterino",implante subdermico: usuarias nuevas,2016-07-01,0,0,9,0,0,9
CHIMORE,"anticoncepcion, prevencion de its y de cancer de cuello uterino",implante subdermico: usuarias nuevas,2016-07-01,0,3,12,4,0,19
CHULUMANI (V. DE LA LIBERTAD),"anticoncepcion, prevencion de its y de cancer de cuello uterino",implante subdermico: usuarias nuevas,2016-07-01,0,0,4,0,0,4
CKOCHAS,"anticoncepcion, prevencion de its y de cancer de cuello uterino",implante subdermico: usuarias nuevas,2016-07-01,0,0,3,2,0,5
CLIZA,"anticoncepcion, prevencion de its y de cancer de cuello uterino",implante subdermico: usuarias nuevas,2016-07-01,0,1,8,0,0,9
COBIJA,"anticoncepcion, prevencion de its y de cancer de cuello uterino",implante subdermico: usuarias nuevas,2016-07-01,2,0,18,0,0,20
COCAPATA,"anticoncepcion, prevencion de its y de cancer de cuello uterino",implante subdermico: usuarias nuevas,2016-07-01,0,0,2,0,0,2
COCHABAMBA,"anticoncepcion, prevencion de its y de cancer de cuello uterino",implante subdermico: usuarias nuevas,2016-07-01,0,20,190,32,0,242
COLCAPIRHUA,"anticoncepcion, prevencion de its y de cancer de cuello uterino",implante subdermico: usuarias nuevas,2016-07-01,0,3,11,0,0,14
COLLANA,"anticoncepcion, prevencion de its y de cancer de cuello uterino",implante subdermico: usuarias nuevas,2016-07-01,0,0,1,0,0,1
COLOMI,"anticoncepcion, prevencion de its y de cancer de cuello uterino",implante subdermico: usuarias nuevas,2016-07-01,0,0,6,0,0,6
COLQUENCHA,"anticoncepcion, prevencion de its y de cancer de cuello uterino",implante subdermico: usuarias nuevas,2016-07-01,0,0,4,1,0,5
COLQUIRI,"anticoncepcion, prevencion de its y de cancer de cuello uterino",implante subdermico: usuarias nuevas,2016-07-01,0,0,1,0,0,1
CORIPATA,"anticoncepcion, prevencion de its y de cancer de cuello uterino",implante subdermico: usuarias nuevas,2016-07-01,0,0,1,1,0,2
CORO CORO,"anticoncepcion, prevencion de its y de cancer de cuello uterino",implante subdermico: usuarias nuevas,2016-07-01,0,0,2,0,0,2
CORQUE,"anticoncepcion, prevencion de its y de cancer de cuello uterino",implante subdermico: usuarias nuevas,2016-07-01,0,1,2,0,0,3
COTAGAITA,"anticoncepcion, prevencion de its y de cancer de cuello uterino",implante subdermico: usuarias nuevas,2016-07-01,0,2,35,7,0,44
CULPINA,"anticoncepcion, prevencion de its y de cancer de cuello uterino",implante subdermico: usuarias nuevas,2016-07-01,0,2,6,1,0,9
CURVA,"anticoncepcion, prevencion de its y de cancer de cuello uterino",implante subdermico: usuarias nuevas,2016-07-01,0,0,2,1,0,3
EL ALTO,"anticoncepcion, prevencion de its y de cancer de cuello uterino",implante subdermico: usuarias nuevas,2016-07-01,0,18,116,47,0,181
EL CHORO,"anticoncepcion, prevencion de its y de cancer de cuello uterino",implante subdermico: usuarias nuevas,2016-07-01,0,0,1,0,0,1
EL TORNO,"anticoncepcion, prevencion de its y de cancer de cuello uterino",implante subdermico: usuarias nuevas,2016-07-01,0,10,24,0,0,34
ENTRE RIOS TRJ,"anticoncepcion, prevencion de its y de cancer de cuello uterino",implante subdermico: usuarias nuevas,2016-07-01,0,3,13,3,0,19
ESCOMA,"anticoncepcion, prevencion de its y de cancer de cuello uterino",implante subdermico: usuarias nuevas,2016-07-01,0,1,2,0,0,3
EUCALIPTUS,"anticoncepcion, prevencion de its y de cancer de cuello uterino",implante subdermico: usuarias nuevas,2016-07-01,0,0,2,0,0,2
FILADELFIA,"anticoncepcion, prevencion de its y de cancer de cuello uterino",implante subdermico: usuarias nuevas,2016-07-01,0,1,0,0,0,1
GRAL. J.J. PEREZ (CHARAZANI),"anticoncepcion, prevencion de its y de cancer de cuello uterino",implante subdermico: usuarias nuevas,2016-07-01,0,1,5,1,0,7
GUAYARAMERIN,"anticoncepcion, prevencion de its y de cancer de cuello uterino",implante subdermico: usuarias nuevas,2016-07-01,3,34,63,6,0,106
HUACARETA,"anticoncepcion, prevencion de its y de cancer de cuello uterino",implante subdermico: usuarias nuevas,2016-07-01,0,0,1,0,0,1
HUANUNI,"anticoncepcion, prevencion de its y de cancer de cuello uterino",implante subdermico: usuarias nuevas,2016-07-01,0,4,18,4,0,26
HUAYLLAMARCA,"anticoncepcion, prevencion de its y de cancer de cuello uterino",implante subdermico: usuarias nuevas,2016-07-01,0,1,0,0,0,1
ICLA,"anticoncepcion, prevencion de its y de cancer de cuello uterino",implante subdermico: usuarias nuevas,2016-07-01,0,1,1,0,0,2
INCAHUASI,"anticoncepcion, prevencion de its y de cancer de cuello uterino",implante subdermico: usuarias nuevas,2016-07-01,0,1,0,0,0,1
INGAVI (HUMAITA),"anticoncepcion, prevencion de its y de cancer de cuello uterino",implante subdermico: usuarias nuevas,2016-07-01,0,0,1,0,0,1
IRUPANA (VILLA DE LANZA),"anticoncepcion, prevencion de its y de cancer de cuello uterino",implante subdermico: usuarias nuevas,2016-07-01,0,2,7,3,0,12
LA ASUNTA,"anticoncepcion, prevencion de its y de cancer de cuello uterino",implante subdermico: usuarias nuevas,2016-07-01,0,1,2,0,0,3
LA PAZ,"anticoncepcion, prevencion de its y de cancer de cuello uterino",implante subdermico: usuarias nuevas,2016-07-01,0,33,162,81,0,276
LAJA,"anticoncepcion, prevencion de its y de cancer de cuello uterino",implante subdermico: usuarias nuevas,2016-07-01,0,0,7,0,0,7
LAS CARRERAS,"anticoncepcion, prevencion de its y de cancer de cuello uterino",implante subdermico: usuarias nuevas,2016-07-01,0,1,5,0,0,6
LLALLAGUA,"anticoncepcion, prevencion de its y de cancer de cuello uterino",implante subdermico: usuarias nuevas,2016-07-01,0,2,21,2,0,25
LURIBAY,"anticoncepcion, prevencion de its y de cancer de cuello uterino",implante subdermico: usuarias nuevas,2016-07-01,0,0,2,0,0,2
MACHACAMARCA,"anticoncepcion, prevencion de its y de cancer de cuello uterino",implante subdermico: usuarias nuevas,2016-07-01,0,1,6,0,0,7
MACHARETI,"anticoncepcion, prevencion de its y de cancer de cuello uterino",implante subdermico: usuarias nuevas,2016-07-01,0,1,6,0,0,7
MAGDALENA,"anticoncepcion, prevencion de its y de cancer de cuello uterino",implante subdermico: usuarias nuevas,2016-07-01,0,1,1,0,0,2
MAPIRI,"anticoncepcion, prevencion de its y de cancer de cuello uterino",implante subdermico: usuarias nuevas,2016-07-01,0,0,5,1,0,6
MECAPACA,"anticoncepcion, prevencion de its y de cancer de cuello uterino",implante subdermico: usuarias nuevas,2016-07-01,0,0,1,0,0,1
MIZQUE,"anticoncepcion, prevencion de its y de cancer de cuello uterino",implante subdermico: usuarias nuevas,2016-07-01,0,0,12,4,0,16
MOJOCOYA,"anticoncepcion, prevencion de its y de cancer de cuello uterino",implante subdermico: usuarias nuevas,2016-07-01,0,1,2,0,0,3
MONTEAGUDO,"anticoncepcion, prevencion de its y de cancer de cuello uterino",implante subdermico: usuarias nuevas,2016-07-01,0,0,4,0,0,4
MOROCHATA,"anticoncepcion, prevencion de its y de cancer de cuello uterino",implante subdermico: usuarias nuevas,2016-07-01,0,0,1,0,0,1
NUEVO MANOA (NUEVA ESPERANZA),"anticoncepcion, prevencion de its y de cancer de cuello uterino",implante subdermico: usuarias nuevas,2016-07-01,0,0,2,0,0,2
ORURO,"anticoncepcion, prevencion de its y de cancer de cuello uterino",implante subdermico: usuarias nuevas,2016-07-01,0,13,63,13,0,89
PADILLA,"anticoncepcion, prevencion de its y de cancer de cuello uterino",implante subdermico: usuarias nuevas,2016-07-01,0,1,9,0,0,10
PAILON,"anticoncepcion, prevencion de its y de cancer de cuello uterino",implante subdermico: usuarias nuevas,2016-07-01,0,0,3,0,0,3
PALOS BLANCOS,"anticoncepcion, prevencion de its y de cancer de cuello uterino",implante subdermico: usuarias nuevas,2016-07-01,0,3,20,1,0,24
PATACAMAYA,"anticoncepcion, prevencion de its y de cancer de cuello uterino",implante subdermico: usuarias nuevas,2016-07-01,0,0,3,0,0,3
PAZÑA,"anticoncepcion, prevencion de its y de cancer de cuello uterino",implante subdermico: usuarias nuevas,2016-07-01,0,1,0,0,0,1
POCOATA,"anticoncepcion, prevencion de its y de cancer de cuello uterino",implante subdermico: usuarias nuevas,2016-07-01,0,0,0,1,0,1
POOPO,"anticoncepcion, prevencion de its y de cancer de cuello uterino",implante subdermico: usuarias nuevas,2016-07-01,0,0,5,1,0,6
PORCO,"anticoncepcion, prevencion de its y de cancer de cuello uterino",implante subdermico: usuarias nuevas,2016-07-01,0,10,44,1,0,55
POROMA,"anticoncepcion, prevencion de its y de cancer de cuello uterino",implante subdermico: usuarias nuevas,2016-07-01,0,1,12,9,0,22
POTOSI,"anticoncepcion, prevencion de its y de cancer de cuello uterino",implante subdermico: usuarias nuevas,2016-07-01,0,18,65,15,0,98
PRESTO,"anticoncepcion, prevencion de its y de cancer de cuello uterino",implante subdermico: usuarias nuevas,2016-07-01,0,0,7,3,0,10
PUCARANI,"anticoncepcion, prevencion de its y de cancer de cuello uterino",implante subdermico: usuarias nuevas,2016-07-01,0,4,2,0,0,6
PUERTO RICO,"anticoncepcion, prevencion de its y de cancer de cuello uterino",implante subdermico: usuarias nuevas,2016-07-01,0,2,0,0,0,2
PUERTO VILLARROEL,"anticoncepcion, prevencion de its y de cancer de cuello uterino",implante subdermico: usuarias nuevas,2016-07-01,0,4,31,6,0,41
PUNA,"anticoncepcion, prevencion de its y de cancer de cuello uterino",implante subdermico: usuarias nuevas,2016-07-01,0,2,3,1,0,6
PUNATA,"anticoncepcion, prevencion de its y de cancer de cuello uterino",implante subdermico: usuarias nuevas,2016-07-01,0,1,5,0,0,6
QUIABAYA,"anticoncepcion, prevencion de its y de cancer de cuello uterino",implante subdermico: usuarias nuevas,2016-07-01,0,0,1,0,0,1
QUILLACOLLO,"anticoncepcion, prevencion de its y de cancer de cuello uterino",implante subdermico: usuarias nuevas,2016-07-01,0,1,12,0,0,13
RIBERALTA,"anticoncepcion, prevencion de its y de cancer de cuello uterino",implante subdermico: usuarias nuevas,2016-07-01,2,42,74,6,0,124
RURRENABAQUE,"anticoncepcion, prevencion de its y de cancer de cuello uterino",implante subdermico: usuarias nuevas,2016-07-01,0,2,7,4,0,13
SABAYA,"anticoncepcion, prevencion de its y de cancer de cuello uterino",implante subdermico: usuarias nuevas,2016-07-01,0,0,0,1,0,1
SACABA,"anticoncepcion, prevencion de its y de cancer de cuello uterino",implante subdermico: usuarias nuevas,2016-07-01,0,0,2,0,0,2
SALINAS DE GARCI MENDOZA,"anticoncepcion, prevencion de its y de cancer de cuello uterino",implante subdermico: usuarias nuevas,2016-07-01,0,0,1,0,0,1
SAN ANDRES,"anticoncepcion, prevencion de its y de cancer de cuello uterino",implante subdermico: usuarias nuevas,2016-07-01,0,0,2,0,0,2
SAN BORJA,"anticoncepcion, prevencion de its y de cancer de cuello uterino",implante subdermico: usuarias nuevas,2016-07-01,0,1,8,1,0,10
SAN CARLOS,"anticoncepcion, prevencion de its y de cancer de cuello uterino",implante subdermico: usuarias nuevas,2016-07-01,0,4,7,1,0,12
SAN IGNACIO,"anticoncepcion, prevencion de its y de cancer de cuello uterino",implante subdermico: usuarias nuevas,2016-07-01,0,2,1,5,0,8
SAN JAVIER(BNI),"anticoncepcion, prevencion de its y de cancer de cuello uterino",implante subdermico: usuarias nuevas,2016-07-01,0,4,4,0,0,8
SAN JOAQUIN,"anticoncepcion, prevencion de its y de cancer de cuello uterino",implante subdermico: usuarias nuevas,2016-07-01,0,4,2,0,0,6
SAN JULIAN,"anticoncepcion, prevencion de its y de cancer de cuello uterino",implante subdermico: usuarias nuevas,2016-07-01,0,8,32,1,0,41
SAN LORENZO(PND),"anticoncepcion, prevencion de its y de cancer de cuello uterino",implante subdermico: usuarias nuevas,2016-07-01,0,0,1,0,0,1
SAN LORENZO(TJA),"anticoncepcion, prevencion de its y de cancer de cuello uterino",implante subdermico: usuarias nuevas,2016-07-01,0,3,10,0,0,13
SAN LUCAS,"anticoncepcion, prevencion de its y de cancer de cuello uterino",implante subdermico: usuarias nuevas,2016-07-01,0,0,6,4,0,10
SAN PEDRO,"anticoncepcion, prevencion de its y de cancer de cuello uterino",implante subdermico: usuarias nuevas,2016-07-01,0,0,2,4,0,6
SAN PEDRO DE TIQUINA,"anticoncepcion, prevencion de its y de cancer de cuello uterino",implante subdermico: usuarias nuevas,2016-07-01,0,0,2,0,0,2
SANTA CRUZ DE LA SIERRA,"anticoncepcion, prevencion de its y de cancer de cuello uterino",implante subdermico: usuarias nuevas,2016-07-01,0,50,167,212,0,429
SANTUARIO DE QUILLACAS,"anticoncepcion, prevencion de its y de cancer de cuello uterino",implante subdermico: usuarias nuevas,2016-07-01,0,0,7,0,0,7
SENA,"anticoncepcion, prevencion de its y de cancer de cuello uterino",implante subdermico: usuarias nuevas,2016-07-01,0,0,3,0,0,3
SICA SICA (VILLA AROMA),"anticoncepcion, prevencion de its y de cancer de cuello uterino",implante subdermico: usuarias nuevas,2016-07-01,0,5,2,1,0,8
SOPACHUY,"anticoncepcion, prevencion de its y de cancer de cuello uterino",implante subdermico: usuarias nuevas,2016-07-01,0,1,2,1,0,4
SORACACHI,"anticoncepcion, prevencion de its y de cancer de cuello uterino",implante subdermico: usuarias nuevas,2016-07-01,0,0,0,1,0,1
SORATA,"anticoncepcion, prevencion de its y de cancer de cuello uterino",implante subdermico: usuarias nuevas,2016-07-01,0,0,3,1,0,4
SUCRE,"anticoncepcion, prevencion de its y de cancer de cuello uterino",implante subdermico: usuarias nuevas,2016-07-01,0,45,155,32,0,232
TACACOMA,"anticoncepcion, prevencion de its y de cancer de cuello uterino",implante subdermico: usuarias nuevas,2016-07-01,0,0,2,0,0,2
TAPACARI,"anticoncepcion, prevencion de its y de cancer de cuello uterino",implante subdermico: usuarias nuevas,2016-07-01,0,0,12,3,0,15
TARATA,"anticoncepcion, prevencion de its y de cancer de cuello uterino",implante subdermico: usuarias nuevas,2016-07-01,0,0,2,0,0,2
TARIJA,"anticoncepcion, prevencion de its y de cancer de cuello uterino",implante subdermico: usuarias nuevas,2016-07-01,0,17,79,37,0,133
TARVITA,"anticoncepcion, prevencion de its y de cancer de cuello uterino",implante subdermico: usuarias nuevas,2016-07-01,0,0,4,0,0,4
TIAWANACU,"anticoncepcion, prevencion de its y de cancer de cuello uterino",implante subdermico: usuarias nuevas,2016-07-01,0,0,1,0,0,1
TIPUANI,"anticoncepcion, prevencion de its y de cancer de cuello uterino",implante subdermico: usuarias nuevas,2016-07-01,0,0,7,0,0,7
TIQUIPAYA,"anticoncepcion, prevencion de its y de cancer de cuello uterino",implante subdermico: usuarias nuevas,2016-07-01,0,3,14,0,0,17
TOLATA,"anticoncepcion, prevencion de its y de cancer de cuello uterino",implante subdermico: usuarias nuevas,2016-07-01,0,1,2,0,0,3
TOLEDO,"anticoncepcion, prevencion de its y de cancer de cuello uterino",implante subdermico: usuarias nuevas,2016-07-01,0,0,2,0,0,2
TOMINA,"anticoncepcion, prevencion de its y de cancer de cuello uterino",implante subdermico: usuarias nuevas,2016-07-01,0,1,4,0,0,5
TORO TORO,"anticoncepcion, prevencion de its y de cancer de cuello uterino",implante subdermico: usuarias nuevas,2016-07-01,0,0,6,1,0,7
TOTORA(ORR),"anticoncepcion, prevencion de its y de cancer de cuello uterino",implante subdermico: usuarias nuevas,2016-07-01,0,1,1,0,0,2
TRINIDAD,"anticoncepcion, prevencion de its y de cancer de cuello uterino",implante subdermico: usuarias nuevas,2016-07-01,0,0,37,3,0,40
TUPIZA,"anticoncepcion, prevencion de its y de cancer de cuello uterino",implante subdermico: usuarias nuevas,2016-07-01,0,6,25,7,0,38
TURCO,"anticoncepcion, prevencion de its y de cancer de cuello uterino",implante subdermico: usuarias nuevas,2016-07-01,0,0,2,0,0,2
URIONDO (A. CONCEPCION),"anticoncepcion, prevencion de its y de cancer de cuello uterino",implante subdermico: usuarias nuevas,2016-07-01,0,2,0,0,0,2
UYUNI,"anticoncepcion, prevencion de its y de cancer de cuello uterino",implante subdermico: usuarias nuevas,2016-07-01,0,0,6,0,0,6
VIACHA,"anticoncepcion, prevencion de its y de cancer de cuello uterino",implante subdermico: usuarias nuevas,2016-07-01,0,0,4,1,0,5
VILLA CHARCAS,"anticoncepcion, prevencion de its y de cancer de cuello uterino",implante subdermico: usuarias nuevas,2016-07-01,0,1,6,3,0,10
VILLA SERRANO,"anticoncepcion, prevencion de its y de cancer de cuello uterino",implante subdermico: usuarias nuevas,2016-07-01,0,0,7,1,0,8
VILLA TUNARI,"anticoncepcion, prevencion de its y de cancer de cuello uterino",implante subdermico: usuarias nuevas,2016-07-01,0,0,7,10,0,17
VILLA VACA GUZMAN (MUYUPAMPA),"anticoncepcion, prevencion de its y de cancer de cuello uterino",implante subdermico: usuarias nuevas,2016-07-01,0,2,12,3,0,17
VILLAZON,"anticoncepcion, prevencion de its y de cancer de cuello uterino",implante subdermico: usuarias nuevas,2016-07-01,0,3,25,3,0,31
VINTO,"anticoncepcion, prevencion de its y de cancer de cuello uterino",implante subdermico: usuarias nuevas,2016-07-01,0,0,4,0,0,4
VITICHI,"anticoncepcion, prevencion de its y de cancer de cuello uterino",implante subdermico: usuarias nuevas,2016-07-01,0,1,4,1,0,6
WARNES,"anticoncepcion, prevencion de its y de cancer de cuello uterino",implante subdermico: usuarias nuevas,2016-07-01,1,1,5,2,0,9
YAMPARAEZ,"anticoncepcion, prevencion de its y de cancer de cuello uterino",implante subdermico: usuarias nuevas,2016-07-01,0,3,3,0,0,6
YANACACHI,"anticoncepcion, prevencion de its y de cancer de cuello uterino",implante subdermico: usuarias nuevas,2016-07-01,0,3,12,4,0,19
YOTALA,"anticoncepcion, prevencion de its y de cancer de cuello uterino",implante subdermico: usuarias nuevas,2016-07-01,0,0,1,0,0,1
ZUDAÑEZ,"anticoncepcion, prevencion de its y de cancer de cuello uterino",implante subdermico: usuarias nuevas,2016-07-01,0,0,1,0,0,1
ACACIO,"anticoncepcion, prevencion de its y de cancer de cuello uterino",implante subdermico: usuarias nuevas,2016-08-01,0,1,1,0,0,2
ACHACACHI,"anticoncepcion, prevencion de its y de cancer de cuello uterino",implante subdermico: usuarias nuevas,2016-08-01,0,0,1,1,0,2
ACHOCALLA,"anticoncepcion, prevencion de its y de cancer de cuello uterino",implante subdermico: usuarias nuevas,2016-08-01,0,4,7,0,0,11
AIQUILE,"anticoncepcion, prevencion de its y de cancer de cuello uterino",implante subdermico: usuarias nuevas,2016-08-01,0,2,11,1,0,14
ALTO BENI,"anticoncepcion, prevencion de its y de cancer de cuello uterino",implante subdermico: usuarias nuevas,2016-08-01,0,0,2,0,0,2
ANDAMARCA,"anticoncepcion, prevencion de its y de cancer de cuello uterino",implante subdermico: usuarias nuevas,2016-08-01,0,0,1,2,0,3
APOLO,"anticoncepcion, prevencion de its y de cancer de cuello uterino",implante subdermico: usuarias nuevas,2016-08-01,0,1,4,4,0,9
ARBIETO,"anticoncepcion, prevencion de its y de cancer de cuello uterino",implante subdermico: usuarias nuevas,2016-08-01,0,0,4,1,0,5
ATOCHA,"anticoncepcion, prevencion de its y de cancer de cuello uterino",implante subdermico: usuarias nuevas,2016-08-01,0,0,4,0,0,4
AYATA,"anticoncepcion, prevencion de its y de cancer de cuello uterino",implante subdermico: usuarias nuevas,2016-08-01,0,0,2,2,0,4
AYOPAYA (V. DE INDEPENDENCIA),"anticoncepcion, prevencion de its y de cancer de cuello uterino",implante subdermico: usuarias nuevas,2016-08-01,0,1,1,0,0,2
BERMEJO,"anticoncepcion, prevencion de its y de cancer de cuello uterino",implante subdermico: usuarias nuevas,2016-08-01,0,3,7,1,0,11
BOLIVAR,"anticoncepcion, prevencion de its y de cancer de cuello uterino",implante subdermico: usuarias nuevas,2016-08-01,0,0,1,0,0,1
"CAIZA ""D""","anticoncepcion, prevencion de its y de cancer de cuello uterino",implante subdermico: usuarias nuevas,2016-08-01,1,3,8,0,0,12
CALAMARCA,"anticoncepcion, prevencion de its y de cancer de cuello uterino",implante subdermico: usuarias nuevas,2016-08-01,0,0,1,1,0,2
CAMARGO,"anticoncepcion, prevencion de its y de cancer de cuello uterino",implante subdermico: usuarias nuevas,2016-08-01,0,0,0,1,0,1
CAPINOTA,"anticoncepcion, prevencion de its y de cancer de cuello uterino",implante subdermico: usuarias nuevas,2016-08-01,0,1,7,0,0,8
CARACOLLO,"anticoncepcion, prevencion de its y de cancer de cuello uterino",implante subdermico: usuarias nuevas,2016-08-01,0,0,11,1,0,12
CARANAVI,"anticoncepcion, prevencion de its y de cancer de cuello uterino",implante subdermico: usuarias nuevas,2016-08-01,0,5,42,2,0,49
CHALLAPATA,"anticoncepcion, prevencion de its y de cancer de cuello uterino",implante subdermico: usuarias nuevas,2016-08-01,0,0,8,5,0,13
CHAYANTA,"anticoncepcion, prevencion de its y de cancer de cuello uterino",implante subdermico: usuarias nuevas,2016-08-01,0,1,6,2,0,9
CHIMORE,"anticoncepcion, prevencion de its y de cancer de cuello uterino",implante subdermico: usuarias nuevas,2016-08-01,0,2,18,2,0,22
CHULUMANI (V. DE LA LIBERTAD),"anticoncepcion, prevencion de its y de cancer de cuello uterino",implante subdermico: usuarias nuevas,2016-08-01,0,1,2,1,0,4
CHUMA,"anticoncepcion, prevencion de its y de cancer de cuello uterino",implante subdermico: usuarias nuevas,2016-08-01,0,0,3,1,0,4
CKOCHAS,"anticoncepcion, prevencion de its y de cancer de cuello uterino",implante subdermico: usuarias nuevas,2016-08-01,0,1,4,3,0,8
CLIZA,"anticoncepcion, prevencion de its y de cancer de cuello uterino",implante subdermico: usuarias nuevas,2016-08-01,0,2,3,0,0,5
COBIJA,"anticoncepcion, prevencion de its y de cancer de cuello uterino",implante subdermico: usuarias nuevas,2016-08-01,2,10,21,0,0,33
COCAPATA,"anticoncepcion, prevencion de its y de cancer de cuello uterino",implante subdermico: usuarias nuevas,2016-08-01,0,0,3,0,0,3
COCHABAMBA,"anticoncepcion, prevencion de its y de cancer de cuello uterino",implante subdermico: usuarias nuevas,2016-08-01,0,23,137,77,0,237
COLCAPIRHUA,"anticoncepcion, prevencion de its y de cancer de cuello uterino",implante subdermico: usuarias nuevas,2016-08-01,0,3,44,1,0,48
COLOMI,"anticoncepcion, prevencion de its y de cancer de cuello uterino",implante subdermico: usuarias nuevas,2016-08-01,0,0,14,0,0,14
COLQUIRI,"anticoncepcion, prevencion de its y de cancer de cuello uterino",implante subdermico: usuarias nuevas,2016-08-01,0,0,1,0,0,1
CORIPATA,"anticoncepcion, prevencion de its y de cancer de cuello uterino",implante subdermico: usuarias nuevas,2016-08-01,0,0,6,0,0,6
CORQUE,"anticoncepcion, prevencion de its y de cancer de cuello uterino",implante subdermico: usuarias nuevas,2016-08-01,0,0,1,1,0,2
COTAGAITA,"anticoncepcion, prevencion de its y de cancer de cuello uterino",implante subdermico: usuarias nuevas,2016-08-01,0,1,11,1,0,13
CULPINA,"anticoncepcion, prevencion de its y de cancer de cuello uterino",implante subdermico: usuarias nuevas,2016-08-01,0,1,8,3,0,12
EL ALTO,"anticoncepcion, prevencion de its y de cancer de cuello uterino",implante subdermico: usuarias nuevas,2016-08-01,0,20,104,50,0,174
EL TORNO,"anticoncepcion, prevencion de its y de cancer de cuello uterino",implante subdermico: usuarias nuevas,2016-08-01,0,19,37,8,0,64
EL VILLAR,"anticoncepcion, prevencion de its y de cancer de cuello uterino",implante subdermico: usuarias nuevas,2016-08-01,0,0,1,0,0,1
ENTRE RIOS TRJ,"anticoncepcion, prevencion de its y de cancer de cuello uterino",implante subdermico: usuarias nuevas,2016-08-01,0,1,11,2,0,14
ENTRE RIOS CBBA,"anticoncepcion, prevencion de its y de cancer de cuello uterino",implante subdermico: usuarias nuevas,2016-08-01,0,7,7,2,0,16
ESCOMA,"anticoncepcion, prevencion de its y de cancer de cuello uterino",implante subdermico: usuarias nuevas,2016-08-01,0,0,2,1,0,3
ESMERALDA,"anticoncepcion, prevencion de its y de cancer de cuello uterino",implante subdermico: usuarias nuevas,2016-08-01,0,0,1,0,0,1
EUREKA (SANTOS MERCADO),"anticoncepcion, prevencion de its y de cancer de cuello uterino",implante subdermico: usuarias nuevas,2016-08-01,0,1,0,0,0,1
FILADELFIA,"anticoncepcion, prevencion de its y de cancer de cuello uterino",implante subdermico: usuarias nuevas,2016-08-01,0,0,1,1,0,2
GRAL. J.J. PEREZ (CHARAZANI),"anticoncepcion, prevencion de its y de cancer de cuello uterino",implante subdermico: usuarias nuevas,2016-08-01,0,0,5,1,0,6
GUAYARAMERIN,"anticoncepcion, prevencion de its y de cancer de cuello uterino",implante subdermico: usuarias nuevas,2016-08-01,1,19,48,7,0,75
HUACARETA,"anticoncepcion, prevencion de its y de cancer de cuello uterino",implante subdermico: usuarias nuevas,2016-08-01,0,0,2,0,0,2
HUANUNI,"anticoncepcion, prevencion de its y de cancer de cuello uterino",implante subdermico: usuarias nuevas,2016-08-01,0,4,14,5,0,23
ICHOCA,"anticoncepcion, prevencion de its y de cancer de cuello uterino",implante subdermico: usuarias nuevas,2016-08-01,0,0,1,0,0,1
ICLA,"anticoncepcion, prevencion de its y de cancer de cuello uterino",implante subdermico: usuarias nuevas,2016-08-01,0,0,3,0,0,3
INCAHUASI,"anticoncepcion, prevencion de its y de cancer de cuello uterino",implante subdermico: usuarias nuevas,2016-08-01,0,1,4,1,0,6
INGAVI (HUMAITA),"anticoncepcion, prevencion de its y de cancer de cuello uterino",implante subdermico: usuarias nuevas,2016-08-01,0,1,1,0,0,2
IRUPANA (VILLA DE LANZA),"anticoncepcion, prevencion de its y de cancer de cuello uterino",implante subdermico: usuarias nuevas,2016-08-01,0,5,15,7,0,27
LA PAZ,"anticoncepcion, prevencion de its y de cancer de cuello uterino",implante subdermico: usuarias nuevas,2016-08-01,3,29,157,90,0,279
LAJA,"anticoncepcion, prevencion de its y de cancer de cuello uterino",implante subdermico: usuarias nuevas,2016-08-01,0,0,1,0,0,1
LAS CARRERAS,"anticoncepcion, prevencion de its y de cancer de cuello uterino",implante subdermico: usuarias nuevas,2016-08-01,0,0,3,0,0,3
LICOMA PAMPA,"anticoncepcion, prevencion de its y de cancer de cuello uterino",implante subdermico: usuarias nuevas,2016-08-01,0,0,1,0,0,1
LLALLAGUA,"anticoncepcion, prevencion de its y de cancer de cuello uterino",implante subdermico: usuarias nuevas,2016-08-01,0,2,15,2,0,19
LLICA,"anticoncepcion, prevencion de its y de cancer de cuello uterino",implante subdermico: usuarias nuevas,2016-08-01,0,1,0,0,0,1
LURIBAY,"anticoncepcion, prevencion de its y de cancer de cuello uterino",implante subdermico: usuarias nuevas,2016-08-01,0,0,0,1,0,1
MACHACAMARCA,"anticoncepcion, prevencion de its y de cancer de cuello uterino",implante subdermico: usuarias nuevas,2016-08-01,0,0,5,0,0,5
MACHARETI,"anticoncepcion, prevencion de its y de cancer de cuello uterino",implante subdermico: usuarias nuevas,2016-08-01,0,0,3,0,0,3
MAGDALENA,"anticoncepcion, prevencion de its y de cancer de cuello uterino",implante subdermico: usuarias nuevas,2016-08-01,0,0,1,0,0,1
MAPIRI,"anticoncepcion, prevencion de its y de cancer de cuello uterino",implante subdermico: usuarias nuevas,2016-08-01,0,2,6,0,0,8
MIZQUE,"anticoncepcion, prevencion de its y de cancer de cuello uterino",implante subdermico: usuarias nuevas,2016-08-01,1,0,8,1,0,10
MOCOMOCO,"anticoncepcion, prevencion de its y de cancer de cuello uterino",implante subdermico: usuarias nuevas,2016-08-01,0,0,2,0,0,2
MOJOCOYA,"anticoncepcion, prevencion de its y de cancer de cuello uterino",implante subdermico: usuarias nuevas,2016-08-01,0,1,1,1,0,3
MONTEAGUDO,"anticoncepcion, prevencion de its y de cancer de cuello uterino",implante subdermico: usuarias nuevas,2016-08-01,0,0,7,1,0,8
MONTERO,"anticoncepcion, prevencion de its y de cancer de cuello uterino",implante subdermico: usuarias nuevas,2016-08-01,0,2,0,0,0,2
ORURO,"anticoncepcion, prevencion de its y de cancer de cuello uterino",implante subdermico: usuarias nuevas,2016-08-01,0,14,72,15,0,101
PADILLA,"anticoncepcion, prevencion de its y de cancer de cuello uterino",implante subdermico: usuarias nuevas,2016-08-01,0,0,5,0,0,5
PAILON,"anticoncepcion, prevencion de its y de cancer de cuello uterino",implante subdermico: usuarias nuevas,2016-08-01,0,0,1,0,0,1
PALCA,"anticoncepcion, prevencion de its y de cancer de cuello uterino",implante subdermico: usuarias nuevas,2016-08-01,0,2,3,0,0,5
PALOS BLANCOS,"anticoncepcion, prevencion de its y de cancer de cuello uterino",implante subdermico: usuarias nuevas,2016-08-01,1,3,15,4,0,23
PAMPA AULLAGAS,"anticoncepcion, prevencion de its y de cancer de cuello uterino",implante subdermico: usuarias nuevas,2016-08-01,0,1,1,0,0,2
PASORAPA,"anticoncepcion, prevencion de its y de cancer de cuello uterino",implante subdermico: usuarias nuevas,2016-08-01,0,0,1,0,0,1
PAZÑA,"anticoncepcion, prevencion de its y de cancer de cuello uterino",implante subdermico: usuarias nuevas,2016-08-01,0,1,0,0,0,1
POCOATA,"anticoncepcion, prevencion de its y de cancer de cuello uterino",implante subdermico: usuarias nuevas,2016-08-01,0,0,2,0,0,2
POOPO,"anticoncepcion, prevencion de its y de cancer de cuello uterino",implante subdermico: usuarias nuevas,2016-08-01,0,2,3,1,0,6
PORCO,"anticoncepcion, prevencion de its y de cancer de cuello uterino",implante subdermico: usuarias nuevas,2016-08-01,0,1,17,0,0,18
POROMA,"anticoncepcion, prevencion de its y de cancer de cuello uterino",implante subdermico: usuarias nuevas,2016-08-01,0,11,11,4,0,26
POTOSI,"anticoncepcion, prevencion de its y de cancer de cuello uterino",implante subdermico: usuarias nuevas,2016-08-01,0,17,95,23,0,135
PRESTO,"anticoncepcion, prevencion de its y de cancer de cuello uterino",implante subdermico: usuarias nuevas,2016-08-01,0,0,4,2,0,6
PUCARANI,"anticoncepcion, prevencion de its y de cancer de cuello uterino",implante subdermico: usuarias nuevas,2016-08-01,0,0,1,0,0,1
PUERTO GONZALO MORENO,"anticoncepcion, prevencion de its y de cancer de cuello uterino",implante subdermico: usuarias nuevas,2016-08-01,1,0,1,0,0,2
PUERTO RICO,"anticoncepcion, prevencion de its y de cancer de cuello uterino",implante subdermico: usuarias nuevas,2016-08-01,0,3,0,0,0,3
PUERTO VILLARROEL,"anticoncepcion, prevencion de its y de cancer de cuello uterino",implante subdermico: usuarias nuevas,2016-08-01,0,2,18,3,0,23
PUNA,"anticoncepcion, prevencion de its y de cancer de cuello uterino",implante subdermico: usuarias nuevas,2016-08-01,0,3,2,2,0,7
QUILLACOLLO,"anticoncepcion, prevencion de its y de cancer de cuello uterino",implante subdermico: usuarias nuevas,2016-08-01,0,1,9,0,0,10
RIBERALTA,"anticoncepcion, prevencion de its y de cancer de cuello uterino",implante subdermico: usuarias nuevas,2016-08-01,1,31,67,22,0,121
ROBORE,"anticoncepcion, prevencion de its y de cancer de cuello uterino",implante subdermico: usuarias nuevas,2016-08-01,0,0,24,0,0,24
RURRENABAQUE,"anticoncepcion, prevencion de its y de cancer de cuello uterino",implante subdermico: usuarias nuevas,2016-08-01,0,3,10,0,0,13
SACABA,"anticoncepcion, prevencion de its y de cancer de cuello uterino",implante subdermico: usuarias nuevas,2016-08-01,0,6,27,10,0,43
SACACA,"anticoncepcion, prevencion de its y de cancer de cuello uterino",implante subdermico: usuarias nuevas,2016-08-01,0,1,7,1,0,9
SALINAS DE GARCI MENDOZA,"anticoncepcion, prevencion de its y de cancer de cuello uterino",implante subdermico: usuarias nuevas,2016-08-01,0,0,3,2,0,5
SAN ANDRES,"anticoncepcion, prevencion de its y de cancer de cuello uterino",implante subdermico: usuarias nuevas,2016-08-01,0,0,3,0,0,3
SAN BORJA,"anticoncepcion, prevencion de its y de cancer de cuello uterino",implante subdermico: usuarias nuevas,2016-08-01,0,1,3,4,0,8
SAN CARLOS,"anticoncepcion, prevencion de its y de cancer de cuello uterino",implante subdermico: usuarias nuevas,2016-08-01,0,9,20,1,0,30
SAN IGNACIO,"anticoncepcion, prevencion de its y de cancer de cuello uterino",implante subdermico: usuarias nuevas,2016-08-01,0,2,7,0,0,9
SAN JOAQUIN,"anticoncepcion, prevencion de its y de cancer de cuello uterino",implante subdermico: usuarias nuevas,2016-08-01,0,0,2,0,0,2
SAN JULIAN,"anticoncepcion, prevencion de its y de cancer de cuello uterino",implante subdermico: usuarias nuevas,2016-08-01,1,10,18,4,0,33
SAN LORENZO(PND),"anticoncepcion, prevencion de its y de cancer de cuello uterino",implante subdermico: usuarias nuevas,2016-08-01,0,4,8,0,0,12
SAN LORENZO(TJA),"anticoncepcion, prevencion de its y de cancer de cuello uterino",implante subdermico: usuarias nuevas,2016-08-01,0,0,1,0,0,1
SAN LUCAS,"anticoncepcion, prevencion de its y de cancer de cuello uterino",implante subdermico: usuarias nuevas,2016-08-01,0,5,4,0,0,9
SAN PABLO DE LIPEZ,"anticoncepcion, prevencion de its y de cancer de cuello uterino",implante subdermico: usuarias nuevas,2016-08-01,0,0,1,0,0,1
SANTA CRUZ DE LA SIERRA,"anticoncepcion, prevencion de its y de cancer de cuello uterino",implante subdermico: usuarias nuevas,2016-08-01,3,41,98,162,0,304
SANTIAGO DE HUARI,"anticoncepcion, prevencion de its y de cancer de cuello uterino",implante subdermico: usuarias nuevas,2016-08-01,0,0,2,2,0,4
SANTUARIO DE QUILLACAS,"anticoncepcion, prevencion de its y de cancer de cuello uterino",implante subdermico: usuarias nuevas,2016-08-01,0,0,3,0,0,3
SAPAHAQUI,"anticoncepcion, prevencion de its y de cancer de cuello uterino",implante subdermico: usuarias nuevas,2016-08-01,0,0,3,0,0,3
SENA,"anticoncepcion, prevencion de its y de cancer de cuello uterino",implante subdermico: usuarias nuevas,2016-08-01,0,0,1,0,0,1
SICA SICA (VILLA AROMA),"anticoncepcion, prevencion de its y de cancer de cuello uterino",implante subdermico: usuarias nuevas,2016-08-01,0,1,16,7,0,24
SOPACHUY,"anticoncepcion, prevencion de its y de cancer de cuello uterino",implante subdermico: usuarias nuevas,2016-08-01,0,0,0,1,0,1
SORATA,"anticoncepcion, prevencion de its y de cancer de cuello uterino",implante subdermico: usuarias nuevas,2016-08-01,0,1,3,1,0,5
SUCRE,"anticoncepcion, prevencion de its y de cancer de cuello uterino",implante subdermico: usuarias nuevas,2016-08-01,0,43,167,20,2,232
TAPACARI,"anticoncepcion, prevencion de its y de cancer de cuello uterino",implante subdermico: usuarias nuevas,2016-08-01,0,0,2,5,0,7
TARABUCO,"anticoncepcion, prevencion de its y de cancer de cuello uterino",implante subdermico: usuarias nuevas,2016-08-01,0,0,0,1,0,1
TARATA,"anticoncepcion, prevencion de its y de cancer de cuello uterino",implante subdermico: usuarias nuevas,2016-08-01,0,0,2,1,0,3
TARIJA,"anticoncepcion, prevencion de its y de cancer de cuello uterino",implante subdermico: usuarias nuevas,2016-08-01,0,33,168,12,0,213
TARVITA,"anticoncepcion, prevencion de its y de cancer de cuello uterino",implante subdermico: usuarias nuevas,2016-08-01,0,0,3,0,0,3
TIAWANACU,"anticoncepcion, prevencion de its y de cancer de cuello uterino",implante subdermico: usuarias nuevas,2016-08-01,0,1,3,0,0,4
TINGUIPAYA,"anticoncepcion, prevencion de its y de cancer de cuello uterino",implante subdermico: usuarias nuevas,2016-08-01,0,0,3,0,0,3
TIPUANI,"anticoncepcion, prevencion de its y de cancer de cuello uterino",implante subdermico: usuarias nuevas,2016-08-01,0,1,3,0,0,4
TIQUIPAYA,"anticoncepcion, prevencion de its y de cancer de cuello uterino",implante subdermico: usuarias nuevas,2016-08-01,0,0,11,1,0,12
TIRAQUE (CBBA),"anticoncepcion, prevencion de its y de cancer de cuello uterino",implante subdermico: usuarias nuevas,2016-08-01,0,0,3,0,0,3
TODOS SANTOS,"anticoncepcion, prevencion de its y de cancer de cuello uterino",implante subdermico: usuarias nuevas,2016-08-01,0,0,1,0,0,1
TOLATA,"anticoncepcion, prevencion de its y de cancer de cuello uterino",implante subdermico: usuarias nuevas,2016-08-01,0,0,2,0,0,2
TOLEDO,"anticoncepcion, prevencion de its y de cancer de cuello uterino",implante subdermico: usuarias nuevas,2016-08-01,0,0,3,0,0,3
TOMINA,"anticoncepcion, prevencion de its y de cancer de cuello uterino",implante subdermico: usuarias nuevas,2016-08-01,0,1,12,0,0,13
TORO TORO,"anticoncepcion, prevencion de its y de cancer de cuello uterino",implante subdermico: usuarias nuevas,2016-08-01,0,1,7,3,0,11
TOTORA(CBBA),"anticoncepcion, prevencion de its y de cancer de cuello uterino",implante subdermico: usuarias nuevas,2016-08-01,0,1,6,0,0,7
TOTORA(ORR),"anticoncepcion, prevencion de its y de cancer de cuello uterino",implante subdermico: usuarias nuevas,2016-08-01,1,1,2,0,0,4
TRINIDAD,"anticoncepcion, prevencion de its y de cancer de cuello uterino",implante subdermico: usuarias nuevas,2016-08-01,1,11,34,18,0,64
TUPIZA,"anticoncepcion, prevencion de its y de cancer de cuello uterino",implante subdermico: usuarias nuevas,2016-08-01,0,4,30,5,0,39
TURCO,"anticoncepcion, prevencion de its y de cancer de cuello uterino",implante subdermico: usuarias nuevas,2016-08-01,0,1,1,0,0,2
URIONDO (A. CONCEPCION),"anticoncepcion, prevencion de its y de cancer de cuello uterino",implante subdermico: usuarias nuevas,2016-08-01,0,1,1,0,0,2
VALLEGRANDE,"anticoncepcion, prevencion de its y de cancer de cuello uterino",implante subdermico: usuarias nuevas,2016-08-01,0,0,0,3,0,3
VIACHA,"anticoncepcion, prevencion de its y de cancer de cuello uterino",implante subdermico: usuarias nuevas,2016-08-01,0,21,110,9,0,140
VILLA CHARCAS,"anticoncepcion, prevencion de its y de cancer de cuello uterino",implante subdermico: usuarias nuevas,2016-08-01,0,1,7,0,0,8
VILLA SERRANO,"anticoncepcion, prevencion de its y de cancer de cuello uterino",implante subdermico: usuarias nuevas,2016-08-01,0,1,1,0,0,2
VILLA TUNARI,"anticoncepcion, prevencion de its y de cancer de cuello uterino",implante subdermico: usuarias nuevas,2016-08-01,0,0,11,9,0,20
VILLA VACA GUZMAN (MUYUPAMPA),"anticoncepcion, prevencion de its y de cancer de cuello uterino",implante subdermico: usuarias nuevas,2016-08-01,0,2,4,0,0,6
VILLAZON,"anticoncepcion, prevencion de its y de cancer de cuello uterino",implante subdermico: usuarias nuevas,2016-08-01,0,10,29,7,0,46
VITICHI,"anticoncepcion, prevencion de its y de cancer de cuello uterino",implante subdermico: usuarias nuevas,2016-08-01,0,1,0,1,0,2
WALDO BALLIVIAN,"anticoncepcion, prevencion de its y de cancer de cuello uterino",implante subdermico: usuarias nuevas,2016-08-01,0,0,5,0,0,5
WARNES,"anticoncepcion, prevencion de its y de cancer de cuello uterino",implante subdermico: usuarias nuevas,2016-08-01,0,0,11,0,0,11
YAMPARAEZ,"anticoncepcion, prevencion de its y de cancer de cuello uterino",implante subdermico: usuarias nuevas,2016-08-01,0,1,3,0,0,4
YANACACHI,"anticoncepcion, prevencion de its y de cancer de cuello uterino",implante subdermico: usuarias nuevas,2016-08-01,0,0,2,0,0,2
YOTALA,"anticoncepcion, prevencion de its y de cancer de cuello uterino",implante subdermico: usuarias nuevas,2016-08-01,0,0,3,0,0,3
ZUDAÑEZ,"anticoncepcion, prevencion de its y de cancer de cuello uterino",implante subdermico: usuarias nuevas,2016-08-01,0,0,2,0,0,2
ACHOCALLA,"anticoncepcion, prevencion de its y de cancer de cuello uterino",implante subdermico: usuarias nuevas,2016-09-01,0,1,7,2,0,10
AIQUILE,"anticoncepcion, prevencion de its y de cancer de cuello uterino",implante subdermico: usuarias nuevas,2016-09-01,0,2,10,8,0,20
ALCALA,"anticoncepcion, prevencion de its y de cancer de cuello uterino",implante subdermico: usuarias nuevas,2016-09-01,0,1,2,2,0,5
ALTO BENI,"anticoncepcion, prevencion de its y de cancer de cuello uterino",implante subdermico: usuarias nuevas,2016-09-01,0,0,2,0,0,2
ANDAMARCA,"anticoncepcion, prevencion de its y de cancer de cuello uterino",implante subdermico: usuarias nuevas,2016-09-01,0,0,1,0,0,1
ANTEQUERA,"anticoncepcion, prevencion de its y de cancer de cuello uterino",implante subdermico: usuarias nuevas,2016-09-01,0,1,3,0,0,4
APOLO,"anticoncepcion, prevencion de its y de cancer de cuello uterino",implante subdermico: usuarias nuevas,2016-09-01,0,1,6,2,0,9
ARBIETO,"anticoncepcion, prevencion de its y de cancer de cuello uterino",implante subdermico: usuarias nuevas,2016-09-01,0,0,5,0,0,5
ATOCHA,"anticoncepcion, prevencion de its y de cancer de cuello uterino",implante subdermico: usuarias nuevas,2016-09-01,0,0,2,0,0,2
AUCAPATA,"anticoncepcion, prevencion de its y de cancer de cuello uterino",implante subdermico: usuarias nuevas,2016-09-01,0,2,2,3,0,7
AYATA,"anticoncepcion, prevencion de its y de cancer de cuello uterino",implante subdermico: usuarias nuevas,2016-09-01,0,0,1,1,0,2
AYOPAYA (V. DE INDEPENDENCIA),"anticoncepcion, prevencion de its y de cancer de cuello uterino",implante subdermico: usuarias nuevas,2016-09-01,0,0,5,0,0,5
AZURDUY,"anticoncepcion, prevencion de its y de cancer de cuello uterino",implante subdermico: usuarias nuevas,2016-09-01,0,0,2,0,0,2
BELLA FLOR,"anticoncepcion, prevencion de its y de cancer de cuello uterino",implante subdermico: usuarias nuevas,2016-09-01,0,2,2,0,0,4
BERMEJO,"anticoncepcion, prevencion de its y de cancer de cuello uterino",implante subdermico: usuarias nuevas,2016-09-01,0,2,9,0,0,11
BETANZOS,"anticoncepcion, prevencion de its y de cancer de cuello uterino",implante subdermico: usuarias nuevas,2016-09-01,0,3,4,0,0,7
"CAIZA ""D""","anticoncepcion, prevencion de its y de cancer de cuello uterino",implante subdermico: usuarias nuevas,2016-09-01,0,0,1,0,0,1
CALAMARCA,"anticoncepcion, prevencion de its y de cancer de cuello uterino",implante subdermico: usuarias nuevas,2016-09-01,0,0,2,0,0,2
CAMARGO,"anticoncepcion, prevencion de its y de cancer de cuello uterino",implante subdermico: usuarias nuevas,2016-09-01,0,1,1,1,0,3
CAPINOTA,"anticoncepcion, prevencion de its y de cancer de cuello uterino",implante subdermico: usuarias nuevas,2016-09-01,0,3,8,1,0,12
CARACOLLO,"anticoncepcion, prevencion de its y de cancer de cuello uterino",implante subdermico: usuarias nuevas,2016-09-01,0,1,13,2,0,16
CARANAVI,"anticoncepcion, prevencion de its y de cancer de cuello uterino",implante subdermico: usuarias nuevas,2016-09-01,1,11,41,8,0,61
CATACORA,"anticoncepcion, prevencion de its y de cancer de cuello uterino",implante subdermico: usuarias nuevas,2016-09-01,0,0,1,0,0,1
CHALLAPATA,"anticoncepcion, prevencion de its y de cancer de cuello uterino",implante subdermico: usuarias nuevas,2016-09-01,0,2,8,0,0,10
CHAYANTA,"anticoncepcion, prevencion de its y de cancer de cuello uterino",implante subdermico: usuarias nuevas,2016-09-01,0,4,2,0,0,6
CHIMORE,"anticoncepcion, prevencion de its y de cancer de cuello uterino",implante subdermico: usuarias nuevas,2016-09-01,0,2,15,1,0,18
CHULUMANI (V. DE LA LIBERTAD),"anticoncepcion, prevencion de its y de cancer de cuello uterino",implante subdermico: usuarias nuevas,2016-09-01,0,3,3,0,0,6
CHUMA,"anticoncepcion, prevencion de its y de cancer de cuello uterino",implante subdermico: usuarias nuevas,2016-09-01,0,0,1,0,0,1
CLIZA,"anticoncepcion, prevencion de its y de cancer de cuello uterino",implante subdermico: usuarias nuevas,2016-09-01,0,0,5,0,0,5
COBIJA,"anticoncepcion, prevencion de its y de cancer de cuello uterino",implante subdermico: usuarias nuevas,2016-09-01,1,9,14,1,0,25
COCAPATA,"anticoncepcion, prevencion de its y de cancer de cuello uterino",implante subdermico: usuarias nuevas,2016-09-01,0,3,4,0,0,7
COCHABAMBA,"anticoncepcion, prevencion de its y de cancer de cuello uterino",implante subdermico: usuarias nuevas,2016-09-01,0,24,98,14,0,136
COLCAPIRHUA,"anticoncepcion, prevencion de its y de cancer de cuello uterino",implante subdermico: usuarias nuevas,2016-09-01,0,5,23,6,0,34
COLOMI,"anticoncepcion, prevencion de its y de cancer de cuello uterino",implante subdermico: usuarias nuevas,2016-09-01,0,0,3,0,0,3
COLQUENCHA,"anticoncepcion, prevencion de its y de cancer de cuello uterino",implante subdermico: usuarias nuevas,2016-09-01,0,0,2,0,0,2
COLQUIRI,"anticoncepcion, prevencion de its y de cancer de cuello uterino",implante subdermico: usuarias nuevas,2016-09-01,0,8,28,5,0,41
CORIPATA,"anticoncepcion, prevencion de its y de cancer de cuello uterino",implante subdermico: usuarias nuevas,2016-09-01,0,2,1,1,0,4
COROICO,"anticoncepcion, prevencion de its y de cancer de cuello uterino",implante subdermico: usuarias nuevas,2016-09-01,0,0,1,0,0,1
CORQUE,"anticoncepcion, prevencion de its y de cancer de cuello uterino",implante subdermico: usuarias nuevas,2016-09-01,0,0,4,2,0,6
COTAGAITA,"anticoncepcion, prevencion de its y de cancer de cuello uterino",implante subdermico: usuarias nuevas,2016-09-01,0,0,1,0,0,1
CUCHUMUELA (V. G. VILLARROEL),"anticoncepcion, prevencion de its y de cancer de cuello uterino",implante subdermico: usuarias nuevas,2016-09-01,0,0,12,1,0,13
CULPINA,"anticoncepcion, prevencion de its y de cancer de cuello uterino",implante subdermico: usuarias nuevas,2016-09-01,0,2,4,1,0,7
EL ALTO,"anticoncepcion, prevencion de its y de cancer de cuello uterino",implante subdermico: usuarias nuevas,2016-09-01,0,17,106,44,1,168
EL CHORO,"anticoncepcion, prevencion de its y de cancer de cuello uterino",implante subdermico: usuarias nuevas,2016-09-01,0,0,1,0,0,1
EL TORNO,"anticoncepcion, prevencion de its y de cancer de cuello uterino",implante subdermico: usuarias nuevas,2016-09-01,0,8,41,3,0,52
ENTRE RIOS TRJ,"anticoncepcion, prevencion de its y de cancer de cuello uterino",implante subdermico: usuarias nuevas,2016-09-01,0,3,14,3,0,20
ESCOMA,"anticoncepcion, prevencion de its y de cancer de cuello uterino",implante subdermico: usuarias nuevas,2016-09-01,0,0,3,1,0,4
EUCALIPTUS,"anticoncepcion, prevencion de its y de cancer de cuello uterino",implante subdermico: usuarias nuevas,2016-09-01,0,0,0,1,0,1
FILADELFIA,"anticoncepcion, prevencion de its y de cancer de cuello uterino",implante subdermico: usuarias nuevas,2016-09-01,0,0,3,3,0,6
GRAL. J.J. PEREZ (CHARAZANI),"anticoncepcion, prevencion de its y de cancer de cuello uterino",implante subdermico: usuarias nuevas,2016-09-01,0,0,7,2,0,9
GUAYARAMERIN,"anticoncepcion, prevencion de its y de cancer de cuello uterino",implante subdermico: usuarias nuevas,2016-09-01,3,40,106,3,0,152
HUACARETA,"anticoncepcion, prevencion de its y de cancer de cuello uterino",implante subdermico: usuarias nuevas,2016-09-01,0,0,1,1,0,2
HUACHACALLA,"anticoncepcion, prevencion de its y de cancer de cuello uterino",implante subdermico: usuarias nuevas,2016-09-01,0,0,2,0,0,2
HUANUNI,"anticoncepcion, prevencion de its y de cancer de cuello uterino",implante subdermico: usuarias nuevas,2016-09-01,0,1,10,1,0,12
HUAYLLAMARCA,"anticoncepcion, prevencion de its y de cancer de cuello uterino",implante subdermico: usuarias nuevas,2016-09-01,0,0,1,0,0,1
ICLA,"anticoncepcion, prevencion de its y de cancer de cuello uterino",implante subdermico: usuarias nuevas,2016-09-01,0,0,1,0,0,1
INCAHUASI,"anticoncepcion, prevencion de its y de cancer de cuello uterino",implante subdermico: usuarias nuevas,2016-09-01,0,1,2,0,0,3
IRUPANA (VILLA DE LANZA),"anticoncepcion, prevencion de its y de cancer de cuello uterino",implante subdermico: usuarias nuevas,2016-09-01,0,1,8,2,0,11
LA ASUNTA,"anticoncepcion, prevencion de its y de cancer de cuello uterino",implante subdermico: usuarias nuevas,2016-09-01,0,2,11,3,0,16
LA PAZ,"anticoncepcion, prevencion de its y de cancer de cuello uterino",implante subdermico: usuarias nuevas,2016-09-01,0,19,135,133,1,288
LAJA,"anticoncepcion, prevencion de its y de cancer de cuello uterino",implante subdermico: usuarias nuevas,2016-09-01,0,0,1,0,0,1
LAS CARRERAS,"anticoncepcion, prevencion de its y de cancer de cuello uterino",implante subdermico: usuarias nuevas,2016-09-01,0,0,2,0,0,2
LLALLAGUA,"anticoncepcion, prevencion de its y de cancer de cuello uterino",implante subdermico: usuarias nuevas,2016-09-01,0,5,17,3,0,25
LURIBAY,"anticoncepcion, prevencion de its y de cancer de cuello uterino",implante subdermico: usuarias nuevas,2016-09-01,0,0,1,0,0,1
MACHACAMARCA,"anticoncepcion, prevencion de its y de cancer de cuello uterino",implante subdermico: usuarias nuevas,2016-09-01,0,0,3,0,0,3
MACHARETI,"anticoncepcion, prevencion de its y de cancer de cuello uterino",implante subdermico: usuarias nuevas,2016-09-01,0,1,6,0,0,7
MAPIRI,"anticoncepcion, prevencion de its y de cancer de cuello uterino",implante subdermico: usuarias nuevas,2016-09-01,0,0,3,0,0,3
MECAPACA,"anticoncepcion, prevencion de its y de cancer de cuello uterino",implante subdermico: usuarias nuevas,2016-09-01,0,0,2,0,0,2
MIZQUE,"anticoncepcion, prevencion de its y de cancer de cuello uterino",implante subdermico: usuarias nuevas,2016-09-01,0,0,6,1,0,7
MOJOCOYA,"anticoncepcion, prevencion de its y de cancer de cuello uterino",implante subdermico: usuarias nuevas,2016-09-01,0,0,1,0,0,1
MONTEAGUDO,"anticoncepcion, prevencion de its y de cancer de cuello uterino",implante subdermico: usuarias nuevas,2016-09-01,0,2,3,0,0,5
MONTERO,"anticoncepcion, prevencion de its y de cancer de cuello uterino",implante subdermico: usuarias nuevas,2016-09-01,0,1,0,0,0,1
NUEVO MANOA (NUEVA ESPERANZA),"anticoncepcion, prevencion de its y de cancer de cuello uterino",implante subdermico: usuarias nuevas,2016-09-01,0,1,4,0,0,5
OKINAWA,"anticoncepcion, prevencion de its y de cancer de cuello uterino",implante subdermico: usuarias nuevas,2016-09-01,0,0,2,1,0,3
ORURO,"anticoncepcion, prevencion de its y de cancer de cuello uterino",implante subdermico: usuarias nuevas,2016-09-01,1,16,71,14,0,102
PADILLA,"anticoncepcion, prevencion de its y de cancer de cuello uterino",implante subdermico: usuarias nuevas,2016-09-01,0,1,1,1,0,3
PAILON,"anticoncepcion, prevencion de its y de cancer de cuello uterino",implante subdermico: usuarias nuevas,2016-09-01,0,0,6,1,0,7
PALCA,"anticoncepcion, prevencion de its y de cancer de cuello uterino",implante subdermico: usuarias nuevas,2016-09-01,0,0,4,0,0,4
PALOS BLANCOS,"anticoncepcion, prevencion de its y de cancer de cuello uterino",implante subdermico: usuarias nuevas,2016-09-01,0,1,6,1,0,8
PAMPA AULLAGAS,"anticoncepcion, prevencion de its y de cancer de cuello uterino",implante subdermico: usuarias nuevas,2016-09-01,0,2,0,0,0,2
PAPEL PAMPA,"anticoncepcion, prevencion de its y de cancer de cuello uterino",implante subdermico: usuarias nuevas,2016-09-01,0,0,0,1,0,1
PAZÑA,"anticoncepcion, prevencion de its y de cancer de cuello uterino",implante subdermico: usuarias nuevas,2016-09-01,0,0,2,0,0,2
POCOATA,"anticoncepcion, prevencion de its y de cancer de cuello uterino",implante subdermico: usuarias nuevas,2016-09-01,0,0,0,7,0,7
POCONA,"anticoncepcion, prevencion de its y de cancer de cuello uterino",implante subdermico: usuarias nuevas,2016-09-01,0,3,3,0,0,6
POOPO,"anticoncepcion, prevencion de its y de cancer de cuello uterino",implante subdermico: usuarias nuevas,2016-09-01,0,2,10,3,0,15
PORCO,"anticoncepcion, prevencion de its y de cancer de cuello uterino",implante subdermico: usuarias nuevas,2016-09-01,0,1,15,5,0,21
POROMA,"anticoncepcion, prevencion de its y de cancer de cuello uterino",implante subdermico: usuarias nuevas,2016-09-01,0,3,3,4,0,10
PORVENIR,"anticoncepcion, prevencion de its y de cancer de cuello uterino",implante subdermico: usuarias nuevas,2016-09-01,0,1,0,0,0,1
POTOSI,"anticoncepcion, prevencion de its y de cancer de cuello uterino",implante subdermico: usuarias nuevas,2016-09-01,0,10,60,11,0,81
PRESTO,"anticoncepcion, prevencion de its y de cancer de cuello uterino",implante subdermico: usuarias nuevas,2016-09-01,0,0,1,0,0,1
PUCARANI,"anticoncepcion, prevencion de its y de cancer de cuello uterino",implante subdermico: usuarias nuevas,2016-09-01,0,2,1,0,0,3
PUERTO GONZALO MORENO,"anticoncepcion, prevencion de its y de cancer de cuello uterino",implante subdermico: usuarias nuevas,2016-09-01,1,0,1,0,0,2
PUERTO VILLARROEL,"anticoncepcion, prevencion de its y de cancer de cuello uterino",implante subdermico: usuarias nuevas,2016-09-01,0,5,21,2,0,28
PUNA,"anticoncepcion, prevencion de its y de cancer de cuello uterino",implante subdermico: usuarias nuevas,2016-09-01,0,2,6,2,0,10
QUILLACOLLO,"anticoncepcion, prevencion de its y de cancer de cuello uterino",implante subdermico: usuarias nuevas,2016-09-01,0,1,6,3,0,10
RIBERALTA,"anticoncepcion, prevencion de its y de cancer de cuello uterino",implante subdermico: usuarias nuevas,2016-09-01,0,19,37,8,0,64
RURRENABAQUE,"anticoncepcion, prevencion de its y de cancer de cuello uterino",implante subdermico: usuarias nuevas,2016-09-01,0,4,13,2,0,19
SACABA,"anticoncepcion, prevencion de its y de cancer de cuello uterino",implante subdermico: usuarias nuevas,2016-09-01,0,6,49,10,0,65
SACACA,"anticoncepcion, prevencion de its y de cancer de cuello uterino",implante subdermico: usuarias nuevas,2016-09-01,0,1,2,0,0,3
SALINAS DE GARCI MENDOZA,"anticoncepcion, prevencion de its y de cancer de cuello uterino",implante subdermico: usuarias nuevas,2016-09-01,0,0,3,2,0,5
SAN ANDRES,"anticoncepcion, prevencion de its y de cancer de cuello uterino",implante subdermico: usuarias nuevas,2016-09-01,0,0,4,0,0,4
SAN ANTONIO DE LOMERIO,"anticoncepcion, prevencion de its y de cancer de cuello uterino",implante subdermico: usuarias nuevas,2016-09-01,0,0,6,3,0,9
SAN BORJA,"anticoncepcion, prevencion de its y de cancer de cuello uterino",implante subdermico: usuarias nuevas,2016-09-01,0,3,1,0,0,4
SAN CARLOS,"anticoncepcion, prevencion de its y de cancer de cuello uterino",implante subdermico: usuarias nuevas,2016-09-01,0,7,7,2,0,16
SAN IGNACIO,"anticoncepcion, prevencion de its y de cancer de cuello uterino",implante subdermico: usuarias nuevas,2016-09-01,0,1,3,0,0,4
SAN JAVIER(BNI),"anticoncepcion, prevencion de its y de cancer de cuello uterino",implante subdermico: usuarias nuevas,2016-09-01,0,0,2,3,0,5
SAN JULIAN,"anticoncepcion, prevencion de its y de cancer de cuello uterino",implante subdermico: usuarias nuevas,2016-09-01,0,2,13,1,0,16
SAN LORENZO(PND),"anticoncepcion, prevencion de its y de cancer de cuello uterino",implante subdermico: usuarias nuevas,2016-09-01,0,3,3,0,0,6
SAN LORENZO(TJA),"anticoncepcion, prevencion de its y de cancer de cuello uterino",implante subdermico: usuarias nuevas,2016-09-01,0,2,3,1,0,6
SAN LUCAS,"anticoncepcion, prevencion de its y de cancer de cuello uterino",implante subdermico: usuarias nuevas,2016-09-01,0,1,4,0,0,5
SAN PEDRO(PND),"anticoncepcion, prevencion de its y de cancer de cuello uterino",implante subdermico: usuarias nuevas,2016-09-01,0,1,0,0,0,1
SANTA CRUZ DE LA SIERRA,"anticoncepcion, prevencion de its y de cancer de cuello uterino",implante subdermico: usuarias nuevas,2016-09-01,0,4,16,138,0,158
SANTIAGO DE HUARI,"anticoncepcion, prevencion de its y de cancer de cuello uterino",implante subdermico: usuarias nuevas,2016-09-01,0,0,3,0,0,3
SANTIAGO DE MACHACA,"anticoncepcion, prevencion de its y de cancer de cuello uterino",implante subdermico: usuarias nuevas,2016-09-01,0,1,9,3,0,13
SANTIVAÑES,"anticoncepcion, prevencion de its y de cancer de cuello uterino",implante subdermico: usuarias nuevas,2016-09-01,0,1,1,0,0,2
SANTUARIO DE QUILLACAS,"anticoncepcion, prevencion de its y de cancer de cuello uterino",implante subdermico: usuarias nuevas,2016-09-01,0,0,9,0,0,9
SAPAHAQUI,"anticoncepcion, prevencion de its y de cancer de cuello uterino",implante subdermico: usuarias nuevas,2016-09-01,0,0,3,0,0,3
SENA,"anticoncepcion, prevencion de its y de cancer de cuello uterino",implante subdermico: usuarias nuevas,2016-09-01,0,1,1,0,0,2
SICA SICA (VILLA AROMA),"anticoncepcion, prevencion de its y de cancer de cuello uterino",implante subdermico: usuarias nuevas,2016-09-01,0,2,4,3,0,9
SOPACHUY,"anticoncepcion, prevencion de its y de cancer de cuello uterino",implante subdermico: usuarias nuevas,2016-09-01,0,0,2,0,0,2
SORATA,"anticoncepcion, prevencion de its y de cancer de cuello uterino",implante subdermico: usuarias nuevas,2016-09-01,0,1,10,2,0,13
SUCRE,"anticoncepcion, prevencion de its y de cancer de cuello uterino",implante subdermico: usuarias nuevas,2016-09-01,1,26,136,19,0,182
TACACOMA,"anticoncepcion, prevencion de its y de cancer de cuello uterino",implante subdermico: usuarias nuevas,2016-09-01,0,1,1,0,0,2
TAPACARI,"anticoncepcion, prevencion de its y de cancer de cuello uterino",implante subdermico: usuarias nuevas,2016-09-01,0,0,4,1,0,5
TARABUCO,"anticoncepcion, prevencion de its y de cancer de cuello uterino",implante subdermico: usuarias nuevas,2016-09-01,0,1,2,0,0,3
TARATA,"anticoncepcion, prevencion de its y de cancer de cuello uterino",implante subdermico: usuarias nuevas,2016-09-01,0,0,2,0,0,2
TARIJA,"anticoncepcion, prevencion de its y de cancer de cuello uterino",implante subdermico: usuarias nuevas,2016-09-01,1,19,98,17,0,135
TARVITA,"anticoncepcion, prevencion de its y de cancer de cuello uterino",implante subdermico: usuarias nuevas,2016-09-01,0,0,3,0,0,3
TIAWANACU,"anticoncepcion, prevencion de its y de cancer de cuello uterino",implante subdermico: usuarias nuevas,2016-09-01,0,3,3,3,0,9
TINGUIPAYA,"anticoncepcion, prevencion de its y de cancer de cuello uterino",implante subdermico: usuarias nuevas,2016-09-01,0,0,0,2,0,2
TIPUANI,"anticoncepcion, prevencion de its y de cancer de cuello uterino",implante subdermico: usuarias nuevas,2016-09-01,0,0,5,3,0,8
TIQUIPAYA,"anticoncepcion, prevencion de its y de cancer de cuello uterino",implante subdermico: usuarias nuevas,2016-09-01,0,0,14,1,0,15
TIRAQUE (CBBA),"anticoncepcion, prevencion de its y de cancer de cuello uterino",implante subdermico: usuarias nuevas,2016-09-01,0,0,1,0,0,1
TOLEDO,"anticoncepcion, prevencion de its y de cancer de cuello uterino",implante subdermico: usuarias nuevas,2016-09-01,0,0,2,0,0,2
TOMINA,"anticoncepcion, prevencion de its y de cancer de cuello uterino",implante subdermico: usuarias nuevas,2016-09-01,0,1,9,0,0,10
TORO TORO,"anticoncepcion, prevencion de its y de cancer de cuello uterino",implante subdermico: usuarias nuevas,2016-09-01,0,1,2,0,0,3
TOTORA(CBBA),"anticoncepcion, prevencion de its y de cancer de cuello uterino",implante subdermico: usuarias nuevas,2016-09-01,0,0,1,0,0,1
TOTORA(ORR),"anticoncepcion, prevencion de its y de cancer de cuello uterino",implante subdermico: usuarias nuevas,2016-09-01,2,1,1,0,0,4
TRINIDAD,"anticoncepcion, prevencion de its y de cancer de cuello uterino",implante subdermico: usuarias nuevas,2016-09-01,0,10,52,0,0,62
TUPIZA,"anticoncepcion, prevencion de its y de cancer de cuello uterino",implante subdermico: usuarias nuevas,2016-09-01,0,4,22,30,0,56
TURCO,"anticoncepcion, prevencion de its y de cancer de cuello uterino",implante subdermico: usuarias nuevas,2016-09-01,0,0,1,2,0,3
URIONDO (A. CONCEPCION),"anticoncepcion, prevencion de its y de cancer de cuello uterino",implante subdermico: usuarias nuevas,2016-09-01,0,2,1,0,0,3
UYUNI,"anticoncepcion, prevencion de its y de cancer de cuello uterino",implante subdermico: usuarias nuevas,2016-09-01,0,10,41,4,0,55
VILLA CHARCAS,"anticoncepcion, prevencion de its y de cancer de cuello uterino",implante subdermico: usuarias nuevas,2016-09-01,0,0,4,0,0,4
VILLA NUEVA (LOMA ALTA),"anticoncepcion, prevencion de its y de cancer de cuello uterino",implante subdermico: usuarias nuevas,2016-09-01,0,0,1,0,0,1
VILLA SERRANO,"anticoncepcion, prevencion de its y de cancer de cuello uterino",implante subdermico: usuarias nuevas,2016-09-01,0,0,0,2,0,2
VILLA TUNARI,"anticoncepcion, prevencion de its y de cancer de cuello uterino",implante subdermico: usuarias nuevas,2016-09-01,0,1,10,8,0,19
VILLA VACA GUZMAN (MUYUPAMPA),"anticoncepcion, prevencion de its y de cancer de cuello uterino",implante subdermico: usuarias nuevas,2016-09-01,0,1,6,4,0,11
VILLAZON,"anticoncepcion, prevencion de its y de cancer de cuello uterino",implante subdermico: usuarias nuevas,2016-09-01,0,5,27,1,0,33
VINTO,"anticoncepcion, prevencion de its y de cancer de cuello uterino",implante subdermico: usuarias nuevas,2016-09-01,0,0,3,0,0,3
VITICHI,"anticoncepcion, prevencion de its y de cancer de cuello uterino",implante subdermico: usuarias nuevas,2016-09-01,0,0,6,3,0,9
WARNES,"anticoncepcion, prevencion de its y de cancer de cuello uterino",implante subdermico: usuarias nuevas,2016-09-01,0,2,17,1,0,20
YACUIBA,"anticoncepcion, prevencion de its y de cancer de cuello uterino",implante subdermico: usuarias nuevas,2016-09-01,0,0,6,0,0,6
YAMPARAEZ,"anticoncepcion, prevencion de its y de cancer de cuello uterino",implante subdermico: usuarias nuevas,2016-09-01,0,0,4,2,1,7
YANACACHI,"anticoncepcion, prevencion de its y de cancer de cuello uterino",implante subdermico: usuarias nuevas,2016-09-01,0,2,2,1,0,5
YAPACANI,"anticoncepcion, prevencion de its y de cancer de cuello uterino",implante subdermico: usuarias nuevas,2016-09-01,0,0,12,0,0,12
YOTALA,"anticoncepcion, prevencion de its y de cancer de cuello uterino",implante subdermico: usuarias nuevas,2016-09-01,0,0,1,0,0,1
ACHACACHI,"anticoncepcion, prevencion de its y de cancer de cuello uterino",implante subdermico: usuarias nuevas,2016-10-01,0,1,3,1,0,5
ACHOCALLA,"anticoncepcion, prevencion de its y de cancer de cuello uterino",implante subdermico: usuarias nuevas,2016-10-01,0,0,2,0,0,2
AIQUILE,"anticoncepcion, prevencion de its y de cancer de cuello uterino",implante subdermico: usuarias nuevas,2016-10-01,0,6,12,5,0,23
ALCALA,"anticoncepcion, prevencion de its y de cancer de cuello uterino",implante subdermico: usuarias nuevas,2016-10-01,0,0,5,0,0,5
ALTO BENI,"anticoncepcion, prevencion de its y de cancer de cuello uterino",implante subdermico: usuarias nuevas,2016-10-01,0,1,2,1,0,4
ANTEQUERA,"anticoncepcion, prevencion de its y de cancer de cuello uterino",implante subdermico: usuarias nuevas,2016-10-01,0,1,2,0,0,3
APOLO,"anticoncepcion, prevencion de its y de cancer de cuello uterino",implante subdermico: usuarias nuevas,2016-10-01,0,2,4,1,0,7
ATOCHA,"anticoncepcion, prevencion de its y de cancer de cuello uterino",implante subdermico: usuarias nuevas,2016-10-01,0,1,3,0,0,4
AUCAPATA,"anticoncepcion, prevencion de its y de cancer de cuello uterino",implante subdermico: usuarias nuevas,2016-10-01,0,0,1,0,0,1
AYATA,"anticoncepcion, prevencion de its y de cancer de cuello uterino",implante subdermico: usuarias nuevas,2016-10-01,0,0,4,1,0,5
AYOPAYA (V. DE INDEPENDENCIA),"anticoncepcion, prevencion de its y de cancer de cuello uterino",implante subdermico: usuarias nuevas,2016-10-01,0,1,2,1,0,4
AZURDUY,"anticoncepcion, prevencion de its y de cancer de cuello uterino",implante subdermico: usuarias nuevas,2016-10-01,0,0,3,0,0,3
BATALLAS,"anticoncepcion, prevencion de its y de cancer de cuello uterino",implante subdermico: usuarias nuevas,2016-10-01,0,0,5,0,0,5
BAURES,"anticoncepcion, prevencion de its y de cancer de cuello uterino",implante subdermico: usuarias nuevas,2016-10-01,0,0,1,0,0,1
BELLA FLOR,"anticoncepcion, prevencion de its y de cancer de cuello uterino",implante subdermico: usuarias nuevas,2016-10-01,0,0,3,0,0,3
BERMEJO,"anticoncepcion, prevencion de its y de cancer de cuello uterino",implante subdermico: usuarias nuevas,2016-10-01,0,1,10,0,0,11
BETANZOS,"anticoncepcion, prevencion de its y de cancer de cuello uterino",implante subdermico: usuarias nuevas,2016-10-01,0,0,3,2,0,5
"CAIZA ""D""","anticoncepcion, prevencion de its y de cancer de cuello uterino",implante subdermico: usuarias nuevas,2016-10-01,0,0,2,1,0,3
CALAMARCA,"anticoncepcion, prevencion de its y de cancer de cuello uterino",implante subdermico: usuarias nuevas,2016-10-01,0,0,2,0,0,2
CAMARGO,"anticoncepcion, prevencion de its y de cancer de cuello uterino",implante subdermico: usuarias nuevas,2016-10-01,0,0,3,0,0,3
CAMATAQUI (C. VILLA ABECIA),"anticoncepcion, prevencion de its y de cancer de cuello uterino",implante subdermico: usuarias nuevas,2016-10-01,0,2,0,0,0,2
CAPINOTA,"anticoncepcion, prevencion de its y de cancer de cuello uterino",implante subdermico: usuarias nuevas,2016-10-01,0,8,9,3,0,20
CARACOLLO,"anticoncepcion, prevencion de its y de cancer de cuello uterino",implante subdermico: usuarias nuevas,2016-10-01,0,3,1,0,0,4
CARANAVI,"anticoncepcion, prevencion de its y de cancer de cuello uterino",implante subdermico: usuarias nuevas,2016-10-01,0,5,40,5,0,50
CHALLAPATA,"anticoncepcion, prevencion de its y de cancer de cuello uterino",implante subdermico: usuarias nuevas,2016-10-01,0,1,10,0,0,11
CHAYANTA,"anticoncepcion, prevencion de its y de cancer de cuello uterino",implante subdermico: usuarias nuevas,2016-10-01,0,1,8,2,0,11
CHIMORE,"anticoncepcion, prevencion de its y de cancer de cuello uterino",implante subdermico: usuarias nuevas,2016-10-01,0,2,8,1,0,11
CHIPAYA,"anticoncepcion, prevencion de its y de cancer de cuello uterino",implante subdermico: usuarias nuevas,2016-10-01,0,0,1,0,0,1
CHUA COCANI,"anticoncepcion, prevencion de its y de cancer de cuello uterino",implante subdermico: usuarias nuevas,2016-10-01,0,0,3,1,0,4
CHULUMANI (V. DE LA LIBERTAD),"anticoncepcion, prevencion de its y de cancer de cuello uterino",implante subdermico: usuarias nuevas,2016-10-01,0,1,6,3,0,10
CHUMA,"anticoncepcion, prevencion de its y de cancer de cuello uterino",implante subdermico: usuarias nuevas,2016-10-01,0,0,1,1,0,2
CKOCHAS,"anticoncepcion, prevencion de its y de cancer de cuello uterino",implante subdermico: usuarias nuevas,2016-10-01,0,0,8,3,0,11
CLIZA,"anticoncepcion, prevencion de its y de cancer de cuello uterino",implante subdermico: usuarias nuevas,2016-10-01,0,1,2,1,0,4
COBIJA,"anticoncepcion, prevencion de its y de cancer de cuello uterino",implante subdermico: usuarias nuevas,2016-10-01,2,8,17,2,0,29
COCAPATA,"anticoncepcion, prevencion de its y de cancer de cuello uterino",implante subdermico: usuarias nuevas,2016-10-01,0,0,3,0,0,3
COCHABAMBA,"anticoncepcion, prevencion de its y de cancer de cuello uterino",implante subdermico: usuarias nuevas,2016-10-01,0,16,236,4,0,256
COLCAPIRHUA,"anticoncepcion, prevencion de its y de cancer de cuello uterino",implante subdermico: usuarias nuevas,2016-10-01,0,0,14,1,0,15
COLOMI,"anticoncepcion, prevencion de its y de cancer de cuello uterino",implante subdermico: usuarias nuevas,2016-10-01,0,2,5,0,0,7
COLQUENCHA,"anticoncepcion, prevencion de its y de cancer de cuello uterino",implante subdermico: usuarias nuevas,2016-10-01,0,0,4,1,0,5
COLQUIRI,"anticoncepcion, prevencion de its y de cancer de cuello uterino",implante subdermico: usuarias nuevas,2016-10-01,0,0,1,1,0,2
CORIPATA,"anticoncepcion, prevencion de its y de cancer de cuello uterino",implante subdermico: usuarias nuevas,2016-10-01,0,1,9,2,0,12
COROICO,"anticoncepcion, prevencion de its y de cancer de cuello uterino",implante subdermico: usuarias nuevas,2016-10-01,0,6,14,3,0,23
CORQUE,"anticoncepcion, prevencion de its y de cancer de cuello uterino",implante subdermico: usuarias nuevas,2016-10-01,0,0,2,0,0,2
COTAGAITA,"anticoncepcion, prevencion de its y de cancer de cuello uterino",implante subdermico: usuarias nuevas,2016-10-01,0,2,16,2,0,20
CUCHUMUELA (V. G. VILLARROEL),"anticoncepcion, prevencion de its y de cancer de cuello uterino",implante subdermico: usuarias nuevas,2016-10-01,0,0,2,0,0,2
CULPINA,"anticoncepcion, prevencion de its y de cancer de cuello uterino",implante subdermico: usuarias nuevas,2016-10-01,0,3,7,1,0,11
EL ALTO,"anticoncepcion, prevencion de its y de cancer de cuello uterino",implante subdermico: usuarias nuevas,2016-10-01,0,15,99,48,0,162
EL TORNO,"anticoncepcion, prevencion de its y de cancer de cuello uterino",implante subdermico: usuarias nuevas,2016-10-01,0,14,29,0,0,43
EL VILLAR,"anticoncepcion, prevencion de its y de cancer de cuello uterino",implante subdermico: usuarias nuevas,2016-10-01,0,1,1,0,0,2
ENTRE RIOS TRJ,"anticoncepcion, prevencion de its y de cancer de cuello uterino",implante subdermico: usuarias nuevas,2016-10-01,0,2,10,2,0,14
ENTRE RIOS CBBA,"anticoncepcion, prevencion de its y de cancer de cuello uterino",implante subdermico: usuarias nuevas,2016-10-01,0,2,8,2,0,12
ESCOMA,"anticoncepcion, prevencion de its y de cancer de cuello uterino",implante subdermico: usuarias nuevas,2016-10-01,0,0,2,0,0,2
EXALTACION,"anticoncepcion, prevencion de its y de cancer de cuello uterino",implante subdermico: usuarias nuevas,2016-10-01,0,0,0,1,0,1
FILADELFIA,"anticoncepcion, prevencion de its y de cancer de cuello uterino",implante subdermico: usuarias nuevas,2016-10-01,1,4,6,2,0,13
GRAL. J.J. PEREZ (CHARAZANI),"anticoncepcion, prevencion de its y de cancer de cuello uterino",implante subdermico: usuarias nuevas,2016-10-01,0,0,4,2,0,6
GUAQUI,"anticoncepcion, prevencion de its y de cancer de cuello uterino",implante subdermico: usuarias nuevas,2016-10-01,0,4,5,0,0,9
GUAYARAMERIN,"anticoncepcion, prevencion de its y de cancer de cuello uterino",implante subdermico: usuarias nuevas,2016-10-01,0,2,11,3,0,16
HUACARETA,"anticoncepcion, prevencion de its y de cancer de cuello uterino",implante subdermico: usuarias nuevas,2016-10-01,0,1,18,0,0,19
HUACHACALLA,"anticoncepcion, prevencion de its y de cancer de cuello uterino",implante subdermico: usuarias nuevas,2016-10-01,0,0,1,0,0,1
HUANUNI,"anticoncepcion, prevencion de its y de cancer de cuello uterino",implante subdermico: usuarias nuevas,2016-10-01,0,0,15,1,0,16
HUAYLLAMARCA,"anticoncepcion, prevencion de its y de cancer de cuello uterino",implante subdermico: usuarias nuevas,2016-10-01,0,0,0,1,0,1
ICLA,"anticoncepcion, prevencion de its y de cancer de cuello uterino",implante subdermico: usuarias nuevas,2016-10-01,0,1,2,0,0,3
INCAHUASI,"anticoncepcion, prevencion de its y de cancer de cuello uterino",implante subdermico: usuarias nuevas,2016-10-01,0,2,6,2,0,10
IRUPANA (VILLA DE LANZA),"anticoncepcion, prevencion de its y de cancer de cuello uterino",implante subdermico: usuarias nuevas,2016-10-01,0,1,12,1,0,14
JESUS DE MACHACA,"anticoncepcion, prevencion de its y de cancer de cuello uterino",implante subdermico: usuarias nuevas,2016-10-01,0,2,2,0,0,4
LA ASUNTA,"anticoncepcion, prevencion de its y de cancer de cuello uterino",implante subdermico: usuarias nuevas,2016-10-01,0,5,19,2,0,26
LA PAZ,"anticoncepcion, prevencion de its y de cancer de cuello uterino",implante subdermico: usuarias nuevas,2016-10-01,1,19,144,25,0,189
LAJA,"anticoncepcion, prevencion de its y de cancer de cuello uterino",implante subdermico: usuarias nuevas,2016-10-01,0,0,2,0,0,2
LAS CARRERAS,"anticoncepcion, prevencion de its y de cancer de cuello uterino",implante subdermico: usuarias nuevas,2016-10-01,0,1,1,1,0,3
LLALLAGUA,"anticoncepcion, prevencion de its y de cancer de cuello uterino",implante subdermico: usuarias nuevas,2016-10-01,0,0,8,1,0,9
MACHACAMARCA,"anticoncepcion, prevencion de its y de cancer de cuello uterino",implante subdermico: usuarias nuevas,2016-10-01,0,1,0,0,0,1
MACHARETI,"anticoncepcion, prevencion de its y de cancer de cuello uterino",implante subdermico: usuarias nuevas,2016-10-01,0,0,2,0,0,2
MAIRANA,"anticoncepcion, prevencion de its y de cancer de cuello uterino",implante subdermico: usuarias nuevas,2016-10-01,0,0,3,0,0,3
MIZQUE,"anticoncepcion, prevencion de its y de cancer de cuello uterino",implante subdermico: usuarias nuevas,2016-10-01,0,1,10,2,0,13
MONTEAGUDO,"anticoncepcion, prevencion de its y de cancer de cuello uterino",implante subdermico: usuarias nuevas,2016-10-01,0,1,6,0,0,7
MONTERO,"anticoncepcion, prevencion de its y de cancer de cuello uterino",implante subdermico: usuarias nuevas,2016-10-01,0,0,1,0,0,1
NUEVO MANOA (NUEVA ESPERANZA),"anticoncepcion, prevencion de its y de cancer de cuello uterino",implante subdermico: usuarias nuevas,2016-10-01,1,1,3,1,0,6
OCURI,"anticoncepcion, prevencion de its y de cancer de cuello uterino",implante subdermico: usuarias nuevas,2016-10-01,0,0,1,0,0,1
ORURO,"anticoncepcion, prevencion de its y de cancer de cuello uterino",implante subdermico: usuarias nuevas,2016-10-01,0,16,77,7,0,100
PADCAYA,"anticoncepcion, prevencion de its y de cancer de cuello uterino",implante subdermico: usuarias nuevas,2016-10-01,0,11,49,20,0,80
PADILLA,"anticoncepcion, prevencion de its y de cancer de cuello uterino",implante subdermico: usuarias nuevas,2016-10-01,0,1,1,0,0,2
PAILON,"anticoncepcion, prevencion de its y de cancer de cuello uterino",implante subdermico: usuarias nuevas,2016-10-01,0,6,8,0,0,14
PALCA,"anticoncepcion, prevencion de its y de cancer de cuello uterino",implante subdermico: usuarias nuevas,2016-10-01,0,3,10,4,1,18
PALOS BLANCOS,"anticoncepcion, prevencion de its y de cancer de cuello uterino",implante subdermico: usuarias nuevas,2016-10-01,0,1,6,1,0,8
PAMPA AULLAGAS,"anticoncepcion, prevencion de its y de cancer de cuello uterino",implante subdermico: usuarias nuevas,2016-10-01,0,0,2,0,0,2
PAPEL PAMPA,"anticoncepcion, prevencion de its y de cancer de cuello uterino",implante subdermico: usuarias nuevas,2016-10-01,0,1,1,0,0,2
PAZÑA,"anticoncepcion, prevencion de its y de cancer de cuello uterino",implante subdermico: usuarias nuevas,2016-10-01,0,0,3,0,0,3
POCOATA,"anticoncepcion, prevencion de its y de cancer de cuello uterino",implante subdermico: usuarias nuevas,2016-10-01,0,1,6,3,0,10
POCONA,"anticoncepcion, prevencion de its y de cancer de cuello uterino",implante subdermico: usuarias nuevas,2016-10-01,0,0,1,0,0,1
POOPO,"anticoncepcion, prevencion de its y de cancer de cuello uterino",implante subdermico: usuarias nuevas,2016-10-01,0,0,1,1,0,2
PORCO,"anticoncepcion, prevencion de its y de cancer de cuello uterino",implante subdermico: usuarias nuevas,2016-10-01,0,0,1,0,0,1
POROMA,"anticoncepcion, prevencion de its y de cancer de cuello uterino",implante subdermico: usuarias nuevas,2016-10-01,0,1,2,2,0,5
PORTACHUELO,"anticoncepcion, prevencion de its y de cancer de cuello uterino",implante subdermico: usuarias nuevas,2016-10-01,0,0,1,0,0,1
PORVENIR,"anticoncepcion, prevencion de its y de cancer de cuello uterino",implante subdermico: usuarias nuevas,2016-10-01,0,5,0,0,0,5
POTOSI,"anticoncepcion, prevencion de its y de cancer de cuello uterino",implante subdermico: usuarias nuevas,2016-10-01,0,12,67,9,1,89
PRESTO,"anticoncepcion, prevencion de its y de cancer de cuello uterino",implante subdermico: usuarias nuevas,2016-10-01,0,0,2,0,0,2
PUCARANI,"anticoncepcion, prevencion de its y de cancer de cuello uterino",implante subdermico: usuarias nuevas,2016-10-01,0,0,4,0,0,4
PUERTO GONZALO MORENO,"anticoncepcion, prevencion de its y de cancer de cuello uterino",implante subdermico: usuarias nuevas,2016-10-01,0,1,0,0,0,1
PUERTO VILLARROEL,"anticoncepcion, prevencion de its y de cancer de cuello uterino",implante subdermico: usuarias nuevas,2016-10-01,0,0,9,0,0,9
PUNA,"anticoncepcion, prevencion de its y de cancer de cuello uterino",implante subdermico: usuarias nuevas,2016-10-01,0,0,1,1,0,2
RIBERALTA,"anticoncepcion, prevencion de its y de cancer de cuello uterino",implante subdermico: usuarias nuevas,2016-10-01,2,46,67,7,0,122
RURRENABAQUE,"anticoncepcion, prevencion de its y de cancer de cuello uterino",implante subdermico: usuarias nuevas,2016-10-01,0,4,10,0,0,14
SACABA,"anticoncepcion, prevencion de its y de cancer de cuello uterino",implante subdermico: usuarias nuevas,2016-10-01,0,4,17,2,0,23
SACACA,"anticoncepcion, prevencion de its y de cancer de cuello uterino",implante subdermico: usuarias nuevas,2016-10-01,0,4,4,2,0,10
SALINAS DE GARCI MENDOZA,"anticoncepcion, prevencion de its y de cancer de cuello uterino",implante subdermico: usuarias nuevas,2016-10-01,0,0,1,0,0,1
SAN ANDRES,"anticoncepcion, prevencion de its y de cancer de cuello uterino",implante subdermico: usuarias nuevas,2016-10-01,0,0,2,0,0,2
SAN BORJA,"anticoncepcion, prevencion de its y de cancer de cuello uterino",implante subdermico: usuarias nuevas,2016-10-01,0,3,4,0,0,7
SAN CARLOS,"anticoncepcion, prevencion de its y de cancer de cuello uterino",implante subdermico: usuarias nuevas,2016-10-01,0,4,17,3,0,24
SAN IGNACIO,"anticoncepcion, prevencion de its y de cancer de cuello uterino",implante subdermico: usuarias nuevas,2016-10-01,0,1,1,1,0,3
SAN JAVIER(BNI),"anticoncepcion, prevencion de its y de cancer de cuello uterino",implante subdermico: usuarias nuevas,2016-10-01,0,0,1,0,0,1
SAN JULIAN,"anticoncepcion, prevencion de its y de cancer de cuello uterino",implante subdermico: usuarias nuevas,2016-10-01,0,3,4,1,0,8
SAN LORENZO(PND),"anticoncepcion, prevencion de its y de cancer de cuello uterino",implante subdermico: usuarias nuevas,2016-10-01,0,1,0,0,0,1
SAN LORENZO(TJA),"anticoncepcion, prevencion de its y de cancer de cuello uterino",implante subdermico: usuarias nuevas,2016-10-01,0,2,3,1,0,6
SAN LUCAS,"anticoncepcion, prevencion de its y de cancer de cuello uterino",implante subdermico: usuarias nuevas,2016-10-01,0,2,4,0,0,6
SAN PEDRO(PND),"anticoncepcion, prevencion de its y de cancer de cuello uterino",implante subdermico: usuarias nuevas,2016-10-01,0,1,3,0,0,4
SANTA CRUZ DE LA SIERRA,"anticoncepcion, prevencion de its y de cancer de cuello uterino",implante subdermico: usuarias nuevas,2016-10-01,0,17,157,176,0,350
SANTIVAÑES,"anticoncepcion, prevencion de its y de cancer de cuello uterino",implante subdermico: usuarias nuevas,2016-10-01,0,2,0,0,0,2
SANTUARIO DE QUILLACAS,"anticoncepcion, prevencion de its y de cancer de cuello uterino",implante subdermico: usuarias nuevas,2016-10-01,0,0,4,1,0,5
SENA,"anticoncepcion, prevencion de its y de cancer de cuello uterino",implante subdermico: usuarias nuevas,2016-10-01,0,0,1,0,0,1
SICA SICA (VILLA AROMA),"anticoncepcion, prevencion de its y de cancer de cuello uterino",implante subdermico: usuarias nuevas,2016-10-01,0,1,7,3,0,11
SIPE SIPE,"anticoncepcion, prevencion de its y de cancer de cuello uterino",implante subdermico: usuarias nuevas,2016-10-01,0,0,2,0,0,2
SOPACHUY,"anticoncepcion, prevencion de its y de cancer de cuello uterino",implante subdermico: usuarias nuevas,2016-10-01,0,0,3,0,0,3
SORATA,"anticoncepcion, prevencion de its y de cancer de cuello uterino",implante subdermico: usuarias nuevas,2016-10-01,0,1,1,0,0,2
SUCRE,"anticoncepcion, prevencion de its y de cancer de cuello uterino",implante subdermico: usuarias nuevas,2016-10-01,0,109,190,20,0,319
TACACOMA,"anticoncepcion, prevencion de its y de cancer de cuello uterino",implante subdermico: usuarias nuevas,2016-10-01,0,0,0,1,0,1
TAPACARI,"anticoncepcion, prevencion de its y de cancer de cuello uterino",implante subdermico: usuarias nuevas,2016-10-01,0,5,4,4,0,13
TARABUCO,"anticoncepcion, prevencion de its y de cancer de cuello uterino",implante subdermico: usuarias nuevas,2016-10-01,0,1,3,0,0,4
TARATA,"anticoncepcion, prevencion de its y de cancer de cuello uterino",implante subdermico: usuarias nuevas,2016-10-01,0,0,1,0,0,1
TARIJA,"anticoncepcion, prevencion de its y de cancer de cuello uterino",implante subdermico: usuarias nuevas,2016-10-01,0,18,94,14,0,126
TARVITA,"anticoncepcion, prevencion de its y de cancer de cuello uterino",implante subdermico: usuarias nuevas,2016-10-01,0,1,1,1,1,4
TEOPONTE,"anticoncepcion, prevencion de its y de cancer de cuello uterino",implante subdermico: usuarias nuevas,2016-10-01,0,0,1,0,0,1
TIAWANACU,"anticoncepcion, prevencion de its y de cancer de cuello uterino",implante subdermico: usuarias nuevas,2016-10-01,0,1,0,0,0,1
TINGUIPAYA,"anticoncepcion, prevencion de its y de cancer de cuello uterino",implante subdermico: usuarias nuevas,2016-10-01,0,0,1,1,0,2
TIPUANI,"anticoncepcion, prevencion de its y de cancer de cuello uterino",implante subdermico: usuarias nuevas,2016-10-01,0,0,3,0,0,3
TIQUIPAYA,"anticoncepcion, prevencion de its y de cancer de cuello uterino",implante subdermico: usuarias nuevas,2016-10-01,0,3,8,0,0,11
TOLATA,"anticoncepcion, prevencion de its y de cancer de cuello uterino",implante subdermico: usuarias nuevas,2016-10-01,0,0,3,0,0,3
TOLEDO,"anticoncepcion, prevencion de its y de cancer de cuello uterino",implante subdermico: usuarias nuevas,2016-10-01,0,0,1,0,0,1
TOMINA,"anticoncepcion, prevencion de its y de cancer de cuello uterino",implante subdermico: usuarias nuevas,2016-10-01,0,0,7,0,0,7
TORO TORO,"anticoncepcion, prevencion de its y de cancer de cuello uterino",implante subdermico: usuarias nuevas,2016-10-01,0,1,6,1,0,8
TOTORA(CBBA),"anticoncepcion, prevencion de its y de cancer de cuello uterino",implante subdermico: usuarias nuevas,2016-10-01,0,1,4,1,0,6
TOTORA(ORR),"anticoncepcion, prevencion de its y de cancer de cuello uterino",implante subdermico: usuarias nuevas,2016-10-01,0,1,0,0,0,1
TRINIDAD,"anticoncepcion, prevencion de its y de cancer de cuello uterino",implante subdermico: usuarias nuevas,2016-10-01,0,16,56,7,0,79
TUPIZA,"anticoncepcion, prevencion de its y de cancer de cuello uterino",implante subdermico: usuarias nuevas,2016-10-01,0,2,29,5,0,36
TURCO,"anticoncepcion, prevencion de its y de cancer de cuello uterino",implante subdermico: usuarias nuevas,2016-10-01,0,0,1,0,0,1
URIONDO (A. CONCEPCION),"anticoncepcion, prevencion de its y de cancer de cuello uterino",implante subdermico: usuarias nuevas,2016-10-01,0,0,1,0,0,1
VIACHA,"anticoncepcion, prevencion de its y de cancer de cuello uterino",implante subdermico: usuarias nuevas,2016-10-01,0,18,83,7,0,108
VILLA CHARCAS,"anticoncepcion, prevencion de its y de cancer de cuello uterino",implante subdermico: usuarias nuevas,2016-10-01,0,0,1,1,0,2
VILLA NUEVA (LOMA ALTA),"anticoncepcion, prevencion de its y de cancer de cuello uterino",implante subdermico: usuarias nuevas,2016-10-01,0,0,1,0,0,1
VILLA SERRANO,"anticoncepcion, prevencion de its y de cancer de cuello uterino",implante subdermico: usuarias nuevas,2016-10-01,0,4,4,1,0,9
VILLA VACA GUZMAN (MUYUPAMPA),"anticoncepcion, prevencion de its y de cancer de cuello uterino",implante subdermico: usuarias nuevas,2016-10-01,2,2,3,0,0,7
VILLAZON,"anticoncepcion, prevencion de its y de cancer de cuello uterino",implante subdermico: usuarias nuevas,2016-10-01,0,3,13,1,0,17
VINTO,"anticoncepcion, prevencion de its y de cancer de cuello uterino",implante subdermico: usuarias nuevas,2016-10-01,0,0,4,0,0,4
VITICHI,"anticoncepcion, prevencion de its y de cancer de cuello uterino",implante subdermico: usuarias nuevas,2016-10-01,0,0,4,1,0,5
WARNES,"anticoncepcion, prevencion de its y de cancer de cuello uterino",implante subdermico: usuarias nuevas,2016-10-01,0,0,7,0,0,7
YACUIBA,"anticoncepcion, prevencion de its y de cancer de cuello uterino",implante subdermico: usuarias nuevas,2016-10-01,0,1,2,1,0,4
YAMPARAEZ,"anticoncepcion, prevencion de its y de cancer de cuello uterino",implante subdermico: usuarias nuevas,2016-10-01,0,1,1,0,0,2
YAPACANI,"anticoncepcion, prevencion de its y de cancer de cuello uterino",implante subdermico: usuarias nuevas,2016-10-01,0,2,32,1,0,35
YOCALLA,"anticoncepcion, prevencion de its y de cancer de cuello uterino",implante subdermico: usuarias nuevas,2016-10-01,0,2,4,0,0,6
YOTALA,"anticoncepcion, prevencion de its y de cancer de cuello uterino",implante subdermico: usuarias nuevas,2016-10-01,0,0,1,1,0,2
YUNCHARA,"anticoncepcion, prevencion de its y de cancer de cuello uterino",implante subdermico: usuarias nuevas,2016-10-01,0,0,4,2,0,6
ZUDAÑEZ,"anticoncepcion, prevencion de its y de cancer de cuello uterino",implante subdermico: usuarias nuevas,2016-10-01,0,0,1,0,0,1
ACHACACHI,"anticoncepcion, prevencion de its y de cancer de cuello uterino",implante subdermico: usuarias nuevas,2016-11-01,0,2,6,4,0,12
ACHOCALLA,"anticoncepcion, prevencion de its y de cancer de cuello uterino",implante subdermico: usuarias nuevas,2016-11-01,0,0,7,4,0,11
AIQUILE,"anticoncepcion, prevencion de its y de cancer de cuello uterino",implante subdermico: usuarias nuevas,2016-11-01,0,4,22,2,0,28
ALCALA,"anticoncepcion, prevencion de its y de cancer de cuello uterino",implante subdermico: usuarias nuevas,2016-11-01,0,1,2,1,0,4
ALTO BENI,"anticoncepcion, prevencion de its y de cancer de cuello uterino",implante subdermico: usuarias nuevas,2016-11-01,0,1,2,2,0,5
ANTEQUERA,"anticoncepcion, prevencion de its y de cancer de cuello uterino",implante subdermico: usuarias nuevas,2016-11-01,0,0,1,0,0,1
APOLO,"anticoncepcion, prevencion de its y de cancer de cuello uterino",implante subdermico: usuarias nuevas,2016-11-01,0,0,4,3,0,7
ARBIETO,"anticoncepcion, prevencion de its y de cancer de cuello uterino",implante subdermico: usuarias nuevas,2016-11-01,0,1,5,0,0,6
ATOCHA,"anticoncepcion, prevencion de its y de cancer de cuello uterino",implante subdermico: usuarias nuevas,2016-11-01,0,1,1,0,0,2
AUCAPATA,"anticoncepcion, prevencion de its y de cancer de cuello uterino",implante subdermico: usuarias nuevas,2016-11-01,0,0,0,1,0,1
AYATA,"anticoncepcion, prevencion de its y de cancer de cuello uterino",implante subdermico: usuarias nuevas,2016-11-01,0,0,1,0,0,1
AYOPAYA (V. DE INDEPENDENCIA),"anticoncepcion, prevencion de its y de cancer de cuello uterino",implante subdermico: usuarias nuevas,2016-11-01,0,0,3,0,0,3
BELLA FLOR,"anticoncepcion, prevencion de its y de cancer de cuello uterino",implante subdermico: usuarias nuevas,2016-11-01,0,1,2,0,0,3
BERMEJO,"anticoncepcion, prevencion de its y de cancer de cuello uterino",implante subdermico: usuarias nuevas,2016-11-01,0,3,6,2,0,11
BOLIVAR,"anticoncepcion, prevencion de its y de cancer de cuello uterino",implante subdermico: usuarias nuevas,2016-11-01,0,0,1,0,0,1
"CAIZA ""D""","anticoncepcion, prevencion de its y de cancer de cuello uterino",implante subdermico: usuarias nuevas,2016-11-01,0,0,2,1,0,3
CAMARGO,"anticoncepcion, prevencion de its y de cancer de cuello uterino",implante subdermico: usuarias nuevas,2016-11-01,0,2,0,0,0,2
CAPINOTA,"anticoncepcion, prevencion de its y de cancer de cuello uterino",implante subdermico: usuarias nuevas,2016-11-01,0,0,9,2,0,11
CARACOLLO,"anticoncepcion, prevencion de its y de cancer de cuello uterino",implante subdermico: usuarias nuevas,2016-11-01,0,4,7,2,1,14
CARANAVI,"anticoncepcion, prevencion de its y de cancer de cuello uterino",implante subdermico: usuarias nuevas,2016-11-01,0,7,24,6,0,37
CHALLAPATA,"anticoncepcion, prevencion de its y de cancer de cuello uterino",implante subdermico: usuarias nuevas,2016-11-01,0,1,9,0,0,10
CHAYANTA,"anticoncepcion, prevencion de its y de cancer de cuello uterino",implante subdermico: usuarias nuevas,2016-11-01,0,0,4,2,0,6
CHIMORE,"anticoncepcion, prevencion de its y de cancer de cuello uterino",implante subdermico: usuarias nuevas,2016-11-01,0,1,5,0,0,6
CHULUMANI (V. DE LA LIBERTAD),"anticoncepcion, prevencion de its y de cancer de cuello uterino",implante subdermico: usuarias nuevas,2016-11-01,0,2,2,1,0,5
CKOCHAS,"anticoncepcion, prevencion de its y de cancer de cuello uterino",implante subdermico: usuarias nuevas,2016-11-01,0,2,3,0,0,5
CLIZA,"anticoncepcion, prevencion de its y de cancer de cuello uterino",implante subdermico: usuarias nuevas,2016-11-01,0,2,6,0,0,8
COBIJA,"anticoncepcion, prevencion de its y de cancer de cuello uterino",implante subdermico: usuarias nuevas,2016-11-01,0,7,21,1,0,29
COCAPATA,"anticoncepcion, prevencion de its y de cancer de cuello uterino",implante subdermico: usuarias nuevas,2016-11-01,0,4,11,2,0,17
COCHABAMBA,"anticoncepcion, prevencion de its y de cancer de cuello uterino",implante subdermico: usuarias nuevas,2016-11-01,1,5,61,7,0,74
COLCAPIRHUA,"anticoncepcion, prevencion de its y de cancer de cuello uterino",implante subdermico: usuarias nuevas,2016-11-01,0,4,29,7,0,40
COLOMI,"anticoncepcion, prevencion de its y de cancer de cuello uterino",implante subdermico: usuarias nuevas,2016-11-01,0,2,0,0,0,2
COLQUECHACA,"anticoncepcion, prevencion de its y de cancer de cuello uterino",implante subdermico: usuarias nuevas,2016-11-01,0,0,3,0,0,3
COLQUENCHA,"anticoncepcion, prevencion de its y de cancer de cuello uterino",implante subdermico: usuarias nuevas,2016-11-01,0,0,1,1,0,2
CONCEPCION,"anticoncepcion, prevencion de its y de cancer de cuello uterino",implante subdermico: usuarias nuevas,2016-11-01,0,1,6,0,0,7
CORIPATA,"anticoncepcion, prevencion de its y de cancer de cuello uterino",implante subdermico: usuarias nuevas,2016-11-01,0,3,6,1,0,10
CORQUE,"anticoncepcion, prevencion de its y de cancer de cuello uterino",implante subdermico: usuarias nuevas,2016-11-01,0,1,3,0,0,4
COTAGAITA,"anticoncepcion, prevencion de its y de cancer de cuello uterino",implante subdermico: usuarias nuevas,2016-11-01,0,1,2,0,0,3
CUATRO CAÑADAS,"anticoncepcion, prevencion de its y de cancer de cuello uterino",implante subdermico: usuarias nuevas,2016-11-01,0,3,9,0,0,12
CUCHUMUELA (V. G. VILLARROEL),"anticoncepcion, prevencion de its y de cancer de cuello uterino",implante subdermico: usuarias nuevas,2016-11-01,0,0,2,0,0,2
CULPINA,"anticoncepcion, prevencion de its y de cancer de cuello uterino",implante subdermico: usuarias nuevas,2016-11-01,0,0,3,1,0,4
EL ALTO,"anticoncepcion, prevencion de its y de cancer de cuello uterino",implante subdermico: usuarias nuevas,2016-11-01,0,24,212,19,0,255
EL PUENTE(TJA),"anticoncepcion, prevencion de its y de cancer de cuello uterino",implante subdermico: usuarias nuevas,2016-11-01,0,0,2,0,0,2
EL TORNO,"anticoncepcion, prevencion de its y de cancer de cuello uterino",implante subdermico: usuarias nuevas,2016-11-01,0,10,31,5,0,46
EL VILLAR,"anticoncepcion, prevencion de its y de cancer de cuello uterino",implante subdermico: usuarias nuevas,2016-11-01,0,0,1,0,0,1
ENTRE RIOS TRJ,"anticoncepcion, prevencion de its y de cancer de cuello uterino",implante subdermico: usuarias nuevas,2016-11-01,0,5,18,5,0,28
ENTRE RIOS CBBA,"anticoncepcion, prevencion de its y de cancer de cuello uterino",implante subdermico: usuarias nuevas,2016-11-01,1,2,16,2,0,21
ESCOMA,"anticoncepcion, prevencion de its y de cancer de cuello uterino",implante subdermico: usuarias nuevas,2016-11-01,0,0,2,0,0,2
EUCALIPTUS,"anticoncepcion, prevencion de its y de cancer de cuello uterino",implante subdermico: usuarias nuevas,2016-11-01,0,1,1,0,0,2
EUREKA (SANTOS MERCADO),"anticoncepcion, prevencion de its y de cancer de cuello uterino",implante subdermico: usuarias nuevas,2016-11-01,0,0,1,0,0,1
GRAL. J.J. PEREZ (CHARAZANI),"anticoncepcion, prevencion de its y de cancer de cuello uterino",implante subdermico: usuarias nuevas,2016-11-01,0,1,0,1,0,2
GUAYARAMERIN,"anticoncepcion, prevencion de its y de cancer de cuello uterino",implante subdermico: usuarias nuevas,2016-11-01,0,4,25,5,0,34
HUACARETA,"anticoncepcion, prevencion de its y de cancer de cuello uterino",implante subdermico: usuarias nuevas,2016-11-01,0,0,4,0,0,4
HUANUNI,"anticoncepcion, prevencion de its y de cancer de cuello uterino",implante subdermico: usuarias nuevas,2016-11-01,0,1,16,2,0,19
HUARINA,"anticoncepcion, prevencion de its y de cancer de cuello uterino",implante subdermico: usuarias nuevas,2016-11-01,0,2,6,0,0,8
HUATAJATA,"anticoncepcion, prevencion de its y de cancer de cuello uterino",implante subdermico: usuarias nuevas,2016-11-01,0,1,0,0,0,1
HUAYLLAMARCA,"anticoncepcion, prevencion de its y de cancer de cuello uterino",implante subdermico: usuarias nuevas,2016-11-01,0,1,3,0,0,4
ICLA,"anticoncepcion, prevencion de its y de cancer de cuello uterino",implante subdermico: usuarias nuevas,2016-11-01,0,0,4,0,0,4
INCAHUASI,"anticoncepcion, prevencion de its y de cancer de cuello uterino",implante subdermico: usuarias nuevas,2016-11-01,0,1,2,0,0,3
INGAVI (HUMAITA),"anticoncepcion, prevencion de its y de cancer de cuello uterino",implante subdermico: usuarias nuevas,2016-11-01,0,1,1,0,0,2
IRUPANA (VILLA DE LANZA),"anticoncepcion, prevencion de its y de cancer de cuello uterino",implante subdermico: usuarias nuevas,2016-11-01,0,1,6,3,0,10
LA ASUNTA,"anticoncepcion, prevencion de its y de cancer de cuello uterino",implante subdermico: usuarias nuevas,2016-11-01,0,3,15,0,0,18
LA PAZ,"anticoncepcion, prevencion de its y de cancer de cuello uterino",implante subdermico: usuarias nuevas,2016-11-01,0,36,181,82,0,299
LAJA,"anticoncepcion, prevencion de its y de cancer de cuello uterino",implante subdermico: usuarias nuevas,2016-11-01,0,3,11,2,0,16
LAS CARRERAS,"anticoncepcion, prevencion de its y de cancer de cuello uterino",implante subdermico: usuarias nuevas,2016-11-01,0,1,7,3,0,11
LLALLAGUA,"anticoncepcion, prevencion de its y de cancer de cuello uterino",implante subdermico: usuarias nuevas,2016-11-01,0,5,6,0,0,11
LLICA,"anticoncepcion, prevencion de its y de cancer de cuello uterino",implante subdermico: usuarias nuevas,2016-11-01,0,0,1,0,0,1
MACHARETI,"anticoncepcion, prevencion de its y de cancer de cuello uterino",implante subdermico: usuarias nuevas,2016-11-01,0,3,5,0,0,8
MAGDALENA,"anticoncepcion, prevencion de its y de cancer de cuello uterino",implante subdermico: usuarias nuevas,2016-11-01,0,2,3,0,0,5
MAIRANA,"anticoncepcion, prevencion de its y de cancer de cuello uterino",implante subdermico: usuarias nuevas,2016-11-01,0,0,7,0,0,7
MAPIRI,"anticoncepcion, prevencion de its y de cancer de cuello uterino",implante subdermico: usuarias nuevas,2016-11-01,0,2,3,2,0,7
MECAPACA,"anticoncepcion, prevencion de its y de cancer de cuello uterino",implante subdermico: usuarias nuevas,2016-11-01,0,1,20,2,0,23
MIZQUE,"anticoncepcion, prevencion de its y de cancer de cuello uterino",implante subdermico: usuarias nuevas,2016-11-01,0,2,7,1,0,10
MOCOMOCO,"anticoncepcion, prevencion de its y de cancer de cuello uterino",implante subdermico: usuarias nuevas,2016-11-01,0,1,0,0,0,1
MOJOCOYA,"anticoncepcion, prevencion de its y de cancer de cuello uterino",implante subdermico: usuarias nuevas,2016-11-01,0,1,0,0,0,1
MONTEAGUDO,"anticoncepcion, prevencion de its y de cancer de cuello uterino",implante subdermico: usuarias nuevas,2016-11-01,0,1,1,1,0,3
MONTERO,"anticoncepcion, prevencion de its y de cancer de cuello uterino",implante subdermico: usuarias nuevas,2016-11-01,0,1,7,0,0,8
MOROCHATA,"anticoncepcion, prevencion de its y de cancer de cuello uterino",implante subdermico: usuarias nuevas,2016-11-01,0,1,0,0,0,1
NUEVO MANOA (NUEVA ESPERANZA),"anticoncepcion, prevencion de its y de cancer de cuello uterino",implante subdermico: usuarias nuevas,2016-11-01,0,2,4,0,0,6
OCURI,"anticoncepcion, prevencion de its y de cancer de cuello uterino",implante subdermico: usuarias nuevas,2016-11-01,0,1,2,1,0,4
ORURO,"anticoncepcion, prevencion de its y de cancer de cuello uterino",implante subdermico: usuarias nuevas,2016-11-01,0,26,156,22,0,204
PADILLA,"anticoncepcion, prevencion de its y de cancer de cuello uterino",implante subdermico: usuarias nuevas,2016-11-01,0,3,3,1,0,7
PAILON,"anticoncepcion, prevencion de its y de cancer de cuello uterino",implante subdermico: usuarias nuevas,2016-11-01,0,0,5,0,0,5
PALCA,"anticoncepcion, prevencion de its y de cancer de cuello uterino",implante subdermico: usuarias nuevas,2016-11-01,0,3,7,2,0,12
PALOS BLANCOS,"anticoncepcion, prevencion de its y de cancer de cuello uterino",implante subdermico: usuarias nuevas,2016-11-01,0,0,14,6,0,20
PAMPA AULLAGAS,"anticoncepcion, prevencion de its y de cancer de cuello uterino",implante subdermico: usuarias nuevas,2016-11-01,0,1,2,0,0,3
PASORAPA,"anticoncepcion, prevencion de its y de cancer de cuello uterino",implante subdermico: usuarias nuevas,2016-11-01,0,0,1,0,0,1
PATACAMAYA,"anticoncepcion, prevencion de its y de cancer de cuello uterino",implante subdermico: usuarias nuevas,2016-11-01,0,0,18,0,0,18
PAZÑA,"anticoncepcion, prevencion de its y de cancer de cuello uterino",implante subdermico: usuarias nuevas,2016-11-01,0,0,3,0,0,3
POCOATA,"anticoncepcion, prevencion de its y de cancer de cuello uterino",implante subdermico: usuarias nuevas,2016-11-01,0,1,2,2,0,5
POCONA,"anticoncepcion, prevencion de its y de cancer de cuello uterino",implante subdermico: usuarias nuevas,2016-11-01,0,0,0,1,0,1
POOPO,"anticoncepcion, prevencion de its y de cancer de cuello uterino",implante subdermico: usuarias nuevas,2016-11-01,0,0,3,0,0,3
PORCO,"anticoncepcion, prevencion de its y de cancer de cuello uterino",implante subdermico: usuarias nuevas,2016-11-01,0,6,17,0,0,23
POROMA,"anticoncepcion, prevencion de its y de cancer de cuello uterino",implante subdermico: usuarias nuevas,2016-11-01,0,3,7,1,0,11
POTOSI,"anticoncepcion, prevencion de its y de cancer de cuello uterino",implante subdermico: usuarias nuevas,2016-11-01,0,11,77,6,0,94
PRESTO,"anticoncepcion, prevencion de its y de cancer de cuello uterino",implante subdermico: usuarias nuevas,2016-11-01,0,1,3,1,0,5
PUCARANI,"anticoncepcion, prevencion de its y de cancer de cuello uterino",implante subdermico: usuarias nuevas,2016-11-01,0,0,10,2,0,12
PUERTO GONZALO MORENO,"anticoncepcion, prevencion de its y de cancer de cuello uterino",implante subdermico: usuarias nuevas,2016-11-01,0,3,1,0,0,4
PUERTO QUIJARRO,"anticoncepcion, prevencion de its y de cancer de cuello uterino",implante subdermico: usuarias nuevas,2016-11-01,0,1,8,2,0,11
PUERTO VILLARROEL,"anticoncepcion, prevencion de its y de cancer de cuello uterino",implante subdermico: usuarias nuevas,2016-11-01,0,1,8,0,0,9
PUNA,"anticoncepcion, prevencion de its y de cancer de cuello uterino",implante subdermico: usuarias nuevas,2016-11-01,0,0,3,0,0,3
QUILLACOLLO,"anticoncepcion, prevencion de its y de cancer de cuello uterino",implante subdermico: usuarias nuevas,2016-11-01,0,0,8,0,0,8
RIBERALTA,"anticoncepcion, prevencion de its y de cancer de cuello uterino",implante subdermico: usuarias nuevas,2016-11-01,3,40,80,3,0,126
RURRENABAQUE,"anticoncepcion, prevencion de its y de cancer de cuello uterino",implante subdermico: usuarias nuevas,2016-11-01,0,1,11,2,0,14
SACABA,"anticoncepcion, prevencion de its y de cancer de cuello uterino",implante subdermico: usuarias nuevas,2016-11-01,0,7,31,19,0,57
SACACA,"anticoncepcion, prevencion de its y de cancer de cuello uterino",implante subdermico: usuarias nuevas,2016-11-01,0,0,4,1,0,5
SALINAS DE GARCI MENDOZA,"anticoncepcion, prevencion de its y de cancer de cuello uterino",implante subdermico: usuarias nuevas,2016-11-01,0,2,5,1,0,8
SAN ANDRES,"anticoncepcion, prevencion de its y de cancer de cuello uterino",implante subdermico: usuarias nuevas,2016-11-01,0,1,1,0,0,2
SAN BORJA,"anticoncepcion, prevencion de its y de cancer de cuello uterino",implante subdermico: usuarias nuevas,2016-11-01,0,2,7,0,0,9
SAN CARLOS,"anticoncepcion, prevencion de its y de cancer de cuello uterino",implante subdermico: usuarias nuevas,2016-11-01,0,5,27,4,0,36
SAN JULIAN,"anticoncepcion, prevencion de its y de cancer de cuello uterino",implante subdermico: usuarias nuevas,2016-11-01,0,0,6,0,0,6
SAN LORENZO(PND),"anticoncepcion, prevencion de its y de cancer de cuello uterino",implante subdermico: usuarias nuevas,2016-11-01,0,0,2,0,0,2
SAN LORENZO(TJA),"anticoncepcion, prevencion de its y de cancer de cuello uterino",implante subdermico: usuarias nuevas,2016-11-01,0,0,0,1,0,1
SAN LUCAS,"anticoncepcion, prevencion de its y de cancer de cuello uterino",implante subdermico: usuarias nuevas,2016-11-01,0,0,1,1,0,2
SAN PEDRO,"anticoncepcion, prevencion de its y de cancer de cuello uterino",implante subdermico: usuarias nuevas,2016-11-01,0,2,18,11,0,31
SAN PEDRO(PND),"anticoncepcion, prevencion de its y de cancer de cuello uterino",implante subdermico: usuarias nuevas,2016-11-01,0,1,2,0,0,3
SANTA CRUZ DE LA SIERRA,"anticoncepcion, prevencion de its y de cancer de cuello uterino",implante subdermico: usuarias nuevas,2016-11-01,6,6,118,33,15,178
SANTIAGO DE HUARI,"anticoncepcion, prevencion de its y de cancer de cuello uterino",implante subdermico: usuarias nuevas,2016-11-01,0,0,1,0,0,1
SANTIAGO DE MACHACA,"anticoncepcion, prevencion de its y de cancer de cuello uterino",implante subdermico: usuarias nuevas,2016-11-01,0,0,1,0,0,1
SANTIVAÑES,"anticoncepcion, prevencion de its y de cancer de cuello uterino",implante subdermico: usuarias nuevas,2016-11-01,0,0,3,0,0,3
SANTUARIO DE QUILLACAS,"anticoncepcion, prevencion de its y de cancer de cuello uterino",implante subdermico: usuarias nuevas,2016-11-01,0,2,5,0,0,7
SENA,"anticoncepcion, prevencion de its y de cancer de cuello uterino",implante subdermico: usuarias nuevas,2016-11-01,0,3,5,0,0,8
SICA SICA (VILLA AROMA),"anticoncepcion, prevencion de its y de cancer de cuello uterino",implante subdermico: usuarias nuevas,2016-11-01,0,2,1,2,0,5
SOPACHUY,"anticoncepcion, prevencion de its y de cancer de cuello uterino",implante subdermico: usuarias nuevas,2016-11-01,0,0,2,1,0,3
SORATA,"anticoncepcion, prevencion de its y de cancer de cuello uterino",implante subdermico: usuarias nuevas,2016-11-01,0,0,3,0,0,3
SUCRE,"anticoncepcion, prevencion de its y de cancer de cuello uterino",implante subdermico: usuarias nuevas,2016-11-01,0,69,198,13,0,280
TACACOMA,"anticoncepcion, prevencion de its y de cancer de cuello uterino",implante subdermico: usuarias nuevas,2016-11-01,0,1,2,0,0,3
TACOBAMBA,"anticoncepcion, prevencion de its y de cancer de cuello uterino",implante subdermico: usuarias nuevas,2016-11-01,0,0,1,1,0,2
TAPACARI,"anticoncepcion, prevencion de its y de cancer de cuello uterino",implante subdermico: usuarias nuevas,2016-11-01,0,2,4,1,0,7
TARABUCO,"anticoncepcion, prevencion de its y de cancer de cuello uterino",implante subdermico: usuarias nuevas,2016-11-01,0,2,5,0,0,7
TARATA,"anticoncepcion, prevencion de its y de cancer de cuello uterino",implante subdermico: usuarias nuevas,2016-11-01,0,1,0,0,0,1
TARIJA,"anticoncepcion, prevencion de its y de cancer de cuello uterino",implante subdermico: usuarias nuevas,2016-11-01,0,28,102,16,0,146
TEOPONTE,"anticoncepcion, prevencion de its y de cancer de cuello uterino",implante subdermico: usuarias nuevas,2016-11-01,0,1,0,0,0,1
TINGUIPAYA,"anticoncepcion, prevencion de its y de cancer de cuello uterino",implante subdermico: usuarias nuevas,2016-11-01,0,1,1,1,0,3
TIPUANI,"anticoncepcion, prevencion de its y de cancer de cuello uterino",implante subdermico: usuarias nuevas,2016-11-01,0,0,4,0,0,4
TIQUIPAYA,"anticoncepcion, prevencion de its y de cancer de cuello uterino",implante subdermico: usuarias nuevas,2016-11-01,0,4,13,0,0,17
TODOS SANTOS,"anticoncepcion, prevencion de its y de cancer de cuello uterino",implante subdermico: usuarias nuevas,2016-11-01,0,0,1,1,0,2
TOLATA,"anticoncepcion, prevencion de its y de cancer de cuello uterino",implante subdermico: usuarias nuevas,2016-11-01,0,1,3,1,0,5
TOLEDO,"anticoncepcion, prevencion de its y de cancer de cuello uterino",implante subdermico: usuarias nuevas,2016-11-01,0,0,0,1,0,1
TOMINA,"anticoncepcion, prevencion de its y de cancer de cuello uterino",implante subdermico: usuarias nuevas,2016-11-01,0,1,4,1,0,6
TORO TORO,"anticoncepcion, prevencion de its y de cancer de cuello uterino",implante subdermico: usuarias nuevas,2016-11-01,0,0,5,2,0,7
TRINIDAD,"anticoncepcion, prevencion de its y de cancer de cuello uterino",implante subdermico: usuarias nuevas,2016-11-01,0,1,42,1,0,44
TUPIZA,"anticoncepcion, prevencion de its y de cancer de cuello uterino",implante subdermico: usuarias nuevas,2016-11-01,0,12,34,8,0,54
TURCO,"anticoncepcion, prevencion de its y de cancer de cuello uterino",implante subdermico: usuarias nuevas,2016-11-01,0,0,4,1,0,5
UYUNI,"anticoncepcion, prevencion de its y de cancer de cuello uterino",implante subdermico: usuarias nuevas,2016-11-01,0,0,1,0,0,1
VIACHA,"anticoncepcion, prevencion de its y de cancer de cuello uterino",implante subdermico: usuarias nuevas,2016-11-01,0,14,92,15,0,121
VILLA CHARCAS,"anticoncepcion, prevencion de its y de cancer de cuello uterino",implante subdermico: usuarias nuevas,2016-11-01,0,0,9,0,0,9
VILLA SERRANO,"anticoncepcion, prevencion de its y de cancer de cuello uterino",implante subdermico: usuarias nuevas,2016-11-01,0,0,4,0,0,4
VILLA VACA GUZMAN (MUYUPAMPA),"anticoncepcion, prevencion de its y de cancer de cuello uterino",implante subdermico: usuarias nuevas,2016-11-01,0,2,4,4,0,10
VILLAZON,"anticoncepcion, prevencion de its y de cancer de cuello uterino",implante subdermico: usuarias nuevas,2016-11-01,0,6,13,2,0,21
VINTO,"anticoncepcion, prevencion de its y de cancer de cuello uterino",implante subdermico: usuarias nuevas,2016-11-01,0,1,9,0,0,10
VITICHI,"anticoncepcion, prevencion de its y de cancer de cuello uterino",implante subdermico: usuarias nuevas,2016-11-01,0,0,3,0,0,3
WARNES,"anticoncepcion, prevencion de its y de cancer de cuello uterino",implante subdermico: usuarias nuevas,2016-11-01,0,18,18,0,0,36
YAMPARAEZ,"anticoncepcion, prevencion de its y de cancer de cuello uterino",implante subdermico: usuarias nuevas,2016-11-01,0,2,4,0,0,6
YAPACANI,"anticoncepcion, prevencion de its y de cancer de cuello uterino",implante subdermico: usuarias nuevas,2016-11-01,0,0,24,0,0,24
YUNCHARA,"anticoncepcion, prevencion de its y de cancer de cuello uterino",implante subdermico: usuarias nuevas,2016-11-01,0,1,0,0,0,1
ZUDAÑEZ,"anticoncepcion, prevencion de its y de cancer de cuello uterino",implante subdermico: usuarias nuevas,2016-11-01,0,0,1,0,0,1
ACACIO,"anticoncepcion, prevencion de its y de cancer de cuello uterino",implante subdermico: usuarias nuevas,2016-12-01,0,1,1,1,0,3
ACHACACHI,"anticoncepcion, prevencion de its y de cancer de cuello uterino",implante subdermico: usuarias nuevas,2016-12-01,0,0,2,0,0,2
ACHOCALLA,"anticoncepcion, prevencion de its y de cancer de cuello uterino",implante subdermico: usuarias nuevas,2016-12-01,0,0,6,0,0,6
AIQUILE,"anticoncepcion, prevencion de its y de cancer de cuello uterino",implante subdermico: usuarias nuevas,2016-12-01,0,4,8,1,0,13
ALTO BENI,"anticoncepcion, prevencion de its y de cancer de cuello uterino",implante subdermico: usuarias nuevas,2016-12-01,0,0,5,0,0,5
ANDAMARCA,"anticoncepcion, prevencion de its y de cancer de cuello uterino",implante subdermico: usuarias nuevas,2016-12-01,0,0,1,0,0,1
APOLO,"anticoncepcion, prevencion de its y de cancer de cuello uterino",implante subdermico: usuarias nuevas,2016-12-01,0,1,8,3,0,12
ARBIETO,"anticoncepcion, prevencion de its y de cancer de cuello uterino",implante subdermico: usuarias nuevas,2016-12-01,0,1,5,1,0,7
ATOCHA,"anticoncepcion, prevencion de its y de cancer de cuello uterino",implante subdermico: usuarias nuevas,2016-12-01,0,1,4,0,0,5
AUCAPATA,"anticoncepcion, prevencion de its y de cancer de cuello uterino",implante subdermico: usuarias nuevas,2016-12-01,0,0,1,1,0,2
AYATA,"anticoncepcion, prevencion de its y de cancer de cuello uterino",implante subdermico: usuarias nuevas,2016-12-01,0,1,2,2,0,5
AYOPAYA (V. DE INDEPENDENCIA),"anticoncepcion, prevencion de its y de cancer de cuello uterino",implante subdermico: usuarias nuevas,2016-12-01,0,0,1,0,0,1
AZURDUY,"anticoncepcion, prevencion de its y de cancer de cuello uterino",implante subdermico: usuarias nuevas,2016-12-01,0,1,2,1,0,4
BELLA FLOR,"anticoncepcion, prevencion de its y de cancer de cuello uterino",implante subdermico: usuarias nuevas,2016-12-01,0,1,3,0,0,4
BERMEJO,"anticoncepcion, prevencion de its y de cancer de cuello uterino",implante subdermico: usuarias nuevas,2016-12-01,0,1,3,1,0,5
BOLIVAR,"anticoncepcion, prevencion de its y de cancer de cuello uterino",implante subdermico: usuarias nuevas,2016-12-01,0,0,2,0,0,2
CAIROMA,"anticoncepcion, prevencion de its y de cancer de cuello uterino",implante subdermico: usuarias nuevas,2016-12-01,0,0,6,0,0,6
"CAIZA ""D""","anticoncepcion, prevencion de its y de cancer de cuello uterino",implante subdermico: usuarias nuevas,2016-12-01,0,1,14,2,0,17
CALAMARCA,"anticoncepcion, prevencion de its y de cancer de cuello uterino",implante subdermico: usuarias nuevas,2016-12-01,0,0,2,1,0,3
CAMARGO,"anticoncepcion, prevencion de its y de cancer de cuello uterino",implante subdermico: usuarias nuevas,2016-12-01,0,1,7,1,0,9
CAMATAQUI (C. VILLA ABECIA),"anticoncepcion, prevencion de its y de cancer de cuello uterino",implante subdermico: usuarias nuevas,2016-12-01,0,0,1,0,0,1
CAMIRI,"anticoncepcion, prevencion de its y de cancer de cuello uterino",implante subdermico: usuarias nuevas,2016-12-01,0,0,2,0,0,2
CAPINOTA,"anticoncepcion, prevencion de its y de cancer de cuello uterino",implante subdermico: usuarias nuevas,2016-12-01,0,1,3,3,0,7
CARACOLLO,"anticoncepcion, prevencion de its y de cancer de cuello uterino",implante subdermico: usuarias nuevas,2016-12-01,0,1,10,0,0,11
CARANAVI,"anticoncepcion, prevencion de its y de cancer de cuello uterino",implante subdermico: usuarias nuevas,2016-12-01,0,3,12,3,0,18
CHALLAPATA,"anticoncepcion, prevencion de its y de cancer de cuello uterino",implante subdermico: usuarias nuevas,2016-12-01,0,1,0,0,0,1
CHAYANTA,"anticoncepcion, prevencion de its y de cancer de cuello uterino",implante subdermico: usuarias nuevas,2016-12-01,0,0,7,1,0,8
CHIMORE,"anticoncepcion, prevencion de its y de cancer de cuello uterino",implante subdermico: usuarias nuevas,2016-12-01,0,0,3,0,0,3
CHULUMANI (V. DE LA LIBERTAD),"anticoncepcion, prevencion de its y de cancer de cuello uterino",implante subdermico: usuarias nuevas,2016-12-01,0,1,3,0,0,4
CHUMA,"anticoncepcion, prevencion de its y de cancer de cuello uterino",implante subdermico: usuarias nuevas,2016-12-01,0,0,1,1,0,2
CLIZA,"anticoncepcion, prevencion de its y de cancer de cuello uterino",implante subdermico: usuarias nuevas,2016-12-01,0,2,2,0,0,4
COBIJA,"anticoncepcion, prevencion de its y de cancer de cuello uterino",implante subdermico: usuarias nuevas,2016-12-01,0,12,11,0,0,23
COCAPATA,"anticoncepcion, prevencion de its y de cancer de cuello uterino",implante subdermico: usuarias nuevas,2016-12-01,0,3,1,7,0,11
COCHABAMBA,"anticoncepcion, prevencion de its y de cancer de cuello uterino",implante subdermico: usuarias nuevas,2016-12-01,2,31,210,43,0,286
COLCAPIRHUA,"anticoncepcion, prevencion de its y de cancer de cuello uterino",implante subdermico: usuarias nuevas,2016-12-01,0,0,15,0,0,15
COLOMI,"anticoncepcion, prevencion de its y de cancer de cuello uterino",implante subdermico: usuarias nuevas,2016-12-01,0,0,2,0,0,2
COLQUECHACA,"anticoncepcion, prevencion de its y de cancer de cuello uterino",implante subdermico: usuarias nuevas,2016-12-01,0,0,17,5,0,22
COLQUENCHA,"anticoncepcion, prevencion de its y de cancer de cuello uterino",implante subdermico: usuarias nuevas,2016-12-01,0,0,2,0,0,2
CORIPATA,"anticoncepcion, prevencion de its y de cancer de cuello uterino",implante subdermico: usuarias nuevas,2016-12-01,0,1,1,0,0,2
COTAGAITA,"anticoncepcion, prevencion de its y de cancer de cuello uterino",implante subdermico: usuarias nuevas,2016-12-01,0,0,1,1,0,2
CUCHUMUELA (V. G. VILLARROEL),"anticoncepcion, prevencion de its y de cancer de cuello uterino",implante subdermico: usuarias nuevas,2016-12-01,0,0,2,0,0,2
CULPINA,"anticoncepcion, prevencion de its y de cancer de cuello uterino",implante subdermico: usuarias nuevas,2016-12-01,0,2,1,1,0,4
EL ALTO,"anticoncepcion, prevencion de its y de cancer de cuello uterino",implante subdermico: usuarias nuevas,2016-12-01,0,30,288,38,0,356
EL TORNO,"anticoncepcion, prevencion de its y de cancer de cuello uterino",implante subdermico: usuarias nuevas,2016-12-01,0,5,10,0,0,15
EL VILLAR,"anticoncepcion, prevencion de its y de cancer de cuello uterino",implante subdermico: usuarias nuevas,2016-12-01,0,0,0,1,0,1
ENTRE RIOS TRJ,"anticoncepcion, prevencion de its y de cancer de cuello uterino",implante subdermico: usuarias nuevas,2016-12-01,0,5,17,4,0,26
ENTRE RIOS CBBA,"anticoncepcion, prevencion de its y de cancer de cuello uterino",implante subdermico: usuarias nuevas,2016-12-01,0,5,9,0,0,14
ESCOMA,"anticoncepcion, prevencion de its y de cancer de cuello uterino",implante subdermico: usuarias nuevas,2016-12-01,0,1,3,0,0,4
EUCALIPTUS,"anticoncepcion, prevencion de its y de cancer de cuello uterino",implante subdermico: usuarias nuevas,2016-12-01,0,0,2,0,0,2
FILADELFIA,"anticoncepcion, prevencion de its y de cancer de cuello uterino",implante subdermico: usuarias nuevas,2016-12-01,0,4,16,0,0,20
GRAL. J.J. PEREZ (CHARAZANI),"anticoncepcion, prevencion de its y de cancer de cuello uterino",implante subdermico: usuarias nuevas,2016-12-01,0,0,3,0,0,3
GUAYARAMERIN,"anticoncepcion, prevencion de its y de cancer de cuello uterino",implante subdermico: usuarias nuevas,2016-12-01,0,12,29,0,0,41
HUACARETA,"anticoncepcion, prevencion de its y de cancer de cuello uterino",implante subdermico: usuarias nuevas,2016-12-01,0,0,4,0,0,4
HUACHACALLA,"anticoncepcion, prevencion de its y de cancer de cuello uterino",implante subdermico: usuarias nuevas,2016-12-01,0,0,2,0,0,2
HUANUNI,"anticoncepcion, prevencion de its y de cancer de cuello uterino",implante subdermico: usuarias nuevas,2016-12-01,1,0,3,3,0,7
HUARACAJE,"anticoncepcion, prevencion de its y de cancer de cuello uterino",implante subdermico: usuarias nuevas,2016-12-01,0,0,1,0,0,1
ICLA,"anticoncepcion, prevencion de its y de cancer de cuello uterino",implante subdermico: usuarias nuevas,2016-12-01,0,2,1,0,0,3
INCAHUASI,"anticoncepcion, prevencion de its y de cancer de cuello uterino",implante subdermico: usuarias nuevas,2016-12-01,0,3,3,2,0,8
INGAVI (HUMAITA),"anticoncepcion, prevencion de its y de cancer de cuello uterino",implante subdermico: usuarias nuevas,2016-12-01,0,1,2,0,0,3
IRUPANA (VILLA DE LANZA),"anticoncepcion, prevencion de its y de cancer de cuello uterino",implante subdermico: usuarias nuevas,2016-12-01,0,1,8,1,0,10
JESUS DE MACHACA,"anticoncepcion, prevencion de its y de cancer de cuello uterino",implante subdermico: usuarias nuevas,2016-12-01,0,0,1,0,0,1
LA ASUNTA,"anticoncepcion, prevencion de its y de cancer de cuello uterino",implante subdermico: usuarias nuevas,2016-12-01,0,0,0,1,0,1
LA GUARDIA,"anticoncepcion, prevencion de its y de cancer de cuello uterino",implante subdermico: usuarias nuevas,2016-12-01,0,0,9,9,0,18
LA PAZ,"anticoncepcion, prevencion de its y de cancer de cuello uterino",implante subdermico: usuarias nuevas,2016-12-01,1,23,150,51,0,225
LAJA,"anticoncepcion, prevencion de its y de cancer de cuello uterino",implante subdermico: usuarias nuevas,2016-12-01,0,4,13,3,0,20
LAS CARRERAS,"anticoncepcion, prevencion de its y de cancer de cuello uterino",implante subdermico: usuarias nuevas,2016-12-01,0,1,3,1,0,5
LLALLAGUA,"anticoncepcion, prevencion de its y de cancer de cuello uterino",implante subdermico: usuarias nuevas,2016-12-01,0,6,9,2,1,18
MACHACAMARCA,"anticoncepcion, prevencion de its y de cancer de cuello uterino",implante subdermico: usuarias nuevas,2016-12-01,1,0,0,0,0,1
MACHARETI,"anticoncepcion, prevencion de its y de cancer de cuello uterino",implante subdermico: usuarias nuevas,2016-12-01,0,1,1,0,0,2
MAGDALENA,"anticoncepcion, prevencion de its y de cancer de cuello uterino",implante subdermico: usuarias nuevas,2016-12-01,0,0,1,0,0,1
MAPIRI,"anticoncepcion, prevencion de its y de cancer de cuello uterino",implante subdermico: usuarias nuevas,2016-12-01,0,0,3,1,0,4
MIZQUE,"anticoncepcion, prevencion de its y de cancer de cuello uterino",implante subdermico: usuarias nuevas,2016-12-01,0,5,2,0,0,7
MOJOCOYA,"anticoncepcion, prevencion de its y de cancer de cuello uterino",implante subdermico: usuarias nuevas,2016-12-01,0,0,1,0,0,1
MONTEAGUDO,"anticoncepcion, prevencion de its y de cancer de cuello uterino",implante subdermico: usuarias nuevas,2016-12-01,0,0,2,0,0,2
MONTERO,"anticoncepcion, prevencion de its y de cancer de cuello uterino",implante subdermico: usuarias nuevas,2016-12-01,0,2,12,1,0,15
NUEVO MANOA (NUEVA ESPERANZA),"anticoncepcion, prevencion de its y de cancer de cuello uterino",implante subdermico: usuarias nuevas,2016-12-01,0,0,1,0,0,1
ORURO,"anticoncepcion, prevencion de its y de cancer de cuello uterino",implante subdermico: usuarias nuevas,2016-12-01,1,7,94,12,0,114
PADILLA,"anticoncepcion, prevencion de its y de cancer de cuello uterino",implante subdermico: usuarias nuevas,2016-12-01,0,1,4,0,0,5
PAILON,"anticoncepcion, prevencion de its y de cancer de cuello uterino",implante subdermico: usuarias nuevas,2016-12-01,1,8,25,4,0,38
PALCA,"anticoncepcion, prevencion de its y de cancer de cuello uterino",implante subdermico: usuarias nuevas,2016-12-01,0,1,7,4,0,12
PALOS BLANCOS,"anticoncepcion, prevencion de its y de cancer de cuello uterino",implante subdermico: usuarias nuevas,2016-12-01,0,1,3,1,0,5
PATACAMAYA,"anticoncepcion, prevencion de its y de cancer de cuello uterino",implante subdermico: usuarias nuevas,2016-12-01,0,0,4,3,0,7
POCOATA,"anticoncepcion, prevencion de its y de cancer de cuello uterino",implante subdermico: usuarias nuevas,2016-12-01,0,6,8,2,0,16
POCONA,"anticoncepcion, prevencion de its y de cancer de cuello uterino",implante subdermico: usuarias nuevas,2016-12-01,0,0,3,5,0,8
POOPO,"anticoncepcion, prevencion de its y de cancer de cuello uterino",implante subdermico: usuarias nuevas,2016-12-01,0,0,1,0,0,1
PORCO,"anticoncepcion, prevencion de its y de cancer de cuello uterino",implante subdermico: usuarias nuevas,2016-12-01,0,0,3,0,0,3
POROMA,"anticoncepcion, prevencion de its y de cancer de cuello uterino",implante subdermico: usuarias nuevas,2016-12-01,0,0,1,2,0,3
PORVENIR,"anticoncepcion, prevencion de its y de cancer de cuello uterino",implante subdermico: usuarias nuevas,2016-12-01,0,0,1,0,0,1
POTOSI,"anticoncepcion, prevencion de its y de cancer de cuello uterino",implante subdermico: usuarias nuevas,2016-12-01,0,5,54,32,0,91
PRESTO,"anticoncepcion, prevencion de its y de cancer de cuello uterino",implante subdermico: usuarias nuevas,2016-12-01,0,1,4,0,0,5
PUCARANI,"anticoncepcion, prevencion de its y de cancer de cuello uterino",implante subdermico: usuarias nuevas,2016-12-01,0,0,5,2,0,7
PUERTO GONZALO MORENO,"anticoncepcion, prevencion de its y de cancer de cuello uterino",implante subdermico: usuarias nuevas,2016-12-01,1,3,0,0,0,4
PUERTO QUIJARRO,"anticoncepcion, prevencion de its y de cancer de cuello uterino",implante subdermico: usuarias nuevas,2016-12-01,0,0,3,1,1,5
PUERTO VILLARROEL,"anticoncepcion, prevencion de its y de cancer de cuello uterino",implante subdermico: usuarias nuevas,2016-12-01,0,1,2,0,0,3
PUNA,"anticoncepcion, prevencion de its y de cancer de cuello uterino",implante subdermico: usuarias nuevas,2016-12-01,0,0,4,3,0,7
QUILLACOLLO,"anticoncepcion, prevencion de its y de cancer de cuello uterino",implante subdermico: usuarias nuevas,2016-12-01,0,0,5,0,0,5
RIBERALTA,"anticoncepcion, prevencion de its y de cancer de cuello uterino",implante subdermico: usuarias nuevas,2016-12-01,11,28,100,7,0,146
RURRENABAQUE,"anticoncepcion, prevencion de its y de cancer de cuello uterino",implante subdermico: usuarias nuevas,2016-12-01,0,2,8,0,0,10
SACABA,"anticoncepcion, prevencion de its y de cancer de cuello uterino",implante subdermico: usuarias nuevas,2016-12-01,0,10,35,9,0,54
SACACA,"anticoncepcion, prevencion de its y de cancer de cuello uterino",implante subdermico: usuarias nuevas,2016-12-01,0,1,9,0,0,10
SALINAS DE GARCI MENDOZA,"anticoncepcion, prevencion de its y de cancer de cuello uterino",implante subdermico: usuarias nuevas,2016-12-01,0,1,0,0,0,1
SAN ANDRES,"anticoncepcion, prevencion de its y de cancer de cuello uterino",implante subdermico: usuarias nuevas,2016-12-01,0,0,1,0,0,1
SAN BORJA,"anticoncepcion, prevencion de its y de cancer de cuello uterino",implante subdermico: usuarias nuevas,2016-12-01,0,0,2,1,0,3
SAN CARLOS,"anticoncepcion, prevencion de its y de cancer de cuello uterino",implante subdermico: usuarias nuevas,2016-12-01,0,3,14,3,0,20
SAN IGNACIO,"anticoncepcion, prevencion de its y de cancer de cuello uterino",implante subdermico: usuarias nuevas,2016-12-01,0,0,3,1,0,4
SAN JOAQUIN,"anticoncepcion, prevencion de its y de cancer de cuello uterino",implante subdermico: usuarias nuevas,2016-12-01,0,1,0,0,0,1
SAN JULIAN,"anticoncepcion, prevencion de its y de cancer de cuello uterino",implante subdermico: usuarias nuevas,2016-12-01,0,0,13,1,0,14
SAN LORENZO(PND),"anticoncepcion, prevencion de its y de cancer de cuello uterino",implante subdermico: usuarias nuevas,2016-12-01,0,2,2,0,0,4
SAN LUCAS,"anticoncepcion, prevencion de its y de cancer de cuello uterino",implante subdermico: usuarias nuevas,2016-12-01,0,0,3,1,0,4
SAN PABLO DE LIPEZ,"anticoncepcion, prevencion de its y de cancer de cuello uterino",implante subdermico: usuarias nuevas,2016-12-01,0,0,1,0,0,1
SAN RAFAEL,"anticoncepcion, prevencion de its y de cancer de cuello uterino",implante subdermico: usuarias nuevas,2016-12-01,0,0,8,0,0,8
SANTA ANA,"anticoncepcion, prevencion de its y de cancer de cuello uterino",implante subdermico: usuarias nuevas,2016-12-01,0,0,2,0,0,2
SANTA CRUZ DE LA SIERRA,"anticoncepcion, prevencion de its y de cancer de cuello uterino",implante subdermico: usuarias nuevas,2016-12-01,2,15,31,18,0,66
SANTIAGO DE HUARI,"anticoncepcion, prevencion de its y de cancer de cuello uterino",implante subdermico: usuarias nuevas,2016-12-01,0,1,0,2,0,3
SANTIAGO DE MACHACA,"anticoncepcion, prevencion de its y de cancer de cuello uterino",implante subdermico: usuarias nuevas,2016-12-01,0,0,1,0,0,1
SANTIVAÑES,"anticoncepcion, prevencion de its y de cancer de cuello uterino",implante subdermico: usuarias nuevas,2016-12-01,0,0,1,0,0,1
SANTUARIO DE QUILLACAS,"anticoncepcion, prevencion de its y de cancer de cuello uterino",implante subdermico: usuarias nuevas,2016-12-01,0,0,4,0,0,4
SENA,"anticoncepcion, prevencion de its y de cancer de cuello uterino",implante subdermico: usuarias nuevas,2016-12-01,0,5,0,1,0,6
SICA SICA (VILLA AROMA),"anticoncepcion, prevencion de its y de cancer de cuello uterino",implante subdermico: usuarias nuevas,2016-12-01,0,0,9,1,0,10
SIPE SIPE,"anticoncepcion, prevencion de its y de cancer de cuello uterino",implante subdermico: usuarias nuevas,2016-12-01,0,0,3,0,0,3
SOPACHUY,"anticoncepcion, prevencion de its y de cancer de cuello uterino",implante subdermico: usuarias nuevas,2016-12-01,0,2,3,1,0,6
SORATA,"anticoncepcion, prevencion de its y de cancer de cuello uterino",implante subdermico: usuarias nuevas,2016-12-01,0,0,5,0,0,5
SUCRE,"anticoncepcion, prevencion de its y de cancer de cuello uterino",implante subdermico: usuarias nuevas,2016-12-01,1,74,177,23,0,275
TACOBAMBA,"anticoncepcion, prevencion de its y de cancer de cuello uterino",implante subdermico: usuarias nuevas,2016-12-01,0,1,3,1,0,5
TAPACARI,"anticoncepcion, prevencion de its y de cancer de cuello uterino",implante subdermico: usuarias nuevas,2016-12-01,0,2,4,1,0,7
TARABUCO,"anticoncepcion, prevencion de its y de cancer de cuello uterino",implante subdermico: usuarias nuevas,2016-12-01,0,2,4,2,0,8
TARATA,"anticoncepcion, prevencion de its y de cancer de cuello uterino",implante subdermico: usuarias nuevas,2016-12-01,0,0,2,0,0,2
TARIJA,"anticoncepcion, prevencion de its y de cancer de cuello uterino",implante subdermico: usuarias nuevas,2016-12-01,1,25,175,15,0,216
TIAWANACU,"anticoncepcion, prevencion de its y de cancer de cuello uterino",implante subdermico: usuarias nuevas,2016-12-01,0,0,3,1,0,4
TINGUIPAYA,"anticoncepcion, prevencion de its y de cancer de cuello uterino",implante subdermico: usuarias nuevas,2016-12-01,0,0,1,0,0,1
TIPUANI,"anticoncepcion, prevencion de its y de cancer de cuello uterino",implante subdermico: usuarias nuevas,2016-12-01,0,0,0,1,0,1
TIQUIPAYA,"anticoncepcion, prevencion de its y de cancer de cuello uterino",implante subdermico: usuarias nuevas,2016-12-01,0,2,11,1,0,14
TIRAQUE (CBBA),"anticoncepcion, prevencion de its y de cancer de cuello uterino",implante subdermico: usuarias nuevas,2016-12-01,0,1,2,0,0,3
TODOS SANTOS,"anticoncepcion, prevencion de its y de cancer de cuello uterino",implante subdermico: usuarias nuevas,2016-12-01,0,0,1,0,0,1
TOLATA,"anticoncepcion, prevencion de its y de cancer de cuello uterino",implante subdermico: usuarias nuevas,2016-12-01,0,2,5,0,0,7
TOLEDO,"anticoncepcion, prevencion de its y de cancer de cuello uterino",implante subdermico: usuarias nuevas,2016-12-01,0,1,1,1,0,3
TOMINA,"anticoncepcion, prevencion de its y de cancer de cuello uterino",implante subdermico: usuarias nuevas,2016-12-01,0,1,0,3,0,4
TORO TORO,"anticoncepcion, prevencion de its y de cancer de cuello uterino",implante subdermico: usuarias nuevas,2016-12-01,1,4,5,0,0,10
TOTORA(CBBA),"anticoncepcion, prevencion de its y de cancer de cuello uterino",implante subdermico: usuarias nuevas,2016-12-01,0,0,1,0,0,1
TOTORA(ORR),"anticoncepcion, prevencion de its y de cancer de cuello uterino",implante subdermico: usuarias nuevas,2016-12-01,0,0,1,0,0,1
TRINIDAD,"anticoncepcion, prevencion de its y de cancer de cuello uterino",implante subdermico: usuarias nuevas,2016-12-01,7,71,70,40,0,188
TUPIZA,"anticoncepcion, prevencion de its y de cancer de cuello uterino",implante subdermico: usuarias nuevas,2016-12-01,0,8,20,2,0,30
VIACHA,"anticoncepcion, prevencion de its y de cancer de cuello uterino",implante subdermico: usuarias nuevas,2016-12-01,0,22,99,4,0,125
VILLA CHARCAS,"anticoncepcion, prevencion de its y de cancer de cuello uterino",implante subdermico: usuarias nuevas,2016-12-01,0,1,4,1,0,6
VILLA NUEVA (LOMA ALTA),"anticoncepcion, prevencion de its y de cancer de cuello uterino",implante subdermico: usuarias nuevas,2016-12-01,0,1,1,0,0,2
VILLA SERRANO,"anticoncepcion, prevencion de its y de cancer de cuello uterino",implante subdermico: usuarias nuevas,2016-12-01,0,0,0,1,0,1
VILLA VACA GUZMAN (MUYUPAMPA),"anticoncepcion, prevencion de its y de cancer de cuello uterino",implante subdermico: usuarias nuevas,2016-12-01,0,2,11,0,0,13
VILLAZON,"anticoncepcion, prevencion de its y de cancer de cuello uterino",implante subdermico: usuarias nuevas,2016-12-01,0,5,16,0,0,21
VINTO,"anticoncepcion, prevencion de its y de cancer de cuello uterino",implante subdermico: usuarias nuevas,2016-12-01,0,0,12,0,0,12
VITICHI,"anticoncepcion, prevencion de its y de cancer de cuello uterino",implante subdermico: usuarias nuevas,2016-12-01,0,3,7,2,0,12
WARNES,"anticoncepcion, prevencion de its y de cancer de cuello uterino",implante subdermico: usuarias nuevas,2016-12-01,0,3,13,3,0,19
YACUIBA,"anticoncepcion, prevencion de its y de cancer de cuello uterino",implante subdermico: usuarias nuevas,2016-12-01,0,0,0,1,0,1
YAMPARAEZ,"anticoncepcion, prevencion de its y de cancer de cuello uterino",implante subdermico: usuarias nuevas,2016-12-01,0,0,1,1,0,2
YANACACHI,"anticoncepcion, prevencion de its y de cancer de cuello uterino",implante subdermico: usuarias nuevas,2016-12-01,0,0,5,0,0,5
YAPACANI,"anticoncepcion, prevencion de its y de cancer de cuello uterino",implante subdermico: usuarias nuevas,2016-12-01,0,6,8,2,0,16
YOCALLA,"anticoncepcion, prevencion de its y de cancer de cuello uterino",implante subdermico: usuarias nuevas,2016-12-01,0,1,12,2,0,15
YUNCHARA,"anticoncepcion, prevencion de its y de cancer de cuello uterino",implante subdermico: usuarias nuevas,2016-12-01,0,2,0,0,0,2
ZUDAÑEZ,"anticoncepcion, prevencion de its y de cancer de cuello uterino",implante subdermico: usuarias nuevas,2016-12-01,0,1,0,0,0,1
