municipality,group,variable,month,Número de mujeres con resultados de PAP positivos,Número de mujeres con resultados de PAP positivos1,Número de mujeres con resultados de PAP positivos2,Número de mujeres con resultados de PAP positivos3,Número de mujeres con resultados de PAP positivos4,TOTAL
ACHACACHI,"anticoncepcion, prevencion de its y de cancer de cuello uterino",numero de mujeres con resultados de pap positivos,2016-01-01,0,0,1,0,0,1
AIQUILE,"anticoncepcion, prevencion de its y de cancer de cuello uterino",numero de mujeres con resultados de pap positivos,2016-01-01,0,0,0,0,1,1
BATALLAS,"anticoncepcion, prevencion de its y de cancer de cuello uterino",numero de mujeres con resultados de pap positivos,2016-01-01,0,0,1,1,0,2
CAPINOTA,"anticoncepcion, prevencion de its y de cancer de cuello uterino",numero de mujeres con resultados de pap positivos,2016-01-01,0,0,1,1,0,2
CARANAVI,"anticoncepcion, prevencion de its y de cancer de cuello uterino",numero de mujeres con resultados de pap positivos,2016-01-01,0,0,1,1,0,2
CARMEN RIVERO TORREZ,"anticoncepcion, prevencion de its y de cancer de cuello uterino",numero de mujeres con resultados de pap positivos,2016-01-01,0,0,1,0,0,1
CHULUMANI (V. DE LA LIBERTAD),"anticoncepcion, prevencion de its y de cancer de cuello uterino",numero de mujeres con resultados de pap positivos,2016-01-01,0,0,1,0,0,1
COBIJA,"anticoncepcion, prevencion de its y de cancer de cuello uterino",numero de mujeres con resultados de pap positivos,2016-01-01,0,0,1,0,0,1
COCHABAMBA,"anticoncepcion, prevencion de its y de cancer de cuello uterino",numero de mujeres con resultados de pap positivos,2016-01-01,0,2,43,32,20,97
EL ALTO,"anticoncepcion, prevencion de its y de cancer de cuello uterino",numero de mujeres con resultados de pap positivos,2016-01-01,0,3,25,31,16,75
EL TORNO,"anticoncepcion, prevencion de its y de cancer de cuello uterino",numero de mujeres con resultados de pap positivos,2016-01-01,0,1,6,2,1,10
LA ASUNTA,"anticoncepcion, prevencion de its y de cancer de cuello uterino",numero de mujeres con resultados de pap positivos,2016-01-01,0,0,1,0,0,1
LA GUARDIA,"anticoncepcion, prevencion de its y de cancer de cuello uterino",numero de mujeres con resultados de pap positivos,2016-01-01,0,0,6,2,1,9
LA PAZ,"anticoncepcion, prevencion de its y de cancer de cuello uterino",numero de mujeres con resultados de pap positivos,2016-01-01,0,0,9,8,3,20
MONTEAGUDO,"anticoncepcion, prevencion de its y de cancer de cuello uterino",numero de mujeres con resultados de pap positivos,2016-01-01,0,0,1,0,1,2
MONTERO,"anticoncepcion, prevencion de its y de cancer de cuello uterino",numero de mujeres con resultados de pap positivos,2016-01-01,0,0,5,1,0,6
ORURO,"anticoncepcion, prevencion de its y de cancer de cuello uterino",numero de mujeres con resultados de pap positivos,2016-01-01,0,9,2,1,1,13
PALOS BLANCOS,"anticoncepcion, prevencion de its y de cancer de cuello uterino",numero de mujeres con resultados de pap positivos,2016-01-01,0,0,0,0,1,1
POTOSI,"anticoncepcion, prevencion de its y de cancer de cuello uterino",numero de mujeres con resultados de pap positivos,2016-01-01,0,0,5,2,1,8
QUILLACOLLO,"anticoncepcion, prevencion de its y de cancer de cuello uterino",numero de mujeres con resultados de pap positivos,2016-01-01,0,0,0,11,0,11
RIBERALTA,"anticoncepcion, prevencion de its y de cancer de cuello uterino",numero de mujeres con resultados de pap positivos,2016-01-01,0,0,1,0,0,1
SACABA,"anticoncepcion, prevencion de its y de cancer de cuello uterino",numero de mujeres con resultados de pap positivos,2016-01-01,0,0,2,0,1,3
SAIPINA,"anticoncepcion, prevencion de its y de cancer de cuello uterino",numero de mujeres con resultados de pap positivos,2016-01-01,0,0,8,2,0,10
SAN BENITO,"anticoncepcion, prevencion de its y de cancer de cuello uterino",numero de mujeres con resultados de pap positivos,2016-01-01,0,0,1,0,0,1
SAN BORJA,"anticoncepcion, prevencion de its y de cancer de cuello uterino",numero de mujeres con resultados de pap positivos,2016-01-01,0,0,1,1,0,2
SAN BUENA VENTURA,"anticoncepcion, prevencion de its y de cancer de cuello uterino",numero de mujeres con resultados de pap positivos,2016-01-01,0,0,0,1,0,1
SAN LUCAS,"anticoncepcion, prevencion de its y de cancer de cuello uterino",numero de mujeres con resultados de pap positivos,2016-01-01,0,0,0,1,0,1
SANTA CRUZ DE LA SIERRA,"anticoncepcion, prevencion de its y de cancer de cuello uterino",numero de mujeres con resultados de pap positivos,2016-01-01,0,11,57,22,15,105
SANTUARIO DE QUILLACAS,"anticoncepcion, prevencion de its y de cancer de cuello uterino",numero de mujeres con resultados de pap positivos,2016-01-01,0,0,2,0,0,2
SHINAOTA,"anticoncepcion, prevencion de its y de cancer de cuello uterino",numero de mujeres con resultados de pap positivos,2016-01-01,0,1,0,0,0,1
SUCRE,"anticoncepcion, prevencion de its y de cancer de cuello uterino",numero de mujeres con resultados de pap positivos,2016-01-01,0,1,15,7,3,26
TARATA,"anticoncepcion, prevencion de its y de cancer de cuello uterino",numero de mujeres con resultados de pap positivos,2016-01-01,0,0,1,0,0,1
TARIJA,"anticoncepcion, prevencion de its y de cancer de cuello uterino",numero de mujeres con resultados de pap positivos,2016-01-01,0,0,6,4,1,11
TIQUIPAYA,"anticoncepcion, prevencion de its y de cancer de cuello uterino",numero de mujeres con resultados de pap positivos,2016-01-01,0,0,5,1,0,6
TOMINA,"anticoncepcion, prevencion de its y de cancer de cuello uterino",numero de mujeres con resultados de pap positivos,2016-01-01,0,1,0,0,0,1
TRINIDAD,"anticoncepcion, prevencion de its y de cancer de cuello uterino",numero de mujeres con resultados de pap positivos,2016-01-01,0,0,6,8,0,14
TUPIZA,"anticoncepcion, prevencion de its y de cancer de cuello uterino",numero de mujeres con resultados de pap positivos,2016-01-01,0,0,2,0,0,2
VALLEGRANDE,"anticoncepcion, prevencion de its y de cancer de cuello uterino",numero de mujeres con resultados de pap positivos,2016-01-01,0,0,0,1,0,1
VIACHA,"anticoncepcion, prevencion de its y de cancer de cuello uterino",numero de mujeres con resultados de pap positivos,2016-01-01,0,0,0,1,0,1
VILLAZON,"anticoncepcion, prevencion de its y de cancer de cuello uterino",numero de mujeres con resultados de pap positivos,2016-01-01,0,1,1,1,0,3
VINTO,"anticoncepcion, prevencion de its y de cancer de cuello uterino",numero de mujeres con resultados de pap positivos,2016-01-01,0,1,0,0,0,1
YACUIBA,"anticoncepcion, prevencion de its y de cancer de cuello uterino",numero de mujeres con resultados de pap positivos,2016-01-01,0,0,0,1,0,1
YANACACHI,"anticoncepcion, prevencion de its y de cancer de cuello uterino",numero de mujeres con resultados de pap positivos,2016-01-01,0,0,1,1,0,2
YOTALA,"anticoncepcion, prevencion de its y de cancer de cuello uterino",numero de mujeres con resultados de pap positivos,2016-01-01,0,0,0,1,0,1
ASCENCION DE GUARAYOS,"anticoncepcion, prevencion de its y de cancer de cuello uterino",numero de mujeres con resultados de pap positivos,2016-02-01,0,0,0,1,1,2
BERMEJO,"anticoncepcion, prevencion de its y de cancer de cuello uterino",numero de mujeres con resultados de pap positivos,2016-02-01,0,0,1,0,0,1
BUENA VISTA,"anticoncepcion, prevencion de its y de cancer de cuello uterino",numero de mujeres con resultados de pap positivos,2016-02-01,0,0,2,0,0,2
CARANAVI,"anticoncepcion, prevencion de its y de cancer de cuello uterino",numero de mujeres con resultados de pap positivos,2016-02-01,0,0,1,1,0,2
CHULUMANI (V. DE LA LIBERTAD),"anticoncepcion, prevencion de its y de cancer de cuello uterino",numero de mujeres con resultados de pap positivos,2016-02-01,0,0,1,0,0,1
COCHABAMBA,"anticoncepcion, prevencion de its y de cancer de cuello uterino",numero de mujeres con resultados de pap positivos,2016-02-01,0,4,38,24,4,70
COMBAYA,"anticoncepcion, prevencion de its y de cancer de cuello uterino",numero de mujeres con resultados de pap positivos,2016-02-01,0,0,1,0,0,1
EL ALTO,"anticoncepcion, prevencion de its y de cancer de cuello uterino",numero de mujeres con resultados de pap positivos,2016-02-01,0,4,48,22,5,79
EL TORNO,"anticoncepcion, prevencion de its y de cancer de cuello uterino",numero de mujeres con resultados de pap positivos,2016-02-01,0,0,6,3,0,9
IXIAMAS,"anticoncepcion, prevencion de its y de cancer de cuello uterino",numero de mujeres con resultados de pap positivos,2016-02-01,0,2,10,8,4,24
LA GUARDIA,"anticoncepcion, prevencion de its y de cancer de cuello uterino",numero de mujeres con resultados de pap positivos,2016-02-01,0,0,3,3,0,6
LA PAZ,"anticoncepcion, prevencion de its y de cancer de cuello uterino",numero de mujeres con resultados de pap positivos,2016-02-01,0,2,31,22,15,70
MAPIRI,"anticoncepcion, prevencion de its y de cancer de cuello uterino",numero de mujeres con resultados de pap positivos,2016-02-01,0,0,0,0,1,1
MECAPACA,"anticoncepcion, prevencion de its y de cancer de cuello uterino",numero de mujeres con resultados de pap positivos,2016-02-01,0,1,1,0,0,2
MIZQUE,"anticoncepcion, prevencion de its y de cancer de cuello uterino",numero de mujeres con resultados de pap positivos,2016-02-01,0,0,8,4,4,16
MONTEAGUDO,"anticoncepcion, prevencion de its y de cancer de cuello uterino",numero de mujeres con resultados de pap positivos,2016-02-01,0,0,3,9,1,13
ORURO,"anticoncepcion, prevencion de its y de cancer de cuello uterino",numero de mujeres con resultados de pap positivos,2016-02-01,0,0,4,8,5,17
PORTACHUELO,"anticoncepcion, prevencion de its y de cancer de cuello uterino",numero de mujeres con resultados de pap positivos,2016-02-01,0,0,1,0,0,1
POTOSI,"anticoncepcion, prevencion de its y de cancer de cuello uterino",numero de mujeres con resultados de pap positivos,2016-02-01,0,0,13,7,0,20
QUIRUSILLAS,"anticoncepcion, prevencion de its y de cancer de cuello uterino",numero de mujeres con resultados de pap positivos,2016-02-01,0,0,0,1,0,1
SACABA,"anticoncepcion, prevencion de its y de cancer de cuello uterino",numero de mujeres con resultados de pap positivos,2016-02-01,0,1,2,0,0,3
SAN BUENA VENTURA,"anticoncepcion, prevencion de its y de cancer de cuello uterino",numero de mujeres con resultados de pap positivos,2016-02-01,0,0,0,1,0,1
SAN CARLOS,"anticoncepcion, prevencion de its y de cancer de cuello uterino",numero de mujeres con resultados de pap positivos,2016-02-01,0,0,1,0,0,1
SAN IGNACIO,"anticoncepcion, prevencion de its y de cancer de cuello uterino",numero de mujeres con resultados de pap positivos,2016-02-01,0,0,3,2,0,5
SAN LUCAS,"anticoncepcion, prevencion de its y de cancer de cuello uterino",numero de mujeres con resultados de pap positivos,2016-02-01,0,0,0,1,2,3
SANTA CRUZ DE LA SIERRA,"anticoncepcion, prevencion de its y de cancer de cuello uterino",numero de mujeres con resultados de pap positivos,2016-02-01,0,16,71,32,15,134
SANTIAGO DE HUARI,"anticoncepcion, prevencion de its y de cancer de cuello uterino",numero de mujeres con resultados de pap positivos,2016-02-01,0,0,1,0,0,1
SHINAOTA,"anticoncepcion, prevencion de its y de cancer de cuello uterino",numero de mujeres con resultados de pap positivos,2016-02-01,0,0,1,0,0,1
SICA SICA (VILLA AROMA),"anticoncepcion, prevencion de its y de cancer de cuello uterino",numero de mujeres con resultados de pap positivos,2016-02-01,0,0,1,0,0,1
SUCRE,"anticoncepcion, prevencion de its y de cancer de cuello uterino",numero de mujeres con resultados de pap positivos,2016-02-01,0,2,10,10,7,29
TARIJA,"anticoncepcion, prevencion de its y de cancer de cuello uterino",numero de mujeres con resultados de pap positivos,2016-02-01,0,0,4,0,0,4
TARVITA,"anticoncepcion, prevencion de its y de cancer de cuello uterino",numero de mujeres con resultados de pap positivos,2016-02-01,0,0,0,1,0,1
TIQUIPAYA,"anticoncepcion, prevencion de its y de cancer de cuello uterino",numero de mujeres con resultados de pap positivos,2016-02-01,0,0,1,1,0,2
TRINIDAD,"anticoncepcion, prevencion de its y de cancer de cuello uterino",numero de mujeres con resultados de pap positivos,2016-02-01,0,0,8,10,3,21
TUPIZA,"anticoncepcion, prevencion de its y de cancer de cuello uterino",numero de mujeres con resultados de pap positivos,2016-02-01,0,0,4,4,1,9
VALLEGRANDE,"anticoncepcion, prevencion de its y de cancer de cuello uterino",numero de mujeres con resultados de pap positivos,2016-02-01,0,1,0,0,1,2
VIACHA,"anticoncepcion, prevencion de its y de cancer de cuello uterino",numero de mujeres con resultados de pap positivos,2016-02-01,0,0,4,6,3,13
VILLA NUEVA (LOMA ALTA),"anticoncepcion, prevencion de its y de cancer de cuello uterino",numero de mujeres con resultados de pap positivos,2016-02-01,0,0,0,1,0,1
WARNES,"anticoncepcion, prevencion de its y de cancer de cuello uterino",numero de mujeres con resultados de pap positivos,2016-02-01,0,1,1,1,0,3
YACUIBA,"anticoncepcion, prevencion de its y de cancer de cuello uterino",numero de mujeres con resultados de pap positivos,2016-02-01,0,1,1,1,0,3
YAMPARAEZ,"anticoncepcion, prevencion de its y de cancer de cuello uterino",numero de mujeres con resultados de pap positivos,2016-02-01,0,0,0,1,0,1
YANACACHI,"anticoncepcion, prevencion de its y de cancer de cuello uterino",numero de mujeres con resultados de pap positivos,2016-02-01,0,0,0,0,1,1
YAPACANI,"anticoncepcion, prevencion de its y de cancer de cuello uterino",numero de mujeres con resultados de pap positivos,2016-02-01,0,0,0,1,0,1
ATOCHA,"anticoncepcion, prevencion de its y de cancer de cuello uterino",numero de mujeres con resultados de pap positivos,2016-03-01,0,0,0,1,0,1
BUENA VISTA,"anticoncepcion, prevencion de its y de cancer de cuello uterino",numero de mujeres con resultados de pap positivos,2016-03-01,0,0,1,2,0,3
CARANAVI,"anticoncepcion, prevencion de its y de cancer de cuello uterino",numero de mujeres con resultados de pap positivos,2016-03-01,0,0,0,1,0,1
CHULUMANI (V. DE LA LIBERTAD),"anticoncepcion, prevencion de its y de cancer de cuello uterino",numero de mujeres con resultados de pap positivos,2016-03-01,0,0,2,0,0,2
COBIJA,"anticoncepcion, prevencion de its y de cancer de cuello uterino",numero de mujeres con resultados de pap positivos,2016-03-01,0,0,1,0,0,1
COCAPATA,"anticoncepcion, prevencion de its y de cancer de cuello uterino",numero de mujeres con resultados de pap positivos,2016-03-01,0,0,0,1,1,2
COCHABAMBA,"anticoncepcion, prevencion de its y de cancer de cuello uterino",numero de mujeres con resultados de pap positivos,2016-03-01,1,51,230,862,52,1196
COLCAPIRHUA,"anticoncepcion, prevencion de its y de cancer de cuello uterino",numero de mujeres con resultados de pap positivos,2016-03-01,0,0,1,0,0,1
CORO CORO,"anticoncepcion, prevencion de its y de cancer de cuello uterino",numero de mujeres con resultados de pap positivos,2016-03-01,0,0,0,1,1,2
COROICO,"anticoncepcion, prevencion de its y de cancer de cuello uterino",numero de mujeres con resultados de pap positivos,2016-03-01,0,1,0,0,0,1
EL ALTO,"anticoncepcion, prevencion de its y de cancer de cuello uterino",numero de mujeres con resultados de pap positivos,2016-03-01,0,3,57,46,18,124
EL TORNO,"anticoncepcion, prevencion de its y de cancer de cuello uterino",numero de mujeres con resultados de pap positivos,2016-03-01,0,1,2,2,1,6
GUANAY,"anticoncepcion, prevencion de its y de cancer de cuello uterino",numero de mujeres con resultados de pap positivos,2016-03-01,0,0,1,0,0,1
LA ASUNTA,"anticoncepcion, prevencion de its y de cancer de cuello uterino",numero de mujeres con resultados de pap positivos,2016-03-01,0,0,0,0,1,1
LA GUARDIA,"anticoncepcion, prevencion de its y de cancer de cuello uterino",numero de mujeres con resultados de pap positivos,2016-03-01,0,3,4,0,0,7
LA PAZ,"anticoncepcion, prevencion de its y de cancer de cuello uterino",numero de mujeres con resultados de pap positivos,2016-03-01,0,2,39,58,41,140
MACHARETI,"anticoncepcion, prevencion de its y de cancer de cuello uterino",numero de mujeres con resultados de pap positivos,2016-03-01,0,0,0,0,1,1
MAPIRI,"anticoncepcion, prevencion de its y de cancer de cuello uterino",numero de mujeres con resultados de pap positivos,2016-03-01,0,0,1,0,0,1
MINEROS,"anticoncepcion, prevencion de its y de cancer de cuello uterino",numero de mujeres con resultados de pap positivos,2016-03-01,0,0,0,1,1,2
MIZQUE,"anticoncepcion, prevencion de its y de cancer de cuello uterino",numero de mujeres con resultados de pap positivos,2016-03-01,0,0,9,3,2,14
MOJOCOYA,"anticoncepcion, prevencion de its y de cancer de cuello uterino",numero de mujeres con resultados de pap positivos,2016-03-01,0,0,0,1,0,1
MONTEAGUDO,"anticoncepcion, prevencion de its y de cancer de cuello uterino",numero de mujeres con resultados de pap positivos,2016-03-01,0,1,1,1,5,8
MONTERO,"anticoncepcion, prevencion de its y de cancer de cuello uterino",numero de mujeres con resultados de pap positivos,2016-03-01,0,2,1,0,0,3
ORURO,"anticoncepcion, prevencion de its y de cancer de cuello uterino",numero de mujeres con resultados de pap positivos,2016-03-01,0,0,2,0,0,2
PALOS BLANCOS,"anticoncepcion, prevencion de its y de cancer de cuello uterino",numero de mujeres con resultados de pap positivos,2016-03-01,0,0,2,1,0,3
POCOATA,"anticoncepcion, prevencion de its y de cancer de cuello uterino",numero de mujeres con resultados de pap positivos,2016-03-01,0,0,0,0,2,2
POCONA,"anticoncepcion, prevencion de its y de cancer de cuello uterino",numero de mujeres con resultados de pap positivos,2016-03-01,2,2,1,1,0,6
PORTACHUELO,"anticoncepcion, prevencion de its y de cancer de cuello uterino",numero de mujeres con resultados de pap positivos,2016-03-01,0,0,1,0,0,1
POTOSI,"anticoncepcion, prevencion de its y de cancer de cuello uterino",numero de mujeres con resultados de pap positivos,2016-03-01,0,0,3,2,0,5
PRESTO,"anticoncepcion, prevencion de its y de cancer de cuello uterino",numero de mujeres con resultados de pap positivos,2016-03-01,0,0,0,1,0,1
PUERTO VILLARROEL,"anticoncepcion, prevencion de its y de cancer de cuello uterino",numero de mujeres con resultados de pap positivos,2016-03-01,0,0,1,0,0,1
QUILLACOLLO,"anticoncepcion, prevencion de its y de cancer de cuello uterino",numero de mujeres con resultados de pap positivos,2016-03-01,0,0,3,0,1,4
SACABA,"anticoncepcion, prevencion de its y de cancer de cuello uterino",numero de mujeres con resultados de pap positivos,2016-03-01,0,0,3,1,0,4
SAN IGNACIO DE VELASCO,"anticoncepcion, prevencion de its y de cancer de cuello uterino",numero de mujeres con resultados de pap positivos,2016-03-01,0,0,1,1,0,2
SAN JULIAN,"anticoncepcion, prevencion de its y de cancer de cuello uterino",numero de mujeres con resultados de pap positivos,2016-03-01,0,0,1,0,0,1
SAN RAMON BENI,"anticoncepcion, prevencion de its y de cancer de cuello uterino",numero de mujeres con resultados de pap positivos,2016-03-01,1,0,0,0,0,1
SANTA CRUZ DE LA SIERRA,"anticoncepcion, prevencion de its y de cancer de cuello uterino",numero de mujeres con resultados de pap positivos,2016-03-01,0,26,157,43,28,254
SHINAOTA,"anticoncepcion, prevencion de its y de cancer de cuello uterino",numero de mujeres con resultados de pap positivos,2016-03-01,0,0,1,2,0,3
SUCRE,"anticoncepcion, prevencion de its y de cancer de cuello uterino",numero de mujeres con resultados de pap positivos,2016-03-01,0,2,12,13,10,37
TARIJA,"anticoncepcion, prevencion de its y de cancer de cuello uterino",numero de mujeres con resultados de pap positivos,2016-03-01,0,0,2,3,3,8
TARVITA,"anticoncepcion, prevencion de its y de cancer de cuello uterino",numero de mujeres con resultados de pap positivos,2016-03-01,0,0,2,2,0,4
TIQUIPAYA,"anticoncepcion, prevencion de its y de cancer de cuello uterino",numero de mujeres con resultados de pap positivos,2016-03-01,0,0,1,1,1,3
TOLATA,"anticoncepcion, prevencion de its y de cancer de cuello uterino",numero de mujeres con resultados de pap positivos,2016-03-01,0,0,1,0,0,1
TRINIDAD,"anticoncepcion, prevencion de its y de cancer de cuello uterino",numero de mujeres con resultados de pap positivos,2016-03-01,0,0,6,6,7,19
TUPIZA,"anticoncepcion, prevencion de its y de cancer de cuello uterino",numero de mujeres con resultados de pap positivos,2016-03-01,0,0,6,7,1,14
VALLEGRANDE,"anticoncepcion, prevencion de its y de cancer de cuello uterino",numero de mujeres con resultados de pap positivos,2016-03-01,0,0,0,2,0,2
VIACHA,"anticoncepcion, prevencion de its y de cancer de cuello uterino",numero de mujeres con resultados de pap positivos,2016-03-01,0,0,6,2,0,8
VINTO,"anticoncepcion, prevencion de its y de cancer de cuello uterino",numero de mujeres con resultados de pap positivos,2016-03-01,0,0,0,1,0,1
AIQUILE,"anticoncepcion, prevencion de its y de cancer de cuello uterino",numero de mujeres con resultados de pap positivos,2016-04-01,0,0,0,0,1,1
ASCENCION DE GUARAYOS,"anticoncepcion, prevencion de its y de cancer de cuello uterino",numero de mujeres con resultados de pap positivos,2016-04-01,0,0,1,0,0,1
CABEZAS,"anticoncepcion, prevencion de its y de cancer de cuello uterino",numero de mujeres con resultados de pap positivos,2016-04-01,0,0,0,0,1,1
"CAIZA ""D""","anticoncepcion, prevencion de its y de cancer de cuello uterino",numero de mujeres con resultados de pap positivos,2016-04-01,0,0,3,1,1,5
CAMARGO,"anticoncepcion, prevencion de its y de cancer de cuello uterino",numero de mujeres con resultados de pap positivos,2016-04-01,0,1,2,1,1,5
CARANAVI,"anticoncepcion, prevencion de its y de cancer de cuello uterino",numero de mujeres con resultados de pap positivos,2016-04-01,0,0,0,0,1,1
CATACORA,"anticoncepcion, prevencion de its y de cancer de cuello uterino",numero de mujeres con resultados de pap positivos,2016-04-01,0,0,1,0,0,1
CHULUMANI (V. DE LA LIBERTAD),"anticoncepcion, prevencion de its y de cancer de cuello uterino",numero de mujeres con resultados de pap positivos,2016-04-01,0,0,1,0,0,1
COBIJA,"anticoncepcion, prevencion de its y de cancer de cuello uterino",numero de mujeres con resultados de pap positivos,2016-04-01,0,0,2,0,0,2
COCHABAMBA,"anticoncepcion, prevencion de its y de cancer de cuello uterino",numero de mujeres con resultados de pap positivos,2016-04-01,0,3,107,82,29,221
CORIPATA,"anticoncepcion, prevencion de its y de cancer de cuello uterino",numero de mujeres con resultados de pap positivos,2016-04-01,0,0,0,1,0,1
EL ALTO,"anticoncepcion, prevencion de its y de cancer de cuello uterino",numero de mujeres con resultados de pap positivos,2016-04-01,0,2,41,32,11,86
EL TORNO,"anticoncepcion, prevencion de its y de cancer de cuello uterino",numero de mujeres con resultados de pap positivos,2016-04-01,0,2,10,6,2,20
ESCARA,"anticoncepcion, prevencion de its y de cancer de cuello uterino",numero de mujeres con resultados de pap positivos,2016-04-01,0,0,1,0,0,1
HUACARETA,"anticoncepcion, prevencion de its y de cancer de cuello uterino",numero de mujeres con resultados de pap positivos,2016-04-01,0,0,1,2,0,3
HUANUNI,"anticoncepcion, prevencion de its y de cancer de cuello uterino",numero de mujeres con resultados de pap positivos,2016-04-01,0,0,1,0,0,1
ICLA,"anticoncepcion, prevencion de its y de cancer de cuello uterino",numero de mujeres con resultados de pap positivos,2016-04-01,0,0,1,1,0,2
LA GUARDIA,"anticoncepcion, prevencion de its y de cancer de cuello uterino",numero de mujeres con resultados de pap positivos,2016-04-01,0,1,5,0,0,6
LA PAZ,"anticoncepcion, prevencion de its y de cancer de cuello uterino",numero de mujeres con resultados de pap positivos,2016-04-01,3,1,57,61,12,134
LURIBAY,"anticoncepcion, prevencion de its y de cancer de cuello uterino",numero de mujeres con resultados de pap positivos,2016-04-01,0,0,1,0,0,1
MAPIRI,"anticoncepcion, prevencion de its y de cancer de cuello uterino",numero de mujeres con resultados de pap positivos,2016-04-01,0,0,0,1,0,1
MINEROS,"anticoncepcion, prevencion de its y de cancer de cuello uterino",numero de mujeres con resultados de pap positivos,2016-04-01,0,1,8,6,1,16
MIZQUE,"anticoncepcion, prevencion de its y de cancer de cuello uterino",numero de mujeres con resultados de pap positivos,2016-04-01,0,0,2,1,0,3
MOJOCOYA,"anticoncepcion, prevencion de its y de cancer de cuello uterino",numero de mujeres con resultados de pap positivos,2016-04-01,0,0,1,0,0,1
MONTEAGUDO,"anticoncepcion, prevencion de its y de cancer de cuello uterino",numero de mujeres con resultados de pap positivos,2016-04-01,0,2,1,2,1,6
ORURO,"anticoncepcion, prevencion de its y de cancer de cuello uterino",numero de mujeres con resultados de pap positivos,2016-04-01,0,0,60,15,6,81
PALOS BLANCOS,"anticoncepcion, prevencion de its y de cancer de cuello uterino",numero de mujeres con resultados de pap positivos,2016-04-01,0,0,0,2,1,3
PATACAMAYA,"anticoncepcion, prevencion de its y de cancer de cuello uterino",numero de mujeres con resultados de pap positivos,2016-04-01,0,0,1,0,2,3
POCONA,"anticoncepcion, prevencion de its y de cancer de cuello uterino",numero de mujeres con resultados de pap positivos,2016-04-01,0,0,1,1,0,2
POROMA,"anticoncepcion, prevencion de its y de cancer de cuello uterino",numero de mujeres con resultados de pap positivos,2016-04-01,0,0,1,0,0,1
PORTACHUELO,"anticoncepcion, prevencion de its y de cancer de cuello uterino",numero de mujeres con resultados de pap positivos,2016-04-01,0,0,1,0,0,1
POTOSI,"anticoncepcion, prevencion de its y de cancer de cuello uterino",numero de mujeres con resultados de pap positivos,2016-04-01,0,0,17,15,0,32
PUERTO GONZALO MORENO,"anticoncepcion, prevencion de its y de cancer de cuello uterino",numero de mujeres con resultados de pap positivos,2016-04-01,0,0,1,2,0,3
PUNATA,"anticoncepcion, prevencion de its y de cancer de cuello uterino",numero de mujeres con resultados de pap positivos,2016-04-01,0,0,1,0,0,1
QUILLACOLLO,"anticoncepcion, prevencion de its y de cancer de cuello uterino",numero de mujeres con resultados de pap positivos,2016-04-01,0,0,6,0,0,6
SACABA,"anticoncepcion, prevencion de its y de cancer de cuello uterino",numero de mujeres con resultados de pap positivos,2016-04-01,0,1,2,1,0,4
SAN BUENA VENTURA,"anticoncepcion, prevencion de its y de cancer de cuello uterino",numero de mujeres con resultados de pap positivos,2016-04-01,0,0,1,1,0,2
SAN JULIAN,"anticoncepcion, prevencion de its y de cancer de cuello uterino",numero de mujeres con resultados de pap positivos,2016-04-01,0,0,2,1,0,3
SANTA CRUZ DE LA SIERRA,"anticoncepcion, prevencion de its y de cancer de cuello uterino",numero de mujeres con resultados de pap positivos,2016-04-01,1,12,84,25,3,125
SHINAOTA,"anticoncepcion, prevencion de its y de cancer de cuello uterino",numero de mujeres con resultados de pap positivos,2016-04-01,0,1,1,0,0,2
SUCRE,"anticoncepcion, prevencion de its y de cancer de cuello uterino",numero de mujeres con resultados de pap positivos,2016-04-01,0,2,18,14,3,37
TARIJA,"anticoncepcion, prevencion de its y de cancer de cuello uterino",numero de mujeres con resultados de pap positivos,2016-04-01,0,0,2,3,1,6
TIAWANACU,"anticoncepcion, prevencion de its y de cancer de cuello uterino",numero de mujeres con resultados de pap positivos,2016-04-01,0,0,0,1,0,1
TIQUIPAYA,"anticoncepcion, prevencion de its y de cancer de cuello uterino",numero de mujeres con resultados de pap positivos,2016-04-01,0,1,2,0,0,3
TOLATA,"anticoncepcion, prevencion de its y de cancer de cuello uterino",numero de mujeres con resultados de pap positivos,2016-04-01,0,0,1,0,0,1
TOMINA,"anticoncepcion, prevencion de its y de cancer de cuello uterino",numero de mujeres con resultados de pap positivos,2016-04-01,0,0,0,1,0,1
TRINIDAD,"anticoncepcion, prevencion de its y de cancer de cuello uterino",numero de mujeres con resultados de pap positivos,2016-04-01,0,2,12,4,0,18
TUPIZA,"anticoncepcion, prevencion de its y de cancer de cuello uterino",numero de mujeres con resultados de pap positivos,2016-04-01,0,0,0,1,0,1
UMALA,"anticoncepcion, prevencion de its y de cancer de cuello uterino",numero de mujeres con resultados de pap positivos,2016-04-01,0,0,1,0,0,1
VALLEGRANDE,"anticoncepcion, prevencion de its y de cancer de cuello uterino",numero de mujeres con resultados de pap positivos,2016-04-01,0,2,1,1,1,5
VIACHA,"anticoncepcion, prevencion de its y de cancer de cuello uterino",numero de mujeres con resultados de pap positivos,2016-04-01,0,0,0,3,2,5
VILLA SERRANO,"anticoncepcion, prevencion de its y de cancer de cuello uterino",numero de mujeres con resultados de pap positivos,2016-04-01,0,0,2,1,3,6
VINTO,"anticoncepcion, prevencion de its y de cancer de cuello uterino",numero de mujeres con resultados de pap positivos,2016-04-01,0,0,0,0,2,2
WARNES,"anticoncepcion, prevencion de its y de cancer de cuello uterino",numero de mujeres con resultados de pap positivos,2016-04-01,0,1,1,0,0,2
AIQUILE,"anticoncepcion, prevencion de its y de cancer de cuello uterino",numero de mujeres con resultados de pap positivos,2016-05-01,0,0,0,2,0,2
ATOCHA,"anticoncepcion, prevencion de its y de cancer de cuello uterino",numero de mujeres con resultados de pap positivos,2016-05-01,0,0,1,1,0,2
BERMEJO,"anticoncepcion, prevencion de its y de cancer de cuello uterino",numero de mujeres con resultados de pap positivos,2016-05-01,0,0,0,1,0,1
CABEZAS,"anticoncepcion, prevencion de its y de cancer de cuello uterino",numero de mujeres con resultados de pap positivos,2016-05-01,0,1,0,1,1,3
CAMARGO,"anticoncepcion, prevencion de its y de cancer de cuello uterino",numero de mujeres con resultados de pap positivos,2016-05-01,0,0,0,1,0,1
CAMATAQUI (C. VILLA ABECIA),"anticoncepcion, prevencion de its y de cancer de cuello uterino",numero de mujeres con resultados de pap positivos,2016-05-01,0,0,1,0,0,1
CHARAGUA,"anticoncepcion, prevencion de its y de cancer de cuello uterino",numero de mujeres con resultados de pap positivos,2016-05-01,0,0,2,0,0,2
CHIMORE,"anticoncepcion, prevencion de its y de cancer de cuello uterino",numero de mujeres con resultados de pap positivos,2016-05-01,0,0,2,0,0,2
CHUQUIHUTA AYLLU JUCUMANI,"anticoncepcion, prevencion de its y de cancer de cuello uterino",numero de mujeres con resultados de pap positivos,2016-05-01,0,0,0,2,0,2
COBIJA,"anticoncepcion, prevencion de its y de cancer de cuello uterino",numero de mujeres con resultados de pap positivos,2016-05-01,0,0,3,0,0,3
COCHABAMBA,"anticoncepcion, prevencion de its y de cancer de cuello uterino",numero de mujeres con resultados de pap positivos,2016-05-01,0,21,167,119,47,354
COLCAPIRHUA,"anticoncepcion, prevencion de its y de cancer de cuello uterino",numero de mujeres con resultados de pap positivos,2016-05-01,0,0,3,3,0,6
COTAGAITA,"anticoncepcion, prevencion de its y de cancer de cuello uterino",numero de mujeres con resultados de pap positivos,2016-05-01,0,0,2,7,3,12
COTOCA,"anticoncepcion, prevencion de its y de cancer de cuello uterino",numero de mujeres con resultados de pap positivos,2016-05-01,0,0,3,0,0,3
CUATRO CAÑADAS,"anticoncepcion, prevencion de its y de cancer de cuello uterino",numero de mujeres con resultados de pap positivos,2016-05-01,0,0,1,0,0,1
EL ALTO,"anticoncepcion, prevencion de its y de cancer de cuello uterino",numero de mujeres con resultados de pap positivos,2016-05-01,0,2,53,25,11,91
EL TORNO,"anticoncepcion, prevencion de its y de cancer de cuello uterino",numero de mujeres con resultados de pap positivos,2016-05-01,0,0,1,0,0,1
ENTRE RIOS TRJ,"anticoncepcion, prevencion de its y de cancer de cuello uterino",numero de mujeres con resultados de pap positivos,2016-05-01,0,1,0,0,0,1
ICLA,"anticoncepcion, prevencion de its y de cancer de cuello uterino",numero de mujeres con resultados de pap positivos,2016-05-01,0,0,0,1,1,2
LA GUARDIA,"anticoncepcion, prevencion de its y de cancer de cuello uterino",numero de mujeres con resultados de pap positivos,2016-05-01,0,0,2,0,0,2
LA PAZ,"anticoncepcion, prevencion de its y de cancer de cuello uterino",numero de mujeres con resultados de pap positivos,2016-05-01,0,8,57,61,18,144
MACHARETI,"anticoncepcion, prevencion de its y de cancer de cuello uterino",numero de mujeres con resultados de pap positivos,2016-05-01,0,0,0,3,0,3
MIZQUE,"anticoncepcion, prevencion de its y de cancer de cuello uterino",numero de mujeres con resultados de pap positivos,2016-05-01,0,0,2,1,2,5
MONTEAGUDO,"anticoncepcion, prevencion de its y de cancer de cuello uterino",numero de mujeres con resultados de pap positivos,2016-05-01,0,0,0,0,1,1
MONTERO,"anticoncepcion, prevencion de its y de cancer de cuello uterino",numero de mujeres con resultados de pap positivos,2016-05-01,0,5,3,5,3,16
OKINAWA,"anticoncepcion, prevencion de its y de cancer de cuello uterino",numero de mujeres con resultados de pap positivos,2016-05-01,0,0,2,2,0,4
ORURO,"anticoncepcion, prevencion de its y de cancer de cuello uterino",numero de mujeres con resultados de pap positivos,2016-05-01,0,0,3,3,0,6
PALOS BLANCOS,"anticoncepcion, prevencion de its y de cancer de cuello uterino",numero de mujeres con resultados de pap positivos,2016-05-01,0,0,2,0,0,2
POJO (CBBA),"anticoncepcion, prevencion de its y de cancer de cuello uterino",numero de mujeres con resultados de pap positivos,2016-05-01,0,0,0,1,0,1
PUERTO GONZALO MORENO,"anticoncepcion, prevencion de its y de cancer de cuello uterino",numero de mujeres con resultados de pap positivos,2016-05-01,0,1,2,2,0,5
PUERTO VILLARROEL,"anticoncepcion, prevencion de its y de cancer de cuello uterino",numero de mujeres con resultados de pap positivos,2016-05-01,0,0,1,0,0,1
QUILLACOLLO,"anticoncepcion, prevencion de its y de cancer de cuello uterino",numero de mujeres con resultados de pap positivos,2016-05-01,0,0,2,3,0,5
RIBERALTA,"anticoncepcion, prevencion de its y de cancer de cuello uterino",numero de mujeres con resultados de pap positivos,2016-05-01,0,0,0,1,0,1
SACABA,"anticoncepcion, prevencion de its y de cancer de cuello uterino",numero de mujeres con resultados de pap positivos,2016-05-01,0,0,2,0,0,2
SAN IGNACIO DE VELASCO,"anticoncepcion, prevencion de its y de cancer de cuello uterino",numero de mujeres con resultados de pap positivos,2016-05-01,0,0,2,1,0,3
SAN JUAN DE YAPACANI,"anticoncepcion, prevencion de its y de cancer de cuello uterino",numero de mujeres con resultados de pap positivos,2016-05-01,0,0,0,1,0,1
SAN JULIAN,"anticoncepcion, prevencion de its y de cancer de cuello uterino",numero de mujeres con resultados de pap positivos,2016-05-01,0,0,1,0,0,1
SAN RAFAEL,"anticoncepcion, prevencion de its y de cancer de cuello uterino",numero de mujeres con resultados de pap positivos,2016-05-01,0,0,0,1,0,1
SAN RAMON SCZ,"anticoncepcion, prevencion de its y de cancer de cuello uterino",numero de mujeres con resultados de pap positivos,2016-05-01,0,1,0,1,1,3
SANTA CRUZ DE LA SIERRA,"anticoncepcion, prevencion de its y de cancer de cuello uterino",numero de mujeres con resultados de pap positivos,2016-05-01,0,9,36,23,6,74
SHINAOTA,"anticoncepcion, prevencion de its y de cancer de cuello uterino",numero de mujeres con resultados de pap positivos,2016-05-01,0,0,1,0,0,1
SOPACHUY,"anticoncepcion, prevencion de its y de cancer de cuello uterino",numero de mujeres con resultados de pap positivos,2016-05-01,0,0,0,1,0,1
SUCRE,"anticoncepcion, prevencion de its y de cancer de cuello uterino",numero de mujeres con resultados de pap positivos,2016-05-01,0,2,23,7,2,34
TARABUCO,"anticoncepcion, prevencion de its y de cancer de cuello uterino",numero de mujeres con resultados de pap positivos,2016-05-01,0,0,0,1,0,1
TARIJA,"anticoncepcion, prevencion de its y de cancer de cuello uterino",numero de mujeres con resultados de pap positivos,2016-05-01,0,0,4,3,0,7
TIQUIPAYA,"anticoncepcion, prevencion de its y de cancer de cuello uterino",numero de mujeres con resultados de pap positivos,2016-05-01,0,0,1,0,0,1
TOTORA(ORR),"anticoncepcion, prevencion de its y de cancer de cuello uterino",numero de mujeres con resultados de pap positivos,2016-05-01,0,0,0,0,1,1
TRINIDAD,"anticoncepcion, prevencion de its y de cancer de cuello uterino",numero de mujeres con resultados de pap positivos,2016-05-01,0,0,5,4,3,12
VIACHA,"anticoncepcion, prevencion de its y de cancer de cuello uterino",numero de mujeres con resultados de pap positivos,2016-05-01,0,1,1,5,1,8
VILLA CHARCAS,"anticoncepcion, prevencion de its y de cancer de cuello uterino",numero de mujeres con resultados de pap positivos,2016-05-01,0,0,0,1,0,1
VILLA MONTES,"anticoncepcion, prevencion de its y de cancer de cuello uterino",numero de mujeres con resultados de pap positivos,2016-05-01,0,0,1,0,0,1
VILLA SERRANO,"anticoncepcion, prevencion de its y de cancer de cuello uterino",numero de mujeres con resultados de pap positivos,2016-05-01,0,0,0,1,0,1
VILLA TUNARI,"anticoncepcion, prevencion de its y de cancer de cuello uterino",numero de mujeres con resultados de pap positivos,2016-05-01,0,0,1,0,0,1
WARNES,"anticoncepcion, prevencion de its y de cancer de cuello uterino",numero de mujeres con resultados de pap positivos,2016-05-01,0,0,3,0,0,3
YAMPARAEZ,"anticoncepcion, prevencion de its y de cancer de cuello uterino",numero de mujeres con resultados de pap positivos,2016-05-01,0,0,1,0,0,1
ACHACACHI,"anticoncepcion, prevencion de its y de cancer de cuello uterino",numero de mujeres con resultados de pap positivos,2016-06-01,0,0,1,0,0,1
ACHOCALLA,"anticoncepcion, prevencion de its y de cancer de cuello uterino",numero de mujeres con resultados de pap positivos,2016-06-01,0,0,0,1,0,1
ALCALA,"anticoncepcion, prevencion de its y de cancer de cuello uterino",numero de mujeres con resultados de pap positivos,2016-06-01,0,0,0,1,0,1
BERMEJO,"anticoncepcion, prevencion de its y de cancer de cuello uterino",numero de mujeres con resultados de pap positivos,2016-06-01,0,0,1,1,0,2
CAMARGO,"anticoncepcion, prevencion de its y de cancer de cuello uterino",numero de mujeres con resultados de pap positivos,2016-06-01,0,0,0,1,1,2
CARANAVI,"anticoncepcion, prevencion de its y de cancer de cuello uterino",numero de mujeres con resultados de pap positivos,2016-06-01,0,0,0,0,2,2
CHALLAPATA,"anticoncepcion, prevencion de its y de cancer de cuello uterino",numero de mujeres con resultados de pap positivos,2016-06-01,0,0,1,1,0,2
CHULUMANI (V. DE LA LIBERTAD),"anticoncepcion, prevencion de its y de cancer de cuello uterino",numero de mujeres con resultados de pap positivos,2016-06-01,0,0,2,4,0,6
COBIJA,"anticoncepcion, prevencion de its y de cancer de cuello uterino",numero de mujeres con resultados de pap positivos,2016-06-01,0,0,1,2,0,3
COCHABAMBA,"anticoncepcion, prevencion de its y de cancer de cuello uterino",numero de mujeres con resultados de pap positivos,2016-06-01,0,6,94,36,21,157
COLCAPIRHUA,"anticoncepcion, prevencion de its y de cancer de cuello uterino",numero de mujeres con resultados de pap positivos,2016-06-01,0,0,0,1,2,3
CORIPATA,"anticoncepcion, prevencion de its y de cancer de cuello uterino",numero de mujeres con resultados de pap positivos,2016-06-01,0,0,0,1,0,1
CUATRO CAÑADAS,"anticoncepcion, prevencion de its y de cancer de cuello uterino",numero de mujeres con resultados de pap positivos,2016-06-01,0,1,3,2,3,9
CULPINA,"anticoncepcion, prevencion de its y de cancer de cuello uterino",numero de mujeres con resultados de pap positivos,2016-06-01,0,1,0,0,0,1
EL ALTO,"anticoncepcion, prevencion de its y de cancer de cuello uterino",numero de mujeres con resultados de pap positivos,2016-06-01,0,1,26,51,13,91
EL PUENTE(TJA),"anticoncepcion, prevencion de its y de cancer de cuello uterino",numero de mujeres con resultados de pap positivos,2016-06-01,0,0,0,1,0,1
EL TORNO,"anticoncepcion, prevencion de its y de cancer de cuello uterino",numero de mujeres con resultados de pap positivos,2016-06-01,0,1,4,2,0,7
GUTIERREZ,"anticoncepcion, prevencion de its y de cancer de cuello uterino",numero de mujeres con resultados de pap positivos,2016-06-01,0,0,2,0,0,2
HUACARETA,"anticoncepcion, prevencion de its y de cancer de cuello uterino",numero de mujeres con resultados de pap positivos,2016-06-01,0,0,1,0,0,1
ICLA,"anticoncepcion, prevencion de its y de cancer de cuello uterino",numero de mujeres con resultados de pap positivos,2016-06-01,0,0,0,1,0,1
IXIAMAS,"anticoncepcion, prevencion de its y de cancer de cuello uterino",numero de mujeres con resultados de pap positivos,2016-06-01,0,0,2,3,0,5
LA GUARDIA,"anticoncepcion, prevencion de its y de cancer de cuello uterino",numero de mujeres con resultados de pap positivos,2016-06-01,0,0,21,6,5,32
LA PAZ,"anticoncepcion, prevencion de its y de cancer de cuello uterino",numero de mujeres con resultados de pap positivos,2016-06-01,0,0,26,56,9,91
MAPIRI,"anticoncepcion, prevencion de its y de cancer de cuello uterino",numero de mujeres con resultados de pap positivos,2016-06-01,0,0,0,1,0,1
MOJOCOYA,"anticoncepcion, prevencion de its y de cancer de cuello uterino",numero de mujeres con resultados de pap positivos,2016-06-01,0,0,0,1,0,1
MONTERO,"anticoncepcion, prevencion de its y de cancer de cuello uterino",numero de mujeres con resultados de pap positivos,2016-06-01,0,0,1,2,1,4
ORURO,"anticoncepcion, prevencion de its y de cancer de cuello uterino",numero de mujeres con resultados de pap positivos,2016-06-01,0,0,3,1,0,4
PADILLA,"anticoncepcion, prevencion de its y de cancer de cuello uterino",numero de mujeres con resultados de pap positivos,2016-06-01,0,0,9,0,0,9
PALOS BLANCOS,"anticoncepcion, prevencion de its y de cancer de cuello uterino",numero de mujeres con resultados de pap positivos,2016-06-01,0,0,1,0,0,1
POCONA,"anticoncepcion, prevencion de its y de cancer de cuello uterino",numero de mujeres con resultados de pap positivos,2016-06-01,0,0,0,6,8,14
POROMA,"anticoncepcion, prevencion de its y de cancer de cuello uterino",numero de mujeres con resultados de pap positivos,2016-06-01,0,1,0,0,0,1
PORTACHUELO,"anticoncepcion, prevencion de its y de cancer de cuello uterino",numero de mujeres con resultados de pap positivos,2016-06-01,0,0,1,1,0,2
POTOSI,"anticoncepcion, prevencion de its y de cancer de cuello uterino",numero de mujeres con resultados de pap positivos,2016-06-01,0,0,0,5,0,5
PRESTO,"anticoncepcion, prevencion de its y de cancer de cuello uterino",numero de mujeres con resultados de pap positivos,2016-06-01,0,0,0,2,0,2
PUERTO GONZALO MORENO,"anticoncepcion, prevencion de its y de cancer de cuello uterino",numero de mujeres con resultados de pap positivos,2016-06-01,0,1,0,1,0,2
QUILLACOLLO,"anticoncepcion, prevencion de its y de cancer de cuello uterino",numero de mujeres con resultados de pap positivos,2016-06-01,0,0,1,0,0,1
SACABA,"anticoncepcion, prevencion de its y de cancer de cuello uterino",numero de mujeres con resultados de pap positivos,2016-06-01,0,0,4,3,2,9
SAN BUENA VENTURA,"anticoncepcion, prevencion de its y de cancer de cuello uterino",numero de mujeres con resultados de pap positivos,2016-06-01,0,0,2,1,0,3
SAN IGNACIO,"anticoncepcion, prevencion de its y de cancer de cuello uterino",numero de mujeres con resultados de pap positivos,2016-06-01,0,0,3,4,3,10
SAN IGNACIO DE VELASCO,"anticoncepcion, prevencion de its y de cancer de cuello uterino",numero de mujeres con resultados de pap positivos,2016-06-01,0,0,2,2,2,6
SAN LUCAS,"anticoncepcion, prevencion de its y de cancer de cuello uterino",numero de mujeres con resultados de pap positivos,2016-06-01,0,0,1,0,0,1
SANTA CRUZ DE LA SIERRA,"anticoncepcion, prevencion de its y de cancer de cuello uterino",numero de mujeres con resultados de pap positivos,2016-06-01,0,4,33,27,18,82
SOPACHUY,"anticoncepcion, prevencion de its y de cancer de cuello uterino",numero de mujeres con resultados de pap positivos,2016-06-01,0,0,0,1,0,1
SUCRE,"anticoncepcion, prevencion de its y de cancer de cuello uterino",numero de mujeres con resultados de pap positivos,2016-06-01,0,4,14,8,2,28
TARABUCO,"anticoncepcion, prevencion de its y de cancer de cuello uterino",numero de mujeres con resultados de pap positivos,2016-06-01,0,0,1,1,0,2
TARIJA,"anticoncepcion, prevencion de its y de cancer de cuello uterino",numero de mujeres con resultados de pap positivos,2016-06-01,0,0,0,2,0,2
TINGUIPAYA,"anticoncepcion, prevencion de its y de cancer de cuello uterino",numero de mujeres con resultados de pap positivos,2016-06-01,0,0,9,9,0,18
TIQUIPAYA,"anticoncepcion, prevencion de its y de cancer de cuello uterino",numero de mujeres con resultados de pap positivos,2016-06-01,0,0,3,0,0,3
TIRAQUE (CBBA),"anticoncepcion, prevencion de its y de cancer de cuello uterino",numero de mujeres con resultados de pap positivos,2016-06-01,0,1,0,0,0,1
TOMINA,"anticoncepcion, prevencion de its y de cancer de cuello uterino",numero de mujeres con resultados de pap positivos,2016-06-01,0,0,3,0,0,3
TRINIDAD,"anticoncepcion, prevencion de its y de cancer de cuello uterino",numero de mujeres con resultados de pap positivos,2016-06-01,0,6,29,6,2,43
TUPIZA,"anticoncepcion, prevencion de its y de cancer de cuello uterino",numero de mujeres con resultados de pap positivos,2016-06-01,0,2,1,1,0,4
VIACHA,"anticoncepcion, prevencion de its y de cancer de cuello uterino",numero de mujeres con resultados de pap positivos,2016-06-01,0,0,0,2,0,2
VILLA CHARCAS,"anticoncepcion, prevencion de its y de cancer de cuello uterino",numero de mujeres con resultados de pap positivos,2016-06-01,0,0,0,1,0,1
VILLA MONTES,"anticoncepcion, prevencion de its y de cancer de cuello uterino",numero de mujeres con resultados de pap positivos,2016-06-01,0,0,2,0,0,2
VILLA VACA GUZMAN (MUYUPAMPA),"anticoncepcion, prevencion de its y de cancer de cuello uterino",numero de mujeres con resultados de pap positivos,2016-06-01,0,0,0,1,0,1
WARNES,"anticoncepcion, prevencion de its y de cancer de cuello uterino",numero de mujeres con resultados de pap positivos,2016-06-01,0,0,1,4,0,5
YACUIBA,"anticoncepcion, prevencion de its y de cancer de cuello uterino",numero de mujeres con resultados de pap positivos,2016-06-01,0,1,3,2,1,7
YAPACANI,"anticoncepcion, prevencion de its y de cancer de cuello uterino",numero de mujeres con resultados de pap positivos,2016-06-01,0,0,1,0,2,3
ACHACACHI,"anticoncepcion, prevencion de its y de cancer de cuello uterino",numero de mujeres con resultados de pap positivos,2016-07-01,0,0,1,0,0,1
BOLIVAR,"anticoncepcion, prevencion de its y de cancer de cuello uterino",numero de mujeres con resultados de pap positivos,2016-07-01,0,0,1,0,0,1
BUENA VISTA,"anticoncepcion, prevencion de its y de cancer de cuello uterino",numero de mujeres con resultados de pap positivos,2016-07-01,0,0,1,0,0,1
CABEZAS,"anticoncepcion, prevencion de its y de cancer de cuello uterino",numero de mujeres con resultados de pap positivos,2016-07-01,0,0,1,0,0,1
CAMIRI,"anticoncepcion, prevencion de its y de cancer de cuello uterino",numero de mujeres con resultados de pap positivos,2016-07-01,0,0,1,0,0,1
CARANAVI,"anticoncepcion, prevencion de its y de cancer de cuello uterino",numero de mujeres con resultados de pap positivos,2016-07-01,0,0,3,2,3,8
CHALLAPATA,"anticoncepcion, prevencion de its y de cancer de cuello uterino",numero de mujeres con resultados de pap positivos,2016-07-01,0,0,1,1,0,2
CHULUMANI (V. DE LA LIBERTAD),"anticoncepcion, prevencion de its y de cancer de cuello uterino",numero de mujeres con resultados de pap positivos,2016-07-01,0,0,0,0,1,1
COCHABAMBA,"anticoncepcion, prevencion de its y de cancer de cuello uterino",numero de mujeres con resultados de pap positivos,2016-07-01,0,15,169,48,19,251
COLCAPIRHUA,"anticoncepcion, prevencion de its y de cancer de cuello uterino",numero de mujeres con resultados de pap positivos,2016-07-01,0,0,0,0,1,1
COMARAPA,"anticoncepcion, prevencion de its y de cancer de cuello uterino",numero de mujeres con resultados de pap positivos,2016-07-01,0,0,1,1,2,4
CONCEPCION,"anticoncepcion, prevencion de its y de cancer de cuello uterino",numero de mujeres con resultados de pap positivos,2016-07-01,0,0,1,0,0,1
CORIPATA,"anticoncepcion, prevencion de its y de cancer de cuello uterino",numero de mujeres con resultados de pap positivos,2016-07-01,0,0,0,1,0,1
COROICO,"anticoncepcion, prevencion de its y de cancer de cuello uterino",numero de mujeres con resultados de pap positivos,2016-07-01,0,0,1,0,0,1
CULPINA,"anticoncepcion, prevencion de its y de cancer de cuello uterino",numero de mujeres con resultados de pap positivos,2016-07-01,0,0,1,0,0,1
EL ALTO,"anticoncepcion, prevencion de its y de cancer de cuello uterino",numero de mujeres con resultados de pap positivos,2016-07-01,0,3,42,31,17,93
EL PUENTE(STC),"anticoncepcion, prevencion de its y de cancer de cuello uterino",numero de mujeres con resultados de pap positivos,2016-07-01,0,1,0,0,1,2
EL TORNO,"anticoncepcion, prevencion de its y de cancer de cuello uterino",numero de mujeres con resultados de pap positivos,2016-07-01,0,2,2,3,5,12
HUANUNI,"anticoncepcion, prevencion de its y de cancer de cuello uterino",numero de mujeres con resultados de pap positivos,2016-07-01,0,1,1,2,1,5
ICLA,"anticoncepcion, prevencion de its y de cancer de cuello uterino",numero de mujeres con resultados de pap positivos,2016-07-01,0,0,0,0,1,1
LA GUARDIA,"anticoncepcion, prevencion de its y de cancer de cuello uterino",numero de mujeres con resultados de pap positivos,2016-07-01,0,2,3,1,3,9
LA PAZ,"anticoncepcion, prevencion de its y de cancer de cuello uterino",numero de mujeres con resultados de pap positivos,2016-07-01,0,4,21,24,8,57
MAPIRI,"anticoncepcion, prevencion de its y de cancer de cuello uterino",numero de mujeres con resultados de pap positivos,2016-07-01,0,0,0,1,0,1
MONTEAGUDO,"anticoncepcion, prevencion de its y de cancer de cuello uterino",numero de mujeres con resultados de pap positivos,2016-07-01,0,1,3,2,3,9
MONTERO,"anticoncepcion, prevencion de its y de cancer de cuello uterino",numero de mujeres con resultados de pap positivos,2016-07-01,0,0,0,1,0,1
OCURI,"anticoncepcion, prevencion de its y de cancer de cuello uterino",numero de mujeres con resultados de pap positivos,2016-07-01,0,0,0,1,0,1
PADILLA,"anticoncepcion, prevencion de its y de cancer de cuello uterino",numero de mujeres con resultados de pap positivos,2016-07-01,0,0,0,1,0,1
PAILON,"anticoncepcion, prevencion de its y de cancer de cuello uterino",numero de mujeres con resultados de pap positivos,2016-07-01,0,0,0,2,0,2
PALCA,"anticoncepcion, prevencion de its y de cancer de cuello uterino",numero de mujeres con resultados de pap positivos,2016-07-01,0,0,2,1,1,4
POJO (CBBA),"anticoncepcion, prevencion de its y de cancer de cuello uterino",numero de mujeres con resultados de pap positivos,2016-07-01,0,0,5,1,0,6
PORTACHUELO,"anticoncepcion, prevencion de its y de cancer de cuello uterino",numero de mujeres con resultados de pap positivos,2016-07-01,0,0,1,0,0,1
PORVENIR,"anticoncepcion, prevencion de its y de cancer de cuello uterino",numero de mujeres con resultados de pap positivos,2016-07-01,0,0,4,3,4,11
POTOSI,"anticoncepcion, prevencion de its y de cancer de cuello uterino",numero de mujeres con resultados de pap positivos,2016-07-01,0,0,1,0,0,1
PUERTO GONZALO MORENO,"anticoncepcion, prevencion de its y de cancer de cuello uterino",numero de mujeres con resultados de pap positivos,2016-07-01,0,1,0,1,0,2
PUERTO RICO,"anticoncepcion, prevencion de its y de cancer de cuello uterino",numero de mujeres con resultados de pap positivos,2016-07-01,0,0,3,3,0,6
PUNA,"anticoncepcion, prevencion de its y de cancer de cuello uterino",numero de mujeres con resultados de pap positivos,2016-07-01,0,2,12,3,1,18
QUILLACOLLO,"anticoncepcion, prevencion de its y de cancer de cuello uterino",numero de mujeres con resultados de pap positivos,2016-07-01,0,0,25,12,4,41
RIBERALTA,"anticoncepcion, prevencion de its y de cancer de cuello uterino",numero de mujeres con resultados de pap positivos,2016-07-01,0,0,2,3,0,5
RURRENABAQUE,"anticoncepcion, prevencion de its y de cancer de cuello uterino",numero de mujeres con resultados de pap positivos,2016-07-01,0,0,1,2,0,3
SACABA,"anticoncepcion, prevencion de its y de cancer de cuello uterino",numero de mujeres con resultados de pap positivos,2016-07-01,0,0,7,3,0,10
SAN CARLOS,"anticoncepcion, prevencion de its y de cancer de cuello uterino",numero de mujeres con resultados de pap positivos,2016-07-01,0,1,1,0,0,2
SAN IGNACIO,"anticoncepcion, prevencion de its y de cancer de cuello uterino",numero de mujeres con resultados de pap positivos,2016-07-01,0,0,8,7,1,16
SAN JOSE DE CHIQUITOS,"anticoncepcion, prevencion de its y de cancer de cuello uterino",numero de mujeres con resultados de pap positivos,2016-07-01,0,0,2,6,0,8
SAN JULIAN,"anticoncepcion, prevencion de its y de cancer de cuello uterino",numero de mujeres con resultados de pap positivos,2016-07-01,0,0,0,1,0,1
SAN LUCAS,"anticoncepcion, prevencion de its y de cancer de cuello uterino",numero de mujeres con resultados de pap positivos,2016-07-01,0,0,0,0,1,1
SANTA CRUZ DE LA SIERRA,"anticoncepcion, prevencion de its y de cancer de cuello uterino",numero de mujeres con resultados de pap positivos,2016-07-01,0,16,43,44,28,131
SANTA ROSA DEL SARA,"anticoncepcion, prevencion de its y de cancer de cuello uterino",numero de mujeres con resultados de pap positivos,2016-07-01,0,0,1,0,0,1
SHINAOTA,"anticoncepcion, prevencion de its y de cancer de cuello uterino",numero de mujeres con resultados de pap positivos,2016-07-01,0,0,1,0,0,1
SUCRE,"anticoncepcion, prevencion de its y de cancer de cuello uterino",numero de mujeres con resultados de pap positivos,2016-07-01,0,2,15,7,1,25
TARABUCO,"anticoncepcion, prevencion de its y de cancer de cuello uterino",numero de mujeres con resultados de pap positivos,2016-07-01,0,0,1,0,0,1
TARIJA,"anticoncepcion, prevencion de its y de cancer de cuello uterino",numero de mujeres con resultados de pap positivos,2016-07-01,0,1,1,2,2,6
TIQUIPAYA,"anticoncepcion, prevencion de its y de cancer de cuello uterino",numero de mujeres con resultados de pap positivos,2016-07-01,0,0,1,0,0,1
TOLATA,"anticoncepcion, prevencion de its y de cancer de cuello uterino",numero de mujeres con resultados de pap positivos,2016-07-01,0,0,1,0,0,1
TRINIDAD,"anticoncepcion, prevencion de its y de cancer de cuello uterino",numero de mujeres con resultados de pap positivos,2016-07-01,0,1,4,2,2,9
TUPIZA,"anticoncepcion, prevencion de its y de cancer de cuello uterino",numero de mujeres con resultados de pap positivos,2016-07-01,0,0,5,2,0,7
VALLEGRANDE,"anticoncepcion, prevencion de its y de cancer de cuello uterino",numero de mujeres con resultados de pap positivos,2016-07-01,0,1,1,1,0,3
VIACHA,"anticoncepcion, prevencion de its y de cancer de cuello uterino",numero de mujeres con resultados de pap positivos,2016-07-01,0,0,9,7,2,18
VILLA CHARCAS,"anticoncepcion, prevencion de its y de cancer de cuello uterino",numero de mujeres con resultados de pap positivos,2016-07-01,0,0,1,1,0,2
VILLA MONTES,"anticoncepcion, prevencion de its y de cancer de cuello uterino",numero de mujeres con resultados de pap positivos,2016-07-01,0,0,2,0,0,2
VILLA SERRANO,"anticoncepcion, prevencion de its y de cancer de cuello uterino",numero de mujeres con resultados de pap positivos,2016-07-01,0,0,0,2,0,2
WARNES,"anticoncepcion, prevencion de its y de cancer de cuello uterino",numero de mujeres con resultados de pap positivos,2016-07-01,0,0,0,1,0,1
YACUIBA,"anticoncepcion, prevencion de its y de cancer de cuello uterino",numero de mujeres con resultados de pap positivos,2016-07-01,0,0,0,3,0,3
YAPACANI,"anticoncepcion, prevencion de its y de cancer de cuello uterino",numero de mujeres con resultados de pap positivos,2016-07-01,0,1,3,0,0,4
ZUDAÑEZ,"anticoncepcion, prevencion de its y de cancer de cuello uterino",numero de mujeres con resultados de pap positivos,2016-07-01,0,0,1,0,0,1
ACHACACHI,"anticoncepcion, prevencion de its y de cancer de cuello uterino",numero de mujeres con resultados de pap positivos,2016-08-01,0,0,0,1,0,1
BUENA VISTA,"anticoncepcion, prevencion de its y de cancer de cuello uterino",numero de mujeres con resultados de pap positivos,2016-08-01,0,0,0,3,0,3
CABEZAS,"anticoncepcion, prevencion de its y de cancer de cuello uterino",numero de mujeres con resultados de pap positivos,2016-08-01,0,1,1,0,0,2
CAMIRI,"anticoncepcion, prevencion de its y de cancer de cuello uterino",numero de mujeres con resultados de pap positivos,2016-08-01,0,0,1,0,0,1
CARANAVI,"anticoncepcion, prevencion de its y de cancer de cuello uterino",numero de mujeres con resultados de pap positivos,2016-08-01,0,0,2,0,0,2
CHALLAPATA,"anticoncepcion, prevencion de its y de cancer de cuello uterino",numero de mujeres con resultados de pap positivos,2016-08-01,0,0,1,0,0,1
CHARAGUA,"anticoncepcion, prevencion de its y de cancer de cuello uterino",numero de mujeres con resultados de pap positivos,2016-08-01,0,0,0,1,0,1
CHIMORE,"anticoncepcion, prevencion de its y de cancer de cuello uterino",numero de mujeres con resultados de pap positivos,2016-08-01,0,0,2,0,0,2
COCHABAMBA,"anticoncepcion, prevencion de its y de cancer de cuello uterino",numero de mujeres con resultados de pap positivos,2016-08-01,0,5,60,41,17,123
COLCAPIRHUA,"anticoncepcion, prevencion de its y de cancer de cuello uterino",numero de mujeres con resultados de pap positivos,2016-08-01,0,0,0,2,1,3
COROICO,"anticoncepcion, prevencion de its y de cancer de cuello uterino",numero de mujeres con resultados de pap positivos,2016-08-01,0,0,1,1,0,2
CULPINA,"anticoncepcion, prevencion de its y de cancer de cuello uterino",numero de mujeres con resultados de pap positivos,2016-08-01,0,0,1,1,0,2
EL ALTO,"anticoncepcion, prevencion de its y de cancer de cuello uterino",numero de mujeres con resultados de pap positivos,2016-08-01,0,2,40,26,6,74
EL TORNO,"anticoncepcion, prevencion de its y de cancer de cuello uterino",numero de mujeres con resultados de pap positivos,2016-08-01,0,2,3,1,2,8
FERNANDEZ ALONSO,"anticoncepcion, prevencion de its y de cancer de cuello uterino",numero de mujeres con resultados de pap positivos,2016-08-01,0,0,0,2,0,2
GUTIERREZ,"anticoncepcion, prevencion de its y de cancer de cuello uterino",numero de mujeres con resultados de pap positivos,2016-08-01,0,0,0,2,0,2
HUANUNI,"anticoncepcion, prevencion de its y de cancer de cuello uterino",numero de mujeres con resultados de pap positivos,2016-08-01,0,0,0,1,0,1
INCAHUASI,"anticoncepcion, prevencion de its y de cancer de cuello uterino",numero de mujeres con resultados de pap positivos,2016-08-01,0,0,1,0,0,1
LA ASUNTA,"anticoncepcion, prevencion de its y de cancer de cuello uterino",numero de mujeres con resultados de pap positivos,2016-08-01,0,0,1,1,0,2
LA GUARDIA,"anticoncepcion, prevencion de its y de cancer de cuello uterino",numero de mujeres con resultados de pap positivos,2016-08-01,0,1,1,0,0,2
LA PAZ,"anticoncepcion, prevencion de its y de cancer de cuello uterino",numero de mujeres con resultados de pap positivos,2016-08-01,0,0,17,27,6,50
LAJA,"anticoncepcion, prevencion de its y de cancer de cuello uterino",numero de mujeres con resultados de pap positivos,2016-08-01,0,0,0,0,1,1
LURIBAY,"anticoncepcion, prevencion de its y de cancer de cuello uterino",numero de mujeres con resultados de pap positivos,2016-08-01,0,0,2,1,1,4
MAGDALENA,"anticoncepcion, prevencion de its y de cancer de cuello uterino",numero de mujeres con resultados de pap positivos,2016-08-01,0,2,42,34,19,97
MAPIRI,"anticoncepcion, prevencion de its y de cancer de cuello uterino",numero de mujeres con resultados de pap positivos,2016-08-01,0,0,2,1,0,3
MECAPACA,"anticoncepcion, prevencion de its y de cancer de cuello uterino",numero de mujeres con resultados de pap positivos,2016-08-01,0,0,0,1,0,1
MINEROS,"anticoncepcion, prevencion de its y de cancer de cuello uterino",numero de mujeres con resultados de pap positivos,2016-08-01,0,0,2,0,1,3
MONTEAGUDO,"anticoncepcion, prevencion de its y de cancer de cuello uterino",numero de mujeres con resultados de pap positivos,2016-08-01,0,0,1,2,1,4
OCURI,"anticoncepcion, prevencion de its y de cancer de cuello uterino",numero de mujeres con resultados de pap positivos,2016-08-01,0,0,0,1,0,1
ORURO,"anticoncepcion, prevencion de its y de cancer de cuello uterino",numero de mujeres con resultados de pap positivos,2016-08-01,0,0,4,0,0,4
PADILLA,"anticoncepcion, prevencion de its y de cancer de cuello uterino",numero de mujeres con resultados de pap positivos,2016-08-01,0,0,4,2,1,7
POCOATA,"anticoncepcion, prevencion de its y de cancer de cuello uterino",numero de mujeres con resultados de pap positivos,2016-08-01,0,0,1,0,0,1
PORVENIR,"anticoncepcion, prevencion de its y de cancer de cuello uterino",numero de mujeres con resultados de pap positivos,2016-08-01,0,0,1,0,0,1
POTOSI,"anticoncepcion, prevencion de its y de cancer de cuello uterino",numero de mujeres con resultados de pap positivos,2016-08-01,0,0,7,6,1,14
PRESTO,"anticoncepcion, prevencion de its y de cancer de cuello uterino",numero de mujeres con resultados de pap positivos,2016-08-01,0,0,2,2,0,4
PUCARA,"anticoncepcion, prevencion de its y de cancer de cuello uterino",numero de mujeres con resultados de pap positivos,2016-08-01,0,0,0,2,0,2
PUERTO GONZALO MORENO,"anticoncepcion, prevencion de its y de cancer de cuello uterino",numero de mujeres con resultados de pap positivos,2016-08-01,0,0,1,1,1,3
PUNATA,"anticoncepcion, prevencion de its y de cancer de cuello uterino",numero de mujeres con resultados de pap positivos,2016-08-01,0,0,1,0,0,1
QUIME,"anticoncepcion, prevencion de its y de cancer de cuello uterino",numero de mujeres con resultados de pap positivos,2016-08-01,0,0,1,0,0,1
RIBERALTA,"anticoncepcion, prevencion de its y de cancer de cuello uterino",numero de mujeres con resultados de pap positivos,2016-08-01,0,0,2,0,1,3
RURRENABAQUE,"anticoncepcion, prevencion de its y de cancer de cuello uterino",numero de mujeres con resultados de pap positivos,2016-08-01,0,1,1,0,0,2
SACABA,"anticoncepcion, prevencion de its y de cancer de cuello uterino",numero de mujeres con resultados de pap positivos,2016-08-01,0,1,5,1,0,7
SAN ANDRES DE MACHACA,"anticoncepcion, prevencion de its y de cancer de cuello uterino",numero de mujeres con resultados de pap positivos,2016-08-01,0,0,0,0,1,1
SAN CARLOS,"anticoncepcion, prevencion de its y de cancer de cuello uterino",numero de mujeres con resultados de pap positivos,2016-08-01,0,1,1,0,0,2
SAN IGNACIO,"anticoncepcion, prevencion de its y de cancer de cuello uterino",numero de mujeres con resultados de pap positivos,2016-08-01,0,0,6,7,0,13
SAN IGNACIO DE VELASCO,"anticoncepcion, prevencion de its y de cancer de cuello uterino",numero de mujeres con resultados de pap positivos,2016-08-01,0,0,1,0,0,1
SAN RAFAEL,"anticoncepcion, prevencion de its y de cancer de cuello uterino",numero de mujeres con resultados de pap positivos,2016-08-01,0,1,0,0,0,1
SAN RAMON SCZ,"anticoncepcion, prevencion de its y de cancer de cuello uterino",numero de mujeres con resultados de pap positivos,2016-08-01,0,1,2,0,0,3
SANTA CRUZ DE LA SIERRA,"anticoncepcion, prevencion de its y de cancer de cuello uterino",numero de mujeres con resultados de pap positivos,2016-08-01,1,4,41,36,22,104
SANTIAGO DE MACHACA,"anticoncepcion, prevencion de its y de cancer de cuello uterino",numero de mujeres con resultados de pap positivos,2016-08-01,0,1,1,0,0,2
SENA,"anticoncepcion, prevencion de its y de cancer de cuello uterino",numero de mujeres con resultados de pap positivos,2016-08-01,0,0,1,1,1,3
SHINAOTA,"anticoncepcion, prevencion de its y de cancer de cuello uterino",numero de mujeres con resultados de pap positivos,2016-08-01,0,0,1,0,0,1
SOPACHUY,"anticoncepcion, prevencion de its y de cancer de cuello uterino",numero de mujeres con resultados de pap positivos,2016-08-01,0,0,0,2,0,2
SUCRE,"anticoncepcion, prevencion de its y de cancer de cuello uterino",numero de mujeres con resultados de pap positivos,2016-08-01,0,0,11,8,5,24
TARABUCO,"anticoncepcion, prevencion de its y de cancer de cuello uterino",numero de mujeres con resultados de pap positivos,2016-08-01,0,0,0,2,1,3
TARIJA,"anticoncepcion, prevencion de its y de cancer de cuello uterino",numero de mujeres con resultados de pap positivos,2016-08-01,0,1,17,14,2,34
TARVITA,"anticoncepcion, prevencion de its y de cancer de cuello uterino",numero de mujeres con resultados de pap positivos,2016-08-01,0,0,0,0,1,1
TIQUIPAYA,"anticoncepcion, prevencion de its y de cancer de cuello uterino",numero de mujeres con resultados de pap positivos,2016-08-01,0,1,4,2,1,8
TIRAQUE (CBBA),"anticoncepcion, prevencion de its y de cancer de cuello uterino",numero de mujeres con resultados de pap positivos,2016-08-01,0,0,1,0,0,1
TOMINA,"anticoncepcion, prevencion de its y de cancer de cuello uterino",numero de mujeres con resultados de pap positivos,2016-08-01,0,0,1,0,0,1
TRINIDAD,"anticoncepcion, prevencion de its y de cancer de cuello uterino",numero de mujeres con resultados de pap positivos,2016-08-01,1,0,5,4,4,14
TUPIZA,"anticoncepcion, prevencion de its y de cancer de cuello uterino",numero de mujeres con resultados de pap positivos,2016-08-01,0,0,1,0,1,2
VALLEGRANDE,"anticoncepcion, prevencion de its y de cancer de cuello uterino",numero de mujeres con resultados de pap positivos,2016-08-01,0,0,0,2,0,2
VIACHA,"anticoncepcion, prevencion de its y de cancer de cuello uterino",numero de mujeres con resultados de pap positivos,2016-08-01,0,0,4,3,0,7
VILLA MONTES,"anticoncepcion, prevencion de its y de cancer de cuello uterino",numero de mujeres con resultados de pap positivos,2016-08-01,0,0,4,7,0,11
VILLA SERRANO,"anticoncepcion, prevencion de its y de cancer de cuello uterino",numero de mujeres con resultados de pap positivos,2016-08-01,0,0,1,0,0,1
VILLA TUNARI,"anticoncepcion, prevencion de its y de cancer de cuello uterino",numero de mujeres con resultados de pap positivos,2016-08-01,0,1,0,0,0,1
VILLAZON,"anticoncepcion, prevencion de its y de cancer de cuello uterino",numero de mujeres con resultados de pap positivos,2016-08-01,0,0,1,0,0,1
YACUIBA,"anticoncepcion, prevencion de its y de cancer de cuello uterino",numero de mujeres con resultados de pap positivos,2016-08-01,0,7,7,49,1,64
YAMPARAEZ,"anticoncepcion, prevencion de its y de cancer de cuello uterino",numero de mujeres con resultados de pap positivos,2016-08-01,0,0,0,0,1,1
YAPACANI,"anticoncepcion, prevencion de its y de cancer de cuello uterino",numero de mujeres con resultados de pap positivos,2016-08-01,0,0,6,2,1,9
YOTALA,"anticoncepcion, prevencion de its y de cancer de cuello uterino",numero de mujeres con resultados de pap positivos,2016-08-01,0,0,0,0,1,1
ACHACACHI,"anticoncepcion, prevencion de its y de cancer de cuello uterino",numero de mujeres con resultados de pap positivos,2016-09-01,0,1,0,1,0,2
BERMEJO,"anticoncepcion, prevencion de its y de cancer de cuello uterino",numero de mujeres con resultados de pap positivos,2016-09-01,0,0,2,0,0,2
CABEZAS,"anticoncepcion, prevencion de its y de cancer de cuello uterino",numero de mujeres con resultados de pap positivos,2016-09-01,0,0,1,0,0,1
CARANAVI,"anticoncepcion, prevencion de its y de cancer de cuello uterino",numero de mujeres con resultados de pap positivos,2016-09-01,0,0,4,4,0,8
CHALLAPATA,"anticoncepcion, prevencion de its y de cancer de cuello uterino",numero de mujeres con resultados de pap positivos,2016-09-01,0,1,0,0,0,1
CLIZA,"anticoncepcion, prevencion de its y de cancer de cuello uterino",numero de mujeres con resultados de pap positivos,2016-09-01,0,0,0,0,1,1
COBIJA,"anticoncepcion, prevencion de its y de cancer de cuello uterino",numero de mujeres con resultados de pap positivos,2016-09-01,0,0,0,1,0,1
COCHABAMBA,"anticoncepcion, prevencion de its y de cancer de cuello uterino",numero de mujeres con resultados de pap positivos,2016-09-01,2,15,85,43,13,158
COLCAPIRHUA,"anticoncepcion, prevencion de its y de cancer de cuello uterino",numero de mujeres con resultados de pap positivos,2016-09-01,0,0,5,1,2,8
CONCEPCION,"anticoncepcion, prevencion de its y de cancer de cuello uterino",numero de mujeres con resultados de pap positivos,2016-09-01,0,0,2,0,0,2
EL ALTO,"anticoncepcion, prevencion de its y de cancer de cuello uterino",numero de mujeres con resultados de pap positivos,2016-09-01,0,8,71,80,28,187
EL PUENTE(TJA),"anticoncepcion, prevencion de its y de cancer de cuello uterino",numero de mujeres con resultados de pap positivos,2016-09-01,0,0,1,0,0,1
EL TORNO,"anticoncepcion, prevencion de its y de cancer de cuello uterino",numero de mujeres con resultados de pap positivos,2016-09-01,0,0,3,0,1,4
ENTRE RIOS TRJ,"anticoncepcion, prevencion de its y de cancer de cuello uterino",numero de mujeres con resultados de pap positivos,2016-09-01,0,0,1,2,0,3
GUTIERREZ,"anticoncepcion, prevencion de its y de cancer de cuello uterino",numero de mujeres con resultados de pap positivos,2016-09-01,0,1,1,0,0,2
HUANUNI,"anticoncepcion, prevencion de its y de cancer de cuello uterino",numero de mujeres con resultados de pap positivos,2016-09-01,0,0,1,0,0,1
ICLA,"anticoncepcion, prevencion de its y de cancer de cuello uterino",numero de mujeres con resultados de pap positivos,2016-09-01,0,0,1,2,1,4
INCAHUASI,"anticoncepcion, prevencion de its y de cancer de cuello uterino",numero de mujeres con resultados de pap positivos,2016-09-01,0,0,1,0,0,1
LA GUARDIA,"anticoncepcion, prevencion de its y de cancer de cuello uterino",numero de mujeres con resultados de pap positivos,2016-09-01,0,1,10,3,5,19
LA PAZ,"anticoncepcion, prevencion de its y de cancer de cuello uterino",numero de mujeres con resultados de pap positivos,2016-09-01,0,3,34,25,11,73
LLICA,"anticoncepcion, prevencion de its y de cancer de cuello uterino",numero de mujeres con resultados de pap positivos,2016-09-01,0,0,1,0,0,1
LURIBAY,"anticoncepcion, prevencion de its y de cancer de cuello uterino",numero de mujeres con resultados de pap positivos,2016-09-01,0,0,1,0,0,1
MACHARETI,"anticoncepcion, prevencion de its y de cancer de cuello uterino",numero de mujeres con resultados de pap positivos,2016-09-01,0,0,1,0,0,1
MAPIRI,"anticoncepcion, prevencion de its y de cancer de cuello uterino",numero de mujeres con resultados de pap positivos,2016-09-01,0,0,1,1,0,2
MINEROS,"anticoncepcion, prevencion de its y de cancer de cuello uterino",numero de mujeres con resultados de pap positivos,2016-09-01,0,3,4,2,0,9
MOJINETE,"anticoncepcion, prevencion de its y de cancer de cuello uterino",numero de mujeres con resultados de pap positivos,2016-09-01,0,0,1,0,0,1
MOJOCOYA,"anticoncepcion, prevencion de its y de cancer de cuello uterino",numero de mujeres con resultados de pap positivos,2016-09-01,0,0,1,0,0,1
MONTEAGUDO,"anticoncepcion, prevencion de its y de cancer de cuello uterino",numero de mujeres con resultados de pap positivos,2016-09-01,0,0,2,0,0,2
ORURO,"anticoncepcion, prevencion de its y de cancer de cuello uterino",numero de mujeres con resultados de pap positivos,2016-09-01,0,0,1,1,0,2
PADILLA,"anticoncepcion, prevencion de its y de cancer de cuello uterino",numero de mujeres con resultados de pap positivos,2016-09-01,0,0,1,4,0,5
PAILON,"anticoncepcion, prevencion de its y de cancer de cuello uterino",numero de mujeres con resultados de pap positivos,2016-09-01,0,0,1,0,0,1
POROMA,"anticoncepcion, prevencion de its y de cancer de cuello uterino",numero de mujeres con resultados de pap positivos,2016-09-01,0,0,2,1,0,3
PORTACHUELO,"anticoncepcion, prevencion de its y de cancer de cuello uterino",numero de mujeres con resultados de pap positivos,2016-09-01,0,0,0,1,0,1
POTOSI,"anticoncepcion, prevencion de its y de cancer de cuello uterino",numero de mujeres con resultados de pap positivos,2016-09-01,0,0,4,8,3,15
PUERTO QUIJARRO,"anticoncepcion, prevencion de its y de cancer de cuello uterino",numero de mujeres con resultados de pap positivos,2016-09-01,0,1,1,0,0,2
PUERTO RICO,"anticoncepcion, prevencion de its y de cancer de cuello uterino",numero de mujeres con resultados de pap positivos,2016-09-01,0,0,0,1,0,1
QUILLACOLLO,"anticoncepcion, prevencion de its y de cancer de cuello uterino",numero de mujeres con resultados de pap positivos,2016-09-01,0,0,5,1,1,7
RIBERALTA,"anticoncepcion, prevencion de its y de cancer de cuello uterino",numero de mujeres con resultados de pap positivos,2016-09-01,0,0,10,3,1,14
RURRENABAQUE,"anticoncepcion, prevencion de its y de cancer de cuello uterino",numero de mujeres con resultados de pap positivos,2016-09-01,0,0,1,1,1,3
SAN BUENA VENTURA,"anticoncepcion, prevencion de its y de cancer de cuello uterino",numero de mujeres con resultados de pap positivos,2016-09-01,0,0,1,0,0,1
SAN CARLOS,"anticoncepcion, prevencion de its y de cancer de cuello uterino",numero de mujeres con resultados de pap positivos,2016-09-01,0,0,1,0,0,1
SAN IGNACIO,"anticoncepcion, prevencion de its y de cancer de cuello uterino",numero de mujeres con resultados de pap positivos,2016-09-01,0,0,5,0,1,6
SAN IGNACIO DE VELASCO,"anticoncepcion, prevencion de its y de cancer de cuello uterino",numero de mujeres con resultados de pap positivos,2016-09-01,0,0,3,0,0,3
SAN LUCAS,"anticoncepcion, prevencion de its y de cancer de cuello uterino",numero de mujeres con resultados de pap positivos,2016-09-01,0,0,1,1,1,3
SAN RAFAEL,"anticoncepcion, prevencion de its y de cancer de cuello uterino",numero de mujeres con resultados de pap positivos,2016-09-01,0,0,1,1,0,2
SANTA CRUZ DE LA SIERRA,"anticoncepcion, prevencion de its y de cancer de cuello uterino",numero de mujeres con resultados de pap positivos,2016-09-01,0,3,34,36,31,104
SOPACHUY,"anticoncepcion, prevencion de its y de cancer de cuello uterino",numero de mujeres con resultados de pap positivos,2016-09-01,0,0,1,0,0,1
SUCRE,"anticoncepcion, prevencion de its y de cancer de cuello uterino",numero de mujeres con resultados de pap positivos,2016-09-01,0,2,14,12,3,31
TARIJA,"anticoncepcion, prevencion de its y de cancer de cuello uterino",numero de mujeres con resultados de pap positivos,2016-09-01,1,1,6,2,6,16
TARVITA,"anticoncepcion, prevencion de its y de cancer de cuello uterino",numero de mujeres con resultados de pap positivos,2016-09-01,0,0,0,0,1,1
TEOPONTE,"anticoncepcion, prevencion de its y de cancer de cuello uterino",numero de mujeres con resultados de pap positivos,2016-09-01,0,0,3,0,0,3
TIQUIPAYA,"anticoncepcion, prevencion de its y de cancer de cuello uterino",numero de mujeres con resultados de pap positivos,2016-09-01,0,0,7,3,0,10
TIRAQUE (CBBA),"anticoncepcion, prevencion de its y de cancer de cuello uterino",numero de mujeres con resultados de pap positivos,2016-09-01,0,0,0,1,0,1
TOMAVE,"anticoncepcion, prevencion de its y de cancer de cuello uterino",numero de mujeres con resultados de pap positivos,2016-09-01,0,0,5,1,0,6
TOMINA,"anticoncepcion, prevencion de its y de cancer de cuello uterino",numero de mujeres con resultados de pap positivos,2016-09-01,0,0,0,0,2,2
TRINIDAD,"anticoncepcion, prevencion de its y de cancer de cuello uterino",numero de mujeres con resultados de pap positivos,2016-09-01,0,2,8,7,3,20
VIACHA,"anticoncepcion, prevencion de its y de cancer de cuello uterino",numero de mujeres con resultados de pap positivos,2016-09-01,0,0,1,0,0,1
VILLA CHARCAS,"anticoncepcion, prevencion de its y de cancer de cuello uterino",numero de mujeres con resultados de pap positivos,2016-09-01,0,0,1,1,0,2
VILLA SERRANO,"anticoncepcion, prevencion de its y de cancer de cuello uterino",numero de mujeres con resultados de pap positivos,2016-09-01,0,0,2,1,3,6
VILLAZON,"anticoncepcion, prevencion de its y de cancer de cuello uterino",numero de mujeres con resultados de pap positivos,2016-09-01,0,0,0,2,0,2
YACUIBA,"anticoncepcion, prevencion de its y de cancer de cuello uterino",numero de mujeres con resultados de pap positivos,2016-09-01,0,1,5,5,1,12
YAPACANI,"anticoncepcion, prevencion de its y de cancer de cuello uterino",numero de mujeres con resultados de pap positivos,2016-09-01,0,0,1,0,0,1
ACACIO,"anticoncepcion, prevencion de its y de cancer de cuello uterino",numero de mujeres con resultados de pap positivos,2016-10-01,0,1,5,5,1,12
ACHACACHI,"anticoncepcion, prevencion de its y de cancer de cuello uterino",numero de mujeres con resultados de pap positivos,2016-10-01,0,0,2,0,0,2
AZURDUY,"anticoncepcion, prevencion de its y de cancer de cuello uterino",numero de mujeres con resultados de pap positivos,2016-10-01,0,0,0,1,0,1
BUENA VISTA,"anticoncepcion, prevencion de its y de cancer de cuello uterino",numero de mujeres con resultados de pap positivos,2016-10-01,0,2,1,0,0,3
CABEZAS,"anticoncepcion, prevencion de its y de cancer de cuello uterino",numero de mujeres con resultados de pap positivos,2016-10-01,0,0,1,1,1,3
CAMARGO,"anticoncepcion, prevencion de its y de cancer de cuello uterino",numero de mujeres con resultados de pap positivos,2016-10-01,0,0,0,1,0,1
CAMIRI,"anticoncepcion, prevencion de its y de cancer de cuello uterino",numero de mujeres con resultados de pap positivos,2016-10-01,0,0,0,1,0,1
COBIJA,"anticoncepcion, prevencion de its y de cancer de cuello uterino",numero de mujeres con resultados de pap positivos,2016-10-01,0,0,2,4,0,6
COCHABAMBA,"anticoncepcion, prevencion de its y de cancer de cuello uterino",numero de mujeres con resultados de pap positivos,2016-10-01,0,9,252,249,153,663
COLCAPIRHUA,"anticoncepcion, prevencion de its y de cancer de cuello uterino",numero de mujeres con resultados de pap positivos,2016-10-01,0,0,6,0,0,6
CONCEPCION,"anticoncepcion, prevencion de its y de cancer de cuello uterino",numero de mujeres con resultados de pap positivos,2016-10-01,0,0,2,0,0,2
CUEVO,"anticoncepcion, prevencion de its y de cancer de cuello uterino",numero de mujeres con resultados de pap positivos,2016-10-01,0,1,0,0,0,1
CULPINA,"anticoncepcion, prevencion de its y de cancer de cuello uterino",numero de mujeres con resultados de pap positivos,2016-10-01,0,0,5,4,0,9
EL ALTO,"anticoncepcion, prevencion de its y de cancer de cuello uterino",numero de mujeres con resultados de pap positivos,2016-10-01,0,1,34,27,6,68
EL TORNO,"anticoncepcion, prevencion de its y de cancer de cuello uterino",numero de mujeres con resultados de pap positivos,2016-10-01,0,2,2,1,0,5
FERNANDEZ ALONSO,"anticoncepcion, prevencion de its y de cancer de cuello uterino",numero de mujeres con resultados de pap positivos,2016-10-01,0,0,1,0,0,1
HUANUNI,"anticoncepcion, prevencion de its y de cancer de cuello uterino",numero de mujeres con resultados de pap positivos,2016-10-01,0,0,0,1,0,1
ICLA,"anticoncepcion, prevencion de its y de cancer de cuello uterino",numero de mujeres con resultados de pap positivos,2016-10-01,0,0,0,1,0,1
LA GUARDIA,"anticoncepcion, prevencion de its y de cancer de cuello uterino",numero de mujeres con resultados de pap positivos,2016-10-01,0,0,1,1,0,2
LA PAZ,"anticoncepcion, prevencion de its y de cancer de cuello uterino",numero de mujeres con resultados de pap positivos,2016-10-01,0,8,65,39,22,134
MAPIRI,"anticoncepcion, prevencion de its y de cancer de cuello uterino",numero de mujeres con resultados de pap positivos,2016-10-01,0,0,2,0,0,2
MOJOCOYA,"anticoncepcion, prevencion de its y de cancer de cuello uterino",numero de mujeres con resultados de pap positivos,2016-10-01,0,1,0,1,0,2
MONTEAGUDO,"anticoncepcion, prevencion de its y de cancer de cuello uterino",numero de mujeres con resultados de pap positivos,2016-10-01,0,1,2,0,1,4
ORURO,"anticoncepcion, prevencion de its y de cancer de cuello uterino",numero de mujeres con resultados de pap positivos,2016-10-01,0,1,2,1,0,4
PADILLA,"anticoncepcion, prevencion de its y de cancer de cuello uterino",numero de mujeres con resultados de pap positivos,2016-10-01,0,0,0,3,0,3
PAILON,"anticoncepcion, prevencion de its y de cancer de cuello uterino",numero de mujeres con resultados de pap positivos,2016-10-01,0,1,1,0,0,2
PALOS BLANCOS,"anticoncepcion, prevencion de its y de cancer de cuello uterino",numero de mujeres con resultados de pap positivos,2016-10-01,0,0,0,1,0,1
PATACAMAYA,"anticoncepcion, prevencion de its y de cancer de cuello uterino",numero de mujeres con resultados de pap positivos,2016-10-01,0,0,3,4,1,8
POTOSI,"anticoncepcion, prevencion de its y de cancer de cuello uterino",numero de mujeres con resultados de pap positivos,2016-10-01,0,3,40,21,5,69
PUNA,"anticoncepcion, prevencion de its y de cancer de cuello uterino",numero de mujeres con resultados de pap positivos,2016-10-01,0,0,0,1,1,2
QUILLACOLLO,"anticoncepcion, prevencion de its y de cancer de cuello uterino",numero de mujeres con resultados de pap positivos,2016-10-01,0,0,1,0,0,1
RIBERALTA,"anticoncepcion, prevencion de its y de cancer de cuello uterino",numero de mujeres con resultados de pap positivos,2016-10-01,0,0,4,2,1,7
RURRENABAQUE,"anticoncepcion, prevencion de its y de cancer de cuello uterino",numero de mujeres con resultados de pap positivos,2016-10-01,0,0,0,0,1,1
SACABA,"anticoncepcion, prevencion de its y de cancer de cuello uterino",numero de mujeres con resultados de pap positivos,2016-10-01,0,0,0,1,0,1
SAIPINA,"anticoncepcion, prevencion de its y de cancer de cuello uterino",numero de mujeres con resultados de pap positivos,2016-10-01,0,0,3,1,2,6
SAN IGNACIO,"anticoncepcion, prevencion de its y de cancer de cuello uterino",numero de mujeres con resultados de pap positivos,2016-10-01,0,0,1,1,0,2
SAN JAVIER(STC),"anticoncepcion, prevencion de its y de cancer de cuello uterino",numero de mujeres con resultados de pap positivos,2016-10-01,0,0,1,0,0,1
SAN JULIAN,"anticoncepcion, prevencion de its y de cancer de cuello uterino",numero de mujeres con resultados de pap positivos,2016-10-01,0,0,1,0,0,1
SAN LUCAS,"anticoncepcion, prevencion de its y de cancer de cuello uterino",numero de mujeres con resultados de pap positivos,2016-10-01,0,0,0,3,0,3
SANTA CRUZ DE LA SIERRA,"anticoncepcion, prevencion de its y de cancer de cuello uterino",numero de mujeres con resultados de pap positivos,2016-10-01,2,7,101,70,24,204
SANTA ROSA DEL SARA,"anticoncepcion, prevencion de its y de cancer de cuello uterino",numero de mujeres con resultados de pap positivos,2016-10-01,0,0,0,1,0,1
SHINAOTA,"anticoncepcion, prevencion de its y de cancer de cuello uterino",numero de mujeres con resultados de pap positivos,2016-10-01,0,0,0,1,0,1
SUCRE,"anticoncepcion, prevencion de its y de cancer de cuello uterino",numero de mujeres con resultados de pap positivos,2016-10-01,0,5,22,10,3,40
TARIJA,"anticoncepcion, prevencion de its y de cancer de cuello uterino",numero de mujeres con resultados de pap positivos,2016-10-01,0,0,3,3,1,7
TARVITA,"anticoncepcion, prevencion de its y de cancer de cuello uterino",numero de mujeres con resultados de pap positivos,2016-10-01,0,0,0,1,1,2
TEOPONTE,"anticoncepcion, prevencion de its y de cancer de cuello uterino",numero de mujeres con resultados de pap positivos,2016-10-01,0,2,4,0,0,6
TIQUIPAYA,"anticoncepcion, prevencion de its y de cancer de cuello uterino",numero de mujeres con resultados de pap positivos,2016-10-01,0,0,0,1,1,2
TRINIDAD,"anticoncepcion, prevencion de its y de cancer de cuello uterino",numero de mujeres con resultados de pap positivos,2016-10-01,0,0,0,9,0,9
TUPIZA,"anticoncepcion, prevencion de its y de cancer de cuello uterino",numero de mujeres con resultados de pap positivos,2016-10-01,0,1,8,1,1,11
VALLEGRANDE,"anticoncepcion, prevencion de its y de cancer de cuello uterino",numero de mujeres con resultados de pap positivos,2016-10-01,0,1,0,0,0,1
VIACHA,"anticoncepcion, prevencion de its y de cancer de cuello uterino",numero de mujeres con resultados de pap positivos,2016-10-01,0,0,2,2,0,4
VILLA CHARCAS,"anticoncepcion, prevencion de its y de cancer de cuello uterino",numero de mujeres con resultados de pap positivos,2016-10-01,0,0,0,2,1,3
VILLA MONTES,"anticoncepcion, prevencion de its y de cancer de cuello uterino",numero de mujeres con resultados de pap positivos,2016-10-01,0,0,0,1,0,1
VILLA SERRANO,"anticoncepcion, prevencion de its y de cancer de cuello uterino",numero de mujeres con resultados de pap positivos,2016-10-01,0,0,1,1,1,3
VINTO,"anticoncepcion, prevencion de its y de cancer de cuello uterino",numero de mujeres con resultados de pap positivos,2016-10-01,0,0,1,0,0,1
YACUIBA,"anticoncepcion, prevencion de its y de cancer de cuello uterino",numero de mujeres con resultados de pap positivos,2016-10-01,0,0,4,2,1,7
YAMPARAEZ,"anticoncepcion, prevencion de its y de cancer de cuello uterino",numero de mujeres con resultados de pap positivos,2016-10-01,0,0,0,0,1,1
YAPACANI,"anticoncepcion, prevencion de its y de cancer de cuello uterino",numero de mujeres con resultados de pap positivos,2016-10-01,0,1,1,1,0,3
ACHACACHI,"anticoncepcion, prevencion de its y de cancer de cuello uterino",numero de mujeres con resultados de pap positivos,2016-11-01,0,0,2,1,0,3
ARANI,"anticoncepcion, prevencion de its y de cancer de cuello uterino",numero de mujeres con resultados de pap positivos,2016-11-01,0,0,1,0,0,1
BUENA VISTA,"anticoncepcion, prevencion de its y de cancer de cuello uterino",numero de mujeres con resultados de pap positivos,2016-11-01,1,0,3,0,0,4
CABEZAS,"anticoncepcion, prevencion de its y de cancer de cuello uterino",numero de mujeres con resultados de pap positivos,2016-11-01,0,0,1,0,0,1
CARANAVI,"anticoncepcion, prevencion de its y de cancer de cuello uterino",numero de mujeres con resultados de pap positivos,2016-11-01,0,0,2,4,1,7
CARIPUYO,"anticoncepcion, prevencion de its y de cancer de cuello uterino",numero de mujeres con resultados de pap positivos,2016-11-01,0,0,1,3,0,4
CHULUMANI (V. DE LA LIBERTAD),"anticoncepcion, prevencion de its y de cancer de cuello uterino",numero de mujeres con resultados de pap positivos,2016-11-01,0,0,0,0,1,1
COBIJA,"anticoncepcion, prevencion de its y de cancer de cuello uterino",numero de mujeres con resultados de pap positivos,2016-11-01,0,0,2,1,0,3
COCHABAMBA,"anticoncepcion, prevencion de its y de cancer de cuello uterino",numero de mujeres con resultados de pap positivos,2016-11-01,0,7,64,38,10,119
COLCAPIRHUA,"anticoncepcion, prevencion de its y de cancer de cuello uterino",numero de mujeres con resultados de pap positivos,2016-11-01,0,0,1,2,1,4
CONCEPCION,"anticoncepcion, prevencion de its y de cancer de cuello uterino",numero de mujeres con resultados de pap positivos,2016-11-01,0,0,1,0,0,1
CULPINA,"anticoncepcion, prevencion de its y de cancer de cuello uterino",numero de mujeres con resultados de pap positivos,2016-11-01,0,3,0,2,0,5
EL ALTO,"anticoncepcion, prevencion de its y de cancer de cuello uterino",numero de mujeres con resultados de pap positivos,2016-11-01,0,2,33,31,9,75
EL PUENTE(TJA),"anticoncepcion, prevencion de its y de cancer de cuello uterino",numero de mujeres con resultados de pap positivos,2016-11-01,0,0,0,1,0,1
EL TORNO,"anticoncepcion, prevencion de its y de cancer de cuello uterino",numero de mujeres con resultados de pap positivos,2016-11-01,0,0,2,2,1,5
ENTRE RIOS TRJ,"anticoncepcion, prevencion de its y de cancer de cuello uterino",numero de mujeres con resultados de pap positivos,2016-11-01,0,0,0,0,1,1
GUTIERREZ,"anticoncepcion, prevencion de its y de cancer de cuello uterino",numero de mujeres con resultados de pap positivos,2016-11-01,0,1,1,1,0,3
HUACARETA,"anticoncepcion, prevencion de its y de cancer de cuello uterino",numero de mujeres con resultados de pap positivos,2016-11-01,0,0,1,0,3,4
ICLA,"anticoncepcion, prevencion de its y de cancer de cuello uterino",numero de mujeres con resultados de pap positivos,2016-11-01,0,0,0,1,0,1
LA GUARDIA,"anticoncepcion, prevencion de its y de cancer de cuello uterino",numero de mujeres con resultados de pap positivos,2016-11-01,0,1,11,5,2,19
LA PAZ,"anticoncepcion, prevencion de its y de cancer de cuello uterino",numero de mujeres con resultados de pap positivos,2016-11-01,0,2,26,34,5,67
MECAPACA,"anticoncepcion, prevencion de its y de cancer de cuello uterino",numero de mujeres con resultados de pap positivos,2016-11-01,0,0,3,0,2,5
MONTEAGUDO,"anticoncepcion, prevencion de its y de cancer de cuello uterino",numero de mujeres con resultados de pap positivos,2016-11-01,0,0,2,0,0,2
ORURO,"anticoncepcion, prevencion de its y de cancer de cuello uterino",numero de mujeres con resultados de pap positivos,2016-11-01,0,2,18,14,6,40
PAILON,"anticoncepcion, prevencion de its y de cancer de cuello uterino",numero de mujeres con resultados de pap positivos,2016-11-01,0,0,2,3,0,5
PALOS BLANCOS,"anticoncepcion, prevencion de its y de cancer de cuello uterino",numero de mujeres con resultados de pap positivos,2016-11-01,0,0,2,0,0,2
PAMPA GRANDE,"anticoncepcion, prevencion de its y de cancer de cuello uterino",numero de mujeres con resultados de pap positivos,2016-11-01,0,1,0,0,0,1
POTOSI,"anticoncepcion, prevencion de its y de cancer de cuello uterino",numero de mujeres con resultados de pap positivos,2016-11-01,0,2,16,9,3,30
PUERTO QUIJARRO,"anticoncepcion, prevencion de its y de cancer de cuello uterino",numero de mujeres con resultados de pap positivos,2016-11-01,0,0,0,1,0,1
PUERTO VILLARROEL,"anticoncepcion, prevencion de its y de cancer de cuello uterino",numero de mujeres con resultados de pap positivos,2016-11-01,0,0,1,0,0,1
QUILLACOLLO,"anticoncepcion, prevencion de its y de cancer de cuello uterino",numero de mujeres con resultados de pap positivos,2016-11-01,0,0,0,2,2,4
RIBERALTA,"anticoncepcion, prevencion de its y de cancer de cuello uterino",numero de mujeres con resultados de pap positivos,2016-11-01,0,0,1,0,1,2
RURRENABAQUE,"anticoncepcion, prevencion de its y de cancer de cuello uterino",numero de mujeres con resultados de pap positivos,2016-11-01,0,0,1,3,1,5
SACABA,"anticoncepcion, prevencion de its y de cancer de cuello uterino",numero de mujeres con resultados de pap positivos,2016-11-01,0,0,2,1,1,4
SAN BUENA VENTURA,"anticoncepcion, prevencion de its y de cancer de cuello uterino",numero de mujeres con resultados de pap positivos,2016-11-01,0,0,1,0,0,1
SAN CARLOS,"anticoncepcion, prevencion de its y de cancer de cuello uterino",numero de mujeres con resultados de pap positivos,2016-11-01,0,1,0,0,0,1
SAN IGNACIO,"anticoncepcion, prevencion de its y de cancer de cuello uterino",numero de mujeres con resultados de pap positivos,2016-11-01,0,0,4,3,1,8
SAN LUCAS,"anticoncepcion, prevencion de its y de cancer de cuello uterino",numero de mujeres con resultados de pap positivos,2016-11-01,0,0,0,1,0,1
SAN RAFAEL,"anticoncepcion, prevencion de its y de cancer de cuello uterino",numero de mujeres con resultados de pap positivos,2016-11-01,0,0,1,0,0,1
SAN RAMON SCZ,"anticoncepcion, prevencion de its y de cancer de cuello uterino",numero de mujeres con resultados de pap positivos,2016-11-01,0,0,0,2,0,2
SANTA CRUZ DE LA SIERRA,"anticoncepcion, prevencion de its y de cancer de cuello uterino",numero de mujeres con resultados de pap positivos,2016-11-01,0,14,61,38,32,145
SUCRE,"anticoncepcion, prevencion de its y de cancer de cuello uterino",numero de mujeres con resultados de pap positivos,2016-11-01,0,1,16,7,5,29
TARIJA,"anticoncepcion, prevencion de its y de cancer de cuello uterino",numero de mujeres con resultados de pap positivos,2016-11-01,0,1,3,4,4,12
TIQUIPAYA,"anticoncepcion, prevencion de its y de cancer de cuello uterino",numero de mujeres con resultados de pap positivos,2016-11-01,1,1,1,1,2,6
TOMINA,"anticoncepcion, prevencion de its y de cancer de cuello uterino",numero de mujeres con resultados de pap positivos,2016-11-01,0,0,0,2,0,2
TORO TORO,"anticoncepcion, prevencion de its y de cancer de cuello uterino",numero de mujeres con resultados de pap positivos,2016-11-01,0,2,17,6,3,28
TRINIDAD,"anticoncepcion, prevencion de its y de cancer de cuello uterino",numero de mujeres con resultados de pap positivos,2016-11-01,0,0,4,24,15,43
VIACHA,"anticoncepcion, prevencion de its y de cancer de cuello uterino",numero de mujeres con resultados de pap positivos,2016-11-01,0,0,0,0,1,1
VILLA MONTES,"anticoncepcion, prevencion de its y de cancer de cuello uterino",numero de mujeres con resultados de pap positivos,2016-11-01,0,2,5,2,0,9
VILLA SERRANO,"anticoncepcion, prevencion de its y de cancer de cuello uterino",numero de mujeres con resultados de pap positivos,2016-11-01,0,0,0,2,0,2
YACUIBA,"anticoncepcion, prevencion de its y de cancer de cuello uterino",numero de mujeres con resultados de pap positivos,2016-11-01,0,0,1,3,1,5
YANACACHI,"anticoncepcion, prevencion de its y de cancer de cuello uterino",numero de mujeres con resultados de pap positivos,2016-11-01,0,0,1,0,1,2
ACHACACHI,"anticoncepcion, prevencion de its y de cancer de cuello uterino",numero de mujeres con resultados de pap positivos,2016-12-01,0,2,1,0,0,3
AIQUILE,"anticoncepcion, prevencion de its y de cancer de cuello uterino",numero de mujeres con resultados de pap positivos,2016-12-01,0,0,0,1,0,1
BERMEJO,"anticoncepcion, prevencion de its y de cancer de cuello uterino",numero de mujeres con resultados de pap positivos,2016-12-01,0,0,0,2,0,2
CABEZAS,"anticoncepcion, prevencion de its y de cancer de cuello uterino",numero de mujeres con resultados de pap positivos,2016-12-01,0,1,2,0,0,3
CAMARGO,"anticoncepcion, prevencion de its y de cancer de cuello uterino",numero de mujeres con resultados de pap positivos,2016-12-01,0,0,2,2,0,4
CAPINOTA,"anticoncepcion, prevencion de its y de cancer de cuello uterino",numero de mujeres con resultados de pap positivos,2016-12-01,0,0,0,1,0,1
CARANAVI,"anticoncepcion, prevencion de its y de cancer de cuello uterino",numero de mujeres con resultados de pap positivos,2016-12-01,0,0,1,1,0,2
CHIMORE,"anticoncepcion, prevencion de its y de cancer de cuello uterino",numero de mujeres con resultados de pap positivos,2016-12-01,0,1,0,0,0,1
COBIJA,"anticoncepcion, prevencion de its y de cancer de cuello uterino",numero de mujeres con resultados de pap positivos,2016-12-01,0,0,3,1,0,4
COCHABAMBA,"anticoncepcion, prevencion de its y de cancer de cuello uterino",numero de mujeres con resultados de pap positivos,2016-12-01,0,8,22,8,3,41
CONCEPCION,"anticoncepcion, prevencion de its y de cancer de cuello uterino",numero de mujeres con resultados de pap positivos,2016-12-01,0,0,1,0,0,1
EL ALTO,"anticoncepcion, prevencion de its y de cancer de cuello uterino",numero de mujeres con resultados de pap positivos,2016-12-01,0,3,53,49,10,115
EL TORNO,"anticoncepcion, prevencion de its y de cancer de cuello uterino",numero de mujeres con resultados de pap positivos,2016-12-01,0,0,1,1,0,2
ENTRE RIOS TRJ,"anticoncepcion, prevencion de its y de cancer de cuello uterino",numero de mujeres con resultados de pap positivos,2016-12-01,0,0,2,0,0,2
GUTIERREZ,"anticoncepcion, prevencion de its y de cancer de cuello uterino",numero de mujeres con resultados de pap positivos,2016-12-01,0,0,1,2,0,3
HUACARETA,"anticoncepcion, prevencion de its y de cancer de cuello uterino",numero de mujeres con resultados de pap positivos,2016-12-01,0,2,1,0,1,4
IRUPANA (VILLA DE LANZA),"anticoncepcion, prevencion de its y de cancer de cuello uterino",numero de mujeres con resultados de pap positivos,2016-12-01,0,0,0,1,0,1
LA GUARDIA,"anticoncepcion, prevencion de its y de cancer de cuello uterino",numero de mujeres con resultados de pap positivos,2016-12-01,0,1,14,4,11,30
LA PAZ,"anticoncepcion, prevencion de its y de cancer de cuello uterino",numero de mujeres con resultados de pap positivos,2016-12-01,0,0,17,42,13,72
MOJOCOYA,"anticoncepcion, prevencion de its y de cancer de cuello uterino",numero de mujeres con resultados de pap positivos,2016-12-01,0,0,0,0,3,3
MONTEAGUDO,"anticoncepcion, prevencion de its y de cancer de cuello uterino",numero de mujeres con resultados de pap positivos,2016-12-01,0,0,5,3,0,8
MONTERO,"anticoncepcion, prevencion de its y de cancer de cuello uterino",numero de mujeres con resultados de pap positivos,2016-12-01,0,0,0,0,1,1
ORURO,"anticoncepcion, prevencion de its y de cancer de cuello uterino",numero de mujeres con resultados de pap positivos,2016-12-01,0,0,1,0,1,2
PAILON,"anticoncepcion, prevencion de its y de cancer de cuello uterino",numero de mujeres con resultados de pap positivos,2016-12-01,0,0,0,1,0,1
PALCA,"anticoncepcion, prevencion de its y de cancer de cuello uterino",numero de mujeres con resultados de pap positivos,2016-12-01,0,2,0,0,0,2
POTOSI,"anticoncepcion, prevencion de its y de cancer de cuello uterino",numero de mujeres con resultados de pap positivos,2016-12-01,0,0,17,2,3,22
QUILLACOLLO,"anticoncepcion, prevencion de its y de cancer de cuello uterino",numero de mujeres con resultados de pap positivos,2016-12-01,0,0,0,2,1,3
ROBORE,"anticoncepcion, prevencion de its y de cancer de cuello uterino",numero de mujeres con resultados de pap positivos,2016-12-01,0,0,1,2,0,3
RURRENABAQUE,"anticoncepcion, prevencion de its y de cancer de cuello uterino",numero de mujeres con resultados de pap positivos,2016-12-01,0,0,1,0,1,2
SACABA,"anticoncepcion, prevencion de its y de cancer de cuello uterino",numero de mujeres con resultados de pap positivos,2016-12-01,0,0,0,4,0,4
SAN IGNACIO,"anticoncepcion, prevencion de its y de cancer de cuello uterino",numero de mujeres con resultados de pap positivos,2016-12-01,0,0,1,2,0,3
SAN JULIAN,"anticoncepcion, prevencion de its y de cancer de cuello uterino",numero de mujeres con resultados de pap positivos,2016-12-01,0,2,0,2,1,5
SAN LUCAS,"anticoncepcion, prevencion de its y de cancer de cuello uterino",numero de mujeres con resultados de pap positivos,2016-12-01,0,0,0,1,2,3
SAN PEDRO DE BUENA VISTA,"anticoncepcion, prevencion de its y de cancer de cuello uterino",numero de mujeres con resultados de pap positivos,2016-12-01,0,0,0,5,0,5
SANTA CRUZ DE LA SIERRA,"anticoncepcion, prevencion de its y de cancer de cuello uterino",numero de mujeres con resultados de pap positivos,2016-12-01,0,6,42,33,31,112
SOPACHUY,"anticoncepcion, prevencion de its y de cancer de cuello uterino",numero de mujeres con resultados de pap positivos,2016-12-01,0,0,1,0,0,1
SUCRE,"anticoncepcion, prevencion de its y de cancer de cuello uterino",numero de mujeres con resultados de pap positivos,2016-12-01,0,0,7,8,2,17
TARIJA,"anticoncepcion, prevencion de its y de cancer de cuello uterino",numero de mujeres con resultados de pap positivos,2016-12-01,0,0,0,1,2,3
TARVITA,"anticoncepcion, prevencion de its y de cancer de cuello uterino",numero de mujeres con resultados de pap positivos,2016-12-01,0,0,0,0,1,1
TIQUIPAYA,"anticoncepcion, prevencion de its y de cancer de cuello uterino",numero de mujeres con resultados de pap positivos,2016-12-01,0,0,0,2,1,3
TOMINA,"anticoncepcion, prevencion de its y de cancer de cuello uterino",numero de mujeres con resultados de pap positivos,2016-12-01,0,0,0,1,0,1
TORO TORO,"anticoncepcion, prevencion de its y de cancer de cuello uterino",numero de mujeres con resultados de pap positivos,2016-12-01,0,0,0,1,0,1
TRINIDAD,"anticoncepcion, prevencion de its y de cancer de cuello uterino",numero de mujeres con resultados de pap positivos,2016-12-01,0,1,3,1,2,7
VILLA SERRANO,"anticoncepcion, prevencion de its y de cancer de cuello uterino",numero de mujeres con resultados de pap positivos,2016-12-01,0,0,0,2,0,2
WARNES,"anticoncepcion, prevencion de its y de cancer de cuello uterino",numero de mujeres con resultados de pap positivos,2016-12-01,1,2,4,2,0,9
YACUIBA,"anticoncepcion, prevencion de its y de cancer de cuello uterino",numero de mujeres con resultados de pap positivos,2016-12-01,0,0,0,1,0,1
YAMPARAEZ,"anticoncepcion, prevencion de its y de cancer de cuello uterino",numero de mujeres con resultados de pap positivos,2016-12-01,0,0,1,1,0,2
YOCALLA,"anticoncepcion, prevencion de its y de cancer de cuello uterino",numero de mujeres con resultados de pap positivos,2016-12-01,0,0,1,0,0,1
YOTALA,"anticoncepcion, prevencion de its y de cancer de cuello uterino",numero de mujeres con resultados de pap positivos,2016-12-01,0,0,0,1,0,1
