municipality,group,variable,month,Número de mujeres con píldora anticonceptiva oral de emergencia,Número de mujeres con píldora anticonceptiva oral de emergencia1,Número de mujeres con píldora anticonceptiva oral de emergencia2,Número de mujeres con píldora anticonceptiva oral de emergencia3,Número de mujeres con píldora anticonceptiva oral de emergencia4,TOTAL
ALCALA,"anticoncepcion, prevencion de its y de cancer de cuello uterino",numero de mujeres con pildora anticonceptiva oral de emergencia,2016-01-01,0,0,3,0,0,3
ALTO BENI,"anticoncepcion, prevencion de its y de cancer de cuello uterino",numero de mujeres con pildora anticonceptiva oral de emergencia,2016-01-01,0,0,2,1,0,3
AYOPAYA (V. DE INDEPENDENCIA),"anticoncepcion, prevencion de its y de cancer de cuello uterino",numero de mujeres con pildora anticonceptiva oral de emergencia,2016-01-01,0,1,10,4,0,15
BERMEJO,"anticoncepcion, prevencion de its y de cancer de cuello uterino",numero de mujeres con pildora anticonceptiva oral de emergencia,2016-01-01,0,0,1,0,0,1
CABEZAS,"anticoncepcion, prevencion de its y de cancer de cuello uterino",numero de mujeres con pildora anticonceptiva oral de emergencia,2016-01-01,0,0,1,0,0,1
"CAIZA ""D""","anticoncepcion, prevencion de its y de cancer de cuello uterino",numero de mujeres con pildora anticonceptiva oral de emergencia,2016-01-01,0,0,1,0,0,1
CAMARGO,"anticoncepcion, prevencion de its y de cancer de cuello uterino",numero de mujeres con pildora anticonceptiva oral de emergencia,2016-01-01,0,0,1,0,0,1
CAQUIAVIRI,"anticoncepcion, prevencion de its y de cancer de cuello uterino",numero de mujeres con pildora anticonceptiva oral de emergencia,2016-01-01,0,0,1,0,0,1
CHALLAPATA,"anticoncepcion, prevencion de its y de cancer de cuello uterino",numero de mujeres con pildora anticonceptiva oral de emergencia,2016-01-01,0,0,1,0,0,1
CHARAGUA,"anticoncepcion, prevencion de its y de cancer de cuello uterino",numero de mujeres con pildora anticonceptiva oral de emergencia,2016-01-01,0,0,3,0,0,3
COBIJA,"anticoncepcion, prevencion de its y de cancer de cuello uterino",numero de mujeres con pildora anticonceptiva oral de emergencia,2016-01-01,0,0,3,0,0,3
COCHABAMBA,"anticoncepcion, prevencion de its y de cancer de cuello uterino",numero de mujeres con pildora anticonceptiva oral de emergencia,2016-01-01,1,7,9,6,0,23
"COLCHA ""K""","anticoncepcion, prevencion de its y de cancer de cuello uterino",numero de mujeres con pildora anticonceptiva oral de emergencia,2016-01-01,0,1,0,0,0,1
CORQUE,"anticoncepcion, prevencion de its y de cancer de cuello uterino",numero de mujeres con pildora anticonceptiva oral de emergencia,2016-01-01,0,0,1,0,0,1
CUATRO CAÑADAS,"anticoncepcion, prevencion de its y de cancer de cuello uterino",numero de mujeres con pildora anticonceptiva oral de emergencia,2016-01-01,1,0,0,0,0,1
EL ALTO,"anticoncepcion, prevencion de its y de cancer de cuello uterino",numero de mujeres con pildora anticonceptiva oral de emergencia,2016-01-01,0,1,12,13,0,26
EL PUENTE(TJA),"anticoncepcion, prevencion de its y de cancer de cuello uterino",numero de mujeres con pildora anticonceptiva oral de emergencia,2016-01-01,0,0,1,0,0,1
EL TORNO,"anticoncepcion, prevencion de its y de cancer de cuello uterino",numero de mujeres con pildora anticonceptiva oral de emergencia,2016-01-01,0,2,3,0,0,5
EL VILLAR,"anticoncepcion, prevencion de its y de cancer de cuello uterino",numero de mujeres con pildora anticonceptiva oral de emergencia,2016-01-01,0,0,1,0,0,1
ENTRE RIOS TRJ,"anticoncepcion, prevencion de its y de cancer de cuello uterino",numero de mujeres con pildora anticonceptiva oral de emergencia,2016-01-01,0,0,0,2,0,2
ESCARA,"anticoncepcion, prevencion de its y de cancer de cuello uterino",numero de mujeres con pildora anticonceptiva oral de emergencia,2016-01-01,0,0,3,0,0,3
GUANAY,"anticoncepcion, prevencion de its y de cancer de cuello uterino",numero de mujeres con pildora anticonceptiva oral de emergencia,2016-01-01,0,0,1,0,0,1
GUAYARAMERIN,"anticoncepcion, prevencion de its y de cancer de cuello uterino",numero de mujeres con pildora anticonceptiva oral de emergencia,2016-01-01,0,0,1,1,0,2
HUACARETA,"anticoncepcion, prevencion de its y de cancer de cuello uterino",numero de mujeres con pildora anticonceptiva oral de emergencia,2016-01-01,0,1,0,0,0,1
HUACHACALLA,"anticoncepcion, prevencion de its y de cancer de cuello uterino",numero de mujeres con pildora anticonceptiva oral de emergencia,2016-01-01,0,2,4,0,0,6
INQUISIVI,"anticoncepcion, prevencion de its y de cancer de cuello uterino",numero de mujeres con pildora anticonceptiva oral de emergencia,2016-01-01,0,0,1,0,0,1
LA PAZ,"anticoncepcion, prevencion de its y de cancer de cuello uterino",numero de mujeres con pildora anticonceptiva oral de emergencia,2016-01-01,0,1,6,2,0,9
LAS CARRERAS,"anticoncepcion, prevencion de its y de cancer de cuello uterino",numero de mujeres con pildora anticonceptiva oral de emergencia,2016-01-01,0,0,5,0,0,5
LLALLAGUA,"anticoncepcion, prevencion de its y de cancer de cuello uterino",numero de mujeres con pildora anticonceptiva oral de emergencia,2016-01-01,0,1,10,0,0,11
MACHARETI,"anticoncepcion, prevencion de its y de cancer de cuello uterino",numero de mujeres con pildora anticonceptiva oral de emergencia,2016-01-01,0,1,0,0,0,1
MAGDALENA,"anticoncepcion, prevencion de its y de cancer de cuello uterino",numero de mujeres con pildora anticonceptiva oral de emergencia,2016-01-01,0,0,0,1,0,1
MINEROS,"anticoncepcion, prevencion de its y de cancer de cuello uterino",numero de mujeres con pildora anticonceptiva oral de emergencia,2016-01-01,0,0,0,1,0,1
MIZQUE,"anticoncepcion, prevencion de its y de cancer de cuello uterino",numero de mujeres con pildora anticonceptiva oral de emergencia,2016-01-01,0,0,1,0,0,1
MONTERO,"anticoncepcion, prevencion de its y de cancer de cuello uterino",numero de mujeres con pildora anticonceptiva oral de emergencia,2016-01-01,0,1,16,5,3,25
MOROCHATA,"anticoncepcion, prevencion de its y de cancer de cuello uterino",numero de mujeres con pildora anticonceptiva oral de emergencia,2016-01-01,0,2,0,0,0,2
NUEVO MANOA (NUEVA ESPERANZA),"anticoncepcion, prevencion de its y de cancer de cuello uterino",numero de mujeres con pildora anticonceptiva oral de emergencia,2016-01-01,0,0,1,0,0,1
PADCAYA,"anticoncepcion, prevencion de its y de cancer de cuello uterino",numero de mujeres con pildora anticonceptiva oral de emergencia,2016-01-01,0,0,0,1,0,1
PASORAPA,"anticoncepcion, prevencion de its y de cancer de cuello uterino",numero de mujeres con pildora anticonceptiva oral de emergencia,2016-01-01,0,0,10,5,0,15
PORCO,"anticoncepcion, prevencion de its y de cancer de cuello uterino",numero de mujeres con pildora anticonceptiva oral de emergencia,2016-01-01,0,1,1,0,0,2
POROMA,"anticoncepcion, prevencion de its y de cancer de cuello uterino",numero de mujeres con pildora anticonceptiva oral de emergencia,2016-01-01,0,0,1,0,0,1
PRESTO,"anticoncepcion, prevencion de its y de cancer de cuello uterino",numero de mujeres con pildora anticonceptiva oral de emergencia,2016-01-01,0,0,0,1,0,1
PUCARANI,"anticoncepcion, prevencion de its y de cancer de cuello uterino",numero de mujeres con pildora anticonceptiva oral de emergencia,2016-01-01,0,0,3,2,0,5
PUERTO RICO,"anticoncepcion, prevencion de its y de cancer de cuello uterino",numero de mujeres con pildora anticonceptiva oral de emergencia,2016-01-01,0,1,1,1,0,3
QUILLACOLLO,"anticoncepcion, prevencion de its y de cancer de cuello uterino",numero de mujeres con pildora anticonceptiva oral de emergencia,2016-01-01,0,4,36,1,0,41
SACABA,"anticoncepcion, prevencion de its y de cancer de cuello uterino",numero de mujeres con pildora anticonceptiva oral de emergencia,2016-01-01,0,0,1,0,0,1
SACACA,"anticoncepcion, prevencion de its y de cancer de cuello uterino",numero de mujeres con pildora anticonceptiva oral de emergencia,2016-01-01,0,0,7,4,0,11
SAN BUENA VENTURA,"anticoncepcion, prevencion de its y de cancer de cuello uterino",numero de mujeres con pildora anticonceptiva oral de emergencia,2016-01-01,0,1,0,0,0,1
SAN IGNACIO,"anticoncepcion, prevencion de its y de cancer de cuello uterino",numero de mujeres con pildora anticonceptiva oral de emergencia,2016-01-01,0,0,2,0,0,2
SAN JULIAN,"anticoncepcion, prevencion de its y de cancer de cuello uterino",numero de mujeres con pildora anticonceptiva oral de emergencia,2016-01-01,0,0,1,0,0,1
SAN PEDRO,"anticoncepcion, prevencion de its y de cancer de cuello uterino",numero de mujeres con pildora anticonceptiva oral de emergencia,2016-01-01,0,0,1,0,0,1
SAN PEDRO(PND),"anticoncepcion, prevencion de its y de cancer de cuello uterino",numero de mujeres con pildora anticonceptiva oral de emergencia,2016-01-01,0,0,1,0,0,1
SANTA CRUZ DE LA SIERRA,"anticoncepcion, prevencion de its y de cancer de cuello uterino",numero de mujeres con pildora anticonceptiva oral de emergencia,2016-01-01,0,5,39,1,0,45
SANTUARIO DE QUILLACAS,"anticoncepcion, prevencion de its y de cancer de cuello uterino",numero de mujeres con pildora anticonceptiva oral de emergencia,2016-01-01,0,0,2,0,0,2
SICA SICA (VILLA AROMA),"anticoncepcion, prevencion de its y de cancer de cuello uterino",numero de mujeres con pildora anticonceptiva oral de emergencia,2016-01-01,0,0,1,0,0,1
SORATA,"anticoncepcion, prevencion de its y de cancer de cuello uterino",numero de mujeres con pildora anticonceptiva oral de emergencia,2016-01-01,0,0,2,1,0,3
SUCRE,"anticoncepcion, prevencion de its y de cancer de cuello uterino",numero de mujeres con pildora anticonceptiva oral de emergencia,2016-01-01,0,4,12,7,0,23
TACOBAMBA,"anticoncepcion, prevencion de its y de cancer de cuello uterino",numero de mujeres con pildora anticonceptiva oral de emergencia,2016-01-01,0,0,0,1,0,1
TAPACARI,"anticoncepcion, prevencion de its y de cancer de cuello uterino",numero de mujeres con pildora anticonceptiva oral de emergencia,2016-01-01,0,0,0,1,0,1
TARATA,"anticoncepcion, prevencion de its y de cancer de cuello uterino",numero de mujeres con pildora anticonceptiva oral de emergencia,2016-01-01,0,0,2,0,0,2
TARIJA,"anticoncepcion, prevencion de its y de cancer de cuello uterino",numero de mujeres con pildora anticonceptiva oral de emergencia,2016-01-01,0,0,14,7,0,21
TEOPONTE,"anticoncepcion, prevencion de its y de cancer de cuello uterino",numero de mujeres con pildora anticonceptiva oral de emergencia,2016-01-01,0,0,16,0,0,16
TOMAVE,"anticoncepcion, prevencion de its y de cancer de cuello uterino",numero de mujeres con pildora anticonceptiva oral de emergencia,2016-01-01,0,1,3,1,0,5
TOTORA(ORR),"anticoncepcion, prevencion de its y de cancer de cuello uterino",numero de mujeres con pildora anticonceptiva oral de emergencia,2016-01-01,1,1,0,0,0,2
TRINIDAD,"anticoncepcion, prevencion de its y de cancer de cuello uterino",numero de mujeres con pildora anticonceptiva oral de emergencia,2016-01-01,0,18,88,38,0,144
TUPIZA,"anticoncepcion, prevencion de its y de cancer de cuello uterino",numero de mujeres con pildora anticonceptiva oral de emergencia,2016-01-01,0,1,11,5,1,18
UMALA,"anticoncepcion, prevencion de its y de cancer de cuello uterino",numero de mujeres con pildora anticonceptiva oral de emergencia,2016-01-01,0,2,2,2,0,6
VACAS,"anticoncepcion, prevencion de its y de cancer de cuello uterino",numero de mujeres con pildora anticonceptiva oral de emergencia,2016-01-01,0,0,4,1,0,5
VIACHA,"anticoncepcion, prevencion de its y de cancer de cuello uterino",numero de mujeres con pildora anticonceptiva oral de emergencia,2016-01-01,0,4,62,27,2,95
VILLA CHARCAS,"anticoncepcion, prevencion de its y de cancer de cuello uterino",numero de mujeres con pildora anticonceptiva oral de emergencia,2016-01-01,0,1,1,0,0,2
VILLA VACA GUZMAN (MUYUPAMPA),"anticoncepcion, prevencion de its y de cancer de cuello uterino",numero de mujeres con pildora anticonceptiva oral de emergencia,2016-01-01,0,0,0,1,0,1
YACO,"anticoncepcion, prevencion de its y de cancer de cuello uterino",numero de mujeres con pildora anticonceptiva oral de emergencia,2016-01-01,0,1,0,0,0,1
YUNCHARA,"anticoncepcion, prevencion de its y de cancer de cuello uterino",numero de mujeres con pildora anticonceptiva oral de emergencia,2016-01-01,0,0,3,2,0,5
AIQUILE,"anticoncepcion, prevencion de its y de cancer de cuello uterino",numero de mujeres con pildora anticonceptiva oral de emergencia,2016-02-01,0,0,5,0,0,5
ALTO BENI,"anticoncepcion, prevencion de its y de cancer de cuello uterino",numero de mujeres con pildora anticonceptiva oral de emergencia,2016-02-01,1,0,2,0,0,3
APOLO,"anticoncepcion, prevencion de its y de cancer de cuello uterino",numero de mujeres con pildora anticonceptiva oral de emergencia,2016-02-01,0,2,0,0,0,2
ARQUE,"anticoncepcion, prevencion de its y de cancer de cuello uterino",numero de mujeres con pildora anticonceptiva oral de emergencia,2016-02-01,0,0,11,8,0,19
AYOPAYA (V. DE INDEPENDENCIA),"anticoncepcion, prevencion de its y de cancer de cuello uterino",numero de mujeres con pildora anticonceptiva oral de emergencia,2016-02-01,0,1,0,1,0,2
BERMEJO,"anticoncepcion, prevencion de its y de cancer de cuello uterino",numero de mujeres con pildora anticonceptiva oral de emergencia,2016-02-01,0,0,2,0,0,2
BETANZOS,"anticoncepcion, prevencion de its y de cancer de cuello uterino",numero de mujeres con pildora anticonceptiva oral de emergencia,2016-02-01,0,0,1,0,0,1
CABEZAS,"anticoncepcion, prevencion de its y de cancer de cuello uterino",numero de mujeres con pildora anticonceptiva oral de emergencia,2016-02-01,0,0,2,0,0,2
"CAIZA ""D""","anticoncepcion, prevencion de its y de cancer de cuello uterino",numero de mujeres con pildora anticonceptiva oral de emergencia,2016-02-01,0,0,1,0,0,1
CAMARGO,"anticoncepcion, prevencion de its y de cancer de cuello uterino",numero de mujeres con pildora anticonceptiva oral de emergencia,2016-02-01,0,0,1,0,0,1
CAQUIAVIRI,"anticoncepcion, prevencion de its y de cancer de cuello uterino",numero de mujeres con pildora anticonceptiva oral de emergencia,2016-02-01,0,0,3,0,0,3
CHALLAPATA,"anticoncepcion, prevencion de its y de cancer de cuello uterino",numero de mujeres con pildora anticonceptiva oral de emergencia,2016-02-01,0,0,3,1,0,4
CHARAGUA,"anticoncepcion, prevencion de its y de cancer de cuello uterino",numero de mujeres con pildora anticonceptiva oral de emergencia,2016-02-01,0,0,1,0,0,1
CHULUMANI (V. DE LA LIBERTAD),"anticoncepcion, prevencion de its y de cancer de cuello uterino",numero de mujeres con pildora anticonceptiva oral de emergencia,2016-02-01,0,0,0,1,0,1
COBIJA,"anticoncepcion, prevencion de its y de cancer de cuello uterino",numero de mujeres con pildora anticonceptiva oral de emergencia,2016-02-01,0,0,1,0,0,1
COCHABAMBA,"anticoncepcion, prevencion de its y de cancer de cuello uterino",numero de mujeres con pildora anticonceptiva oral de emergencia,2016-02-01,2,7,6,24,0,39
COLCAPIRHUA,"anticoncepcion, prevencion de its y de cancer de cuello uterino",numero de mujeres con pildora anticonceptiva oral de emergencia,2016-02-01,0,0,168,16,0,184
COLOMI,"anticoncepcion, prevencion de its y de cancer de cuello uterino",numero de mujeres con pildora anticonceptiva oral de emergencia,2016-02-01,0,0,1,0,0,1
COLQUECHACA,"anticoncepcion, prevencion de its y de cancer de cuello uterino",numero de mujeres con pildora anticonceptiva oral de emergencia,2016-02-01,0,0,2,0,0,2
CORIPATA,"anticoncepcion, prevencion de its y de cancer de cuello uterino",numero de mujeres con pildora anticonceptiva oral de emergencia,2016-02-01,0,1,2,0,0,3
COTAGAITA,"anticoncepcion, prevencion de its y de cancer de cuello uterino",numero de mujeres con pildora anticonceptiva oral de emergencia,2016-02-01,0,0,4,0,0,4
CUATRO CAÑADAS,"anticoncepcion, prevencion de its y de cancer de cuello uterino",numero de mujeres con pildora anticonceptiva oral de emergencia,2016-02-01,0,1,5,6,3,15
CULPINA,"anticoncepcion, prevencion de its y de cancer de cuello uterino",numero de mujeres con pildora anticonceptiva oral de emergencia,2016-02-01,0,1,1,0,0,2
EL ALTO,"anticoncepcion, prevencion de its y de cancer de cuello uterino",numero de mujeres con pildora anticonceptiva oral de emergencia,2016-02-01,0,3,5,8,0,16
EL TORNO,"anticoncepcion, prevencion de its y de cancer de cuello uterino",numero de mujeres con pildora anticonceptiva oral de emergencia,2016-02-01,0,1,4,1,0,6
EL VILLAR,"anticoncepcion, prevencion de its y de cancer de cuello uterino",numero de mujeres con pildora anticonceptiva oral de emergencia,2016-02-01,0,0,1,0,0,1
GUANAY,"anticoncepcion, prevencion de its y de cancer de cuello uterino",numero de mujeres con pildora anticonceptiva oral de emergencia,2016-02-01,0,2,16,4,0,22
GUAYARAMERIN,"anticoncepcion, prevencion de its y de cancer de cuello uterino",numero de mujeres con pildora anticonceptiva oral de emergencia,2016-02-01,0,0,13,0,0,13
HUMANATA,"anticoncepcion, prevencion de its y de cancer de cuello uterino",numero de mujeres con pildora anticonceptiva oral de emergencia,2016-02-01,0,0,2,1,0,3
INCAHUASI,"anticoncepcion, prevencion de its y de cancer de cuello uterino",numero de mujeres con pildora anticonceptiva oral de emergencia,2016-02-01,0,1,2,0,0,3
JESUS DE MACHACA,"anticoncepcion, prevencion de its y de cancer de cuello uterino",numero de mujeres con pildora anticonceptiva oral de emergencia,2016-02-01,0,0,1,0,0,1
LA PAZ,"anticoncepcion, prevencion de its y de cancer de cuello uterino",numero de mujeres con pildora anticonceptiva oral de emergencia,2016-02-01,0,3,12,0,0,15
MACHARETI,"anticoncepcion, prevencion de its y de cancer de cuello uterino",numero de mujeres con pildora anticonceptiva oral de emergencia,2016-02-01,0,1,2,1,0,4
MAIRANA,"anticoncepcion, prevencion de its y de cancer de cuello uterino",numero de mujeres con pildora anticonceptiva oral de emergencia,2016-02-01,0,1,2,0,0,3
MIZQUE,"anticoncepcion, prevencion de its y de cancer de cuello uterino",numero de mujeres con pildora anticonceptiva oral de emergencia,2016-02-01,0,1,3,0,0,4
MONTEAGUDO,"anticoncepcion, prevencion de its y de cancer de cuello uterino",numero de mujeres con pildora anticonceptiva oral de emergencia,2016-02-01,0,0,2,0,0,2
MONTERO,"anticoncepcion, prevencion de its y de cancer de cuello uterino",numero de mujeres con pildora anticonceptiva oral de emergencia,2016-02-01,0,0,1,0,0,1
OMEREQUE,"anticoncepcion, prevencion de its y de cancer de cuello uterino",numero de mujeres con pildora anticonceptiva oral de emergencia,2016-02-01,0,1,2,0,0,3
ORURO,"anticoncepcion, prevencion de its y de cancer de cuello uterino",numero de mujeres con pildora anticonceptiva oral de emergencia,2016-02-01,0,6,22,10,0,38
PADCAYA,"anticoncepcion, prevencion de its y de cancer de cuello uterino",numero de mujeres con pildora anticonceptiva oral de emergencia,2016-02-01,0,1,0,0,0,1
PALOS BLANCOS,"anticoncepcion, prevencion de its y de cancer de cuello uterino",numero de mujeres con pildora anticonceptiva oral de emergencia,2016-02-01,0,0,1,0,0,1
POCOATA,"anticoncepcion, prevencion de its y de cancer de cuello uterino",numero de mujeres con pildora anticonceptiva oral de emergencia,2016-02-01,0,0,3,3,0,6
POROMA,"anticoncepcion, prevencion de its y de cancer de cuello uterino",numero de mujeres con pildora anticonceptiva oral de emergencia,2016-02-01,0,0,3,0,0,3
PORONGO,"anticoncepcion, prevencion de its y de cancer de cuello uterino",numero de mujeres con pildora anticonceptiva oral de emergencia,2016-02-01,0,0,5,3,0,8
POTOSI,"anticoncepcion, prevencion de its y de cancer de cuello uterino",numero de mujeres con pildora anticonceptiva oral de emergencia,2016-02-01,0,1,4,0,0,5
PRESTO,"anticoncepcion, prevencion de its y de cancer de cuello uterino",numero de mujeres con pildora anticonceptiva oral de emergencia,2016-02-01,0,4,9,0,0,13
PUNA,"anticoncepcion, prevencion de its y de cancer de cuello uterino",numero de mujeres con pildora anticonceptiva oral de emergencia,2016-02-01,0,0,7,4,0,11
QUILLACOLLO,"anticoncepcion, prevencion de its y de cancer de cuello uterino",numero de mujeres con pildora anticonceptiva oral de emergencia,2016-02-01,0,2,13,9,0,24
RAVELO,"anticoncepcion, prevencion de its y de cancer de cuello uterino",numero de mujeres con pildora anticonceptiva oral de emergencia,2016-02-01,0,1,6,0,0,7
SAIPINA,"anticoncepcion, prevencion de its y de cancer de cuello uterino",numero de mujeres con pildora anticonceptiva oral de emergencia,2016-02-01,0,0,0,6,0,6
SAN BUENA VENTURA,"anticoncepcion, prevencion de its y de cancer de cuello uterino",numero de mujeres con pildora anticonceptiva oral de emergencia,2016-02-01,0,0,1,0,0,1
SAN IGNACIO DE VELASCO,"anticoncepcion, prevencion de its y de cancer de cuello uterino",numero de mujeres con pildora anticonceptiva oral de emergencia,2016-02-01,0,0,1,0,0,1
SAN JOSE DE CHIQUITOS,"anticoncepcion, prevencion de its y de cancer de cuello uterino",numero de mujeres con pildora anticonceptiva oral de emergencia,2016-02-01,0,0,2,3,0,5
SAN LORENZO(TJA),"anticoncepcion, prevencion de its y de cancer de cuello uterino",numero de mujeres con pildora anticonceptiva oral de emergencia,2016-02-01,0,0,1,0,0,1
SAN LUCAS,"anticoncepcion, prevencion de its y de cancer de cuello uterino",numero de mujeres con pildora anticonceptiva oral de emergencia,2016-02-01,0,0,1,1,0,2
SAN PEDRO,"anticoncepcion, prevencion de its y de cancer de cuello uterino",numero de mujeres con pildora anticonceptiva oral de emergencia,2016-02-01,0,0,5,1,0,6
SAN PEDRO DE CURAHUARA,"anticoncepcion, prevencion de its y de cancer de cuello uterino",numero de mujeres con pildora anticonceptiva oral de emergencia,2016-02-01,0,0,0,1,0,1
SANTA CRUZ DE LA SIERRA,"anticoncepcion, prevencion de its y de cancer de cuello uterino",numero de mujeres con pildora anticonceptiva oral de emergencia,2016-02-01,1,7,44,21,2,75
SANTUARIO DE QUILLACAS,"anticoncepcion, prevencion de its y de cancer de cuello uterino",numero de mujeres con pildora anticonceptiva oral de emergencia,2016-02-01,0,1,1,0,0,2
SICA SICA (VILLA AROMA),"anticoncepcion, prevencion de its y de cancer de cuello uterino",numero de mujeres con pildora anticonceptiva oral de emergencia,2016-02-01,0,3,2,4,0,9
SORATA,"anticoncepcion, prevencion de its y de cancer de cuello uterino",numero de mujeres con pildora anticonceptiva oral de emergencia,2016-02-01,0,0,1,0,0,1
SUCRE,"anticoncepcion, prevencion de its y de cancer de cuello uterino",numero de mujeres con pildora anticonceptiva oral de emergencia,2016-02-01,4,1,5,6,0,16
TACOBAMBA,"anticoncepcion, prevencion de its y de cancer de cuello uterino",numero de mujeres con pildora anticonceptiva oral de emergencia,2016-02-01,0,0,1,0,0,1
TAPACARI,"anticoncepcion, prevencion de its y de cancer de cuello uterino",numero de mujeres con pildora anticonceptiva oral de emergencia,2016-02-01,0,1,0,0,0,1
TARABUCO,"anticoncepcion, prevencion de its y de cancer de cuello uterino",numero de mujeres con pildora anticonceptiva oral de emergencia,2016-02-01,0,1,0,0,0,1
TARIJA,"anticoncepcion, prevencion de its y de cancer de cuello uterino",numero de mujeres con pildora anticonceptiva oral de emergencia,2016-02-01,0,6,6,2,0,14
TARVITA,"anticoncepcion, prevencion de its y de cancer de cuello uterino",numero de mujeres con pildora anticonceptiva oral de emergencia,2016-02-01,0,0,1,1,0,2
TEOPONTE,"anticoncepcion, prevencion de its y de cancer de cuello uterino",numero de mujeres con pildora anticonceptiva oral de emergencia,2016-02-01,0,0,1,1,0,2
TIRAQUE (CBBA),"anticoncepcion, prevencion de its y de cancer de cuello uterino",numero de mujeres con pildora anticonceptiva oral de emergencia,2016-02-01,0,0,1,0,0,1
TOMAVE,"anticoncepcion, prevencion de its y de cancer de cuello uterino",numero de mujeres con pildora anticonceptiva oral de emergencia,2016-02-01,0,0,5,0,0,5
TORO TORO,"anticoncepcion, prevencion de its y de cancer de cuello uterino",numero de mujeres con pildora anticonceptiva oral de emergencia,2016-02-01,1,0,22,2,0,25
TOTORA(ORR),"anticoncepcion, prevencion de its y de cancer de cuello uterino",numero de mujeres con pildora anticonceptiva oral de emergencia,2016-02-01,0,1,0,0,0,1
TRINIDAD,"anticoncepcion, prevencion de its y de cancer de cuello uterino",numero de mujeres con pildora anticonceptiva oral de emergencia,2016-02-01,0,1,2,42,2,47
TUPIZA,"anticoncepcion, prevencion de its y de cancer de cuello uterino",numero de mujeres con pildora anticonceptiva oral de emergencia,2016-02-01,0,1,3,2,0,6
TURCO,"anticoncepcion, prevencion de its y de cancer de cuello uterino",numero de mujeres con pildora anticonceptiva oral de emergencia,2016-02-01,0,0,1,0,0,1
UYUNI,"anticoncepcion, prevencion de its y de cancer de cuello uterino",numero de mujeres con pildora anticonceptiva oral de emergencia,2016-02-01,0,0,3,1,0,4
VILLA TUNARI,"anticoncepcion, prevencion de its y de cancer de cuello uterino",numero de mujeres con pildora anticonceptiva oral de emergencia,2016-02-01,0,0,1,0,0,1
VILLA VACA GUZMAN (MUYUPAMPA),"anticoncepcion, prevencion de its y de cancer de cuello uterino",numero de mujeres con pildora anticonceptiva oral de emergencia,2016-02-01,0,9,7,0,0,16
WARNES,"anticoncepcion, prevencion de its y de cancer de cuello uterino",numero de mujeres con pildora anticonceptiva oral de emergencia,2016-02-01,0,0,7,1,0,8
YACUIBA,"anticoncepcion, prevencion de its y de cancer de cuello uterino",numero de mujeres con pildora anticonceptiva oral de emergencia,2016-02-01,0,0,1,0,0,1
ZUDAÑEZ,"anticoncepcion, prevencion de its y de cancer de cuello uterino",numero de mujeres con pildora anticonceptiva oral de emergencia,2016-02-01,0,1,0,0,0,1
ACHACACHI,"anticoncepcion, prevencion de its y de cancer de cuello uterino",numero de mujeres con pildora anticonceptiva oral de emergencia,2016-03-01,0,0,8,1,0,9
AIQUILE,"anticoncepcion, prevencion de its y de cancer de cuello uterino",numero de mujeres con pildora anticonceptiva oral de emergencia,2016-03-01,0,0,5,0,0,5
ALTO BENI,"anticoncepcion, prevencion de its y de cancer de cuello uterino",numero de mujeres con pildora anticonceptiva oral de emergencia,2016-03-01,0,2,3,2,1,8
ANZALDO,"anticoncepcion, prevencion de its y de cancer de cuello uterino",numero de mujeres con pildora anticonceptiva oral de emergencia,2016-03-01,0,0,0,1,0,1
APOLO,"anticoncepcion, prevencion de its y de cancer de cuello uterino",numero de mujeres con pildora anticonceptiva oral de emergencia,2016-03-01,0,0,1,0,0,1
ARBIETO,"anticoncepcion, prevencion de its y de cancer de cuello uterino",numero de mujeres con pildora anticonceptiva oral de emergencia,2016-03-01,0,1,2,1,1,5
ARQUE,"anticoncepcion, prevencion de its y de cancer de cuello uterino",numero de mujeres con pildora anticonceptiva oral de emergencia,2016-03-01,0,0,1,0,0,1
AYOPAYA (V. DE INDEPENDENCIA),"anticoncepcion, prevencion de its y de cancer de cuello uterino",numero de mujeres con pildora anticonceptiva oral de emergencia,2016-03-01,0,0,1,0,0,1
BATALLAS,"anticoncepcion, prevencion de its y de cancer de cuello uterino",numero de mujeres con pildora anticonceptiva oral de emergencia,2016-03-01,0,0,5,1,0,6
BETANZOS,"anticoncepcion, prevencion de its y de cancer de cuello uterino",numero de mujeres con pildora anticonceptiva oral de emergencia,2016-03-01,0,2,1,0,0,3
CABEZAS,"anticoncepcion, prevencion de its y de cancer de cuello uterino",numero de mujeres con pildora anticonceptiva oral de emergencia,2016-03-01,0,3,1,1,0,5
"CAIZA ""D""","anticoncepcion, prevencion de its y de cancer de cuello uterino",numero de mujeres con pildora anticonceptiva oral de emergencia,2016-03-01,0,1,1,0,0,2
CAMARGO,"anticoncepcion, prevencion de its y de cancer de cuello uterino",numero de mujeres con pildora anticonceptiva oral de emergencia,2016-03-01,0,0,2,0,0,2
CAPINOTA,"anticoncepcion, prevencion de its y de cancer de cuello uterino",numero de mujeres con pildora anticonceptiva oral de emergencia,2016-03-01,0,0,5,1,0,6
CARANAVI,"anticoncepcion, prevencion de its y de cancer de cuello uterino",numero de mujeres con pildora anticonceptiva oral de emergencia,2016-03-01,1,0,0,0,0,1
CARIPUYO,"anticoncepcion, prevencion de its y de cancer de cuello uterino",numero de mujeres con pildora anticonceptiva oral de emergencia,2016-03-01,0,0,1,0,0,1
CHALLAPATA,"anticoncepcion, prevencion de its y de cancer de cuello uterino",numero de mujeres con pildora anticonceptiva oral de emergencia,2016-03-01,0,1,7,2,0,10
CHARAGUA,"anticoncepcion, prevencion de its y de cancer de cuello uterino",numero de mujeres con pildora anticonceptiva oral de emergencia,2016-03-01,0,0,2,0,0,2
CHIMORE,"anticoncepcion, prevencion de its y de cancer de cuello uterino",numero de mujeres con pildora anticonceptiva oral de emergencia,2016-03-01,0,0,1,2,0,3
CHULUMANI (V. DE LA LIBERTAD),"anticoncepcion, prevencion de its y de cancer de cuello uterino",numero de mujeres con pildora anticonceptiva oral de emergencia,2016-03-01,0,0,1,5,0,6
CHUMA,"anticoncepcion, prevencion de its y de cancer de cuello uterino",numero de mujeres con pildora anticonceptiva oral de emergencia,2016-03-01,0,1,0,0,0,1
CLIZA,"anticoncepcion, prevencion de its y de cancer de cuello uterino",numero de mujeres con pildora anticonceptiva oral de emergencia,2016-03-01,0,0,2,0,0,2
COBIJA,"anticoncepcion, prevencion de its y de cancer de cuello uterino",numero de mujeres con pildora anticonceptiva oral de emergencia,2016-03-01,0,0,1,0,0,1
COCHABAMBA,"anticoncepcion, prevencion de its y de cancer de cuello uterino",numero de mujeres con pildora anticonceptiva oral de emergencia,2016-03-01,2,41,144,1,0,188
"COLCHA ""K""","anticoncepcion, prevencion de its y de cancer de cuello uterino",numero de mujeres con pildora anticonceptiva oral de emergencia,2016-03-01,0,0,2,0,0,2
COLOMI,"anticoncepcion, prevencion de its y de cancer de cuello uterino",numero de mujeres con pildora anticonceptiva oral de emergencia,2016-03-01,0,0,4,0,0,4
COLQUECHACA,"anticoncepcion, prevencion de its y de cancer de cuello uterino",numero de mujeres con pildora anticonceptiva oral de emergencia,2016-03-01,0,0,3,4,0,7
COTAGAITA,"anticoncepcion, prevencion de its y de cancer de cuello uterino",numero de mujeres con pildora anticonceptiva oral de emergencia,2016-03-01,0,0,4,0,0,4
COTOCA,"anticoncepcion, prevencion de its y de cancer de cuello uterino",numero de mujeres con pildora anticonceptiva oral de emergencia,2016-03-01,0,0,1,0,0,1
CUCHUMUELA (V. G. VILLARROEL),"anticoncepcion, prevencion de its y de cancer de cuello uterino",numero de mujeres con pildora anticonceptiva oral de emergencia,2016-03-01,0,0,1,0,0,1
CULPINA,"anticoncepcion, prevencion de its y de cancer de cuello uterino",numero de mujeres con pildora anticonceptiva oral de emergencia,2016-03-01,0,0,1,0,0,1
EL ALTO,"anticoncepcion, prevencion de its y de cancer de cuello uterino",numero de mujeres con pildora anticonceptiva oral de emergencia,2016-03-01,0,3,7,1,0,11
EL PUENTE(TJA),"anticoncepcion, prevencion de its y de cancer de cuello uterino",numero de mujeres con pildora anticonceptiva oral de emergencia,2016-03-01,0,0,0,1,0,1
EL TORNO,"anticoncepcion, prevencion de its y de cancer de cuello uterino",numero de mujeres con pildora anticonceptiva oral de emergencia,2016-03-01,0,2,2,0,0,4
ENTRE RIOS CBBA,"anticoncepcion, prevencion de its y de cancer de cuello uterino",numero de mujeres con pildora anticonceptiva oral de emergencia,2016-03-01,0,1,0,0,0,1
ESCARA,"anticoncepcion, prevencion de its y de cancer de cuello uterino",numero de mujeres con pildora anticonceptiva oral de emergencia,2016-03-01,0,2,14,4,0,20
GENERAL SAAVEDRA,"anticoncepcion, prevencion de its y de cancer de cuello uterino",numero de mujeres con pildora anticonceptiva oral de emergencia,2016-03-01,0,0,1,0,0,1
GUAYARAMERIN,"anticoncepcion, prevencion de its y de cancer de cuello uterino",numero de mujeres con pildora anticonceptiva oral de emergencia,2016-03-01,0,0,4,0,0,4
HUACARETA,"anticoncepcion, prevencion de its y de cancer de cuello uterino",numero de mujeres con pildora anticonceptiva oral de emergencia,2016-03-01,0,3,10,4,0,17
INCAHUASI,"anticoncepcion, prevencion de its y de cancer de cuello uterino",numero de mujeres con pildora anticonceptiva oral de emergencia,2016-03-01,0,1,3,1,0,5
LA PAZ,"anticoncepcion, prevencion de its y de cancer de cuello uterino",numero de mujeres con pildora anticonceptiva oral de emergencia,2016-03-01,0,2,14,3,0,19
LAS CARRERAS,"anticoncepcion, prevencion de its y de cancer de cuello uterino",numero de mujeres con pildora anticonceptiva oral de emergencia,2016-03-01,0,0,1,0,0,1
LLICA,"anticoncepcion, prevencion de its y de cancer de cuello uterino",numero de mujeres con pildora anticonceptiva oral de emergencia,2016-03-01,0,0,1,0,0,1
MACHACAMARCA,"anticoncepcion, prevencion de its y de cancer de cuello uterino",numero de mujeres con pildora anticonceptiva oral de emergencia,2016-03-01,0,0,2,0,0,2
MACHARETI,"anticoncepcion, prevencion de its y de cancer de cuello uterino",numero de mujeres con pildora anticonceptiva oral de emergencia,2016-03-01,0,2,3,0,0,5
MAPIRI,"anticoncepcion, prevencion de its y de cancer de cuello uterino",numero de mujeres con pildora anticonceptiva oral de emergencia,2016-03-01,0,0,2,1,0,3
MIZQUE,"anticoncepcion, prevencion de its y de cancer de cuello uterino",numero de mujeres con pildora anticonceptiva oral de emergencia,2016-03-01,0,2,0,0,0,2
MONTEAGUDO,"anticoncepcion, prevencion de its y de cancer de cuello uterino",numero de mujeres con pildora anticonceptiva oral de emergencia,2016-03-01,0,0,0,1,0,1
MONTERO,"anticoncepcion, prevencion de its y de cancer de cuello uterino",numero de mujeres con pildora anticonceptiva oral de emergencia,2016-03-01,0,38,66,3,0,107
OCURI,"anticoncepcion, prevencion de its y de cancer de cuello uterino",numero de mujeres con pildora anticonceptiva oral de emergencia,2016-03-01,0,0,1,3,0,4
OMEREQUE,"anticoncepcion, prevencion de its y de cancer de cuello uterino",numero de mujeres con pildora anticonceptiva oral de emergencia,2016-03-01,0,0,1,0,0,1
ORURO,"anticoncepcion, prevencion de its y de cancer de cuello uterino",numero de mujeres con pildora anticonceptiva oral de emergencia,2016-03-01,0,2,8,2,0,12
PADCAYA,"anticoncepcion, prevencion de its y de cancer de cuello uterino",numero de mujeres con pildora anticonceptiva oral de emergencia,2016-03-01,0,1,1,0,0,2
PADILLA,"anticoncepcion, prevencion de its y de cancer de cuello uterino",numero de mujeres con pildora anticonceptiva oral de emergencia,2016-03-01,0,0,3,0,0,3
PAILON,"anticoncepcion, prevencion de its y de cancer de cuello uterino",numero de mujeres con pildora anticonceptiva oral de emergencia,2016-03-01,1,0,0,0,0,1
PALCA,"anticoncepcion, prevencion de its y de cancer de cuello uterino",numero de mujeres con pildora anticonceptiva oral de emergencia,2016-03-01,0,1,10,6,2,19
POCOATA,"anticoncepcion, prevencion de its y de cancer de cuello uterino",numero de mujeres con pildora anticonceptiva oral de emergencia,2016-03-01,0,0,4,0,0,4
POCONA,"anticoncepcion, prevencion de its y de cancer de cuello uterino",numero de mujeres con pildora anticonceptiva oral de emergencia,2016-03-01,0,0,1,0,0,1
POJO (CBBA),"anticoncepcion, prevencion de its y de cancer de cuello uterino",numero de mujeres con pildora anticonceptiva oral de emergencia,2016-03-01,0,0,12,6,0,18
POSTRER VALLE,"anticoncepcion, prevencion de its y de cancer de cuello uterino",numero de mujeres con pildora anticonceptiva oral de emergencia,2016-03-01,0,0,0,1,0,1
POTOSI,"anticoncepcion, prevencion de its y de cancer de cuello uterino",numero de mujeres con pildora anticonceptiva oral de emergencia,2016-03-01,0,8,45,26,0,79
PRESTO,"anticoncepcion, prevencion de its y de cancer de cuello uterino",numero de mujeres con pildora anticonceptiva oral de emergencia,2016-03-01,0,0,2,0,0,2
PUERTO RICO,"anticoncepcion, prevencion de its y de cancer de cuello uterino",numero de mujeres con pildora anticonceptiva oral de emergencia,2016-03-01,0,0,1,0,0,1
PUERTO VILLARROEL,"anticoncepcion, prevencion de its y de cancer de cuello uterino",numero de mujeres con pildora anticonceptiva oral de emergencia,2016-03-01,0,0,2,3,0,5
PUNA,"anticoncepcion, prevencion de its y de cancer de cuello uterino",numero de mujeres con pildora anticonceptiva oral de emergencia,2016-03-01,0,1,12,17,6,36
PUNATA,"anticoncepcion, prevencion de its y de cancer de cuello uterino",numero de mujeres con pildora anticonceptiva oral de emergencia,2016-03-01,0,2,9,1,0,12
RAVELO,"anticoncepcion, prevencion de its y de cancer de cuello uterino",numero de mujeres con pildora anticonceptiva oral de emergencia,2016-03-01,0,1,6,1,0,8
RURRENABAQUE,"anticoncepcion, prevencion de its y de cancer de cuello uterino",numero de mujeres con pildora anticonceptiva oral de emergencia,2016-03-01,0,1,5,2,0,8
SACABA,"anticoncepcion, prevencion de its y de cancer de cuello uterino",numero de mujeres con pildora anticonceptiva oral de emergencia,2016-03-01,0,1,6,1,0,8
SAN IGNACIO,"anticoncepcion, prevencion de its y de cancer de cuello uterino",numero de mujeres con pildora anticonceptiva oral de emergencia,2016-03-01,0,1,3,0,0,4
SAN JULIAN,"anticoncepcion, prevencion de its y de cancer de cuello uterino",numero de mujeres con pildora anticonceptiva oral de emergencia,2016-03-01,0,0,3,0,0,3
SAN PEDRO,"anticoncepcion, prevencion de its y de cancer de cuello uterino",numero de mujeres con pildora anticonceptiva oral de emergencia,2016-03-01,0,0,6,1,0,7
SAN PEDRO DE CURAHUARA,"anticoncepcion, prevencion de its y de cancer de cuello uterino",numero de mujeres con pildora anticonceptiva oral de emergencia,2016-03-01,0,1,2,1,0,4
SANTA CRUZ DE LA SIERRA,"anticoncepcion, prevencion de its y de cancer de cuello uterino",numero de mujeres con pildora anticonceptiva oral de emergencia,2016-03-01,0,0,10,3,3,16
SANTA ROSA DEL SARA,"anticoncepcion, prevencion de its y de cancer de cuello uterino",numero de mujeres con pildora anticonceptiva oral de emergencia,2016-03-01,0,0,2,2,0,4
SANTIVAÑES,"anticoncepcion, prevencion de its y de cancer de cuello uterino",numero de mujeres con pildora anticonceptiva oral de emergencia,2016-03-01,0,0,1,0,0,1
SANTUARIO DE QUILLACAS,"anticoncepcion, prevencion de its y de cancer de cuello uterino",numero de mujeres con pildora anticonceptiva oral de emergencia,2016-03-01,0,0,1,0,0,1
SHINAOTA,"anticoncepcion, prevencion de its y de cancer de cuello uterino",numero de mujeres con pildora anticonceptiva oral de emergencia,2016-03-01,0,1,0,0,0,1
SICA SICA (VILLA AROMA),"anticoncepcion, prevencion de its y de cancer de cuello uterino",numero de mujeres con pildora anticonceptiva oral de emergencia,2016-03-01,0,0,4,0,0,4
SIPE SIPE,"anticoncepcion, prevencion de its y de cancer de cuello uterino",numero de mujeres con pildora anticonceptiva oral de emergencia,2016-03-01,0,0,2,0,1,3
SORATA,"anticoncepcion, prevencion de its y de cancer de cuello uterino",numero de mujeres con pildora anticonceptiva oral de emergencia,2016-03-01,0,0,1,0,0,1
SUCRE,"anticoncepcion, prevencion de its y de cancer de cuello uterino",numero de mujeres con pildora anticonceptiva oral de emergencia,2016-03-01,0,2,6,2,0,10
TACACOMA,"anticoncepcion, prevencion de its y de cancer de cuello uterino",numero de mujeres con pildora anticonceptiva oral de emergencia,2016-03-01,0,0,3,0,0,3
TACOBAMBA,"anticoncepcion, prevencion de its y de cancer de cuello uterino",numero de mujeres con pildora anticonceptiva oral de emergencia,2016-03-01,0,0,0,1,0,1
TACOPAYA,"anticoncepcion, prevencion de its y de cancer de cuello uterino",numero de mujeres con pildora anticonceptiva oral de emergencia,2016-03-01,0,0,1,0,0,1
TARABUCO,"anticoncepcion, prevencion de its y de cancer de cuello uterino",numero de mujeres con pildora anticonceptiva oral de emergencia,2016-03-01,0,0,4,0,0,4
TARIJA,"anticoncepcion, prevencion de its y de cancer de cuello uterino",numero de mujeres con pildora anticonceptiva oral de emergencia,2016-03-01,0,7,6,5,0,18
TEOPONTE,"anticoncepcion, prevencion de its y de cancer de cuello uterino",numero de mujeres con pildora anticonceptiva oral de emergencia,2016-03-01,0,2,2,3,0,7
TINGUIPAYA,"anticoncepcion, prevencion de its y de cancer de cuello uterino",numero de mujeres con pildora anticonceptiva oral de emergencia,2016-03-01,0,0,3,0,0,3
TOLEDO,"anticoncepcion, prevencion de its y de cancer de cuello uterino",numero de mujeres con pildora anticonceptiva oral de emergencia,2016-03-01,0,1,13,4,0,18
TOMAVE,"anticoncepcion, prevencion de its y de cancer de cuello uterino",numero de mujeres con pildora anticonceptiva oral de emergencia,2016-03-01,0,2,1,0,0,3
TOTORA(CBBA),"anticoncepcion, prevencion de its y de cancer de cuello uterino",numero de mujeres con pildora anticonceptiva oral de emergencia,2016-03-01,0,1,0,0,0,1
TRINIDAD,"anticoncepcion, prevencion de its y de cancer de cuello uterino",numero de mujeres con pildora anticonceptiva oral de emergencia,2016-03-01,0,4,43,8,0,55
TUPIZA,"anticoncepcion, prevencion de its y de cancer de cuello uterino",numero de mujeres con pildora anticonceptiva oral de emergencia,2016-03-01,0,1,0,0,0,1
UNCIA,"anticoncepcion, prevencion de its y de cancer de cuello uterino",numero de mujeres con pildora anticonceptiva oral de emergencia,2016-03-01,0,0,2,0,0,2
URIONDO (A. CONCEPCION),"anticoncepcion, prevencion de its y de cancer de cuello uterino",numero de mujeres con pildora anticonceptiva oral de emergencia,2016-03-01,0,0,7,4,0,11
VIACHA,"anticoncepcion, prevencion de its y de cancer de cuello uterino",numero de mujeres con pildora anticonceptiva oral de emergencia,2016-03-01,0,7,76,23,11,117
VILLA CHARCAS,"anticoncepcion, prevencion de its y de cancer de cuello uterino",numero de mujeres con pildora anticonceptiva oral de emergencia,2016-03-01,0,0,1,1,0,2
WARNES,"anticoncepcion, prevencion de its y de cancer de cuello uterino",numero de mujeres con pildora anticonceptiva oral de emergencia,2016-03-01,0,1,5,0,0,6
YAMPARAEZ,"anticoncepcion, prevencion de its y de cancer de cuello uterino",numero de mujeres con pildora anticonceptiva oral de emergencia,2016-03-01,0,2,0,0,0,2
ACHACACHI,"anticoncepcion, prevencion de its y de cancer de cuello uterino",numero de mujeres con pildora anticonceptiva oral de emergencia,2016-04-01,0,0,1,0,0,1
AIQUILE,"anticoncepcion, prevencion de its y de cancer de cuello uterino",numero de mujeres con pildora anticonceptiva oral de emergencia,2016-04-01,0,0,2,1,0,3
ALALAY,"anticoncepcion, prevencion de its y de cancer de cuello uterino",numero de mujeres con pildora anticonceptiva oral de emergencia,2016-04-01,0,0,2,0,0,2
ALCALA,"anticoncepcion, prevencion de its y de cancer de cuello uterino",numero de mujeres con pildora anticonceptiva oral de emergencia,2016-04-01,0,2,0,0,0,2
ALTO BENI,"anticoncepcion, prevencion de its y de cancer de cuello uterino",numero de mujeres con pildora anticonceptiva oral de emergencia,2016-04-01,0,0,11,2,0,13
APOLO,"anticoncepcion, prevencion de its y de cancer de cuello uterino",numero de mujeres con pildora anticonceptiva oral de emergencia,2016-04-01,0,0,1,1,0,2
ARBIETO,"anticoncepcion, prevencion de its y de cancer de cuello uterino",numero de mujeres con pildora anticonceptiva oral de emergencia,2016-04-01,0,0,2,0,0,2
AYOPAYA (V. DE INDEPENDENCIA),"anticoncepcion, prevencion de its y de cancer de cuello uterino",numero de mujeres con pildora anticonceptiva oral de emergencia,2016-04-01,1,1,1,0,0,3
BELEN DE ANDAMARCA,"anticoncepcion, prevencion de its y de cancer de cuello uterino",numero de mujeres con pildora anticonceptiva oral de emergencia,2016-04-01,0,0,1,2,0,3
BOLPEBRA,"anticoncepcion, prevencion de its y de cancer de cuello uterino",numero de mujeres con pildora anticonceptiva oral de emergencia,2016-04-01,0,0,1,0,0,1
"CAIZA ""D""","anticoncepcion, prevencion de its y de cancer de cuello uterino",numero de mujeres con pildora anticonceptiva oral de emergencia,2016-04-01,0,1,2,0,0,3
CAMARGO,"anticoncepcion, prevencion de its y de cancer de cuello uterino",numero de mujeres con pildora anticonceptiva oral de emergencia,2016-04-01,0,8,11,2,0,21
CAPINOTA,"anticoncepcion, prevencion de its y de cancer de cuello uterino",numero de mujeres con pildora anticonceptiva oral de emergencia,2016-04-01,0,0,6,0,0,6
CARACOLLO,"anticoncepcion, prevencion de its y de cancer de cuello uterino",numero de mujeres con pildora anticonceptiva oral de emergencia,2016-04-01,0,0,1,0,0,1
CHALLAPATA,"anticoncepcion, prevencion de its y de cancer de cuello uterino",numero de mujeres con pildora anticonceptiva oral de emergencia,2016-04-01,0,0,3,0,0,3
CHARAGUA,"anticoncepcion, prevencion de its y de cancer de cuello uterino",numero de mujeres con pildora anticonceptiva oral de emergencia,2016-04-01,0,0,2,0,0,2
CHAYANTA,"anticoncepcion, prevencion de its y de cancer de cuello uterino",numero de mujeres con pildora anticonceptiva oral de emergencia,2016-04-01,0,0,3,3,0,6
CHIMORE,"anticoncepcion, prevencion de its y de cancer de cuello uterino",numero de mujeres con pildora anticonceptiva oral de emergencia,2016-04-01,0,0,2,0,0,2
CHOQUE COTA,"anticoncepcion, prevencion de its y de cancer de cuello uterino",numero de mujeres con pildora anticonceptiva oral de emergencia,2016-04-01,0,0,1,0,0,1
CHULUMANI (V. DE LA LIBERTAD),"anticoncepcion, prevencion de its y de cancer de cuello uterino",numero de mujeres con pildora anticonceptiva oral de emergencia,2016-04-01,0,0,2,0,0,2
CHUMA,"anticoncepcion, prevencion de its y de cancer de cuello uterino",numero de mujeres con pildora anticonceptiva oral de emergencia,2016-04-01,1,0,0,0,0,1
CHUQUIHUTA AYLLU JUCUMANI,"anticoncepcion, prevencion de its y de cancer de cuello uterino",numero de mujeres con pildora anticonceptiva oral de emergencia,2016-04-01,0,1,0,0,0,1
COBIJA,"anticoncepcion, prevencion de its y de cancer de cuello uterino",numero de mujeres con pildora anticonceptiva oral de emergencia,2016-04-01,0,0,3,0,0,3
COCHABAMBA,"anticoncepcion, prevencion de its y de cancer de cuello uterino",numero de mujeres con pildora anticonceptiva oral de emergencia,2016-04-01,2,6,9,5,0,22
"COLCHA ""K""","anticoncepcion, prevencion de its y de cancer de cuello uterino",numero de mujeres con pildora anticonceptiva oral de emergencia,2016-04-01,0,1,0,0,0,1
COLOMI,"anticoncepcion, prevencion de its y de cancer de cuello uterino",numero de mujeres con pildora anticonceptiva oral de emergencia,2016-04-01,0,1,1,0,0,2
CORIPATA,"anticoncepcion, prevencion de its y de cancer de cuello uterino",numero de mujeres con pildora anticonceptiva oral de emergencia,2016-04-01,0,0,2,0,0,2
CORQUE,"anticoncepcion, prevencion de its y de cancer de cuello uterino",numero de mujeres con pildora anticonceptiva oral de emergencia,2016-04-01,0,0,1,0,0,1
COTAGAITA,"anticoncepcion, prevencion de its y de cancer de cuello uterino",numero de mujeres con pildora anticonceptiva oral de emergencia,2016-04-01,0,1,10,1,0,12
CUATRO CAÑADAS,"anticoncepcion, prevencion de its y de cancer de cuello uterino",numero de mujeres con pildora anticonceptiva oral de emergencia,2016-04-01,0,0,1,1,0,2
CUCHUMUELA (V. G. VILLARROEL),"anticoncepcion, prevencion de its y de cancer de cuello uterino",numero de mujeres con pildora anticonceptiva oral de emergencia,2016-04-01,0,0,1,0,0,1
EL ALTO,"anticoncepcion, prevencion de its y de cancer de cuello uterino",numero de mujeres con pildora anticonceptiva oral de emergencia,2016-04-01,0,3,14,5,0,22
EL TORNO,"anticoncepcion, prevencion de its y de cancer de cuello uterino",numero de mujeres con pildora anticonceptiva oral de emergencia,2016-04-01,0,5,4,0,0,9
EL VILLAR,"anticoncepcion, prevencion de its y de cancer de cuello uterino",numero de mujeres con pildora anticonceptiva oral de emergencia,2016-04-01,0,0,1,0,0,1
ENTRE RIOS TRJ,"anticoncepcion, prevencion de its y de cancer de cuello uterino",numero de mujeres con pildora anticonceptiva oral de emergencia,2016-04-01,0,0,2,0,0,2
ESMERALDA,"anticoncepcion, prevencion de its y de cancer de cuello uterino",numero de mujeres con pildora anticonceptiva oral de emergencia,2016-04-01,0,0,1,0,0,1
EUREKA (SANTOS MERCADO),"anticoncepcion, prevencion de its y de cancer de cuello uterino",numero de mujeres con pildora anticonceptiva oral de emergencia,2016-04-01,0,0,2,1,0,3
FILADELFIA,"anticoncepcion, prevencion de its y de cancer de cuello uterino",numero de mujeres con pildora anticonceptiva oral de emergencia,2016-04-01,0,0,1,0,0,1
GENERAL SAAVEDRA,"anticoncepcion, prevencion de its y de cancer de cuello uterino",numero de mujeres con pildora anticonceptiva oral de emergencia,2016-04-01,1,0,0,0,0,1
GUANAY,"anticoncepcion, prevencion de its y de cancer de cuello uterino",numero de mujeres con pildora anticonceptiva oral de emergencia,2016-04-01,0,0,5,0,0,5
GUAYARAMERIN,"anticoncepcion, prevencion de its y de cancer de cuello uterino",numero de mujeres con pildora anticonceptiva oral de emergencia,2016-04-01,1,0,9,2,0,12
HUACHACALLA,"anticoncepcion, prevencion de its y de cancer de cuello uterino",numero de mujeres con pildora anticonceptiva oral de emergencia,2016-04-01,0,1,1,0,0,2
ICLA,"anticoncepcion, prevencion de its y de cancer de cuello uterino",numero de mujeres con pildora anticonceptiva oral de emergencia,2016-04-01,0,1,0,0,0,1
INCAHUASI,"anticoncepcion, prevencion de its y de cancer de cuello uterino",numero de mujeres con pildora anticonceptiva oral de emergencia,2016-04-01,0,0,3,1,0,4
LA GUARDIA,"anticoncepcion, prevencion de its y de cancer de cuello uterino",numero de mujeres con pildora anticonceptiva oral de emergencia,2016-04-01,0,1,2,1,0,4
LA PAZ,"anticoncepcion, prevencion de its y de cancer de cuello uterino",numero de mujeres con pildora anticonceptiva oral de emergencia,2016-04-01,0,0,7,0,2,9
LAS CARRERAS,"anticoncepcion, prevencion de its y de cancer de cuello uterino",numero de mujeres con pildora anticonceptiva oral de emergencia,2016-04-01,0,0,2,0,0,2
LLALLAGUA,"anticoncepcion, prevencion de its y de cancer de cuello uterino",numero de mujeres con pildora anticonceptiva oral de emergencia,2016-04-01,0,2,4,0,0,6
MACHACAMARCA,"anticoncepcion, prevencion de its y de cancer de cuello uterino",numero de mujeres con pildora anticonceptiva oral de emergencia,2016-04-01,0,0,1,0,0,1
MACHARETI,"anticoncepcion, prevencion de its y de cancer de cuello uterino",numero de mujeres con pildora anticonceptiva oral de emergencia,2016-04-01,0,2,5,0,0,7
MECAPACA,"anticoncepcion, prevencion de its y de cancer de cuello uterino",numero de mujeres con pildora anticonceptiva oral de emergencia,2016-04-01,0,1,1,0,0,2
MOCOMOCO,"anticoncepcion, prevencion de its y de cancer de cuello uterino",numero de mujeres con pildora anticonceptiva oral de emergencia,2016-04-01,0,0,1,0,0,1
MOJOCOYA,"anticoncepcion, prevencion de its y de cancer de cuello uterino",numero de mujeres con pildora anticonceptiva oral de emergencia,2016-04-01,0,1,0,0,0,1
MONTEAGUDO,"anticoncepcion, prevencion de its y de cancer de cuello uterino",numero de mujeres con pildora anticonceptiva oral de emergencia,2016-04-01,0,1,0,0,0,1
MONTERO,"anticoncepcion, prevencion de its y de cancer de cuello uterino",numero de mujeres con pildora anticonceptiva oral de emergencia,2016-04-01,0,1,0,1,0,2
ORURO,"anticoncepcion, prevencion de its y de cancer de cuello uterino",numero de mujeres con pildora anticonceptiva oral de emergencia,2016-04-01,0,0,4,1,0,5
PADCAYA,"anticoncepcion, prevencion de its y de cancer de cuello uterino",numero de mujeres con pildora anticonceptiva oral de emergencia,2016-04-01,0,0,1,0,0,1
PADILLA,"anticoncepcion, prevencion de its y de cancer de cuello uterino",numero de mujeres con pildora anticonceptiva oral de emergencia,2016-04-01,0,0,2,0,0,2
PALCA,"anticoncepcion, prevencion de its y de cancer de cuello uterino",numero de mujeres con pildora anticonceptiva oral de emergencia,2016-04-01,0,1,4,5,0,10
PAPEL PAMPA,"anticoncepcion, prevencion de its y de cancer de cuello uterino",numero de mujeres con pildora anticonceptiva oral de emergencia,2016-04-01,0,1,1,0,0,2
POCOATA,"anticoncepcion, prevencion de its y de cancer de cuello uterino",numero de mujeres con pildora anticonceptiva oral de emergencia,2016-04-01,0,0,10,3,0,13
POCONA,"anticoncepcion, prevencion de its y de cancer de cuello uterino",numero de mujeres con pildora anticonceptiva oral de emergencia,2016-04-01,0,0,2,0,0,2
POROMA,"anticoncepcion, prevencion de its y de cancer de cuello uterino",numero de mujeres con pildora anticonceptiva oral de emergencia,2016-04-01,0,1,1,0,0,2
POTOSI,"anticoncepcion, prevencion de its y de cancer de cuello uterino",numero de mujeres con pildora anticonceptiva oral de emergencia,2016-04-01,0,0,4,1,0,5
PRESTO,"anticoncepcion, prevencion de its y de cancer de cuello uterino",numero de mujeres con pildora anticonceptiva oral de emergencia,2016-04-01,0,0,6,1,0,7
PUERTO SUAREZ,"anticoncepcion, prevencion de its y de cancer de cuello uterino",numero de mujeres con pildora anticonceptiva oral de emergencia,2016-04-01,0,0,0,1,0,1
QUILLACOLLO,"anticoncepcion, prevencion de its y de cancer de cuello uterino",numero de mujeres con pildora anticonceptiva oral de emergencia,2016-04-01,0,0,1,0,0,1
RAVELO,"anticoncepcion, prevencion de its y de cancer de cuello uterino",numero de mujeres con pildora anticonceptiva oral de emergencia,2016-04-01,0,0,2,0,0,2
SACABA,"anticoncepcion, prevencion de its y de cancer de cuello uterino",numero de mujeres con pildora anticonceptiva oral de emergencia,2016-04-01,0,0,3,3,0,6
SACACA,"anticoncepcion, prevencion de its y de cancer de cuello uterino",numero de mujeres con pildora anticonceptiva oral de emergencia,2016-04-01,0,1,13,6,0,20
SAN ANDRES,"anticoncepcion, prevencion de its y de cancer de cuello uterino",numero de mujeres con pildora anticonceptiva oral de emergencia,2016-04-01,0,0,0,1,0,1
SAN IGNACIO DE VELASCO,"anticoncepcion, prevencion de its y de cancer de cuello uterino",numero de mujeres con pildora anticonceptiva oral de emergencia,2016-04-01,0,1,3,0,0,4
SAN JAVIER(BNI),"anticoncepcion, prevencion de its y de cancer de cuello uterino",numero de mujeres con pildora anticonceptiva oral de emergencia,2016-04-01,0,0,10,0,0,10
SAN JOSE DE CHIQUITOS,"anticoncepcion, prevencion de its y de cancer de cuello uterino",numero de mujeres con pildora anticonceptiva oral de emergencia,2016-04-01,0,0,0,1,0,1
SAN LUCAS,"anticoncepcion, prevencion de its y de cancer de cuello uterino",numero de mujeres con pildora anticonceptiva oral de emergencia,2016-04-01,0,1,3,0,0,4
SAN MATIAS,"anticoncepcion, prevencion de its y de cancer de cuello uterino",numero de mujeres con pildora anticonceptiva oral de emergencia,2016-04-01,0,0,3,4,0,7
SAN PEDRO,"anticoncepcion, prevencion de its y de cancer de cuello uterino",numero de mujeres con pildora anticonceptiva oral de emergencia,2016-04-01,0,0,4,1,0,5
SANTA ANA,"anticoncepcion, prevencion de its y de cancer de cuello uterino",numero de mujeres con pildora anticonceptiva oral de emergencia,2016-04-01,0,0,2,0,0,2
SANTA CRUZ DE LA SIERRA,"anticoncepcion, prevencion de its y de cancer de cuello uterino",numero de mujeres con pildora anticonceptiva oral de emergencia,2016-04-01,0,17,45,0,0,62
SICA SICA (VILLA AROMA),"anticoncepcion, prevencion de its y de cancer de cuello uterino",numero de mujeres con pildora anticonceptiva oral de emergencia,2016-04-01,0,1,4,1,0,6
SIPE SIPE,"anticoncepcion, prevencion de its y de cancer de cuello uterino",numero de mujeres con pildora anticonceptiva oral de emergencia,2016-04-01,0,4,17,5,1,27
SUCRE,"anticoncepcion, prevencion de its y de cancer de cuello uterino",numero de mujeres con pildora anticonceptiva oral de emergencia,2016-04-01,0,2,14,5,0,21
TAPACARI,"anticoncepcion, prevencion de its y de cancer de cuello uterino",numero de mujeres con pildora anticonceptiva oral de emergencia,2016-04-01,0,4,3,0,0,7
TARABUCO,"anticoncepcion, prevencion de its y de cancer de cuello uterino",numero de mujeres con pildora anticonceptiva oral de emergencia,2016-04-01,0,2,2,1,0,5
TARIJA,"anticoncepcion, prevencion de its y de cancer de cuello uterino",numero de mujeres con pildora anticonceptiva oral de emergencia,2016-04-01,0,2,6,4,0,12
TARVITA,"anticoncepcion, prevencion de its y de cancer de cuello uterino",numero de mujeres con pildora anticonceptiva oral de emergencia,2016-04-01,0,1,0,0,0,1
TOLATA,"anticoncepcion, prevencion de its y de cancer de cuello uterino",numero de mujeres con pildora anticonceptiva oral de emergencia,2016-04-01,0,1,3,0,0,4
TOMAVE,"anticoncepcion, prevencion de its y de cancer de cuello uterino",numero de mujeres con pildora anticonceptiva oral de emergencia,2016-04-01,0,4,2,0,0,6
TRINIDAD,"anticoncepcion, prevencion de its y de cancer de cuello uterino",numero de mujeres con pildora anticonceptiva oral de emergencia,2016-04-01,2,38,143,110,66,359
TUPIZA,"anticoncepcion, prevencion de its y de cancer de cuello uterino",numero de mujeres con pildora anticonceptiva oral de emergencia,2016-04-01,0,0,1,0,0,1
UMALA,"anticoncepcion, prevencion de its y de cancer de cuello uterino",numero de mujeres con pildora anticonceptiva oral de emergencia,2016-04-01,0,0,3,0,0,3
URIONDO (A. CONCEPCION),"anticoncepcion, prevencion de its y de cancer de cuello uterino",numero de mujeres con pildora anticonceptiva oral de emergencia,2016-04-01,0,1,10,2,0,13
VILLA CHARCAS,"anticoncepcion, prevencion de its y de cancer de cuello uterino",numero de mujeres con pildora anticonceptiva oral de emergencia,2016-04-01,0,0,2,0,0,2
VILLA SERRANO,"anticoncepcion, prevencion de its y de cancer de cuello uterino",numero de mujeres con pildora anticonceptiva oral de emergencia,2016-04-01,1,0,0,0,0,1
VILLA VACA GUZMAN (MUYUPAMPA),"anticoncepcion, prevencion de its y de cancer de cuello uterino",numero de mujeres con pildora anticonceptiva oral de emergencia,2016-04-01,0,0,0,1,0,1
WARNES,"anticoncepcion, prevencion de its y de cancer de cuello uterino",numero de mujeres con pildora anticonceptiva oral de emergencia,2016-04-01,0,1,0,0,0,1
YACUIBA,"anticoncepcion, prevencion de its y de cancer de cuello uterino",numero de mujeres con pildora anticonceptiva oral de emergencia,2016-04-01,0,0,0,1,0,1
YAMPARAEZ,"anticoncepcion, prevencion de its y de cancer de cuello uterino",numero de mujeres con pildora anticonceptiva oral de emergencia,2016-04-01,0,2,0,0,0,2
YAPACANI,"anticoncepcion, prevencion de its y de cancer de cuello uterino",numero de mujeres con pildora anticonceptiva oral de emergencia,2016-04-01,0,2,13,5,2,22
YUNCHARA,"anticoncepcion, prevencion de its y de cancer de cuello uterino",numero de mujeres con pildora anticonceptiva oral de emergencia,2016-04-01,0,0,1,0,0,1
AIQUILE,"anticoncepcion, prevencion de its y de cancer de cuello uterino",numero de mujeres con pildora anticonceptiva oral de emergencia,2016-05-01,0,1,6,1,0,8
ALCALA,"anticoncepcion, prevencion de its y de cancer de cuello uterino",numero de mujeres con pildora anticonceptiva oral de emergencia,2016-05-01,0,0,1,0,0,1
ALTO BENI,"anticoncepcion, prevencion de its y de cancer de cuello uterino",numero de mujeres con pildora anticonceptiva oral de emergencia,2016-05-01,0,0,4,0,0,4
APOLO,"anticoncepcion, prevencion de its y de cancer de cuello uterino",numero de mujeres con pildora anticonceptiva oral de emergencia,2016-05-01,0,0,2,0,0,2
ARBIETO,"anticoncepcion, prevencion de its y de cancer de cuello uterino",numero de mujeres con pildora anticonceptiva oral de emergencia,2016-05-01,0,3,6,0,0,9
ASCENCION DE GUARAYOS,"anticoncepcion, prevencion de its y de cancer de cuello uterino",numero de mujeres con pildora anticonceptiva oral de emergencia,2016-05-01,0,0,1,0,0,1
CABEZAS,"anticoncepcion, prevencion de its y de cancer de cuello uterino",numero de mujeres con pildora anticonceptiva oral de emergencia,2016-05-01,0,2,1,0,0,3
"CAIZA ""D""","anticoncepcion, prevencion de its y de cancer de cuello uterino",numero de mujeres con pildora anticonceptiva oral de emergencia,2016-05-01,0,2,0,0,0,2
CAMARGO,"anticoncepcion, prevencion de its y de cancer de cuello uterino",numero de mujeres con pildora anticonceptiva oral de emergencia,2016-05-01,0,0,3,1,0,4
CAPINOTA,"anticoncepcion, prevencion de its y de cancer de cuello uterino",numero de mujeres con pildora anticonceptiva oral de emergencia,2016-05-01,0,0,2,0,0,2
CARANAVI,"anticoncepcion, prevencion de its y de cancer de cuello uterino",numero de mujeres con pildora anticonceptiva oral de emergencia,2016-05-01,0,0,2,0,0,2
CHARAGUA,"anticoncepcion, prevencion de its y de cancer de cuello uterino",numero de mujeres con pildora anticonceptiva oral de emergencia,2016-05-01,0,0,1,0,0,1
CHIMORE,"anticoncepcion, prevencion de its y de cancer de cuello uterino",numero de mujeres con pildora anticonceptiva oral de emergencia,2016-05-01,1,1,0,0,0,2
CHULUMANI (V. DE LA LIBERTAD),"anticoncepcion, prevencion de its y de cancer de cuello uterino",numero de mujeres con pildora anticonceptiva oral de emergencia,2016-05-01,0,0,3,0,0,3
COBIJA,"anticoncepcion, prevencion de its y de cancer de cuello uterino",numero de mujeres con pildora anticonceptiva oral de emergencia,2016-05-01,0,1,13,3,0,17
COCHABAMBA,"anticoncepcion, prevencion de its y de cancer de cuello uterino",numero de mujeres con pildora anticonceptiva oral de emergencia,2016-05-01,1,6,28,5,0,40
COLCAPIRHUA,"anticoncepcion, prevencion de its y de cancer de cuello uterino",numero de mujeres con pildora anticonceptiva oral de emergencia,2016-05-01,0,0,4,1,0,5
"COLCHA ""K""","anticoncepcion, prevencion de its y de cancer de cuello uterino",numero de mujeres con pildora anticonceptiva oral de emergencia,2016-05-01,0,0,2,0,0,2
COLOMI,"anticoncepcion, prevencion de its y de cancer de cuello uterino",numero de mujeres con pildora anticonceptiva oral de emergencia,2016-05-01,0,1,2,0,0,3
COLQUECHACA,"anticoncepcion, prevencion de its y de cancer de cuello uterino",numero de mujeres con pildora anticonceptiva oral de emergencia,2016-05-01,0,3,9,3,0,15
CORQUE,"anticoncepcion, prevencion de its y de cancer de cuello uterino",numero de mujeres con pildora anticonceptiva oral de emergencia,2016-05-01,0,2,12,2,1,17
COTAGAITA,"anticoncepcion, prevencion de its y de cancer de cuello uterino",numero de mujeres con pildora anticonceptiva oral de emergencia,2016-05-01,3,6,6,0,0,15
CUCHUMUELA (V. G. VILLARROEL),"anticoncepcion, prevencion de its y de cancer de cuello uterino",numero de mujeres con pildora anticonceptiva oral de emergencia,2016-05-01,0,1,9,1,0,11
CULPINA,"anticoncepcion, prevencion de its y de cancer de cuello uterino",numero de mujeres con pildora anticonceptiva oral de emergencia,2016-05-01,13,22,4,2,0,41
EL ALTO,"anticoncepcion, prevencion de its y de cancer de cuello uterino",numero de mujeres con pildora anticonceptiva oral de emergencia,2016-05-01,0,3,21,8,0,32
EL PUENTE(TJA),"anticoncepcion, prevencion de its y de cancer de cuello uterino",numero de mujeres con pildora anticonceptiva oral de emergencia,2016-05-01,0,0,1,0,0,1
EL TORNO,"anticoncepcion, prevencion de its y de cancer de cuello uterino",numero de mujeres con pildora anticonceptiva oral de emergencia,2016-05-01,0,7,14,0,0,21
EL VILLAR,"anticoncepcion, prevencion de its y de cancer de cuello uterino",numero de mujeres con pildora anticonceptiva oral de emergencia,2016-05-01,0,0,2,1,0,3
ENTRE RIOS TRJ,"anticoncepcion, prevencion de its y de cancer de cuello uterino",numero de mujeres con pildora anticonceptiva oral de emergencia,2016-05-01,0,0,0,1,0,1
ENTRE RIOS CBBA,"anticoncepcion, prevencion de its y de cancer de cuello uterino",numero de mujeres con pildora anticonceptiva oral de emergencia,2016-05-01,0,0,1,0,0,1
ESCARA,"anticoncepcion, prevencion de its y de cancer de cuello uterino",numero de mujeres con pildora anticonceptiva oral de emergencia,2016-05-01,0,2,8,4,0,14
ESMERALDA,"anticoncepcion, prevencion de its y de cancer de cuello uterino",numero de mujeres con pildora anticonceptiva oral de emergencia,2016-05-01,1,2,14,1,0,18
GENERAL SAAVEDRA,"anticoncepcion, prevencion de its y de cancer de cuello uterino",numero de mujeres con pildora anticonceptiva oral de emergencia,2016-05-01,1,0,0,0,0,1
GUANAY,"anticoncepcion, prevencion de its y de cancer de cuello uterino",numero de mujeres con pildora anticonceptiva oral de emergencia,2016-05-01,0,2,19,7,3,31
GUAYARAMERIN,"anticoncepcion, prevencion de its y de cancer de cuello uterino",numero de mujeres con pildora anticonceptiva oral de emergencia,2016-05-01,0,1,9,1,0,11
GUTIERREZ,"anticoncepcion, prevencion de its y de cancer de cuello uterino",numero de mujeres con pildora anticonceptiva oral de emergencia,2016-05-01,0,0,1,0,0,1
HUACARETA,"anticoncepcion, prevencion de its y de cancer de cuello uterino",numero de mujeres con pildora anticonceptiva oral de emergencia,2016-05-01,0,3,4,0,0,7
INCAHUASI,"anticoncepcion, prevencion de its y de cancer de cuello uterino",numero de mujeres con pildora anticonceptiva oral de emergencia,2016-05-01,0,0,1,0,0,1
INGAVI (HUMAITA),"anticoncepcion, prevencion de its y de cancer de cuello uterino",numero de mujeres con pildora anticonceptiva oral de emergencia,2016-05-01,1,0,1,0,0,2
IRUPANA (VILLA DE LANZA),"anticoncepcion, prevencion de its y de cancer de cuello uterino",numero de mujeres con pildora anticonceptiva oral de emergencia,2016-05-01,0,1,0,0,0,1
IXIAMAS,"anticoncepcion, prevencion de its y de cancer de cuello uterino",numero de mujeres con pildora anticonceptiva oral de emergencia,2016-05-01,0,0,1,0,0,1
LA GUARDIA,"anticoncepcion, prevencion de its y de cancer de cuello uterino",numero de mujeres con pildora anticonceptiva oral de emergencia,2016-05-01,0,0,16,2,0,18
LA PAZ,"anticoncepcion, prevencion de its y de cancer de cuello uterino",numero de mujeres con pildora anticonceptiva oral de emergencia,2016-05-01,0,1,11,4,0,16
LAS CARRERAS,"anticoncepcion, prevencion de its y de cancer de cuello uterino",numero de mujeres con pildora anticonceptiva oral de emergencia,2016-05-01,0,0,1,0,0,1
LLALLAGUA,"anticoncepcion, prevencion de its y de cancer de cuello uterino",numero de mujeres con pildora anticonceptiva oral de emergencia,2016-05-01,0,0,3,0,0,3
MACHARETI,"anticoncepcion, prevencion de its y de cancer de cuello uterino",numero de mujeres con pildora anticonceptiva oral de emergencia,2016-05-01,2,1,3,1,0,7
MAPIRI,"anticoncepcion, prevencion de its y de cancer de cuello uterino",numero de mujeres con pildora anticonceptiva oral de emergencia,2016-05-01,0,0,2,0,0,2
MECAPACA,"anticoncepcion, prevencion de its y de cancer de cuello uterino",numero de mujeres con pildora anticonceptiva oral de emergencia,2016-05-01,0,0,0,1,0,1
MIZQUE,"anticoncepcion, prevencion de its y de cancer de cuello uterino",numero de mujeres con pildora anticonceptiva oral de emergencia,2016-05-01,0,1,2,2,0,5
MONTERO,"anticoncepcion, prevencion de its y de cancer de cuello uterino",numero de mujeres con pildora anticonceptiva oral de emergencia,2016-05-01,5,10,21,7,0,43
NUEVO MANOA (NUEVA ESPERANZA),"anticoncepcion, prevencion de its y de cancer de cuello uterino",numero de mujeres con pildora anticonceptiva oral de emergencia,2016-05-01,0,0,0,1,0,1
OCURI,"anticoncepcion, prevencion de its y de cancer de cuello uterino",numero de mujeres con pildora anticonceptiva oral de emergencia,2016-05-01,0,1,0,0,0,1
ORURO,"anticoncepcion, prevencion de its y de cancer de cuello uterino",numero de mujeres con pildora anticonceptiva oral de emergencia,2016-05-01,0,0,8,1,0,9
PADCAYA,"anticoncepcion, prevencion de its y de cancer de cuello uterino",numero de mujeres con pildora anticonceptiva oral de emergencia,2016-05-01,1,0,2,0,0,3
PADILLA,"anticoncepcion, prevencion de its y de cancer de cuello uterino",numero de mujeres con pildora anticonceptiva oral de emergencia,2016-05-01,0,0,2,0,0,2
PALOS BLANCOS,"anticoncepcion, prevencion de its y de cancer de cuello uterino",numero de mujeres con pildora anticonceptiva oral de emergencia,2016-05-01,0,0,1,0,0,1
PAPEL PAMPA,"anticoncepcion, prevencion de its y de cancer de cuello uterino",numero de mujeres con pildora anticonceptiva oral de emergencia,2016-05-01,0,0,1,1,0,2
PAZÑA,"anticoncepcion, prevencion de its y de cancer de cuello uterino",numero de mujeres con pildora anticonceptiva oral de emergencia,2016-05-01,0,0,1,0,0,1
POCOATA,"anticoncepcion, prevencion de its y de cancer de cuello uterino",numero de mujeres con pildora anticonceptiva oral de emergencia,2016-05-01,0,3,10,7,0,20
POCONA,"anticoncepcion, prevencion de its y de cancer de cuello uterino",numero de mujeres con pildora anticonceptiva oral de emergencia,2016-05-01,0,0,1,0,0,1
POROMA,"anticoncepcion, prevencion de its y de cancer de cuello uterino",numero de mujeres con pildora anticonceptiva oral de emergencia,2016-05-01,0,2,0,1,0,3
POTOSI,"anticoncepcion, prevencion de its y de cancer de cuello uterino",numero de mujeres con pildora anticonceptiva oral de emergencia,2016-05-01,0,1,18,5,0,24
PRESTO,"anticoncepcion, prevencion de its y de cancer de cuello uterino",numero de mujeres con pildora anticonceptiva oral de emergencia,2016-05-01,0,2,6,2,0,10
PUERTO GONZALO MORENO,"anticoncepcion, prevencion de its y de cancer de cuello uterino",numero de mujeres con pildora anticonceptiva oral de emergencia,2016-05-01,1,0,0,0,0,1
PUERTO RICO,"anticoncepcion, prevencion de its y de cancer de cuello uterino",numero de mujeres con pildora anticonceptiva oral de emergencia,2016-05-01,0,0,1,0,0,1
PUERTO VILLARROEL,"anticoncepcion, prevencion de its y de cancer de cuello uterino",numero de mujeres con pildora anticonceptiva oral de emergencia,2016-05-01,0,2,0,0,0,2
PUNA,"anticoncepcion, prevencion de its y de cancer de cuello uterino",numero de mujeres con pildora anticonceptiva oral de emergencia,2016-05-01,0,0,19,0,0,19
PUNATA,"anticoncepcion, prevencion de its y de cancer de cuello uterino",numero de mujeres con pildora anticonceptiva oral de emergencia,2016-05-01,0,9,5,1,0,15
QUILLACOLLO,"anticoncepcion, prevencion de its y de cancer de cuello uterino",numero de mujeres con pildora anticonceptiva oral de emergencia,2016-05-01,0,10,12,7,0,29
RAVELO,"anticoncepcion, prevencion de its y de cancer de cuello uterino",numero de mujeres con pildora anticonceptiva oral de emergencia,2016-05-01,0,7,28,4,0,39
RIBERALTA,"anticoncepcion, prevencion de its y de cancer de cuello uterino",numero de mujeres con pildora anticonceptiva oral de emergencia,2016-05-01,0,1,2,1,0,4
SACABA,"anticoncepcion, prevencion de its y de cancer de cuello uterino",numero de mujeres con pildora anticonceptiva oral de emergencia,2016-05-01,0,9,74,11,0,94
SAN BENITO,"anticoncepcion, prevencion de its y de cancer de cuello uterino",numero de mujeres con pildora anticonceptiva oral de emergencia,2016-05-01,0,0,7,0,0,7
SAN BUENA VENTURA,"anticoncepcion, prevencion de its y de cancer de cuello uterino",numero de mujeres con pildora anticonceptiva oral de emergencia,2016-05-01,0,0,1,0,0,1
SAN IGNACIO,"anticoncepcion, prevencion de its y de cancer de cuello uterino",numero de mujeres con pildora anticonceptiva oral de emergencia,2016-05-01,0,0,25,13,0,38
SAN MATIAS,"anticoncepcion, prevencion de its y de cancer de cuello uterino",numero de mujeres con pildora anticonceptiva oral de emergencia,2016-05-01,0,0,2,0,0,2
SAN PEDRO,"anticoncepcion, prevencion de its y de cancer de cuello uterino",numero de mujeres con pildora anticonceptiva oral de emergencia,2016-05-01,0,0,2,0,0,2
SAN PEDRO DE CURAHUARA,"anticoncepcion, prevencion de its y de cancer de cuello uterino",numero de mujeres con pildora anticonceptiva oral de emergencia,2016-05-01,0,0,1,0,0,1
SANTA CRUZ DE LA SIERRA,"anticoncepcion, prevencion de its y de cancer de cuello uterino",numero de mujeres con pildora anticonceptiva oral de emergencia,2016-05-01,0,5,25,6,0,36
SANTIVAÑES,"anticoncepcion, prevencion de its y de cancer de cuello uterino",numero de mujeres con pildora anticonceptiva oral de emergencia,2016-05-01,0,0,1,0,0,1
SANTUARIO DE QUILLACAS,"anticoncepcion, prevencion de its y de cancer de cuello uterino",numero de mujeres con pildora anticonceptiva oral de emergencia,2016-05-01,0,0,1,1,0,2
SICA SICA (VILLA AROMA),"anticoncepcion, prevencion de its y de cancer de cuello uterino",numero de mujeres con pildora anticonceptiva oral de emergencia,2016-05-01,1,0,3,0,0,4
SORATA,"anticoncepcion, prevencion de its y de cancer de cuello uterino",numero de mujeres con pildora anticonceptiva oral de emergencia,2016-05-01,0,1,1,0,0,2
SUCRE,"anticoncepcion, prevencion de its y de cancer de cuello uterino",numero de mujeres con pildora anticonceptiva oral de emergencia,2016-05-01,1,23,138,39,2,203
TACACHI,"anticoncepcion, prevencion de its y de cancer de cuello uterino",numero de mujeres con pildora anticonceptiva oral de emergencia,2016-05-01,0,2,5,1,0,8
TACOBAMBA,"anticoncepcion, prevencion de its y de cancer de cuello uterino",numero de mujeres con pildora anticonceptiva oral de emergencia,2016-05-01,0,1,0,0,0,1
TAPACARI,"anticoncepcion, prevencion de its y de cancer de cuello uterino",numero de mujeres con pildora anticonceptiva oral de emergencia,2016-05-01,0,3,3,1,0,7
TARABUCO,"anticoncepcion, prevencion de its y de cancer de cuello uterino",numero de mujeres con pildora anticonceptiva oral de emergencia,2016-05-01,0,2,2,0,0,4
TARIJA,"anticoncepcion, prevencion de its y de cancer de cuello uterino",numero de mujeres con pildora anticonceptiva oral de emergencia,2016-05-01,0,9,55,17,0,81
TARVITA,"anticoncepcion, prevencion de its y de cancer de cuello uterino",numero de mujeres con pildora anticonceptiva oral de emergencia,2016-05-01,0,0,2,0,0,2
TIPUANI,"anticoncepcion, prevencion de its y de cancer de cuello uterino",numero de mujeres con pildora anticonceptiva oral de emergencia,2016-05-01,0,2,7,2,0,11
TIRAQUE (CBBA),"anticoncepcion, prevencion de its y de cancer de cuello uterino",numero de mujeres con pildora anticonceptiva oral de emergencia,2016-05-01,0,0,1,0,0,1
TITO YUPANQUI (PARQUIPUJIO),"anticoncepcion, prevencion de its y de cancer de cuello uterino",numero de mujeres con pildora anticonceptiva oral de emergencia,2016-05-01,0,0,1,0,0,1
TOLATA,"anticoncepcion, prevencion de its y de cancer de cuello uterino",numero de mujeres con pildora anticonceptiva oral de emergencia,2016-05-01,0,0,2,0,0,2
TOLEDO,"anticoncepcion, prevencion de its y de cancer de cuello uterino",numero de mujeres con pildora anticonceptiva oral de emergencia,2016-05-01,0,1,4,1,0,6
TOMAVE,"anticoncepcion, prevencion de its y de cancer de cuello uterino",numero de mujeres con pildora anticonceptiva oral de emergencia,2016-05-01,0,0,1,1,0,2
TOTORA(CBBA),"anticoncepcion, prevencion de its y de cancer de cuello uterino",numero de mujeres con pildora anticonceptiva oral de emergencia,2016-05-01,0,0,1,0,0,1
TRINIDAD,"anticoncepcion, prevencion de its y de cancer de cuello uterino",numero de mujeres con pildora anticonceptiva oral de emergencia,2016-05-01,1,19,162,43,0,225
TUPIZA,"anticoncepcion, prevencion de its y de cancer de cuello uterino",numero de mujeres con pildora anticonceptiva oral de emergencia,2016-05-01,0,1,2,10,0,13
TURCO,"anticoncepcion, prevencion de its y de cancer de cuello uterino",numero de mujeres con pildora anticonceptiva oral de emergencia,2016-05-01,0,0,3,1,0,4
VILLA TUNARI,"anticoncepcion, prevencion de its y de cancer de cuello uterino",numero de mujeres con pildora anticonceptiva oral de emergencia,2016-05-01,0,0,1,0,0,1
VILLAZON,"anticoncepcion, prevencion de its y de cancer de cuello uterino",numero de mujeres con pildora anticonceptiva oral de emergencia,2016-05-01,0,1,2,1,0,4
WARNES,"anticoncepcion, prevencion de its y de cancer de cuello uterino",numero de mujeres con pildora anticonceptiva oral de emergencia,2016-05-01,0,4,1,0,0,5
YAMPARAEZ,"anticoncepcion, prevencion de its y de cancer de cuello uterino",numero de mujeres con pildora anticonceptiva oral de emergencia,2016-05-01,1,6,1,0,0,8
YAPACANI,"anticoncepcion, prevencion de its y de cancer de cuello uterino",numero de mujeres con pildora anticonceptiva oral de emergencia,2016-05-01,0,0,2,0,0,2
YUNCHARA,"anticoncepcion, prevencion de its y de cancer de cuello uterino",numero de mujeres con pildora anticonceptiva oral de emergencia,2016-05-01,0,2,6,0,0,8
AIQUILE,"anticoncepcion, prevencion de its y de cancer de cuello uterino",numero de mujeres con pildora anticonceptiva oral de emergencia,2016-06-01,0,0,1,0,0,1
ALCALA,"anticoncepcion, prevencion de its y de cancer de cuello uterino",numero de mujeres con pildora anticonceptiva oral de emergencia,2016-06-01,0,1,2,1,0,4
ALTO BENI,"anticoncepcion, prevencion de its y de cancer de cuello uterino",numero de mujeres con pildora anticonceptiva oral de emergencia,2016-06-01,0,1,0,0,0,1
APOLO,"anticoncepcion, prevencion de its y de cancer de cuello uterino",numero de mujeres con pildora anticonceptiva oral de emergencia,2016-06-01,0,0,0,1,0,1
ARBIETO,"anticoncepcion, prevencion de its y de cancer de cuello uterino",numero de mujeres con pildora anticonceptiva oral de emergencia,2016-06-01,0,2,1,2,0,5
ARQUE,"anticoncepcion, prevencion de its y de cancer de cuello uterino",numero de mujeres con pildora anticonceptiva oral de emergencia,2016-06-01,0,0,8,4,0,12
AYOPAYA (V. DE INDEPENDENCIA),"anticoncepcion, prevencion de its y de cancer de cuello uterino",numero de mujeres con pildora anticonceptiva oral de emergencia,2016-06-01,0,1,1,0,0,2
BERMEJO,"anticoncepcion, prevencion de its y de cancer de cuello uterino",numero de mujeres con pildora anticonceptiva oral de emergencia,2016-06-01,0,1,2,0,0,3
CAMARGO,"anticoncepcion, prevencion de its y de cancer de cuello uterino",numero de mujeres con pildora anticonceptiva oral de emergencia,2016-06-01,0,0,1,3,0,4
CAMIRI,"anticoncepcion, prevencion de its y de cancer de cuello uterino",numero de mujeres con pildora anticonceptiva oral de emergencia,2016-06-01,0,1,0,1,0,2
CARANAVI,"anticoncepcion, prevencion de its y de cancer de cuello uterino",numero de mujeres con pildora anticonceptiva oral de emergencia,2016-06-01,0,3,17,8,2,30
CHALLAPATA,"anticoncepcion, prevencion de its y de cancer de cuello uterino",numero de mujeres con pildora anticonceptiva oral de emergencia,2016-06-01,0,0,0,2,0,2
CHARAGUA,"anticoncepcion, prevencion de its y de cancer de cuello uterino",numero de mujeres con pildora anticonceptiva oral de emergencia,2016-06-01,0,0,3,1,0,4
CHIMORE,"anticoncepcion, prevencion de its y de cancer de cuello uterino",numero de mujeres con pildora anticonceptiva oral de emergencia,2016-06-01,0,1,2,1,0,4
CHUMA,"anticoncepcion, prevencion de its y de cancer de cuello uterino",numero de mujeres con pildora anticonceptiva oral de emergencia,2016-06-01,0,0,0,1,0,1
COBIJA,"anticoncepcion, prevencion de its y de cancer de cuello uterino",numero de mujeres con pildora anticonceptiva oral de emergencia,2016-06-01,0,0,2,0,0,2
COCAPATA,"anticoncepcion, prevencion de its y de cancer de cuello uterino",numero de mujeres con pildora anticonceptiva oral de emergencia,2016-06-01,0,0,3,1,0,4
COCHABAMBA,"anticoncepcion, prevencion de its y de cancer de cuello uterino",numero de mujeres con pildora anticonceptiva oral de emergencia,2016-06-01,2,10,12,2,0,26
COLCAPIRHUA,"anticoncepcion, prevencion de its y de cancer de cuello uterino",numero de mujeres con pildora anticonceptiva oral de emergencia,2016-06-01,0,0,8,0,0,8
"COLCHA ""K""","anticoncepcion, prevencion de its y de cancer de cuello uterino",numero de mujeres con pildora anticonceptiva oral de emergencia,2016-06-01,0,0,1,0,0,1
COLOMI,"anticoncepcion, prevencion de its y de cancer de cuello uterino",numero de mujeres con pildora anticonceptiva oral de emergencia,2016-06-01,0,1,1,0,0,2
COMARAPA,"anticoncepcion, prevencion de its y de cancer de cuello uterino",numero de mujeres con pildora anticonceptiva oral de emergencia,2016-06-01,0,0,1,0,0,1
CORIPATA,"anticoncepcion, prevencion de its y de cancer de cuello uterino",numero de mujeres con pildora anticonceptiva oral de emergencia,2016-06-01,0,2,1,1,0,4
COTAGAITA,"anticoncepcion, prevencion de its y de cancer de cuello uterino",numero de mujeres con pildora anticonceptiva oral de emergencia,2016-06-01,0,1,2,0,0,3
CULPINA,"anticoncepcion, prevencion de its y de cancer de cuello uterino",numero de mujeres con pildora anticonceptiva oral de emergencia,2016-06-01,0,0,0,1,0,1
EL ALTO,"anticoncepcion, prevencion de its y de cancer de cuello uterino",numero de mujeres con pildora anticonceptiva oral de emergencia,2016-06-01,1,0,4,11,0,16
EL TORNO,"anticoncepcion, prevencion de its y de cancer de cuello uterino",numero de mujeres con pildora anticonceptiva oral de emergencia,2016-06-01,0,4,3,0,0,7
EL VILLAR,"anticoncepcion, prevencion de its y de cancer de cuello uterino",numero de mujeres con pildora anticonceptiva oral de emergencia,2016-06-01,0,1,1,0,0,2
ENTRE RIOS TRJ,"anticoncepcion, prevencion de its y de cancer de cuello uterino",numero de mujeres con pildora anticonceptiva oral de emergencia,2016-06-01,0,1,0,0,0,1
ENTRE RIOS CBBA,"anticoncepcion, prevencion de its y de cancer de cuello uterino",numero de mujeres con pildora anticonceptiva oral de emergencia,2016-06-01,0,0,0,1,1,2
ESCARA,"anticoncepcion, prevencion de its y de cancer de cuello uterino",numero de mujeres con pildora anticonceptiva oral de emergencia,2016-06-01,0,0,1,0,0,1
ESCOMA,"anticoncepcion, prevencion de its y de cancer de cuello uterino",numero de mujeres con pildora anticonceptiva oral de emergencia,2016-06-01,0,0,1,0,0,1
EUREKA (SANTOS MERCADO),"anticoncepcion, prevencion de its y de cancer de cuello uterino",numero de mujeres con pildora anticonceptiva oral de emergencia,2016-06-01,0,0,1,0,0,1
GRAL. J.J. PEREZ (CHARAZANI),"anticoncepcion, prevencion de its y de cancer de cuello uterino",numero de mujeres con pildora anticonceptiva oral de emergencia,2016-06-01,0,0,1,0,0,1
GUAYARAMERIN,"anticoncepcion, prevencion de its y de cancer de cuello uterino",numero de mujeres con pildora anticonceptiva oral de emergencia,2016-06-01,0,1,8,0,0,9
HUACARETA,"anticoncepcion, prevencion de its y de cancer de cuello uterino",numero de mujeres con pildora anticonceptiva oral de emergencia,2016-06-01,0,1,3,0,0,4
ICLA,"anticoncepcion, prevencion de its y de cancer de cuello uterino",numero de mujeres con pildora anticonceptiva oral de emergencia,2016-06-01,0,0,2,0,0,2
INCAHUASI,"anticoncepcion, prevencion de its y de cancer de cuello uterino",numero de mujeres con pildora anticonceptiva oral de emergencia,2016-06-01,0,0,4,1,0,5
JESUS DE MACHACA,"anticoncepcion, prevencion de its y de cancer de cuello uterino",numero de mujeres con pildora anticonceptiva oral de emergencia,2016-06-01,0,0,1,0,0,1
LA GUARDIA,"anticoncepcion, prevencion de its y de cancer de cuello uterino",numero de mujeres con pildora anticonceptiva oral de emergencia,2016-06-01,0,0,0,1,0,1
LA PAZ,"anticoncepcion, prevencion de its y de cancer de cuello uterino",numero de mujeres con pildora anticonceptiva oral de emergencia,2016-06-01,0,2,19,11,1,33
LLALLAGUA,"anticoncepcion, prevencion de its y de cancer de cuello uterino",numero de mujeres con pildora anticonceptiva oral de emergencia,2016-06-01,0,1,5,0,0,6
MACHARETI,"anticoncepcion, prevencion de its y de cancer de cuello uterino",numero de mujeres con pildora anticonceptiva oral de emergencia,2016-06-01,0,3,2,0,0,5
MIZQUE,"anticoncepcion, prevencion de its y de cancer de cuello uterino",numero de mujeres con pildora anticonceptiva oral de emergencia,2016-06-01,0,1,2,0,0,3
MOCOMOCO,"anticoncepcion, prevencion de its y de cancer de cuello uterino",numero de mujeres con pildora anticonceptiva oral de emergencia,2016-06-01,0,0,1,0,0,1
MOJOCOYA,"anticoncepcion, prevencion de its y de cancer de cuello uterino",numero de mujeres con pildora anticonceptiva oral de emergencia,2016-06-01,0,1,1,0,0,2
MONTEAGUDO,"anticoncepcion, prevencion de its y de cancer de cuello uterino",numero de mujeres con pildora anticonceptiva oral de emergencia,2016-06-01,0,0,1,0,0,1
MONTERO,"anticoncepcion, prevencion de its y de cancer de cuello uterino",numero de mujeres con pildora anticonceptiva oral de emergencia,2016-06-01,1,61,6,3,0,71
MOROCHATA,"anticoncepcion, prevencion de its y de cancer de cuello uterino",numero de mujeres con pildora anticonceptiva oral de emergencia,2016-06-01,0,0,2,0,0,2
OKINAWA,"anticoncepcion, prevencion de its y de cancer de cuello uterino",numero de mujeres con pildora anticonceptiva oral de emergencia,2016-06-01,0,0,3,0,0,3
ORURO,"anticoncepcion, prevencion de its y de cancer de cuello uterino",numero de mujeres con pildora anticonceptiva oral de emergencia,2016-06-01,0,1,2,0,0,3
PADILLA,"anticoncepcion, prevencion de its y de cancer de cuello uterino",numero de mujeres con pildora anticonceptiva oral de emergencia,2016-06-01,0,0,1,0,0,1
PALOS BLANCOS,"anticoncepcion, prevencion de its y de cancer de cuello uterino",numero de mujeres con pildora anticonceptiva oral de emergencia,2016-06-01,0,0,1,0,0,1
PAPEL PAMPA,"anticoncepcion, prevencion de its y de cancer de cuello uterino",numero de mujeres con pildora anticonceptiva oral de emergencia,2016-06-01,0,2,1,0,0,3
PAZÑA,"anticoncepcion, prevencion de its y de cancer de cuello uterino",numero de mujeres con pildora anticonceptiva oral de emergencia,2016-06-01,0,1,3,0,0,4
POOPO,"anticoncepcion, prevencion de its y de cancer de cuello uterino",numero de mujeres con pildora anticonceptiva oral de emergencia,2016-06-01,0,0,1,0,0,1
PORCO,"anticoncepcion, prevencion de its y de cancer de cuello uterino",numero de mujeres con pildora anticonceptiva oral de emergencia,2016-06-01,0,1,1,0,0,2
POROMA,"anticoncepcion, prevencion de its y de cancer de cuello uterino",numero de mujeres con pildora anticonceptiva oral de emergencia,2016-06-01,0,5,0,0,0,5
POTOSI,"anticoncepcion, prevencion de its y de cancer de cuello uterino",numero de mujeres con pildora anticonceptiva oral de emergencia,2016-06-01,0,0,21,10,0,31
PRESTO,"anticoncepcion, prevencion de its y de cancer de cuello uterino",numero de mujeres con pildora anticonceptiva oral de emergencia,2016-06-01,0,1,1,0,0,2
PUNATA,"anticoncepcion, prevencion de its y de cancer de cuello uterino",numero de mujeres con pildora anticonceptiva oral de emergencia,2016-06-01,0,5,3,0,0,8
QUILLACOLLO,"anticoncepcion, prevencion de its y de cancer de cuello uterino",numero de mujeres con pildora anticonceptiva oral de emergencia,2016-06-01,0,0,2,0,0,2
ROBORE,"anticoncepcion, prevencion de its y de cancer de cuello uterino",numero de mujeres con pildora anticonceptiva oral de emergencia,2016-06-01,0,0,1,0,0,1
SACABA,"anticoncepcion, prevencion de its y de cancer de cuello uterino",numero de mujeres con pildora anticonceptiva oral de emergencia,2016-06-01,0,0,7,0,0,7
SACACA,"anticoncepcion, prevencion de its y de cancer de cuello uterino",numero de mujeres con pildora anticonceptiva oral de emergencia,2016-06-01,0,1,3,3,0,7
SAN ANTONIO DE ESMORUCO,"anticoncepcion, prevencion de its y de cancer de cuello uterino",numero de mujeres con pildora anticonceptiva oral de emergencia,2016-06-01,0,0,1,0,0,1
SAN IGNACIO,"anticoncepcion, prevencion de its y de cancer de cuello uterino",numero de mujeres con pildora anticonceptiva oral de emergencia,2016-06-01,0,0,1,0,0,1
SAN IGNACIO DE VELASCO,"anticoncepcion, prevencion de its y de cancer de cuello uterino",numero de mujeres con pildora anticonceptiva oral de emergencia,2016-06-01,0,0,1,0,0,1
SAN JAVIER(BNI),"anticoncepcion, prevencion de its y de cancer de cuello uterino",numero de mujeres con pildora anticonceptiva oral de emergencia,2016-06-01,0,1,3,2,0,6
SAN JULIAN,"anticoncepcion, prevencion de its y de cancer de cuello uterino",numero de mujeres con pildora anticonceptiva oral de emergencia,2016-06-01,0,0,1,0,0,1
SAN PEDRO,"anticoncepcion, prevencion de its y de cancer de cuello uterino",numero de mujeres con pildora anticonceptiva oral de emergencia,2016-06-01,0,1,4,0,0,5
SAN RAMON BENI,"anticoncepcion, prevencion de its y de cancer de cuello uterino",numero de mujeres con pildora anticonceptiva oral de emergencia,2016-06-01,0,20,26,13,0,59
SANTA CRUZ DE LA SIERRA,"anticoncepcion, prevencion de its y de cancer de cuello uterino",numero de mujeres con pildora anticonceptiva oral de emergencia,2016-06-01,0,14,19,12,0,45
SANTUARIO DE QUILLACAS,"anticoncepcion, prevencion de its y de cancer de cuello uterino",numero de mujeres con pildora anticonceptiva oral de emergencia,2016-06-01,0,0,3,0,0,3
SICA SICA (VILLA AROMA),"anticoncepcion, prevencion de its y de cancer de cuello uterino",numero de mujeres con pildora anticonceptiva oral de emergencia,2016-06-01,0,0,1,0,0,1
SICAYA,"anticoncepcion, prevencion de its y de cancer de cuello uterino",numero de mujeres con pildora anticonceptiva oral de emergencia,2016-06-01,0,0,1,0,0,1
SORATA,"anticoncepcion, prevencion de its y de cancer de cuello uterino",numero de mujeres con pildora anticonceptiva oral de emergencia,2016-06-01,0,0,1,0,0,1
SUCRE,"anticoncepcion, prevencion de its y de cancer de cuello uterino",numero de mujeres con pildora anticonceptiva oral de emergencia,2016-06-01,0,4,9,5,0,18
TAPACARI,"anticoncepcion, prevencion de its y de cancer de cuello uterino",numero de mujeres con pildora anticonceptiva oral de emergencia,2016-06-01,0,1,1,0,0,2
TARABUCO,"anticoncepcion, prevencion de its y de cancer de cuello uterino",numero de mujeres con pildora anticonceptiva oral de emergencia,2016-06-01,0,2,26,0,0,28
TARIJA,"anticoncepcion, prevencion de its y de cancer de cuello uterino",numero de mujeres con pildora anticonceptiva oral de emergencia,2016-06-01,0,0,1,6,0,7
TARVITA,"anticoncepcion, prevencion de its y de cancer de cuello uterino",numero de mujeres con pildora anticonceptiva oral de emergencia,2016-06-01,0,1,2,0,0,3
TEOPONTE,"anticoncepcion, prevencion de its y de cancer de cuello uterino",numero de mujeres con pildora anticonceptiva oral de emergencia,2016-06-01,0,2,12,3,0,17
TINGUIPAYA,"anticoncepcion, prevencion de its y de cancer de cuello uterino",numero de mujeres con pildora anticonceptiva oral de emergencia,2016-06-01,0,0,0,1,0,1
TIPUANI,"anticoncepcion, prevencion de its y de cancer de cuello uterino",numero de mujeres con pildora anticonceptiva oral de emergencia,2016-06-01,0,0,1,0,0,1
TITO YUPANQUI (PARQUIPUJIO),"anticoncepcion, prevencion de its y de cancer de cuello uterino",numero de mujeres con pildora anticonceptiva oral de emergencia,2016-06-01,0,1,2,0,0,3
TOLEDO,"anticoncepcion, prevencion de its y de cancer de cuello uterino",numero de mujeres con pildora anticonceptiva oral de emergencia,2016-06-01,0,0,3,0,0,3
TOTORA(ORR),"anticoncepcion, prevencion de its y de cancer de cuello uterino",numero de mujeres con pildora anticonceptiva oral de emergencia,2016-06-01,0,1,0,0,0,1
TRINIDAD,"anticoncepcion, prevencion de its y de cancer de cuello uterino",numero de mujeres con pildora anticonceptiva oral de emergencia,2016-06-01,4,30,44,6,0,84
TUPIZA,"anticoncepcion, prevencion de its y de cancer de cuello uterino",numero de mujeres con pildora anticonceptiva oral de emergencia,2016-06-01,0,1,0,0,0,1
UMALA,"anticoncepcion, prevencion de its y de cancer de cuello uterino",numero de mujeres con pildora anticonceptiva oral de emergencia,2016-06-01,0,0,1,0,0,1
VILLA CHARCAS,"anticoncepcion, prevencion de its y de cancer de cuello uterino",numero de mujeres con pildora anticonceptiva oral de emergencia,2016-06-01,1,1,2,0,0,4
VILLAZON,"anticoncepcion, prevencion de its y de cancer de cuello uterino",numero de mujeres con pildora anticonceptiva oral de emergencia,2016-06-01,0,0,3,0,0,3
WARNES,"anticoncepcion, prevencion de its y de cancer de cuello uterino",numero de mujeres con pildora anticonceptiva oral de emergencia,2016-06-01,0,1,2,1,0,4
YAMPARAEZ,"anticoncepcion, prevencion de its y de cancer de cuello uterino",numero de mujeres con pildora anticonceptiva oral de emergencia,2016-06-01,0,2,1,1,0,4
ZUDAÑEZ,"anticoncepcion, prevencion de its y de cancer de cuello uterino",numero de mujeres con pildora anticonceptiva oral de emergencia,2016-06-01,0,1,1,0,0,2
AIQUILE,"anticoncepcion, prevencion de its y de cancer de cuello uterino",numero de mujeres con pildora anticonceptiva oral de emergencia,2016-07-01,1,0,1,0,0,2
ALCALA,"anticoncepcion, prevencion de its y de cancer de cuello uterino",numero de mujeres con pildora anticonceptiva oral de emergencia,2016-07-01,0,1,1,0,0,2
ALTO BENI,"anticoncepcion, prevencion de its y de cancer de cuello uterino",numero de mujeres con pildora anticonceptiva oral de emergencia,2016-07-01,0,0,0,1,0,1
APOLO,"anticoncepcion, prevencion de its y de cancer de cuello uterino",numero de mujeres con pildora anticonceptiva oral de emergencia,2016-07-01,0,0,2,0,0,2
ARAMPAMPA,"anticoncepcion, prevencion de its y de cancer de cuello uterino",numero de mujeres con pildora anticonceptiva oral de emergencia,2016-07-01,0,0,2,4,0,6
ARBIETO,"anticoncepcion, prevencion de its y de cancer de cuello uterino",numero de mujeres con pildora anticonceptiva oral de emergencia,2016-07-01,0,1,5,0,0,6
BATALLAS,"anticoncepcion, prevencion de its y de cancer de cuello uterino",numero de mujeres con pildora anticonceptiva oral de emergencia,2016-07-01,0,1,8,4,1,14
BERMEJO,"anticoncepcion, prevencion de its y de cancer de cuello uterino",numero de mujeres con pildora anticonceptiva oral de emergencia,2016-07-01,0,0,0,1,0,1
BETANZOS,"anticoncepcion, prevencion de its y de cancer de cuello uterino",numero de mujeres con pildora anticonceptiva oral de emergencia,2016-07-01,0,0,2,2,0,4
CABEZAS,"anticoncepcion, prevencion de its y de cancer de cuello uterino",numero de mujeres con pildora anticonceptiva oral de emergencia,2016-07-01,0,1,1,1,0,3
"CAIZA ""D""","anticoncepcion, prevencion de its y de cancer de cuello uterino",numero de mujeres con pildora anticonceptiva oral de emergencia,2016-07-01,0,0,1,0,0,1
CAMATAQUI (C. VILLA ABECIA),"anticoncepcion, prevencion de its y de cancer de cuello uterino",numero de mujeres con pildora anticonceptiva oral de emergencia,2016-07-01,0,0,1,0,0,1
CAQUIAVIRI,"anticoncepcion, prevencion de its y de cancer de cuello uterino",numero de mujeres con pildora anticonceptiva oral de emergencia,2016-07-01,0,5,3,2,0,10
CARAPARI,"anticoncepcion, prevencion de its y de cancer de cuello uterino",numero de mujeres con pildora anticonceptiva oral de emergencia,2016-07-01,0,0,3,1,0,4
CHALLAPATA,"anticoncepcion, prevencion de its y de cancer de cuello uterino",numero de mujeres con pildora anticonceptiva oral de emergencia,2016-07-01,0,1,3,0,0,4
CHARAGUA,"anticoncepcion, prevencion de its y de cancer de cuello uterino",numero de mujeres con pildora anticonceptiva oral de emergencia,2016-07-01,0,0,6,0,0,6
CLIZA,"anticoncepcion, prevencion de its y de cancer de cuello uterino",numero de mujeres con pildora anticonceptiva oral de emergencia,2016-07-01,0,1,0,0,0,1
COCHABAMBA,"anticoncepcion, prevencion de its y de cancer de cuello uterino",numero de mujeres con pildora anticonceptiva oral de emergencia,2016-07-01,1,6,6,5,0,18
"COLCHA ""K""","anticoncepcion, prevencion de its y de cancer de cuello uterino",numero de mujeres con pildora anticonceptiva oral de emergencia,2016-07-01,0,0,1,0,0,1
COLQUECHACA,"anticoncepcion, prevencion de its y de cancer de cuello uterino",numero de mujeres con pildora anticonceptiva oral de emergencia,2016-07-01,0,0,1,0,0,1
COMARAPA,"anticoncepcion, prevencion de its y de cancer de cuello uterino",numero de mujeres con pildora anticonceptiva oral de emergencia,2016-07-01,0,1,0,0,0,1
CONCEPCION,"anticoncepcion, prevencion de its y de cancer de cuello uterino",numero de mujeres con pildora anticonceptiva oral de emergencia,2016-07-01,0,1,1,0,0,2
CORIPATA,"anticoncepcion, prevencion de its y de cancer de cuello uterino",numero de mujeres con pildora anticonceptiva oral de emergencia,2016-07-01,0,0,1,1,0,2
COTAGAITA,"anticoncepcion, prevencion de its y de cancer de cuello uterino",numero de mujeres con pildora anticonceptiva oral de emergencia,2016-07-01,0,1,0,1,0,2
CULPINA,"anticoncepcion, prevencion de its y de cancer de cuello uterino",numero de mujeres con pildora anticonceptiva oral de emergencia,2016-07-01,0,0,1,0,0,1
EL ALTO,"anticoncepcion, prevencion de its y de cancer de cuello uterino",numero de mujeres con pildora anticonceptiva oral de emergencia,2016-07-01,1,7,46,29,0,83
EL TORNO,"anticoncepcion, prevencion de its y de cancer de cuello uterino",numero de mujeres con pildora anticonceptiva oral de emergencia,2016-07-01,0,0,3,0,0,3
EL VILLAR,"anticoncepcion, prevencion de its y de cancer de cuello uterino",numero de mujeres con pildora anticonceptiva oral de emergencia,2016-07-01,0,0,2,0,0,2
ENTRE RIOS TRJ,"anticoncepcion, prevencion de its y de cancer de cuello uterino",numero de mujeres con pildora anticonceptiva oral de emergencia,2016-07-01,0,0,1,2,0,3
ENTRE RIOS CBBA,"anticoncepcion, prevencion de its y de cancer de cuello uterino",numero de mujeres con pildora anticonceptiva oral de emergencia,2016-07-01,0,0,1,0,0,1
ESCARA,"anticoncepcion, prevencion de its y de cancer de cuello uterino",numero de mujeres con pildora anticonceptiva oral de emergencia,2016-07-01,0,0,2,2,0,4
FILADELFIA,"anticoncepcion, prevencion de its y de cancer de cuello uterino",numero de mujeres con pildora anticonceptiva oral de emergencia,2016-07-01,0,0,1,1,0,2
GRAL. J.J. PEREZ (CHARAZANI),"anticoncepcion, prevencion de its y de cancer de cuello uterino",numero de mujeres con pildora anticonceptiva oral de emergencia,2016-07-01,0,0,1,0,0,1
GUAYARAMERIN,"anticoncepcion, prevencion de its y de cancer de cuello uterino",numero de mujeres con pildora anticonceptiva oral de emergencia,2016-07-01,0,0,5,0,0,5
HUACARETA,"anticoncepcion, prevencion de its y de cancer de cuello uterino",numero de mujeres con pildora anticonceptiva oral de emergencia,2016-07-01,0,4,5,2,0,11
INQUISIVI,"anticoncepcion, prevencion de its y de cancer de cuello uterino",numero de mujeres con pildora anticonceptiva oral de emergencia,2016-07-01,0,0,1,0,0,1
LA PAZ,"anticoncepcion, prevencion de its y de cancer de cuello uterino",numero de mujeres con pildora anticonceptiva oral de emergencia,2016-07-01,0,1,5,6,0,12
LAS CARRERAS,"anticoncepcion, prevencion de its y de cancer de cuello uterino",numero de mujeres con pildora anticonceptiva oral de emergencia,2016-07-01,0,1,0,0,0,1
LLALLAGUA,"anticoncepcion, prevencion de its y de cancer de cuello uterino",numero de mujeres con pildora anticonceptiva oral de emergencia,2016-07-01,0,1,2,0,0,3
MAPIRI,"anticoncepcion, prevencion de its y de cancer de cuello uterino",numero de mujeres con pildora anticonceptiva oral de emergencia,2016-07-01,0,1,0,0,0,1
MIZQUE,"anticoncepcion, prevencion de its y de cancer de cuello uterino",numero de mujeres con pildora anticonceptiva oral de emergencia,2016-07-01,0,1,3,0,0,4
MONTEAGUDO,"anticoncepcion, prevencion de its y de cancer de cuello uterino",numero de mujeres con pildora anticonceptiva oral de emergencia,2016-07-01,0,1,0,0,0,1
OCURI,"anticoncepcion, prevencion de its y de cancer de cuello uterino",numero de mujeres con pildora anticonceptiva oral de emergencia,2016-07-01,0,1,1,0,0,2
ORURO,"anticoncepcion, prevencion de its y de cancer de cuello uterino",numero de mujeres con pildora anticonceptiva oral de emergencia,2016-07-01,0,1,3,2,0,6
PADILLA,"anticoncepcion, prevencion de its y de cancer de cuello uterino",numero de mujeres con pildora anticonceptiva oral de emergencia,2016-07-01,0,0,1,0,0,1
PAMPA GRANDE,"anticoncepcion, prevencion de its y de cancer de cuello uterino",numero de mujeres con pildora anticonceptiva oral de emergencia,2016-07-01,0,0,1,0,0,1
PAPEL PAMPA,"anticoncepcion, prevencion de its y de cancer de cuello uterino",numero de mujeres con pildora anticonceptiva oral de emergencia,2016-07-01,0,1,2,0,0,3
PORCO,"anticoncepcion, prevencion de its y de cancer de cuello uterino",numero de mujeres con pildora anticonceptiva oral de emergencia,2016-07-01,0,1,1,0,0,2
POROMA,"anticoncepcion, prevencion de its y de cancer de cuello uterino",numero de mujeres con pildora anticonceptiva oral de emergencia,2016-07-01,0,0,4,2,0,6
POTOSI,"anticoncepcion, prevencion de its y de cancer de cuello uterino",numero de mujeres con pildora anticonceptiva oral de emergencia,2016-07-01,0,0,4,0,0,4
PRESTO,"anticoncepcion, prevencion de its y de cancer de cuello uterino",numero de mujeres con pildora anticonceptiva oral de emergencia,2016-07-01,0,7,4,0,0,11
PUERTO QUIJARRO,"anticoncepcion, prevencion de its y de cancer de cuello uterino",numero de mujeres con pildora anticonceptiva oral de emergencia,2016-07-01,0,0,1,0,0,1
PUERTO RICO,"anticoncepcion, prevencion de its y de cancer de cuello uterino",numero de mujeres con pildora anticonceptiva oral de emergencia,2016-07-01,0,0,0,1,0,1
PUERTO VILLARROEL,"anticoncepcion, prevencion de its y de cancer de cuello uterino",numero de mujeres con pildora anticonceptiva oral de emergencia,2016-07-01,0,0,24,2,0,26
PUNATA,"anticoncepcion, prevencion de its y de cancer de cuello uterino",numero de mujeres con pildora anticonceptiva oral de emergencia,2016-07-01,0,0,1,0,0,1
QUILLACOLLO,"anticoncepcion, prevencion de its y de cancer de cuello uterino",numero de mujeres con pildora anticonceptiva oral de emergencia,2016-07-01,0,0,0,1,0,1
RIBERALTA,"anticoncepcion, prevencion de its y de cancer de cuello uterino",numero de mujeres con pildora anticonceptiva oral de emergencia,2016-07-01,0,0,1,0,0,1
SACABA,"anticoncepcion, prevencion de its y de cancer de cuello uterino",numero de mujeres con pildora anticonceptiva oral de emergencia,2016-07-01,0,0,3,0,0,3
SACABAMBA,"anticoncepcion, prevencion de its y de cancer de cuello uterino",numero de mujeres con pildora anticonceptiva oral de emergencia,2016-07-01,0,0,2,0,0,2
SAIPINA,"anticoncepcion, prevencion de its y de cancer de cuello uterino",numero de mujeres con pildora anticonceptiva oral de emergencia,2016-07-01,0,2,15,2,0,19
SAN JOAQUIN,"anticoncepcion, prevencion de its y de cancer de cuello uterino",numero de mujeres con pildora anticonceptiva oral de emergencia,2016-07-01,0,0,0,1,0,1
SAN LORENZO(PND),"anticoncepcion, prevencion de its y de cancer de cuello uterino",numero de mujeres con pildora anticonceptiva oral de emergencia,2016-07-01,0,0,1,0,0,1
SAN MATIAS,"anticoncepcion, prevencion de its y de cancer de cuello uterino",numero de mujeres con pildora anticonceptiva oral de emergencia,2016-07-01,0,0,1,0,0,1
SAN PEDRO,"anticoncepcion, prevencion de its y de cancer de cuello uterino",numero de mujeres con pildora anticonceptiva oral de emergencia,2016-07-01,0,0,3,0,0,3
SAN PEDRO DE CURAHUARA,"anticoncepcion, prevencion de its y de cancer de cuello uterino",numero de mujeres con pildora anticonceptiva oral de emergencia,2016-07-01,0,0,1,0,0,1
SANTA CRUZ DE LA SIERRA,"anticoncepcion, prevencion de its y de cancer de cuello uterino",numero de mujeres con pildora anticonceptiva oral de emergencia,2016-07-01,0,2,93,37,0,132
SANTIVAÑES,"anticoncepcion, prevencion de its y de cancer de cuello uterino",numero de mujeres con pildora anticonceptiva oral de emergencia,2016-07-01,0,0,1,0,0,1
SANTUARIO DE QUILLACAS,"anticoncepcion, prevencion de its y de cancer de cuello uterino",numero de mujeres con pildora anticonceptiva oral de emergencia,2016-07-01,0,0,0,2,0,2
SICA SICA (VILLA AROMA),"anticoncepcion, prevencion de its y de cancer de cuello uterino",numero de mujeres con pildora anticonceptiva oral de emergencia,2016-07-01,0,2,1,0,0,3
SICAYA,"anticoncepcion, prevencion de its y de cancer de cuello uterino",numero de mujeres con pildora anticonceptiva oral de emergencia,2016-07-01,0,0,1,0,0,1
SOPACHUY,"anticoncepcion, prevencion de its y de cancer de cuello uterino",numero de mujeres con pildora anticonceptiva oral de emergencia,2016-07-01,0,0,1,0,0,1
SUCRE,"anticoncepcion, prevencion de its y de cancer de cuello uterino",numero de mujeres con pildora anticonceptiva oral de emergencia,2016-07-01,0,4,78,3,0,85
TARIJA,"anticoncepcion, prevencion de its y de cancer de cuello uterino",numero de mujeres con pildora anticonceptiva oral de emergencia,2016-07-01,0,0,1,2,0,3
TARVITA,"anticoncepcion, prevencion de its y de cancer de cuello uterino",numero de mujeres con pildora anticonceptiva oral de emergencia,2016-07-01,0,1,0,0,0,1
TIAWANACU,"anticoncepcion, prevencion de its y de cancer de cuello uterino",numero de mujeres con pildora anticonceptiva oral de emergencia,2016-07-01,0,1,0,0,0,1
TIQUIPAYA,"anticoncepcion, prevencion de its y de cancer de cuello uterino",numero de mujeres con pildora anticonceptiva oral de emergencia,2016-07-01,0,0,1,0,0,1
TITO YUPANQUI (PARQUIPUJIO),"anticoncepcion, prevencion de its y de cancer de cuello uterino",numero de mujeres con pildora anticonceptiva oral de emergencia,2016-07-01,0,0,0,1,0,1
TOMAVE,"anticoncepcion, prevencion de its y de cancer de cuello uterino",numero de mujeres con pildora anticonceptiva oral de emergencia,2016-07-01,0,1,2,0,0,3
TRINIDAD,"anticoncepcion, prevencion de its y de cancer de cuello uterino",numero de mujeres con pildora anticonceptiva oral de emergencia,2016-07-01,0,3,1,0,0,4
TUPIZA,"anticoncepcion, prevencion de its y de cancer de cuello uterino",numero de mujeres con pildora anticonceptiva oral de emergencia,2016-07-01,1,8,2,2,0,13
TURCO,"anticoncepcion, prevencion de its y de cancer de cuello uterino",numero de mujeres con pildora anticonceptiva oral de emergencia,2016-07-01,0,0,1,0,0,1
UMALA,"anticoncepcion, prevencion de its y de cancer de cuello uterino",numero de mujeres con pildora anticonceptiva oral de emergencia,2016-07-01,0,1,0,0,0,1
VALLEGRANDE,"anticoncepcion, prevencion de its y de cancer de cuello uterino",numero de mujeres con pildora anticonceptiva oral de emergencia,2016-07-01,0,0,2,0,0,2
WARNES,"anticoncepcion, prevencion de its y de cancer de cuello uterino",numero de mujeres con pildora anticonceptiva oral de emergencia,2016-07-01,0,0,2,0,0,2
YAMPARAEZ,"anticoncepcion, prevencion de its y de cancer de cuello uterino",numero de mujeres con pildora anticonceptiva oral de emergencia,2016-07-01,0,1,0,0,0,1
YOTALA,"anticoncepcion, prevencion de its y de cancer de cuello uterino",numero de mujeres con pildora anticonceptiva oral de emergencia,2016-07-01,0,1,1,0,0,2
ZUDAÑEZ,"anticoncepcion, prevencion de its y de cancer de cuello uterino",numero de mujeres con pildora anticonceptiva oral de emergencia,2016-07-01,0,1,0,0,0,1
ACHACACHI,"anticoncepcion, prevencion de its y de cancer de cuello uterino",numero de mujeres con pildora anticonceptiva oral de emergencia,2016-08-01,0,0,2,0,0,2
AIQUILE,"anticoncepcion, prevencion de its y de cancer de cuello uterino",numero de mujeres con pildora anticonceptiva oral de emergencia,2016-08-01,0,0,1,0,0,1
ALCALA,"anticoncepcion, prevencion de its y de cancer de cuello uterino",numero de mujeres con pildora anticonceptiva oral de emergencia,2016-08-01,0,3,0,0,0,3
ALTO BENI,"anticoncepcion, prevencion de its y de cancer de cuello uterino",numero de mujeres con pildora anticonceptiva oral de emergencia,2016-08-01,0,0,1,0,0,1
ARBIETO,"anticoncepcion, prevencion de its y de cancer de cuello uterino",numero de mujeres con pildora anticonceptiva oral de emergencia,2016-08-01,0,1,1,0,0,2
AYOPAYA (V. DE INDEPENDENCIA),"anticoncepcion, prevencion de its y de cancer de cuello uterino",numero de mujeres con pildora anticonceptiva oral de emergencia,2016-08-01,0,0,2,0,0,2
BETANZOS,"anticoncepcion, prevencion de its y de cancer de cuello uterino",numero de mujeres con pildora anticonceptiva oral de emergencia,2016-08-01,0,0,1,0,0,1
CABEZAS,"anticoncepcion, prevencion de its y de cancer de cuello uterino",numero de mujeres con pildora anticonceptiva oral de emergencia,2016-08-01,1,0,3,1,0,5
CAIROMA,"anticoncepcion, prevencion de its y de cancer de cuello uterino",numero de mujeres con pildora anticonceptiva oral de emergencia,2016-08-01,0,0,1,0,0,1
"CAIZA ""D""","anticoncepcion, prevencion de its y de cancer de cuello uterino",numero de mujeres con pildora anticonceptiva oral de emergencia,2016-08-01,0,0,3,0,0,3
CAMATAQUI (C. VILLA ABECIA),"anticoncepcion, prevencion de its y de cancer de cuello uterino",numero de mujeres con pildora anticonceptiva oral de emergencia,2016-08-01,0,0,2,0,0,2
CARANAVI,"anticoncepcion, prevencion de its y de cancer de cuello uterino",numero de mujeres con pildora anticonceptiva oral de emergencia,2016-08-01,0,1,5,0,0,6
CARIPUYO,"anticoncepcion, prevencion de its y de cancer de cuello uterino",numero de mujeres con pildora anticonceptiva oral de emergencia,2016-08-01,0,1,2,2,0,5
CHALLAPATA,"anticoncepcion, prevencion de its y de cancer de cuello uterino",numero de mujeres con pildora anticonceptiva oral de emergencia,2016-08-01,0,0,3,0,0,3
CHUMA,"anticoncepcion, prevencion de its y de cancer de cuello uterino",numero de mujeres con pildora anticonceptiva oral de emergencia,2016-08-01,0,1,5,0,0,6
CHUQUIHUTA AYLLU JUCUMANI,"anticoncepcion, prevencion de its y de cancer de cuello uterino",numero de mujeres con pildora anticonceptiva oral de emergencia,2016-08-01,0,3,0,0,0,3
COCHABAMBA,"anticoncepcion, prevencion de its y de cancer de cuello uterino",numero de mujeres con pildora anticonceptiva oral de emergencia,2016-08-01,2,4,7,6,0,19
"COLCHA ""K""","anticoncepcion, prevencion de its y de cancer de cuello uterino",numero de mujeres con pildora anticonceptiva oral de emergencia,2016-08-01,0,0,2,0,0,2
COLOMI,"anticoncepcion, prevencion de its y de cancer de cuello uterino",numero de mujeres con pildora anticonceptiva oral de emergencia,2016-08-01,0,1,1,1,0,3
COLQUECHACA,"anticoncepcion, prevencion de its y de cancer de cuello uterino",numero de mujeres con pildora anticonceptiva oral de emergencia,2016-08-01,0,0,6,0,0,6
COLQUENCHA,"anticoncepcion, prevencion de its y de cancer de cuello uterino",numero de mujeres con pildora anticonceptiva oral de emergencia,2016-08-01,0,0,1,0,0,1
COMARAPA,"anticoncepcion, prevencion de its y de cancer de cuello uterino",numero de mujeres con pildora anticonceptiva oral de emergencia,2016-08-01,0,2,1,0,0,3
CORIPATA,"anticoncepcion, prevencion de its y de cancer de cuello uterino",numero de mujeres con pildora anticonceptiva oral de emergencia,2016-08-01,0,0,1,0,0,1
CORQUE,"anticoncepcion, prevencion de its y de cancer de cuello uterino",numero de mujeres con pildora anticonceptiva oral de emergencia,2016-08-01,0,0,1,0,0,1
EL ALTO,"anticoncepcion, prevencion de its y de cancer de cuello uterino",numero de mujeres con pildora anticonceptiva oral de emergencia,2016-08-01,0,3,18,39,6,66
EL PUENTE(STC),"anticoncepcion, prevencion de its y de cancer de cuello uterino",numero de mujeres con pildora anticonceptiva oral de emergencia,2016-08-01,0,0,3,1,0,4
EL TORNO,"anticoncepcion, prevencion de its y de cancer de cuello uterino",numero de mujeres con pildora anticonceptiva oral de emergencia,2016-08-01,0,5,10,1,0,16
ESCARA,"anticoncepcion, prevencion de its y de cancer de cuello uterino",numero de mujeres con pildora anticonceptiva oral de emergencia,2016-08-01,0,0,3,0,0,3
GUAYARAMERIN,"anticoncepcion, prevencion de its y de cancer de cuello uterino",numero de mujeres con pildora anticonceptiva oral de emergencia,2016-08-01,0,10,15,3,1,29
HUACARETA,"anticoncepcion, prevencion de its y de cancer de cuello uterino",numero de mujeres con pildora anticonceptiva oral de emergencia,2016-08-01,0,3,16,2,0,21
ICLA,"anticoncepcion, prevencion de its y de cancer de cuello uterino",numero de mujeres con pildora anticonceptiva oral de emergencia,2016-08-01,0,2,0,0,0,2
JESUS DE MACHACA,"anticoncepcion, prevencion de its y de cancer de cuello uterino",numero de mujeres con pildora anticonceptiva oral de emergencia,2016-08-01,0,0,1,0,0,1
LA PAZ,"anticoncepcion, prevencion de its y de cancer de cuello uterino",numero de mujeres con pildora anticonceptiva oral de emergencia,2016-08-01,0,1,11,14,0,26
LLALLAGUA,"anticoncepcion, prevencion de its y de cancer de cuello uterino",numero de mujeres con pildora anticonceptiva oral de emergencia,2016-08-01,0,0,4,0,0,4
MACHARETI,"anticoncepcion, prevencion de its y de cancer de cuello uterino",numero de mujeres con pildora anticonceptiva oral de emergencia,2016-08-01,0,0,5,0,0,5
MOJOCOYA,"anticoncepcion, prevencion de its y de cancer de cuello uterino",numero de mujeres con pildora anticonceptiva oral de emergencia,2016-08-01,0,1,0,0,0,1
MONTEAGUDO,"anticoncepcion, prevencion de its y de cancer de cuello uterino",numero de mujeres con pildora anticonceptiva oral de emergencia,2016-08-01,0,3,0,1,0,4
MONTERO,"anticoncepcion, prevencion de its y de cancer de cuello uterino",numero de mujeres con pildora anticonceptiva oral de emergencia,2016-08-01,5,5,5,5,5,25
ORURO,"anticoncepcion, prevencion de its y de cancer de cuello uterino",numero de mujeres con pildora anticonceptiva oral de emergencia,2016-08-01,0,1,9,22,4,36
PADILLA,"anticoncepcion, prevencion de its y de cancer de cuello uterino",numero de mujeres con pildora anticonceptiva oral de emergencia,2016-08-01,1,0,0,1,0,2
PALOS BLANCOS,"anticoncepcion, prevencion de its y de cancer de cuello uterino",numero de mujeres con pildora anticonceptiva oral de emergencia,2016-08-01,0,0,1,0,0,1
PAPEL PAMPA,"anticoncepcion, prevencion de its y de cancer de cuello uterino",numero de mujeres con pildora anticonceptiva oral de emergencia,2016-08-01,0,2,2,1,0,5
PATACAMAYA,"anticoncepcion, prevencion de its y de cancer de cuello uterino",numero de mujeres con pildora anticonceptiva oral de emergencia,2016-08-01,0,1,0,0,0,1
PORCO,"anticoncepcion, prevencion de its y de cancer de cuello uterino",numero de mujeres con pildora anticonceptiva oral de emergencia,2016-08-01,0,0,1,0,0,1
POROMA,"anticoncepcion, prevencion de its y de cancer de cuello uterino",numero de mujeres con pildora anticonceptiva oral de emergencia,2016-08-01,1,4,2,0,0,7
POTOSI,"anticoncepcion, prevencion de its y de cancer de cuello uterino",numero de mujeres con pildora anticonceptiva oral de emergencia,2016-08-01,0,0,0,1,0,1
PRESTO,"anticoncepcion, prevencion de its y de cancer de cuello uterino",numero de mujeres con pildora anticonceptiva oral de emergencia,2016-08-01,0,2,3,0,0,5
PUERTO VILLARROEL,"anticoncepcion, prevencion de its y de cancer de cuello uterino",numero de mujeres con pildora anticonceptiva oral de emergencia,2016-08-01,0,1,0,0,0,1
QUILLACOLLO,"anticoncepcion, prevencion de its y de cancer de cuello uterino",numero de mujeres con pildora anticonceptiva oral de emergencia,2016-08-01,0,8,6,0,0,14
RIBERALTA,"anticoncepcion, prevencion de its y de cancer de cuello uterino",numero de mujeres con pildora anticonceptiva oral de emergencia,2016-08-01,0,0,1,0,0,1
ROBORE,"anticoncepcion, prevencion de its y de cancer de cuello uterino",numero de mujeres con pildora anticonceptiva oral de emergencia,2016-08-01,0,0,4,0,0,4
SACABA,"anticoncepcion, prevencion de its y de cancer de cuello uterino",numero de mujeres con pildora anticonceptiva oral de emergencia,2016-08-01,0,1,1,0,0,2
SAN BUENA VENTURA,"anticoncepcion, prevencion de its y de cancer de cuello uterino",numero de mujeres con pildora anticonceptiva oral de emergencia,2016-08-01,0,0,1,1,0,2
SAN JAVIER(BNI),"anticoncepcion, prevencion de its y de cancer de cuello uterino",numero de mujeres con pildora anticonceptiva oral de emergencia,2016-08-01,0,5,7,1,0,13
SAN JULIAN,"anticoncepcion, prevencion de its y de cancer de cuello uterino",numero de mujeres con pildora anticonceptiva oral de emergencia,2016-08-01,0,0,1,0,0,1
SAN LUCAS,"anticoncepcion, prevencion de its y de cancer de cuello uterino",numero de mujeres con pildora anticonceptiva oral de emergencia,2016-08-01,0,1,5,0,0,6
SAN PEDRO,"anticoncepcion, prevencion de its y de cancer de cuello uterino",numero de mujeres con pildora anticonceptiva oral de emergencia,2016-08-01,0,0,1,0,0,1
SANTA CRUZ DE LA SIERRA,"anticoncepcion, prevencion de its y de cancer de cuello uterino",numero de mujeres con pildora anticonceptiva oral de emergencia,2016-08-01,0,1,10,9,0,20
SANTUARIO DE QUILLACAS,"anticoncepcion, prevencion de its y de cancer de cuello uterino",numero de mujeres con pildora anticonceptiva oral de emergencia,2016-08-01,0,0,1,0,0,1
SICA SICA (VILLA AROMA),"anticoncepcion, prevencion de its y de cancer de cuello uterino",numero de mujeres con pildora anticonceptiva oral de emergencia,2016-08-01,0,3,1,2,0,6
SOPACHUY,"anticoncepcion, prevencion de its y de cancer de cuello uterino",numero de mujeres con pildora anticonceptiva oral de emergencia,2016-08-01,0,0,2,0,0,2
SUCRE,"anticoncepcion, prevencion de its y de cancer de cuello uterino",numero de mujeres con pildora anticonceptiva oral de emergencia,2016-08-01,0,1,10,3,1,15
TARABUCO,"anticoncepcion, prevencion de its y de cancer de cuello uterino",numero de mujeres con pildora anticonceptiva oral de emergencia,2016-08-01,0,1,2,0,0,3
TARIJA,"anticoncepcion, prevencion de its y de cancer de cuello uterino",numero de mujeres con pildora anticonceptiva oral de emergencia,2016-08-01,0,0,4,4,0,8
TARVITA,"anticoncepcion, prevencion de its y de cancer de cuello uterino",numero de mujeres con pildora anticonceptiva oral de emergencia,2016-08-01,0,0,1,0,0,1
TIAWANACU,"anticoncepcion, prevencion de its y de cancer de cuello uterino",numero de mujeres con pildora anticonceptiva oral de emergencia,2016-08-01,0,1,1,1,0,3
TINGUIPAYA,"anticoncepcion, prevencion de its y de cancer de cuello uterino",numero de mujeres con pildora anticonceptiva oral de emergencia,2016-08-01,0,1,4,4,0,9
TITO YUPANQUI (PARQUIPUJIO),"anticoncepcion, prevencion de its y de cancer de cuello uterino",numero de mujeres con pildora anticonceptiva oral de emergencia,2016-08-01,1,0,0,0,0,1
TOLEDO,"anticoncepcion, prevencion de its y de cancer de cuello uterino",numero de mujeres con pildora anticonceptiva oral de emergencia,2016-08-01,0,0,3,0,0,3
TOMAVE,"anticoncepcion, prevencion de its y de cancer de cuello uterino",numero de mujeres con pildora anticonceptiva oral de emergencia,2016-08-01,0,0,3,1,0,4
TOMINA,"anticoncepcion, prevencion de its y de cancer de cuello uterino",numero de mujeres con pildora anticonceptiva oral de emergencia,2016-08-01,0,1,0,0,0,1
TOTORA(ORR),"anticoncepcion, prevencion de its y de cancer de cuello uterino",numero de mujeres con pildora anticonceptiva oral de emergencia,2016-08-01,0,0,2,0,0,2
TRINIDAD,"anticoncepcion, prevencion de its y de cancer de cuello uterino",numero de mujeres con pildora anticonceptiva oral de emergencia,2016-08-01,0,0,32,0,0,32
TUPIZA,"anticoncepcion, prevencion de its y de cancer de cuello uterino",numero de mujeres con pildora anticonceptiva oral de emergencia,2016-08-01,0,3,5,14,0,22
TURCO,"anticoncepcion, prevencion de its y de cancer de cuello uterino",numero de mujeres con pildora anticonceptiva oral de emergencia,2016-08-01,0,0,1,0,0,1
UMALA,"anticoncepcion, prevencion de its y de cancer de cuello uterino",numero de mujeres con pildora anticonceptiva oral de emergencia,2016-08-01,0,1,0,0,0,1
UYUNI,"anticoncepcion, prevencion de its y de cancer de cuello uterino",numero de mujeres con pildora anticonceptiva oral de emergencia,2016-08-01,0,1,4,1,0,6
VIACHA,"anticoncepcion, prevencion de its y de cancer de cuello uterino",numero de mujeres con pildora anticonceptiva oral de emergencia,2016-08-01,0,0,1,0,0,1
VILLA CHARCAS,"anticoncepcion, prevencion de its y de cancer de cuello uterino",numero de mujeres con pildora anticonceptiva oral de emergencia,2016-08-01,0,1,0,0,0,1
VILLA TUNARI,"anticoncepcion, prevencion de its y de cancer de cuello uterino",numero de mujeres con pildora anticonceptiva oral de emergencia,2016-08-01,0,0,6,1,0,7
VILLA VACA GUZMAN (MUYUPAMPA),"anticoncepcion, prevencion de its y de cancer de cuello uterino",numero de mujeres con pildora anticonceptiva oral de emergencia,2016-08-01,0,0,2,0,0,2
VILLAZON,"anticoncepcion, prevencion de its y de cancer de cuello uterino",numero de mujeres con pildora anticonceptiva oral de emergencia,2016-08-01,0,1,0,0,0,1
VINTO,"anticoncepcion, prevencion de its y de cancer de cuello uterino",numero de mujeres con pildora anticonceptiva oral de emergencia,2016-08-01,0,0,3,0,0,3
YAMPARAEZ,"anticoncepcion, prevencion de its y de cancer de cuello uterino",numero de mujeres con pildora anticonceptiva oral de emergencia,2016-08-01,1,0,2,1,0,4
YANACACHI,"anticoncepcion, prevencion de its y de cancer de cuello uterino",numero de mujeres con pildora anticonceptiva oral de emergencia,2016-08-01,0,0,3,0,0,3
YAPACANI,"anticoncepcion, prevencion de its y de cancer de cuello uterino",numero de mujeres con pildora anticonceptiva oral de emergencia,2016-08-01,2,4,10,2,1,19
ZUDAÑEZ,"anticoncepcion, prevencion de its y de cancer de cuello uterino",numero de mujeres con pildora anticonceptiva oral de emergencia,2016-08-01,0,1,0,0,0,1
ACHACACHI,"anticoncepcion, prevencion de its y de cancer de cuello uterino",numero de mujeres con pildora anticonceptiva oral de emergencia,2016-09-01,0,3,4,0,0,7
AIQUILE,"anticoncepcion, prevencion de its y de cancer de cuello uterino",numero de mujeres con pildora anticonceptiva oral de emergencia,2016-09-01,0,0,0,2,0,2
ALCALA,"anticoncepcion, prevencion de its y de cancer de cuello uterino",numero de mujeres con pildora anticonceptiva oral de emergencia,2016-09-01,0,0,1,1,0,2
BETANZOS,"anticoncepcion, prevencion de its y de cancer de cuello uterino",numero de mujeres con pildora anticonceptiva oral de emergencia,2016-09-01,0,1,0,0,0,1
CAIROMA,"anticoncepcion, prevencion de its y de cancer de cuello uterino",numero de mujeres con pildora anticonceptiva oral de emergencia,2016-09-01,0,0,0,1,0,1
CAMARGO,"anticoncepcion, prevencion de its y de cancer de cuello uterino",numero de mujeres con pildora anticonceptiva oral de emergencia,2016-09-01,0,0,2,0,0,2
CAMATAQUI (C. VILLA ABECIA),"anticoncepcion, prevencion de its y de cancer de cuello uterino",numero de mujeres con pildora anticonceptiva oral de emergencia,2016-09-01,0,1,0,0,0,1
CHUMA,"anticoncepcion, prevencion de its y de cancer de cuello uterino",numero de mujeres con pildora anticonceptiva oral de emergencia,2016-09-01,0,1,1,1,0,3
COCHABAMBA,"anticoncepcion, prevencion de its y de cancer de cuello uterino",numero de mujeres con pildora anticonceptiva oral de emergencia,2016-09-01,3,6,3,3,1,16
"COLCHA ""K""","anticoncepcion, prevencion de its y de cancer de cuello uterino",numero de mujeres con pildora anticonceptiva oral de emergencia,2016-09-01,0,0,5,0,0,5
COLOMI,"anticoncepcion, prevencion de its y de cancer de cuello uterino",numero de mujeres con pildora anticonceptiva oral de emergencia,2016-09-01,0,1,2,1,0,4
COLQUECHACA,"anticoncepcion, prevencion de its y de cancer de cuello uterino",numero de mujeres con pildora anticonceptiva oral de emergencia,2016-09-01,0,0,3,0,0,3
COLQUENCHA,"anticoncepcion, prevencion de its y de cancer de cuello uterino",numero de mujeres con pildora anticonceptiva oral de emergencia,2016-09-01,0,0,0,1,0,1
CORIPATA,"anticoncepcion, prevencion de its y de cancer de cuello uterino",numero de mujeres con pildora anticonceptiva oral de emergencia,2016-09-01,0,0,1,0,0,1
CULPINA,"anticoncepcion, prevencion de its y de cancer de cuello uterino",numero de mujeres con pildora anticonceptiva oral de emergencia,2016-09-01,0,1,1,0,0,2
DESAGUADERO,"anticoncepcion, prevencion de its y de cancer de cuello uterino",numero de mujeres con pildora anticonceptiva oral de emergencia,2016-09-01,0,0,0,1,0,1
EL ALTO,"anticoncepcion, prevencion de its y de cancer de cuello uterino",numero de mujeres con pildora anticonceptiva oral de emergencia,2016-09-01,0,6,33,12,0,51
EL PUENTE(TJA),"anticoncepcion, prevencion de its y de cancer de cuello uterino",numero de mujeres con pildora anticonceptiva oral de emergencia,2016-09-01,0,0,0,1,0,1
EL TORNO,"anticoncepcion, prevencion de its y de cancer de cuello uterino",numero de mujeres con pildora anticonceptiva oral de emergencia,2016-09-01,0,5,3,0,0,8
ENTRE RIOS CBBA,"anticoncepcion, prevencion de its y de cancer de cuello uterino",numero de mujeres con pildora anticonceptiva oral de emergencia,2016-09-01,0,0,0,1,0,1
ESMERALDA,"anticoncepcion, prevencion de its y de cancer de cuello uterino",numero de mujeres con pildora anticonceptiva oral de emergencia,2016-09-01,0,0,1,0,0,1
GRAL. J.J. PEREZ (CHARAZANI),"anticoncepcion, prevencion de its y de cancer de cuello uterino",numero de mujeres con pildora anticonceptiva oral de emergencia,2016-09-01,0,0,1,0,0,1
GUAQUI,"anticoncepcion, prevencion de its y de cancer de cuello uterino",numero de mujeres con pildora anticonceptiva oral de emergencia,2016-09-01,0,1,0,0,0,1
GUAYARAMERIN,"anticoncepcion, prevencion de its y de cancer de cuello uterino",numero de mujeres con pildora anticonceptiva oral de emergencia,2016-09-01,0,1,14,1,0,16
HUACARETA,"anticoncepcion, prevencion de its y de cancer de cuello uterino",numero de mujeres con pildora anticonceptiva oral de emergencia,2016-09-01,0,0,2,3,0,5
INCAHUASI,"anticoncepcion, prevencion de its y de cancer de cuello uterino",numero de mujeres con pildora anticonceptiva oral de emergencia,2016-09-01,0,0,1,2,0,3
IXIAMAS,"anticoncepcion, prevencion de its y de cancer de cuello uterino",numero de mujeres con pildora anticonceptiva oral de emergencia,2016-09-01,0,0,1,0,0,1
LA PAZ,"anticoncepcion, prevencion de its y de cancer de cuello uterino",numero de mujeres con pildora anticonceptiva oral de emergencia,2016-09-01,0,1,4,4,0,9
LAS CARRERAS,"anticoncepcion, prevencion de its y de cancer de cuello uterino",numero de mujeres con pildora anticonceptiva oral de emergencia,2016-09-01,0,1,1,0,0,2
LLALLAGUA,"anticoncepcion, prevencion de its y de cancer de cuello uterino",numero de mujeres con pildora anticonceptiva oral de emergencia,2016-09-01,0,1,6,1,0,8
LORETO,"anticoncepcion, prevencion de its y de cancer de cuello uterino",numero de mujeres con pildora anticonceptiva oral de emergencia,2016-09-01,0,1,0,0,0,1
MACHARETI,"anticoncepcion, prevencion de its y de cancer de cuello uterino",numero de mujeres con pildora anticonceptiva oral de emergencia,2016-09-01,0,4,2,0,0,6
MOJINETE,"anticoncepcion, prevencion de its y de cancer de cuello uterino",numero de mujeres con pildora anticonceptiva oral de emergencia,2016-09-01,0,0,1,0,0,1
MONTEAGUDO,"anticoncepcion, prevencion de its y de cancer de cuello uterino",numero de mujeres con pildora anticonceptiva oral de emergencia,2016-09-01,0,0,4,0,0,4
MONTERO,"anticoncepcion, prevencion de its y de cancer de cuello uterino",numero de mujeres con pildora anticonceptiva oral de emergencia,2016-09-01,3,2,3,3,0,11
OCURI,"anticoncepcion, prevencion de its y de cancer de cuello uterino",numero de mujeres con pildora anticonceptiva oral de emergencia,2016-09-01,0,0,2,2,0,4
ORURO,"anticoncepcion, prevencion de its y de cancer de cuello uterino",numero de mujeres con pildora anticonceptiva oral de emergencia,2016-09-01,0,9,30,8,0,47
PADILLA,"anticoncepcion, prevencion de its y de cancer de cuello uterino",numero de mujeres con pildora anticonceptiva oral de emergencia,2016-09-01,0,0,2,2,0,4
PALOS BLANCOS,"anticoncepcion, prevencion de its y de cancer de cuello uterino",numero de mujeres con pildora anticonceptiva oral de emergencia,2016-09-01,0,0,1,0,0,1
PAPEL PAMPA,"anticoncepcion, prevencion de its y de cancer de cuello uterino",numero de mujeres con pildora anticonceptiva oral de emergencia,2016-09-01,0,1,3,2,0,6
PATACAMAYA,"anticoncepcion, prevencion de its y de cancer de cuello uterino",numero de mujeres con pildora anticonceptiva oral de emergencia,2016-09-01,0,0,1,0,0,1
POCOATA,"anticoncepcion, prevencion de its y de cancer de cuello uterino",numero de mujeres con pildora anticonceptiva oral de emergencia,2016-09-01,0,0,1,11,0,12
POROMA,"anticoncepcion, prevencion de its y de cancer de cuello uterino",numero de mujeres con pildora anticonceptiva oral de emergencia,2016-09-01,0,0,1,0,0,1
POTOSI,"anticoncepcion, prevencion de its y de cancer de cuello uterino",numero de mujeres con pildora anticonceptiva oral de emergencia,2016-09-01,0,2,27,7,0,36
PRESTO,"anticoncepcion, prevencion de its y de cancer de cuello uterino",numero de mujeres con pildora anticonceptiva oral de emergencia,2016-09-01,0,2,1,1,0,4
PUNATA,"anticoncepcion, prevencion de its y de cancer de cuello uterino",numero de mujeres con pildora anticonceptiva oral de emergencia,2016-09-01,0,1,0,0,0,1
QUILLACOLLO,"anticoncepcion, prevencion de its y de cancer de cuello uterino",numero de mujeres con pildora anticonceptiva oral de emergencia,2016-09-01,0,8,1,0,0,9
RIBERALTA,"anticoncepcion, prevencion de its y de cancer de cuello uterino",numero de mujeres con pildora anticonceptiva oral de emergencia,2016-09-01,0,1,2,0,0,3
SACABA,"anticoncepcion, prevencion de its y de cancer de cuello uterino",numero de mujeres con pildora anticonceptiva oral de emergencia,2016-09-01,0,0,4,0,0,4
SAN JAVIER(BNI),"anticoncepcion, prevencion de its y de cancer de cuello uterino",numero de mujeres con pildora anticonceptiva oral de emergencia,2016-09-01,0,1,4,2,0,7
SAN JULIAN,"anticoncepcion, prevencion de its y de cancer de cuello uterino",numero de mujeres con pildora anticonceptiva oral de emergencia,2016-09-01,1,1,3,0,0,5
SAN LUCAS,"anticoncepcion, prevencion de its y de cancer de cuello uterino",numero de mujeres con pildora anticonceptiva oral de emergencia,2016-09-01,1,0,4,0,0,5
SAN PEDRO,"anticoncepcion, prevencion de its y de cancer de cuello uterino",numero de mujeres con pildora anticonceptiva oral de emergencia,2016-09-01,0,1,0,0,0,1
SANTA CRUZ DE LA SIERRA,"anticoncepcion, prevencion de its y de cancer de cuello uterino",numero de mujeres con pildora anticonceptiva oral de emergencia,2016-09-01,1,23,62,14,0,100
SANTIAGO DE HUARI,"anticoncepcion, prevencion de its y de cancer de cuello uterino",numero de mujeres con pildora anticonceptiva oral de emergencia,2016-09-01,0,1,0,0,0,1
SANTUARIO DE QUILLACAS,"anticoncepcion, prevencion de its y de cancer de cuello uterino",numero de mujeres con pildora anticonceptiva oral de emergencia,2016-09-01,0,1,1,0,0,2
SICA SICA (VILLA AROMA),"anticoncepcion, prevencion de its y de cancer de cuello uterino",numero de mujeres con pildora anticonceptiva oral de emergencia,2016-09-01,0,1,3,0,0,4
SOPACHUY,"anticoncepcion, prevencion de its y de cancer de cuello uterino",numero de mujeres con pildora anticonceptiva oral de emergencia,2016-09-01,0,0,1,0,0,1
SUCRE,"anticoncepcion, prevencion de its y de cancer de cuello uterino",numero de mujeres con pildora anticonceptiva oral de emergencia,2016-09-01,1,3,13,3,1,21
TAPACARI,"anticoncepcion, prevencion de its y de cancer de cuello uterino",numero de mujeres con pildora anticonceptiva oral de emergencia,2016-09-01,0,1,0,1,0,2
TARABUCO,"anticoncepcion, prevencion de its y de cancer de cuello uterino",numero de mujeres con pildora anticonceptiva oral de emergencia,2016-09-01,1,1,3,0,0,5
TARACO,"anticoncepcion, prevencion de its y de cancer de cuello uterino",numero de mujeres con pildora anticonceptiva oral de emergencia,2016-09-01,0,0,1,0,0,1
TARVITA,"anticoncepcion, prevencion de its y de cancer de cuello uterino",numero de mujeres con pildora anticonceptiva oral de emergencia,2016-09-01,0,0,1,0,0,1
TINGUIPAYA,"anticoncepcion, prevencion de its y de cancer de cuello uterino",numero de mujeres con pildora anticonceptiva oral de emergencia,2016-09-01,0,0,1,0,0,1
TIPUANI,"anticoncepcion, prevencion de its y de cancer de cuello uterino",numero de mujeres con pildora anticonceptiva oral de emergencia,2016-09-01,0,0,9,5,0,14
TIRAQUE (CBBA),"anticoncepcion, prevencion de its y de cancer de cuello uterino",numero de mujeres con pildora anticonceptiva oral de emergencia,2016-09-01,0,0,0,1,0,1
TOMAVE,"anticoncepcion, prevencion de its y de cancer de cuello uterino",numero de mujeres con pildora anticonceptiva oral de emergencia,2016-09-01,0,2,3,0,0,5
TOTORA(CBBA),"anticoncepcion, prevencion de its y de cancer de cuello uterino",numero de mujeres con pildora anticonceptiva oral de emergencia,2016-09-01,0,0,0,1,0,1
TOTORA(ORR),"anticoncepcion, prevencion de its y de cancer de cuello uterino",numero de mujeres con pildora anticonceptiva oral de emergencia,2016-09-01,0,0,5,0,0,5
TUPIZA,"anticoncepcion, prevencion de its y de cancer de cuello uterino",numero de mujeres con pildora anticonceptiva oral de emergencia,2016-09-01,0,2,1,1,0,4
TURCO,"anticoncepcion, prevencion de its y de cancer de cuello uterino",numero de mujeres con pildora anticonceptiva oral de emergencia,2016-09-01,0,0,2,0,0,2
VILLA CHARCAS,"anticoncepcion, prevencion de its y de cancer de cuello uterino",numero de mujeres con pildora anticonceptiva oral de emergencia,2016-09-01,0,2,3,1,0,6
VILLA TUNARI,"anticoncepcion, prevencion de its y de cancer de cuello uterino",numero de mujeres con pildora anticonceptiva oral de emergencia,2016-09-01,0,1,1,0,0,2
VILLA VACA GUZMAN (MUYUPAMPA),"anticoncepcion, prevencion de its y de cancer de cuello uterino",numero de mujeres con pildora anticonceptiva oral de emergencia,2016-09-01,0,0,3,0,0,3
VILLAZON,"anticoncepcion, prevencion de its y de cancer de cuello uterino",numero de mujeres con pildora anticonceptiva oral de emergencia,2016-09-01,0,2,32,3,0,37
VINTO,"anticoncepcion, prevencion de its y de cancer de cuello uterino",numero de mujeres con pildora anticonceptiva oral de emergencia,2016-09-01,0,1,0,1,0,2
YACUIBA,"anticoncepcion, prevencion de its y de cancer de cuello uterino",numero de mujeres con pildora anticonceptiva oral de emergencia,2016-09-01,0,0,0,1,0,1
ACHACACHI,"anticoncepcion, prevencion de its y de cancer de cuello uterino",numero de mujeres con pildora anticonceptiva oral de emergencia,2016-10-01,0,0,2,0,0,2
AIQUILE,"anticoncepcion, prevencion de its y de cancer de cuello uterino",numero de mujeres con pildora anticonceptiva oral de emergencia,2016-10-01,0,0,1,0,0,1
ALCALA,"anticoncepcion, prevencion de its y de cancer de cuello uterino",numero de mujeres con pildora anticonceptiva oral de emergencia,2016-10-01,0,0,1,0,0,1
ALTO BENI,"anticoncepcion, prevencion de its y de cancer de cuello uterino",numero de mujeres con pildora anticonceptiva oral de emergencia,2016-10-01,0,0,0,1,0,1
ATOCHA,"anticoncepcion, prevencion de its y de cancer de cuello uterino",numero de mujeres con pildora anticonceptiva oral de emergencia,2016-10-01,0,0,2,2,0,4
AZURDUY,"anticoncepcion, prevencion de its y de cancer de cuello uterino",numero de mujeres con pildora anticonceptiva oral de emergencia,2016-10-01,0,1,0,1,0,2
CABEZAS,"anticoncepcion, prevencion de its y de cancer de cuello uterino",numero de mujeres con pildora anticonceptiva oral de emergencia,2016-10-01,0,0,2,2,0,4
"CAIZA ""D""","anticoncepcion, prevencion de its y de cancer de cuello uterino",numero de mujeres con pildora anticonceptiva oral de emergencia,2016-10-01,0,0,1,1,0,2
CAMARGO,"anticoncepcion, prevencion de its y de cancer de cuello uterino",numero de mujeres con pildora anticonceptiva oral de emergencia,2016-10-01,0,0,2,0,0,2
CAMIRI,"anticoncepcion, prevencion de its y de cancer de cuello uterino",numero de mujeres con pildora anticonceptiva oral de emergencia,2016-10-01,0,0,1,0,0,1
CAQUIAVIRI,"anticoncepcion, prevencion de its y de cancer de cuello uterino",numero de mujeres con pildora anticonceptiva oral de emergencia,2016-10-01,0,1,2,0,0,3
CHALLAPATA,"anticoncepcion, prevencion de its y de cancer de cuello uterino",numero de mujeres con pildora anticonceptiva oral de emergencia,2016-10-01,0,0,0,1,0,1
CHARAGUA,"anticoncepcion, prevencion de its y de cancer de cuello uterino",numero de mujeres con pildora anticonceptiva oral de emergencia,2016-10-01,0,0,1,1,0,2
CHULUMANI (V. DE LA LIBERTAD),"anticoncepcion, prevencion de its y de cancer de cuello uterino",numero de mujeres con pildora anticonceptiva oral de emergencia,2016-10-01,0,1,0,0,0,1
CHUMA,"anticoncepcion, prevencion de its y de cancer de cuello uterino",numero de mujeres con pildora anticonceptiva oral de emergencia,2016-10-01,0,1,0,0,0,1
COCHABAMBA,"anticoncepcion, prevencion de its y de cancer de cuello uterino",numero de mujeres con pildora anticonceptiva oral de emergencia,2016-10-01,3,6,2,2,0,13
"COLCHA ""K""","anticoncepcion, prevencion de its y de cancer de cuello uterino",numero de mujeres con pildora anticonceptiva oral de emergencia,2016-10-01,0,0,1,0,0,1
COLOMI,"anticoncepcion, prevencion de its y de cancer de cuello uterino",numero de mujeres con pildora anticonceptiva oral de emergencia,2016-10-01,0,1,0,0,0,1
COLQUECHACA,"anticoncepcion, prevencion de its y de cancer de cuello uterino",numero de mujeres con pildora anticonceptiva oral de emergencia,2016-10-01,0,0,1,0,0,1
COMARAPA,"anticoncepcion, prevencion de its y de cancer de cuello uterino",numero de mujeres con pildora anticonceptiva oral de emergencia,2016-10-01,0,0,1,0,0,1
CORIPATA,"anticoncepcion, prevencion de its y de cancer de cuello uterino",numero de mujeres con pildora anticonceptiva oral de emergencia,2016-10-01,0,0,0,1,0,1
COTAGAITA,"anticoncepcion, prevencion de its y de cancer de cuello uterino",numero de mujeres con pildora anticonceptiva oral de emergencia,2016-10-01,0,0,1,0,0,1
CULPINA,"anticoncepcion, prevencion de its y de cancer de cuello uterino",numero de mujeres con pildora anticonceptiva oral de emergencia,2016-10-01,0,0,1,0,0,1
EL ALTO,"anticoncepcion, prevencion de its y de cancer de cuello uterino",numero de mujeres con pildora anticonceptiva oral de emergencia,2016-10-01,0,3,44,10,0,57
EL CHORO,"anticoncepcion, prevencion de its y de cancer de cuello uterino",numero de mujeres con pildora anticonceptiva oral de emergencia,2016-10-01,0,0,4,2,0,6
EL TORNO,"anticoncepcion, prevencion de its y de cancer de cuello uterino",numero de mujeres con pildora anticonceptiva oral de emergencia,2016-10-01,0,0,4,4,0,8
EL VILLAR,"anticoncepcion, prevencion de its y de cancer de cuello uterino",numero de mujeres con pildora anticonceptiva oral de emergencia,2016-10-01,1,2,0,0,0,3
ESCARA,"anticoncepcion, prevencion de its y de cancer de cuello uterino",numero de mujeres con pildora anticonceptiva oral de emergencia,2016-10-01,0,0,2,0,0,2
GUAQUI,"anticoncepcion, prevencion de its y de cancer de cuello uterino",numero de mujeres con pildora anticonceptiva oral de emergencia,2016-10-01,0,0,1,0,0,1
GUAYARAMERIN,"anticoncepcion, prevencion de its y de cancer de cuello uterino",numero de mujeres con pildora anticonceptiva oral de emergencia,2016-10-01,0,3,20,8,0,31
HUACARETA,"anticoncepcion, prevencion de its y de cancer de cuello uterino",numero de mujeres con pildora anticonceptiva oral de emergencia,2016-10-01,0,1,1,0,0,2
INCAHUASI,"anticoncepcion, prevencion de its y de cancer de cuello uterino",numero de mujeres con pildora anticonceptiva oral de emergencia,2016-10-01,0,0,5,8,0,13
LA PAZ,"anticoncepcion, prevencion de its y de cancer de cuello uterino",numero de mujeres con pildora anticonceptiva oral de emergencia,2016-10-01,0,1,5,3,0,9
LAS CARRERAS,"anticoncepcion, prevencion de its y de cancer de cuello uterino",numero de mujeres con pildora anticonceptiva oral de emergencia,2016-10-01,0,1,0,0,0,1
LLALLAGUA,"anticoncepcion, prevencion de its y de cancer de cuello uterino",numero de mujeres con pildora anticonceptiva oral de emergencia,2016-10-01,0,0,4,0,0,4
LURIBAY,"anticoncepcion, prevencion de its y de cancer de cuello uterino",numero de mujeres con pildora anticonceptiva oral de emergencia,2016-10-01,0,0,1,0,0,1
MACHARETI,"anticoncepcion, prevencion de its y de cancer de cuello uterino",numero de mujeres con pildora anticonceptiva oral de emergencia,2016-10-01,0,0,2,0,0,2
MOJOCOYA,"anticoncepcion, prevencion de its y de cancer de cuello uterino",numero de mujeres con pildora anticonceptiva oral de emergencia,2016-10-01,0,2,1,0,0,3
MONTEAGUDO,"anticoncepcion, prevencion de its y de cancer de cuello uterino",numero de mujeres con pildora anticonceptiva oral de emergencia,2016-10-01,0,2,2,0,0,4
MONTERO,"anticoncepcion, prevencion de its y de cancer de cuello uterino",numero de mujeres con pildora anticonceptiva oral de emergencia,2016-10-01,0,0,1,0,0,1
MOROCHATA,"anticoncepcion, prevencion de its y de cancer de cuello uterino",numero de mujeres con pildora anticonceptiva oral de emergencia,2016-10-01,1,0,0,0,0,1
OMEREQUE,"anticoncepcion, prevencion de its y de cancer de cuello uterino",numero de mujeres con pildora anticonceptiva oral de emergencia,2016-10-01,0,0,1,0,0,1
ORURO,"anticoncepcion, prevencion de its y de cancer de cuello uterino",numero de mujeres con pildora anticonceptiva oral de emergencia,2016-10-01,0,0,3,0,0,3
PALOS BLANCOS,"anticoncepcion, prevencion de its y de cancer de cuello uterino",numero de mujeres con pildora anticonceptiva oral de emergencia,2016-10-01,1,0,0,0,0,1
PAPEL PAMPA,"anticoncepcion, prevencion de its y de cancer de cuello uterino",numero de mujeres con pildora anticonceptiva oral de emergencia,2016-10-01,0,2,4,0,0,6
PASORAPA,"anticoncepcion, prevencion de its y de cancer de cuello uterino",numero de mujeres con pildora anticonceptiva oral de emergencia,2016-10-01,0,1,0,0,0,1
PELECHUCO,"anticoncepcion, prevencion de its y de cancer de cuello uterino",numero de mujeres con pildora anticonceptiva oral de emergencia,2016-10-01,0,1,0,0,0,1
POROMA,"anticoncepcion, prevencion de its y de cancer de cuello uterino",numero de mujeres con pildora anticonceptiva oral de emergencia,2016-10-01,0,0,1,0,0,1
POTOSI,"anticoncepcion, prevencion de its y de cancer de cuello uterino",numero de mujeres con pildora anticonceptiva oral de emergencia,2016-10-01,1,0,1,0,0,2
PRESTO,"anticoncepcion, prevencion de its y de cancer de cuello uterino",numero de mujeres con pildora anticonceptiva oral de emergencia,2016-10-01,0,2,3,2,0,7
PUNA,"anticoncepcion, prevencion de its y de cancer de cuello uterino",numero de mujeres con pildora anticonceptiva oral de emergencia,2016-10-01,0,0,3,1,0,4
RAVELO,"anticoncepcion, prevencion de its y de cancer de cuello uterino",numero de mujeres con pildora anticonceptiva oral de emergencia,2016-10-01,0,0,1,0,0,1
SACABA,"anticoncepcion, prevencion de its y de cancer de cuello uterino",numero de mujeres con pildora anticonceptiva oral de emergencia,2016-10-01,0,2,0,0,0,2
SACACA,"anticoncepcion, prevencion de its y de cancer de cuello uterino",numero de mujeres con pildora anticonceptiva oral de emergencia,2016-10-01,0,0,1,0,0,1
SAN ANTONIO DE LOMERIO,"anticoncepcion, prevencion de its y de cancer de cuello uterino",numero de mujeres con pildora anticonceptiva oral de emergencia,2016-10-01,0,0,1,0,0,1
SAN BUENA VENTURA,"anticoncepcion, prevencion de its y de cancer de cuello uterino",numero de mujeres con pildora anticonceptiva oral de emergencia,2016-10-01,0,0,1,0,0,1
SAN IGNACIO,"anticoncepcion, prevencion de its y de cancer de cuello uterino",numero de mujeres con pildora anticonceptiva oral de emergencia,2016-10-01,0,6,80,30,0,116
SAN LORENZO(TJA),"anticoncepcion, prevencion de its y de cancer de cuello uterino",numero de mujeres con pildora anticonceptiva oral de emergencia,2016-10-01,0,9,15,9,0,33
SAN PEDRO,"anticoncepcion, prevencion de its y de cancer de cuello uterino",numero de mujeres con pildora anticonceptiva oral de emergencia,2016-10-01,1,0,0,0,0,1
SANTA CRUZ DE LA SIERRA,"anticoncepcion, prevencion de its y de cancer de cuello uterino",numero de mujeres con pildora anticonceptiva oral de emergencia,2016-10-01,0,1,4,6,0,11
SANTUARIO DE QUILLACAS,"anticoncepcion, prevencion de its y de cancer de cuello uterino",numero de mujeres con pildora anticonceptiva oral de emergencia,2016-10-01,1,0,0,0,0,1
SICA SICA (VILLA AROMA),"anticoncepcion, prevencion de its y de cancer de cuello uterino",numero de mujeres con pildora anticonceptiva oral de emergencia,2016-10-01,0,0,1,1,0,2
SORATA,"anticoncepcion, prevencion de its y de cancer de cuello uterino",numero de mujeres con pildora anticonceptiva oral de emergencia,2016-10-01,0,0,3,0,0,3
SUCRE,"anticoncepcion, prevencion de its y de cancer de cuello uterino",numero de mujeres con pildora anticonceptiva oral de emergencia,2016-10-01,1,6,30,6,3,46
TAPACARI,"anticoncepcion, prevencion de its y de cancer de cuello uterino",numero de mujeres con pildora anticonceptiva oral de emergencia,2016-10-01,0,3,2,1,0,6
TARABUCO,"anticoncepcion, prevencion de its y de cancer de cuello uterino",numero de mujeres con pildora anticonceptiva oral de emergencia,2016-10-01,0,0,1,0,0,1
TARIJA,"anticoncepcion, prevencion de its y de cancer de cuello uterino",numero de mujeres con pildora anticonceptiva oral de emergencia,2016-10-01,0,0,5,4,0,9
TOLEDO,"anticoncepcion, prevencion de its y de cancer de cuello uterino",numero de mujeres con pildora anticonceptiva oral de emergencia,2016-10-01,0,0,7,4,0,11
TOMAVE,"anticoncepcion, prevencion de its y de cancer de cuello uterino",numero de mujeres con pildora anticonceptiva oral de emergencia,2016-10-01,0,0,5,0,0,5
TOTORA(CBBA),"anticoncepcion, prevencion de its y de cancer de cuello uterino",numero de mujeres con pildora anticonceptiva oral de emergencia,2016-10-01,0,0,1,0,0,1
TRINIDAD,"anticoncepcion, prevencion de its y de cancer de cuello uterino",numero de mujeres con pildora anticonceptiva oral de emergencia,2016-10-01,0,4,8,4,0,16
TUPIZA,"anticoncepcion, prevencion de its y de cancer de cuello uterino",numero de mujeres con pildora anticonceptiva oral de emergencia,2016-10-01,0,0,2,1,0,3
TURCO,"anticoncepcion, prevencion de its y de cancer de cuello uterino",numero de mujeres con pildora anticonceptiva oral de emergencia,2016-10-01,0,0,1,0,0,1
VIACHA,"anticoncepcion, prevencion de its y de cancer de cuello uterino",numero de mujeres con pildora anticonceptiva oral de emergencia,2016-10-01,0,0,15,1,0,16
VILLA VACA GUZMAN (MUYUPAMPA),"anticoncepcion, prevencion de its y de cancer de cuello uterino",numero de mujeres con pildora anticonceptiva oral de emergencia,2016-10-01,0,0,1,0,0,1
VILLAZON,"anticoncepcion, prevencion de its y de cancer de cuello uterino",numero de mujeres con pildora anticonceptiva oral de emergencia,2016-10-01,0,0,1,0,0,1
WARNES,"anticoncepcion, prevencion de its y de cancer de cuello uterino",numero de mujeres con pildora anticonceptiva oral de emergencia,2016-10-01,0,0,0,1,0,1
YACO,"anticoncepcion, prevencion de its y de cancer de cuello uterino",numero de mujeres con pildora anticonceptiva oral de emergencia,2016-10-01,0,0,1,0,0,1
ACHACACHI,"anticoncepcion, prevencion de its y de cancer de cuello uterino",numero de mujeres con pildora anticonceptiva oral de emergencia,2016-11-01,0,0,1,0,0,1
AIQUILE,"anticoncepcion, prevencion de its y de cancer de cuello uterino",numero de mujeres con pildora anticonceptiva oral de emergencia,2016-11-01,0,0,1,0,0,1
ALCALA,"anticoncepcion, prevencion de its y de cancer de cuello uterino",numero de mujeres con pildora anticonceptiva oral de emergencia,2016-11-01,0,1,1,0,0,2
ALTO BENI,"anticoncepcion, prevencion de its y de cancer de cuello uterino",numero de mujeres con pildora anticonceptiva oral de emergencia,2016-11-01,0,0,1,0,0,1
AYATA,"anticoncepcion, prevencion de its y de cancer de cuello uterino",numero de mujeres con pildora anticonceptiva oral de emergencia,2016-11-01,0,0,0,1,0,1
BETANZOS,"anticoncepcion, prevencion de its y de cancer de cuello uterino",numero de mujeres con pildora anticonceptiva oral de emergencia,2016-11-01,0,0,0,1,0,1
CABEZAS,"anticoncepcion, prevencion de its y de cancer de cuello uterino",numero de mujeres con pildora anticonceptiva oral de emergencia,2016-11-01,1,0,0,0,0,1
CAIROMA,"anticoncepcion, prevencion de its y de cancer de cuello uterino",numero de mujeres con pildora anticonceptiva oral de emergencia,2016-11-01,0,1,0,0,0,1
"CAIZA ""D""","anticoncepcion, prevencion de its y de cancer de cuello uterino",numero de mujeres con pildora anticonceptiva oral de emergencia,2016-11-01,0,0,2,1,0,3
CAMATAQUI (C. VILLA ABECIA),"anticoncepcion, prevencion de its y de cancer de cuello uterino",numero de mujeres con pildora anticonceptiva oral de emergencia,2016-11-01,0,0,1,0,0,1
CHACARILLA,"anticoncepcion, prevencion de its y de cancer de cuello uterino",numero de mujeres con pildora anticonceptiva oral de emergencia,2016-11-01,0,1,0,0,0,1
CHARAGUA,"anticoncepcion, prevencion de its y de cancer de cuello uterino",numero de mujeres con pildora anticonceptiva oral de emergencia,2016-11-01,0,0,1,0,0,1
COCHABAMBA,"anticoncepcion, prevencion de its y de cancer de cuello uterino",numero de mujeres con pildora anticonceptiva oral de emergencia,2016-11-01,1,4,12,0,0,17
"COLCHA ""K""","anticoncepcion, prevencion de its y de cancer de cuello uterino",numero de mujeres con pildora anticonceptiva oral de emergencia,2016-11-01,0,0,0,1,0,1
CORIPATA,"anticoncepcion, prevencion de its y de cancer de cuello uterino",numero de mujeres con pildora anticonceptiva oral de emergencia,2016-11-01,0,4,0,1,0,5
COTOCA,"anticoncepcion, prevencion de its y de cancer de cuello uterino",numero de mujeres con pildora anticonceptiva oral de emergencia,2016-11-01,0,0,0,1,0,1
CUEVO,"anticoncepcion, prevencion de its y de cancer de cuello uterino",numero de mujeres con pildora anticonceptiva oral de emergencia,2016-11-01,0,0,1,0,0,1
CULPINA,"anticoncepcion, prevencion de its y de cancer de cuello uterino",numero de mujeres con pildora anticonceptiva oral de emergencia,2016-11-01,0,0,0,1,0,1
EL ALTO,"anticoncepcion, prevencion de its y de cancer de cuello uterino",numero de mujeres con pildora anticonceptiva oral de emergencia,2016-11-01,0,5,25,6,0,36
EL TORNO,"anticoncepcion, prevencion de its y de cancer de cuello uterino",numero de mujeres con pildora anticonceptiva oral de emergencia,2016-11-01,0,5,17,2,0,24
EL VILLAR,"anticoncepcion, prevencion de its y de cancer de cuello uterino",numero de mujeres con pildora anticonceptiva oral de emergencia,2016-11-01,0,2,2,0,0,4
ENTRE RIOS TRJ,"anticoncepcion, prevencion de its y de cancer de cuello uterino",numero de mujeres con pildora anticonceptiva oral de emergencia,2016-11-01,0,0,2,0,0,2
ESCARA,"anticoncepcion, prevencion de its y de cancer de cuello uterino",numero de mujeres con pildora anticonceptiva oral de emergencia,2016-11-01,0,0,3,0,0,3
GUAYARAMERIN,"anticoncepcion, prevencion de its y de cancer de cuello uterino",numero de mujeres con pildora anticonceptiva oral de emergencia,2016-11-01,1,1,8,2,0,12
GUTIERREZ,"anticoncepcion, prevencion de its y de cancer de cuello uterino",numero de mujeres con pildora anticonceptiva oral de emergencia,2016-11-01,0,0,1,0,0,1
HUACARETA,"anticoncepcion, prevencion de its y de cancer de cuello uterino",numero de mujeres con pildora anticonceptiva oral de emergencia,2016-11-01,0,0,1,1,0,2
ICLA,"anticoncepcion, prevencion de its y de cancer de cuello uterino",numero de mujeres con pildora anticonceptiva oral de emergencia,2016-11-01,0,2,1,1,0,4
INCAHUASI,"anticoncepcion, prevencion de its y de cancer de cuello uterino",numero de mujeres con pildora anticonceptiva oral de emergencia,2016-11-01,0,1,2,0,0,3
IXIAMAS,"anticoncepcion, prevencion de its y de cancer de cuello uterino",numero de mujeres con pildora anticonceptiva oral de emergencia,2016-11-01,0,0,1,0,0,1
LA PAZ,"anticoncepcion, prevencion de its y de cancer de cuello uterino",numero de mujeres con pildora anticonceptiva oral de emergencia,2016-11-01,0,10,42,11,1,64
LAGUNILLAS,"anticoncepcion, prevencion de its y de cancer de cuello uterino",numero de mujeres con pildora anticonceptiva oral de emergencia,2016-11-01,0,1,8,6,0,15
LORETO,"anticoncepcion, prevencion de its y de cancer de cuello uterino",numero de mujeres con pildora anticonceptiva oral de emergencia,2016-11-01,0,0,0,1,0,1
LURIBAY,"anticoncepcion, prevencion de its y de cancer de cuello uterino",numero de mujeres con pildora anticonceptiva oral de emergencia,2016-11-01,0,0,1,2,0,3
MACHARETI,"anticoncepcion, prevencion de its y de cancer de cuello uterino",numero de mujeres con pildora anticonceptiva oral de emergencia,2016-11-01,0,2,3,0,0,5
MAPIRI,"anticoncepcion, prevencion de its y de cancer de cuello uterino",numero de mujeres con pildora anticonceptiva oral de emergencia,2016-11-01,0,0,6,3,0,9
MIZQUE,"anticoncepcion, prevencion de its y de cancer de cuello uterino",numero de mujeres con pildora anticonceptiva oral de emergencia,2016-11-01,1,0,0,0,0,1
MOCOMOCO,"anticoncepcion, prevencion de its y de cancer de cuello uterino",numero de mujeres con pildora anticonceptiva oral de emergencia,2016-11-01,0,0,0,1,0,1
MOJOCOYA,"anticoncepcion, prevencion de its y de cancer de cuello uterino",numero de mujeres con pildora anticonceptiva oral de emergencia,2016-11-01,0,1,0,0,0,1
MONTEAGUDO,"anticoncepcion, prevencion de its y de cancer de cuello uterino",numero de mujeres con pildora anticonceptiva oral de emergencia,2016-11-01,0,1,2,1,0,4
MONTERO,"anticoncepcion, prevencion de its y de cancer de cuello uterino",numero de mujeres con pildora anticonceptiva oral de emergencia,2016-11-01,0,0,1,0,0,1
ORURO,"anticoncepcion, prevencion de its y de cancer de cuello uterino",numero de mujeres con pildora anticonceptiva oral de emergencia,2016-11-01,0,1,3,4,0,8
PALOS BLANCOS,"anticoncepcion, prevencion de its y de cancer de cuello uterino",numero de mujeres con pildora anticonceptiva oral de emergencia,2016-11-01,1,0,0,0,0,1
PAPEL PAMPA,"anticoncepcion, prevencion de its y de cancer de cuello uterino",numero de mujeres con pildora anticonceptiva oral de emergencia,2016-11-01,0,0,1,0,0,1
POTOSI,"anticoncepcion, prevencion de its y de cancer de cuello uterino",numero de mujeres con pildora anticonceptiva oral de emergencia,2016-11-01,0,0,1,3,0,4
PRESTO,"anticoncepcion, prevencion de its y de cancer de cuello uterino",numero de mujeres con pildora anticonceptiva oral de emergencia,2016-11-01,0,1,5,2,0,8
PUERTO CARABUCO,"anticoncepcion, prevencion de its y de cancer de cuello uterino",numero de mujeres con pildora anticonceptiva oral de emergencia,2016-11-01,0,0,3,0,0,3
PUERTO SILES,"anticoncepcion, prevencion de its y de cancer de cuello uterino",numero de mujeres con pildora anticonceptiva oral de emergencia,2016-11-01,0,1,10,0,0,11
PUERTO VILLARROEL,"anticoncepcion, prevencion de its y de cancer de cuello uterino",numero de mujeres con pildora anticonceptiva oral de emergencia,2016-11-01,0,0,0,4,0,4
SACABA,"anticoncepcion, prevencion de its y de cancer de cuello uterino",numero de mujeres con pildora anticonceptiva oral de emergencia,2016-11-01,0,1,0,0,0,1
SACACA,"anticoncepcion, prevencion de its y de cancer de cuello uterino",numero de mujeres con pildora anticonceptiva oral de emergencia,2016-11-01,0,1,5,2,0,8
SAMAIPATA,"anticoncepcion, prevencion de its y de cancer de cuello uterino",numero de mujeres con pildora anticonceptiva oral de emergencia,2016-11-01,0,1,7,0,0,8
SAN LUCAS,"anticoncepcion, prevencion de its y de cancer de cuello uterino",numero de mujeres con pildora anticonceptiva oral de emergencia,2016-11-01,0,1,0,1,0,2
SAN PEDRO,"anticoncepcion, prevencion de its y de cancer de cuello uterino",numero de mujeres con pildora anticonceptiva oral de emergencia,2016-11-01,0,1,0,1,0,2
SANTA CRUZ DE LA SIERRA,"anticoncepcion, prevencion de its y de cancer de cuello uterino",numero de mujeres con pildora anticonceptiva oral de emergencia,2016-11-01,0,2,56,216,5,279
SANTA ROSA DEL SARA,"anticoncepcion, prevencion de its y de cancer de cuello uterino",numero de mujeres con pildora anticonceptiva oral de emergencia,2016-11-01,0,0,1,0,0,1
SICA SICA (VILLA AROMA),"anticoncepcion, prevencion de its y de cancer de cuello uterino",numero de mujeres con pildora anticonceptiva oral de emergencia,2016-11-01,0,0,3,1,0,4
SORATA,"anticoncepcion, prevencion de its y de cancer de cuello uterino",numero de mujeres con pildora anticonceptiva oral de emergencia,2016-11-01,1,1,0,0,0,2
SUCRE,"anticoncepcion, prevencion de its y de cancer de cuello uterino",numero de mujeres con pildora anticonceptiva oral de emergencia,2016-11-01,6,47,8,0,0,61
TAPACARI,"anticoncepcion, prevencion de its y de cancer de cuello uterino",numero de mujeres con pildora anticonceptiva oral de emergencia,2016-11-01,1,2,1,0,0,4
TARABUCO,"anticoncepcion, prevencion de its y de cancer de cuello uterino",numero de mujeres con pildora anticonceptiva oral de emergencia,2016-11-01,0,3,4,1,0,8
TARIJA,"anticoncepcion, prevencion de its y de cancer de cuello uterino",numero de mujeres con pildora anticonceptiva oral de emergencia,2016-11-01,0,0,0,4,0,4
TINGUIPAYA,"anticoncepcion, prevencion de its y de cancer de cuello uterino",numero de mujeres con pildora anticonceptiva oral de emergencia,2016-11-01,0,0,2,1,0,3
TODOS SANTOS,"anticoncepcion, prevencion de its y de cancer de cuello uterino",numero de mujeres con pildora anticonceptiva oral de emergencia,2016-11-01,0,1,1,1,0,3
TOLEDO,"anticoncepcion, prevencion de its y de cancer de cuello uterino",numero de mujeres con pildora anticonceptiva oral de emergencia,2016-11-01,0,0,1,0,0,1
TOMAVE,"anticoncepcion, prevencion de its y de cancer de cuello uterino",numero de mujeres con pildora anticonceptiva oral de emergencia,2016-11-01,0,1,3,2,0,6
TORO TORO,"anticoncepcion, prevencion de its y de cancer de cuello uterino",numero de mujeres con pildora anticonceptiva oral de emergencia,2016-11-01,0,0,1,1,0,2
TRINIDAD,"anticoncepcion, prevencion de its y de cancer de cuello uterino",numero de mujeres con pildora anticonceptiva oral de emergencia,2016-11-01,0,0,54,15,0,69
TUPIZA,"anticoncepcion, prevencion de its y de cancer de cuello uterino",numero de mujeres con pildora anticonceptiva oral de emergencia,2016-11-01,0,1,3,0,0,4
UMALA,"anticoncepcion, prevencion de its y de cancer de cuello uterino",numero de mujeres con pildora anticonceptiva oral de emergencia,2016-11-01,1,2,0,0,0,3
URIONDO (A. CONCEPCION),"anticoncepcion, prevencion de its y de cancer de cuello uterino",numero de mujeres con pildora anticonceptiva oral de emergencia,2016-11-01,0,1,7,8,1,17
VIACHA,"anticoncepcion, prevencion de its y de cancer de cuello uterino",numero de mujeres con pildora anticonceptiva oral de emergencia,2016-11-01,0,0,1,0,0,1
VILLA CHARCAS,"anticoncepcion, prevencion de its y de cancer de cuello uterino",numero de mujeres con pildora anticonceptiva oral de emergencia,2016-11-01,0,1,1,0,0,2
VILLA SERRANO,"anticoncepcion, prevencion de its y de cancer de cuello uterino",numero de mujeres con pildora anticonceptiva oral de emergencia,2016-11-01,0,0,1,0,0,1
VILLAZON,"anticoncepcion, prevencion de its y de cancer de cuello uterino",numero de mujeres con pildora anticonceptiva oral de emergencia,2016-11-01,0,5,20,2,1,28
VINTO,"anticoncepcion, prevencion de its y de cancer de cuello uterino",numero de mujeres con pildora anticonceptiva oral de emergencia,2016-11-01,0,4,41,7,1,53
YANACACHI,"anticoncepcion, prevencion de its y de cancer de cuello uterino",numero de mujeres con pildora anticonceptiva oral de emergencia,2016-11-01,0,0,0,1,0,1
YAPACANI,"anticoncepcion, prevencion de its y de cancer de cuello uterino",numero de mujeres con pildora anticonceptiva oral de emergencia,2016-11-01,0,0,0,1,0,1
YUNCHARA,"anticoncepcion, prevencion de its y de cancer de cuello uterino",numero de mujeres con pildora anticonceptiva oral de emergencia,2016-11-01,0,1,0,0,0,1
ACACIO,"anticoncepcion, prevencion de its y de cancer de cuello uterino",numero de mujeres con pildora anticonceptiva oral de emergencia,2016-12-01,0,6,8,5,0,19
ARBIETO,"anticoncepcion, prevencion de its y de cancer de cuello uterino",numero de mujeres con pildora anticonceptiva oral de emergencia,2016-12-01,0,1,0,0,0,1
ASCENCION DE GUARAYOS,"anticoncepcion, prevencion de its y de cancer de cuello uterino",numero de mujeres con pildora anticonceptiva oral de emergencia,2016-12-01,0,0,3,0,0,3
ATOCHA,"anticoncepcion, prevencion de its y de cancer de cuello uterino",numero de mujeres con pildora anticonceptiva oral de emergencia,2016-12-01,0,0,3,0,0,3
AYATA,"anticoncepcion, prevencion de its y de cancer de cuello uterino",numero de mujeres con pildora anticonceptiva oral de emergencia,2016-12-01,0,4,0,0,0,4
AZURDUY,"anticoncepcion, prevencion de its y de cancer de cuello uterino",numero de mujeres con pildora anticonceptiva oral de emergencia,2016-12-01,0,0,1,2,0,3
"CAIZA ""D""","anticoncepcion, prevencion de its y de cancer de cuello uterino",numero de mujeres con pildora anticonceptiva oral de emergencia,2016-12-01,0,1,0,0,0,1
CALAMARCA,"anticoncepcion, prevencion de its y de cancer de cuello uterino",numero de mujeres con pildora anticonceptiva oral de emergencia,2016-12-01,0,1,2,0,0,3
CAMIRI,"anticoncepcion, prevencion de its y de cancer de cuello uterino",numero de mujeres con pildora anticonceptiva oral de emergencia,2016-12-01,0,14,46,7,0,67
CARANAVI,"anticoncepcion, prevencion de its y de cancer de cuello uterino",numero de mujeres con pildora anticonceptiva oral de emergencia,2016-12-01,0,0,2,0,0,2
CHALLAPATA,"anticoncepcion, prevencion de its y de cancer de cuello uterino",numero de mujeres con pildora anticonceptiva oral de emergencia,2016-12-01,0,1,2,0,0,3
CHULUMANI (V. DE LA LIBERTAD),"anticoncepcion, prevencion de its y de cancer de cuello uterino",numero de mujeres con pildora anticonceptiva oral de emergencia,2016-12-01,0,0,0,1,0,1
CLIZA,"anticoncepcion, prevencion de its y de cancer de cuello uterino",numero de mujeres con pildora anticonceptiva oral de emergencia,2016-12-01,0,1,0,0,0,1
COCHABAMBA,"anticoncepcion, prevencion de its y de cancer de cuello uterino",numero de mujeres con pildora anticonceptiva oral de emergencia,2016-12-01,2,4,8,2,0,16
"COLCHA ""K""","anticoncepcion, prevencion de its y de cancer de cuello uterino",numero de mujeres con pildora anticonceptiva oral de emergencia,2016-12-01,1,1,3,0,0,5
COLQUECHACA,"anticoncepcion, prevencion de its y de cancer de cuello uterino",numero de mujeres con pildora anticonceptiva oral de emergencia,2016-12-01,0,0,3,2,0,5
COLQUENCHA,"anticoncepcion, prevencion de its y de cancer de cuello uterino",numero de mujeres con pildora anticonceptiva oral de emergencia,2016-12-01,0,0,1,0,0,1
COMARAPA,"anticoncepcion, prevencion de its y de cancer de cuello uterino",numero de mujeres con pildora anticonceptiva oral de emergencia,2016-12-01,0,0,1,0,0,1
CORIPATA,"anticoncepcion, prevencion de its y de cancer de cuello uterino",numero de mujeres con pildora anticonceptiva oral de emergencia,2016-12-01,0,1,1,0,0,2
CUEVO,"anticoncepcion, prevencion de its y de cancer de cuello uterino",numero de mujeres con pildora anticonceptiva oral de emergencia,2016-12-01,0,0,1,0,0,1
EL ALTO,"anticoncepcion, prevencion de its y de cancer de cuello uterino",numero de mujeres con pildora anticonceptiva oral de emergencia,2016-12-01,0,3,16,2,0,21
EL VILLAR,"anticoncepcion, prevencion de its y de cancer de cuello uterino",numero de mujeres con pildora anticonceptiva oral de emergencia,2016-12-01,0,2,0,0,0,2
ESCARA,"anticoncepcion, prevencion de its y de cancer de cuello uterino",numero de mujeres con pildora anticonceptiva oral de emergencia,2016-12-01,0,0,4,0,0,4
GUANAY,"anticoncepcion, prevencion de its y de cancer de cuello uterino",numero de mujeres con pildora anticonceptiva oral de emergencia,2016-12-01,0,0,5,1,0,6
GUAYARAMERIN,"anticoncepcion, prevencion de its y de cancer de cuello uterino",numero de mujeres con pildora anticonceptiva oral de emergencia,2016-12-01,0,3,4,0,0,7
GUTIERREZ,"anticoncepcion, prevencion de its y de cancer de cuello uterino",numero de mujeres con pildora anticonceptiva oral de emergencia,2016-12-01,0,0,1,0,0,1
INCAHUASI,"anticoncepcion, prevencion de its y de cancer de cuello uterino",numero de mujeres con pildora anticonceptiva oral de emergencia,2016-12-01,0,1,0,0,0,1
IRUPANA (VILLA DE LANZA),"anticoncepcion, prevencion de its y de cancer de cuello uterino",numero de mujeres con pildora anticonceptiva oral de emergencia,2016-12-01,0,0,1,0,0,1
LA PAZ,"anticoncepcion, prevencion de its y de cancer de cuello uterino",numero de mujeres con pildora anticonceptiva oral de emergencia,2016-12-01,0,0,11,15,0,26
LAS CARRERAS,"anticoncepcion, prevencion de its y de cancer de cuello uterino",numero de mujeres con pildora anticonceptiva oral de emergencia,2016-12-01,0,0,2,0,0,2
MACHACAMARCA,"anticoncepcion, prevencion de its y de cancer de cuello uterino",numero de mujeres con pildora anticonceptiva oral de emergencia,2016-12-01,0,0,1,0,0,1
MACHARETI,"anticoncepcion, prevencion de its y de cancer de cuello uterino",numero de mujeres con pildora anticonceptiva oral de emergencia,2016-12-01,1,3,3,0,0,7
MECAPACA,"anticoncepcion, prevencion de its y de cancer de cuello uterino",numero de mujeres con pildora anticonceptiva oral de emergencia,2016-12-01,0,2,1,0,0,3
MIZQUE,"anticoncepcion, prevencion de its y de cancer de cuello uterino",numero de mujeres con pildora anticonceptiva oral de emergencia,2016-12-01,0,1,0,0,0,1
MOJOCOYA,"anticoncepcion, prevencion de its y de cancer de cuello uterino",numero de mujeres con pildora anticonceptiva oral de emergencia,2016-12-01,0,1,0,0,0,1
MONTEAGUDO,"anticoncepcion, prevencion de its y de cancer de cuello uterino",numero de mujeres con pildora anticonceptiva oral de emergencia,2016-12-01,0,0,1,0,0,1
MONTERO,"anticoncepcion, prevencion de its y de cancer de cuello uterino",numero de mujeres con pildora anticonceptiva oral de emergencia,2016-12-01,0,2,2,0,0,4
NUEVO MANOA (NUEVA ESPERANZA),"anticoncepcion, prevencion de its y de cancer de cuello uterino",numero de mujeres con pildora anticonceptiva oral de emergencia,2016-12-01,0,1,0,0,0,1
OMEREQUE,"anticoncepcion, prevencion de its y de cancer de cuello uterino",numero de mujeres con pildora anticonceptiva oral de emergencia,2016-12-01,0,2,0,0,0,2
ORURO,"anticoncepcion, prevencion de its y de cancer de cuello uterino",numero de mujeres con pildora anticonceptiva oral de emergencia,2016-12-01,0,1,1,0,0,2
PADCAYA,"anticoncepcion, prevencion de its y de cancer de cuello uterino",numero de mujeres con pildora anticonceptiva oral de emergencia,2016-12-01,0,0,1,0,0,1
PALOS BLANCOS,"anticoncepcion, prevencion de its y de cancer de cuello uterino",numero de mujeres con pildora anticonceptiva oral de emergencia,2016-12-01,2,4,0,0,0,6
PAPEL PAMPA,"anticoncepcion, prevencion de its y de cancer de cuello uterino",numero de mujeres con pildora anticonceptiva oral de emergencia,2016-12-01,0,1,0,1,0,2
PATACAMAYA,"anticoncepcion, prevencion de its y de cancer de cuello uterino",numero de mujeres con pildora anticonceptiva oral de emergencia,2016-12-01,0,0,4,0,0,4
PELECHUCO,"anticoncepcion, prevencion de its y de cancer de cuello uterino",numero de mujeres con pildora anticonceptiva oral de emergencia,2016-12-01,0,0,1,0,0,1
POROMA,"anticoncepcion, prevencion de its y de cancer de cuello uterino",numero de mujeres con pildora anticonceptiva oral de emergencia,2016-12-01,0,0,0,1,0,1
POTOSI,"anticoncepcion, prevencion de its y de cancer de cuello uterino",numero de mujeres con pildora anticonceptiva oral de emergencia,2016-12-01,0,1,11,0,0,12
PRESTO,"anticoncepcion, prevencion de its y de cancer de cuello uterino",numero de mujeres con pildora anticonceptiva oral de emergencia,2016-12-01,0,1,1,0,0,2
PUERTO VILLARROEL,"anticoncepcion, prevencion de its y de cancer de cuello uterino",numero de mujeres con pildora anticonceptiva oral de emergencia,2016-12-01,0,1,0,0,0,1
QUILLACOLLO,"anticoncepcion, prevencion de its y de cancer de cuello uterino",numero de mujeres con pildora anticonceptiva oral de emergencia,2016-12-01,0,6,18,4,0,28
RIBERALTA,"anticoncepcion, prevencion de its y de cancer de cuello uterino",numero de mujeres con pildora anticonceptiva oral de emergencia,2016-12-01,1,0,0,0,0,1
SACABA,"anticoncepcion, prevencion de its y de cancer de cuello uterino",numero de mujeres con pildora anticonceptiva oral de emergencia,2016-12-01,0,0,12,4,0,16
SAN IGNACIO,"anticoncepcion, prevencion de its y de cancer de cuello uterino",numero de mujeres con pildora anticonceptiva oral de emergencia,2016-12-01,0,0,0,1,0,1
SAN JOSE DE CHIQUITOS,"anticoncepcion, prevencion de its y de cancer de cuello uterino",numero de mujeres con pildora anticonceptiva oral de emergencia,2016-12-01,0,3,5,2,0,10
SAN LUCAS,"anticoncepcion, prevencion de its y de cancer de cuello uterino",numero de mujeres con pildora anticonceptiva oral de emergencia,2016-12-01,0,3,2,0,0,5
SANTA CRUZ DE LA SIERRA,"anticoncepcion, prevencion de its y de cancer de cuello uterino",numero de mujeres con pildora anticonceptiva oral de emergencia,2016-12-01,0,1,22,2,0,25
SANTUARIO DE QUILLACAS,"anticoncepcion, prevencion de its y de cancer de cuello uterino",numero de mujeres con pildora anticonceptiva oral de emergencia,2016-12-01,0,3,16,4,0,23
SICA SICA (VILLA AROMA),"anticoncepcion, prevencion de its y de cancer de cuello uterino",numero de mujeres con pildora anticonceptiva oral de emergencia,2016-12-01,0,1,2,2,0,5
SOPACHUY,"anticoncepcion, prevencion de its y de cancer de cuello uterino",numero de mujeres con pildora anticonceptiva oral de emergencia,2016-12-01,0,0,0,1,0,1
SUCRE,"anticoncepcion, prevencion de its y de cancer de cuello uterino",numero de mujeres con pildora anticonceptiva oral de emergencia,2016-12-01,0,4,16,6,0,26
TARABUCO,"anticoncepcion, prevencion de its y de cancer de cuello uterino",numero de mujeres con pildora anticonceptiva oral de emergencia,2016-12-01,2,0,2,0,0,4
TARIJA,"anticoncepcion, prevencion de its y de cancer de cuello uterino",numero de mujeres con pildora anticonceptiva oral de emergencia,2016-12-01,0,0,2,10,0,12
TARVITA,"anticoncepcion, prevencion de its y de cancer de cuello uterino",numero de mujeres con pildora anticonceptiva oral de emergencia,2016-12-01,0,0,1,0,0,1
TEOPONTE,"anticoncepcion, prevencion de its y de cancer de cuello uterino",numero de mujeres con pildora anticonceptiva oral de emergencia,2016-12-01,0,0,2,0,0,2
TIAWANACU,"anticoncepcion, prevencion de its y de cancer de cuello uterino",numero de mujeres con pildora anticonceptiva oral de emergencia,2016-12-01,0,1,0,0,0,1
TINGUIPAYA,"anticoncepcion, prevencion de its y de cancer de cuello uterino",numero de mujeres con pildora anticonceptiva oral de emergencia,2016-12-01,0,0,2,0,0,2
TOLEDO,"anticoncepcion, prevencion de its y de cancer de cuello uterino",numero de mujeres con pildora anticonceptiva oral de emergencia,2016-12-01,0,0,2,0,0,2
TOMAVE,"anticoncepcion, prevencion de its y de cancer de cuello uterino",numero de mujeres con pildora anticonceptiva oral de emergencia,2016-12-01,0,1,5,3,0,9
TUPIZA,"anticoncepcion, prevencion de its y de cancer de cuello uterino",numero de mujeres con pildora anticonceptiva oral de emergencia,2016-12-01,0,8,19,3,0,30
UMALA,"anticoncepcion, prevencion de its y de cancer de cuello uterino",numero de mujeres con pildora anticonceptiva oral de emergencia,2016-12-01,0,1,0,0,0,1
VIACHA,"anticoncepcion, prevencion de its y de cancer de cuello uterino",numero de mujeres con pildora anticonceptiva oral de emergencia,2016-12-01,0,0,1,0,0,1
VILLA CHARCAS,"anticoncepcion, prevencion de its y de cancer de cuello uterino",numero de mujeres con pildora anticonceptiva oral de emergencia,2016-12-01,0,1,0,0,0,1
VILLA TUNARI,"anticoncepcion, prevencion de its y de cancer de cuello uterino",numero de mujeres con pildora anticonceptiva oral de emergencia,2016-12-01,0,1,1,0,0,2
VILLAZON,"anticoncepcion, prevencion de its y de cancer de cuello uterino",numero de mujeres con pildora anticonceptiva oral de emergencia,2016-12-01,0,0,0,1,0,1
VINTO,"anticoncepcion, prevencion de its y de cancer de cuello uterino",numero de mujeres con pildora anticonceptiva oral de emergencia,2016-12-01,0,3,7,1,0,11
WARNES,"anticoncepcion, prevencion de its y de cancer de cuello uterino",numero de mujeres con pildora anticonceptiva oral de emergencia,2016-12-01,0,0,3,0,0,3
YOTALA,"anticoncepcion, prevencion de its y de cancer de cuello uterino",numero de mujeres con pildora anticonceptiva oral de emergencia,2016-12-01,0,1,4,0,0,5
