municipality,group,variable,month,Píldora: Usuarias Nuevas,Píldora: Usuarias Nuevas1,Píldora: Usuarias Nuevas2,Píldora: Usuarias Nuevas3,Píldora: Usuarias Nuevas4,TOTAL
ACACIO,"anticoncepcion, prevencion de its y de cancer de cuello uterino",pildora: usuarias nuevas,2016-01-01,0,0,2,1,1,4
ACHOCALLA,"anticoncepcion, prevencion de its y de cancer de cuello uterino",pildora: usuarias nuevas,2016-01-01,0,0,1,0,0,1
AIQUILE,"anticoncepcion, prevencion de its y de cancer de cuello uterino",pildora: usuarias nuevas,2016-01-01,0,4,4,1,0,9
ALCALA,"anticoncepcion, prevencion de its y de cancer de cuello uterino",pildora: usuarias nuevas,2016-01-01,0,0,1,1,0,2
ALTO BENI,"anticoncepcion, prevencion de its y de cancer de cuello uterino",pildora: usuarias nuevas,2016-01-01,0,1,1,0,0,2
ANDAMARCA,"anticoncepcion, prevencion de its y de cancer de cuello uterino",pildora: usuarias nuevas,2016-01-01,0,0,2,0,0,2
APOLO,"anticoncepcion, prevencion de its y de cancer de cuello uterino",pildora: usuarias nuevas,2016-01-01,0,0,0,2,0,2
ARANI,"anticoncepcion, prevencion de its y de cancer de cuello uterino",pildora: usuarias nuevas,2016-01-01,0,0,2,2,0,4
ARBIETO,"anticoncepcion, prevencion de its y de cancer de cuello uterino",pildora: usuarias nuevas,2016-01-01,0,2,6,2,0,10
ARQUE,"anticoncepcion, prevencion de its y de cancer de cuello uterino",pildora: usuarias nuevas,2016-01-01,0,1,0,0,0,1
ASCENCION DE GUARAYOS,"anticoncepcion, prevencion de its y de cancer de cuello uterino",pildora: usuarias nuevas,2016-01-01,0,0,11,1,0,12
ATOCHA,"anticoncepcion, prevencion de its y de cancer de cuello uterino",pildora: usuarias nuevas,2016-01-01,0,0,1,0,0,1
AYATA,"anticoncepcion, prevencion de its y de cancer de cuello uterino",pildora: usuarias nuevas,2016-01-01,0,0,1,0,0,1
AYO AYO,"anticoncepcion, prevencion de its y de cancer de cuello uterino",pildora: usuarias nuevas,2016-01-01,0,0,2,2,0,4
AYOPAYA (V. DE INDEPENDENCIA),"anticoncepcion, prevencion de its y de cancer de cuello uterino",pildora: usuarias nuevas,2016-01-01,0,4,7,3,0,14
AZURDUY,"anticoncepcion, prevencion de its y de cancer de cuello uterino",pildora: usuarias nuevas,2016-01-01,0,0,2,1,0,3
BAURES,"anticoncepcion, prevencion de its y de cancer de cuello uterino",pildora: usuarias nuevas,2016-01-01,0,0,3,0,0,3
BELLA FLOR,"anticoncepcion, prevencion de its y de cancer de cuello uterino",pildora: usuarias nuevas,2016-01-01,0,1,1,0,0,2
BERMEJO,"anticoncepcion, prevencion de its y de cancer de cuello uterino",pildora: usuarias nuevas,2016-01-01,0,2,11,2,0,15
BOLIVAR,"anticoncepcion, prevencion de its y de cancer de cuello uterino",pildora: usuarias nuevas,2016-01-01,0,0,0,1,0,1
BOYUIBE,"anticoncepcion, prevencion de its y de cancer de cuello uterino",pildora: usuarias nuevas,2016-01-01,0,1,1,0,0,2
BUENA VISTA,"anticoncepcion, prevencion de its y de cancer de cuello uterino",pildora: usuarias nuevas,2016-01-01,0,0,2,0,0,2
CABEZAS,"anticoncepcion, prevencion de its y de cancer de cuello uterino",pildora: usuarias nuevas,2016-01-01,0,2,11,0,0,13
CAIROMA,"anticoncepcion, prevencion de its y de cancer de cuello uterino",pildora: usuarias nuevas,2016-01-01,0,1,1,0,0,2
"CAIZA ""D""","anticoncepcion, prevencion de its y de cancer de cuello uterino",pildora: usuarias nuevas,2016-01-01,0,1,2,0,0,3
CAJUATA,"anticoncepcion, prevencion de its y de cancer de cuello uterino",pildora: usuarias nuevas,2016-01-01,0,0,1,0,0,1
CALAMARCA,"anticoncepcion, prevencion de its y de cancer de cuello uterino",pildora: usuarias nuevas,2016-01-01,0,0,3,1,0,4
CAMARGO,"anticoncepcion, prevencion de its y de cancer de cuello uterino",pildora: usuarias nuevas,2016-01-01,0,2,0,0,0,2
CAMIRI,"anticoncepcion, prevencion de its y de cancer de cuello uterino",pildora: usuarias nuevas,2016-01-01,0,1,0,0,0,1
CAPINOTA,"anticoncepcion, prevencion de its y de cancer de cuello uterino",pildora: usuarias nuevas,2016-01-01,0,0,2,1,0,3
CARACOLLO,"anticoncepcion, prevencion de its y de cancer de cuello uterino",pildora: usuarias nuevas,2016-01-01,0,0,1,0,0,1
CARANAVI,"anticoncepcion, prevencion de its y de cancer de cuello uterino",pildora: usuarias nuevas,2016-01-01,0,1,4,2,0,7
CARAPARI,"anticoncepcion, prevencion de its y de cancer de cuello uterino",pildora: usuarias nuevas,2016-01-01,0,1,2,1,0,4
CARMEN RIVERO TORREZ,"anticoncepcion, prevencion de its y de cancer de cuello uterino",pildora: usuarias nuevas,2016-01-01,0,0,1,1,0,2
CHALLAPATA,"anticoncepcion, prevencion de its y de cancer de cuello uterino",pildora: usuarias nuevas,2016-01-01,0,0,2,0,0,2
CHARAGUA,"anticoncepcion, prevencion de its y de cancer de cuello uterino",pildora: usuarias nuevas,2016-01-01,0,0,5,0,0,5
CHIMORE,"anticoncepcion, prevencion de its y de cancer de cuello uterino",pildora: usuarias nuevas,2016-01-01,1,0,6,1,0,8
CHUA COCANI,"anticoncepcion, prevencion de its y de cancer de cuello uterino",pildora: usuarias nuevas,2016-01-01,0,0,0,1,1,2
CHULUMANI (V. DE LA LIBERTAD),"anticoncepcion, prevencion de its y de cancer de cuello uterino",pildora: usuarias nuevas,2016-01-01,0,0,2,1,0,3
CHUQUIHUTA AYLLU JUCUMANI,"anticoncepcion, prevencion de its y de cancer de cuello uterino",pildora: usuarias nuevas,2016-01-01,0,0,0,2,0,2
CLIZA,"anticoncepcion, prevencion de its y de cancer de cuello uterino",pildora: usuarias nuevas,2016-01-01,0,1,1,0,0,2
COBIJA,"anticoncepcion, prevencion de its y de cancer de cuello uterino",pildora: usuarias nuevas,2016-01-01,0,3,5,2,0,10
COCAPATA,"anticoncepcion, prevencion de its y de cancer de cuello uterino",pildora: usuarias nuevas,2016-01-01,0,4,1,1,0,6
COCHABAMBA,"anticoncepcion, prevencion de its y de cancer de cuello uterino",pildora: usuarias nuevas,2016-01-01,1,5,121,79,0,206
COIPASA,"anticoncepcion, prevencion de its y de cancer de cuello uterino",pildora: usuarias nuevas,2016-01-01,0,0,1,0,0,1
COLCAPIRHUA,"anticoncepcion, prevencion de its y de cancer de cuello uterino",pildora: usuarias nuevas,2016-01-01,0,1,10,1,0,12
"COLCHA ""K""","anticoncepcion, prevencion de its y de cancer de cuello uterino",pildora: usuarias nuevas,2016-01-01,0,0,3,0,0,3
COLLANA,"anticoncepcion, prevencion de its y de cancer de cuello uterino",pildora: usuarias nuevas,2016-01-01,0,1,1,0,0,2
COLPA BELGICA,"anticoncepcion, prevencion de its y de cancer de cuello uterino",pildora: usuarias nuevas,2016-01-01,0,0,1,0,0,1
COLQUECHACA,"anticoncepcion, prevencion de its y de cancer de cuello uterino",pildora: usuarias nuevas,2016-01-01,0,1,8,5,0,14
COLQUENCHA,"anticoncepcion, prevencion de its y de cancer de cuello uterino",pildora: usuarias nuevas,2016-01-01,0,1,1,0,0,2
COLQUIRI,"anticoncepcion, prevencion de its y de cancer de cuello uterino",pildora: usuarias nuevas,2016-01-01,0,0,3,0,0,3
COMANCHE,"anticoncepcion, prevencion de its y de cancer de cuello uterino",pildora: usuarias nuevas,2016-01-01,0,0,1,0,0,1
COMARAPA,"anticoncepcion, prevencion de its y de cancer de cuello uterino",pildora: usuarias nuevas,2016-01-01,0,3,3,0,0,6
CONCEPCION,"anticoncepcion, prevencion de its y de cancer de cuello uterino",pildora: usuarias nuevas,2016-01-01,0,1,3,0,0,4
COPACABANA,"anticoncepcion, prevencion de its y de cancer de cuello uterino",pildora: usuarias nuevas,2016-01-01,0,0,1,0,0,1
CORIPATA,"anticoncepcion, prevencion de its y de cancer de cuello uterino",pildora: usuarias nuevas,2016-01-01,0,0,1,0,0,1
COTAGAITA,"anticoncepcion, prevencion de its y de cancer de cuello uterino",pildora: usuarias nuevas,2016-01-01,0,0,1,0,0,1
COTOCA,"anticoncepcion, prevencion de its y de cancer de cuello uterino",pildora: usuarias nuevas,2016-01-01,0,0,10,0,0,10
CRUZ DE MACHACAMARCA,"anticoncepcion, prevencion de its y de cancer de cuello uterino",pildora: usuarias nuevas,2016-01-01,0,0,1,0,0,1
CUATRO CAÑADAS,"anticoncepcion, prevencion de its y de cancer de cuello uterino",pildora: usuarias nuevas,2016-01-01,0,1,5,2,0,8
CULPINA,"anticoncepcion, prevencion de its y de cancer de cuello uterino",pildora: usuarias nuevas,2016-01-01,0,0,1,0,0,1
CURAHUARA DE CARANGAS,"anticoncepcion, prevencion de its y de cancer de cuello uterino",pildora: usuarias nuevas,2016-01-01,0,0,1,0,0,1
CURVA,"anticoncepcion, prevencion de its y de cancer de cuello uterino",pildora: usuarias nuevas,2016-01-01,0,0,2,0,0,2
DESAGUADERO,"anticoncepcion, prevencion de its y de cancer de cuello uterino",pildora: usuarias nuevas,2016-01-01,0,0,1,1,0,2
EL ALTO,"anticoncepcion, prevencion de its y de cancer de cuello uterino",pildora: usuarias nuevas,2016-01-01,0,14,90,19,0,123
EL CHORO,"anticoncepcion, prevencion de its y de cancer de cuello uterino",pildora: usuarias nuevas,2016-01-01,0,0,1,0,0,1
EL PUENTE(STC),"anticoncepcion, prevencion de its y de cancer de cuello uterino",pildora: usuarias nuevas,2016-01-01,0,0,0,1,0,1
EL PUENTE(TJA),"anticoncepcion, prevencion de its y de cancer de cuello uterino",pildora: usuarias nuevas,2016-01-01,0,0,2,0,0,2
EL TORNO,"anticoncepcion, prevencion de its y de cancer de cuello uterino",pildora: usuarias nuevas,2016-01-01,1,8,13,3,0,25
EL VILLAR,"anticoncepcion, prevencion de its y de cancer de cuello uterino",pildora: usuarias nuevas,2016-01-01,0,0,3,0,0,3
ENTRE RIOS TRJ,"anticoncepcion, prevencion de its y de cancer de cuello uterino",pildora: usuarias nuevas,2016-01-01,0,2,11,4,0,17
ENTRE RIOS CBBA,"anticoncepcion, prevencion de its y de cancer de cuello uterino",pildora: usuarias nuevas,2016-01-01,0,1,2,5,0,8
ESCARA,"anticoncepcion, prevencion de its y de cancer de cuello uterino",pildora: usuarias nuevas,2016-01-01,0,0,0,1,0,1
EUREKA (SANTOS MERCADO),"anticoncepcion, prevencion de its y de cancer de cuello uterino",pildora: usuarias nuevas,2016-01-01,0,0,2,0,0,2
FERNANDEZ ALONSO,"anticoncepcion, prevencion de its y de cancer de cuello uterino",pildora: usuarias nuevas,2016-01-01,0,0,2,0,0,2
FILADELFIA,"anticoncepcion, prevencion de its y de cancer de cuello uterino",pildora: usuarias nuevas,2016-01-01,0,0,1,0,0,1
GENERAL SAAVEDRA,"anticoncepcion, prevencion de its y de cancer de cuello uterino",pildora: usuarias nuevas,2016-01-01,0,3,4,1,0,8
GUANAY,"anticoncepcion, prevencion de its y de cancer de cuello uterino",pildora: usuarias nuevas,2016-01-01,0,0,1,0,0,1
GUAYARAMERIN,"anticoncepcion, prevencion de its y de cancer de cuello uterino",pildora: usuarias nuevas,2016-01-01,0,5,16,4,0,25
HUACARETA,"anticoncepcion, prevencion de its y de cancer de cuello uterino",pildora: usuarias nuevas,2016-01-01,0,0,2,0,0,2
HUACAYA (VILLA DE HUACAYA),"anticoncepcion, prevencion de its y de cancer de cuello uterino",pildora: usuarias nuevas,2016-01-01,0,0,0,1,0,1
HUACHACALLA,"anticoncepcion, prevencion de its y de cancer de cuello uterino",pildora: usuarias nuevas,2016-01-01,0,0,0,1,0,1
HUANUNI,"anticoncepcion, prevencion de its y de cancer de cuello uterino",pildora: usuarias nuevas,2016-01-01,0,0,2,0,0,2
HUARACAJE,"anticoncepcion, prevencion de its y de cancer de cuello uterino",pildora: usuarias nuevas,2016-01-01,0,0,1,1,0,2
ICLA,"anticoncepcion, prevencion de its y de cancer de cuello uterino",pildora: usuarias nuevas,2016-01-01,0,1,1,0,0,2
INCAHUASI,"anticoncepcion, prevencion de its y de cancer de cuello uterino",pildora: usuarias nuevas,2016-01-01,0,1,2,1,0,4
INGAVI (HUMAITA),"anticoncepcion, prevencion de its y de cancer de cuello uterino",pildora: usuarias nuevas,2016-01-01,0,0,1,0,0,1
IRUPANA (VILLA DE LANZA),"anticoncepcion, prevencion de its y de cancer de cuello uterino",pildora: usuarias nuevas,2016-01-01,0,0,3,4,0,7
IXIAMAS,"anticoncepcion, prevencion de its y de cancer de cuello uterino",pildora: usuarias nuevas,2016-01-01,0,0,1,1,0,2
JESUS DE MACHACA,"anticoncepcion, prevencion de its y de cancer de cuello uterino",pildora: usuarias nuevas,2016-01-01,0,0,1,0,0,1
LA ASUNTA,"anticoncepcion, prevencion de its y de cancer de cuello uterino",pildora: usuarias nuevas,2016-01-01,0,1,1,3,0,5
LA GUARDIA,"anticoncepcion, prevencion de its y de cancer de cuello uterino",pildora: usuarias nuevas,2016-01-01,0,4,10,4,0,18
LA PAZ,"anticoncepcion, prevencion de its y de cancer de cuello uterino",pildora: usuarias nuevas,2016-01-01,2,13,94,36,0,145
LAGUNILLAS,"anticoncepcion, prevencion de its y de cancer de cuello uterino",pildora: usuarias nuevas,2016-01-01,0,0,2,0,0,2
LAJA,"anticoncepcion, prevencion de its y de cancer de cuello uterino",pildora: usuarias nuevas,2016-01-01,0,0,2,0,0,2
LAS CARRERAS,"anticoncepcion, prevencion de its y de cancer de cuello uterino",pildora: usuarias nuevas,2016-01-01,0,0,1,0,0,1
LLALLAGUA,"anticoncepcion, prevencion de its y de cancer de cuello uterino",pildora: usuarias nuevas,2016-01-01,0,2,5,4,0,11
LLICA,"anticoncepcion, prevencion de its y de cancer de cuello uterino",pildora: usuarias nuevas,2016-01-01,0,0,2,0,0,2
LORETO,"anticoncepcion, prevencion de its y de cancer de cuello uterino",pildora: usuarias nuevas,2016-01-01,0,0,4,1,0,5
LURIBAY,"anticoncepcion, prevencion de its y de cancer de cuello uterino",pildora: usuarias nuevas,2016-01-01,0,1,0,0,0,1
MAGDALENA,"anticoncepcion, prevencion de its y de cancer de cuello uterino",pildora: usuarias nuevas,2016-01-01,0,0,5,1,0,6
MAIRANA,"anticoncepcion, prevencion de its y de cancer de cuello uterino",pildora: usuarias nuevas,2016-01-01,0,0,3,0,0,3
MAPIRI,"anticoncepcion, prevencion de its y de cancer de cuello uterino",pildora: usuarias nuevas,2016-01-01,0,0,1,0,0,1
MECAPACA,"anticoncepcion, prevencion de its y de cancer de cuello uterino",pildora: usuarias nuevas,2016-01-01,0,0,1,0,0,1
MINEROS,"anticoncepcion, prevencion de its y de cancer de cuello uterino",pildora: usuarias nuevas,2016-01-01,0,0,2,1,0,3
MIZQUE,"anticoncepcion, prevencion de its y de cancer de cuello uterino",pildora: usuarias nuevas,2016-01-01,0,1,2,2,0,5
MONTEAGUDO,"anticoncepcion, prevencion de its y de cancer de cuello uterino",pildora: usuarias nuevas,2016-01-01,0,0,5,0,0,5
MONTERO,"anticoncepcion, prevencion de its y de cancer de cuello uterino",pildora: usuarias nuevas,2016-01-01,0,9,14,9,0,32
MORO MORO,"anticoncepcion, prevencion de its y de cancer de cuello uterino",pildora: usuarias nuevas,2016-01-01,0,1,0,0,0,1
MOROCHATA,"anticoncepcion, prevencion de its y de cancer de cuello uterino",pildora: usuarias nuevas,2016-01-01,0,2,2,2,0,6
NACEBE (SANTA ROSA DEL ABUNA),"anticoncepcion, prevencion de its y de cancer de cuello uterino",pildora: usuarias nuevas,2016-01-01,0,0,2,1,0,3
NUEVO MANOA (NUEVA ESPERANZA),"anticoncepcion, prevencion de its y de cancer de cuello uterino",pildora: usuarias nuevas,2016-01-01,1,0,0,1,0,2
OCURI,"anticoncepcion, prevencion de its y de cancer de cuello uterino",pildora: usuarias nuevas,2016-01-01,0,0,0,1,0,1
OKINAWA,"anticoncepcion, prevencion de its y de cancer de cuello uterino",pildora: usuarias nuevas,2016-01-01,0,0,2,1,0,3
OMEREQUE,"anticoncepcion, prevencion de its y de cancer de cuello uterino",pildora: usuarias nuevas,2016-01-01,0,0,1,0,0,1
ORURO,"anticoncepcion, prevencion de its y de cancer de cuello uterino",pildora: usuarias nuevas,2016-01-01,0,6,50,21,0,77
PADCAYA,"anticoncepcion, prevencion de its y de cancer de cuello uterino",pildora: usuarias nuevas,2016-01-01,0,0,3,0,0,3
PADILLA,"anticoncepcion, prevencion de its y de cancer de cuello uterino",pildora: usuarias nuevas,2016-01-01,0,1,4,0,0,5
PAILON,"anticoncepcion, prevencion de its y de cancer de cuello uterino",pildora: usuarias nuevas,2016-01-01,1,1,3,0,0,5
PALCA,"anticoncepcion, prevencion de its y de cancer de cuello uterino",pildora: usuarias nuevas,2016-01-01,0,2,1,0,0,3
PALOS BLANCOS,"anticoncepcion, prevencion de its y de cancer de cuello uterino",pildora: usuarias nuevas,2016-01-01,0,0,1,0,0,1
PAMPA GRANDE,"anticoncepcion, prevencion de its y de cancer de cuello uterino",pildora: usuarias nuevas,2016-01-01,0,0,3,1,0,4
PAPEL PAMPA,"anticoncepcion, prevencion de its y de cancer de cuello uterino",pildora: usuarias nuevas,2016-01-01,0,0,1,1,0,2
PAZÑA,"anticoncepcion, prevencion de its y de cancer de cuello uterino",pildora: usuarias nuevas,2016-01-01,0,0,1,1,0,2
PELECHUCO,"anticoncepcion, prevencion de its y de cancer de cuello uterino",pildora: usuarias nuevas,2016-01-01,0,0,1,0,0,1
POCOATA,"anticoncepcion, prevencion de its y de cancer de cuello uterino",pildora: usuarias nuevas,2016-01-01,0,0,1,2,0,3
POCONA,"anticoncepcion, prevencion de its y de cancer de cuello uterino",pildora: usuarias nuevas,2016-01-01,0,0,2,2,0,4
POJO (CBBA),"anticoncepcion, prevencion de its y de cancer de cuello uterino",pildora: usuarias nuevas,2016-01-01,0,2,2,0,0,4
PORCO,"anticoncepcion, prevencion de its y de cancer de cuello uterino",pildora: usuarias nuevas,2016-01-01,0,0,1,1,0,2
POROMA,"anticoncepcion, prevencion de its y de cancer de cuello uterino",pildora: usuarias nuevas,2016-01-01,0,0,0,1,0,1
PORONGO,"anticoncepcion, prevencion de its y de cancer de cuello uterino",pildora: usuarias nuevas,2016-01-01,0,0,1,0,0,1
POTOSI,"anticoncepcion, prevencion de its y de cancer de cuello uterino",pildora: usuarias nuevas,2016-01-01,1,3,39,20,0,63
PRESTO,"anticoncepcion, prevencion de its y de cancer de cuello uterino",pildora: usuarias nuevas,2016-01-01,0,0,1,0,0,1
PUCARANI,"anticoncepcion, prevencion de its y de cancer de cuello uterino",pildora: usuarias nuevas,2016-01-01,0,0,2,1,0,3
PUERTO ACOSTA,"anticoncepcion, prevencion de its y de cancer de cuello uterino",pildora: usuarias nuevas,2016-01-01,0,0,1,0,0,1
PUERTO CARABUCO,"anticoncepcion, prevencion de its y de cancer de cuello uterino",pildora: usuarias nuevas,2016-01-01,0,0,1,1,0,2
PUERTO GONZALO MORENO,"anticoncepcion, prevencion de its y de cancer de cuello uterino",pildora: usuarias nuevas,2016-01-01,0,1,4,0,0,5
PUERTO PEREZ,"anticoncepcion, prevencion de its y de cancer de cuello uterino",pildora: usuarias nuevas,2016-01-01,0,0,1,0,0,1
PUERTO RICO,"anticoncepcion, prevencion de its y de cancer de cuello uterino",pildora: usuarias nuevas,2016-01-01,0,0,2,0,0,2
PUERTO SILES,"anticoncepcion, prevencion de its y de cancer de cuello uterino",pildora: usuarias nuevas,2016-01-01,0,0,1,0,0,1
PUERTO SUAREZ,"anticoncepcion, prevencion de its y de cancer de cuello uterino",pildora: usuarias nuevas,2016-01-01,0,1,0,1,0,2
PUERTO VILLARROEL,"anticoncepcion, prevencion de its y de cancer de cuello uterino",pildora: usuarias nuevas,2016-01-01,0,0,6,0,0,6
PUNA,"anticoncepcion, prevencion de its y de cancer de cuello uterino",pildora: usuarias nuevas,2016-01-01,0,1,0,1,0,2
PUNATA,"anticoncepcion, prevencion de its y de cancer de cuello uterino",pildora: usuarias nuevas,2016-01-01,0,0,3,1,0,4
QUILLACOLLO,"anticoncepcion, prevencion de its y de cancer de cuello uterino",pildora: usuarias nuevas,2016-01-01,0,1,15,1,0,17
QUIME,"anticoncepcion, prevencion de its y de cancer de cuello uterino",pildora: usuarias nuevas,2016-01-01,0,1,3,0,0,4
REYES,"anticoncepcion, prevencion de its y de cancer de cuello uterino",pildora: usuarias nuevas,2016-01-01,1,1,7,5,0,14
RIBERALTA,"anticoncepcion, prevencion de its y de cancer de cuello uterino",pildora: usuarias nuevas,2016-01-01,0,11,27,3,0,41
ROBORE,"anticoncepcion, prevencion de its y de cancer de cuello uterino",pildora: usuarias nuevas,2016-01-01,0,0,1,0,0,1
RURRENABAQUE,"anticoncepcion, prevencion de its y de cancer de cuello uterino",pildora: usuarias nuevas,2016-01-01,0,0,6,0,0,6
SABAYA,"anticoncepcion, prevencion de its y de cancer de cuello uterino",pildora: usuarias nuevas,2016-01-01,0,0,1,0,0,1
SACABA,"anticoncepcion, prevencion de its y de cancer de cuello uterino",pildora: usuarias nuevas,2016-01-01,0,3,8,4,0,15
SACABAMBA,"anticoncepcion, prevencion de its y de cancer de cuello uterino",pildora: usuarias nuevas,2016-01-01,0,0,2,0,0,2
SACACA,"anticoncepcion, prevencion de its y de cancer de cuello uterino",pildora: usuarias nuevas,2016-01-01,0,0,1,0,0,1
SALINAS DE GARCI MENDOZA,"anticoncepcion, prevencion de its y de cancer de cuello uterino",pildora: usuarias nuevas,2016-01-01,0,0,3,1,0,4
SAMAIPATA,"anticoncepcion, prevencion de its y de cancer de cuello uterino",pildora: usuarias nuevas,2016-01-01,0,0,1,0,0,1
SAN ANDRES,"anticoncepcion, prevencion de its y de cancer de cuello uterino",pildora: usuarias nuevas,2016-01-01,0,5,13,6,0,24
SAN ANTONIO DE LOMERIO,"anticoncepcion, prevencion de its y de cancer de cuello uterino",pildora: usuarias nuevas,2016-01-01,0,0,5,1,0,6
SAN BORJA,"anticoncepcion, prevencion de its y de cancer de cuello uterino",pildora: usuarias nuevas,2016-01-01,2,1,6,2,0,11
SAN BUENA VENTURA,"anticoncepcion, prevencion de its y de cancer de cuello uterino",pildora: usuarias nuevas,2016-01-01,0,0,2,0,0,2
SAN CARLOS,"anticoncepcion, prevencion de its y de cancer de cuello uterino",pildora: usuarias nuevas,2016-01-01,0,1,12,0,0,13
SAN IGNACIO,"anticoncepcion, prevencion de its y de cancer de cuello uterino",pildora: usuarias nuevas,2016-01-01,0,1,10,8,0,19
SAN IGNACIO DE VELASCO,"anticoncepcion, prevencion de its y de cancer de cuello uterino",pildora: usuarias nuevas,2016-01-01,0,1,1,2,0,4
SAN JAVIER(BNI),"anticoncepcion, prevencion de its y de cancer de cuello uterino",pildora: usuarias nuevas,2016-01-01,0,4,5,1,0,10
SAN JAVIER(STC),"anticoncepcion, prevencion de its y de cancer de cuello uterino",pildora: usuarias nuevas,2016-01-01,0,5,20,7,0,32
SAN JOAQUIN,"anticoncepcion, prevencion de its y de cancer de cuello uterino",pildora: usuarias nuevas,2016-01-01,0,1,1,0,0,2
SAN JOSE DE CHIQUITOS,"anticoncepcion, prevencion de its y de cancer de cuello uterino",pildora: usuarias nuevas,2016-01-01,0,7,4,2,0,13
SAN JUAN DE YAPACANI,"anticoncepcion, prevencion de its y de cancer de cuello uterino",pildora: usuarias nuevas,2016-01-01,0,0,1,0,0,1
SAN JULIAN,"anticoncepcion, prevencion de its y de cancer de cuello uterino",pildora: usuarias nuevas,2016-01-01,0,3,8,6,0,17
SAN LORENZO(PND),"anticoncepcion, prevencion de its y de cancer de cuello uterino",pildora: usuarias nuevas,2016-01-01,0,0,1,0,0,1
SAN LORENZO(TJA),"anticoncepcion, prevencion de its y de cancer de cuello uterino",pildora: usuarias nuevas,2016-01-01,0,1,11,1,0,13
SAN LUCAS,"anticoncepcion, prevencion de its y de cancer de cuello uterino",pildora: usuarias nuevas,2016-01-01,1,0,1,0,0,2
SAN MATIAS,"anticoncepcion, prevencion de its y de cancer de cuello uterino",pildora: usuarias nuevas,2016-01-01,0,1,13,0,0,14
SAN MIGUEL DE VELASCO,"anticoncepcion, prevencion de its y de cancer de cuello uterino",pildora: usuarias nuevas,2016-01-01,0,2,0,1,0,3
SAN PABLO DE LIPEZ,"anticoncepcion, prevencion de its y de cancer de cuello uterino",pildora: usuarias nuevas,2016-01-01,0,0,1,0,0,1
SAN PEDRO,"anticoncepcion, prevencion de its y de cancer de cuello uterino",pildora: usuarias nuevas,2016-01-01,0,0,6,4,0,10
SAN PEDRO DE BUENA VISTA,"anticoncepcion, prevencion de its y de cancer de cuello uterino",pildora: usuarias nuevas,2016-01-01,0,0,0,1,0,1
SAN PEDRO DE CURAHUARA,"anticoncepcion, prevencion de its y de cancer de cuello uterino",pildora: usuarias nuevas,2016-01-01,0,0,3,2,0,5
SAN PEDRO DE QUEMES,"anticoncepcion, prevencion de its y de cancer de cuello uterino",pildora: usuarias nuevas,2016-01-01,0,0,1,0,0,1
SAN PEDRO DE TIQUINA,"anticoncepcion, prevencion de its y de cancer de cuello uterino",pildora: usuarias nuevas,2016-01-01,0,0,0,1,0,1
SAN RAFAEL,"anticoncepcion, prevencion de its y de cancer de cuello uterino",pildora: usuarias nuevas,2016-01-01,0,0,1,2,0,3
SAN RAMON BENI,"anticoncepcion, prevencion de its y de cancer de cuello uterino",pildora: usuarias nuevas,2016-01-01,0,0,1,0,0,1
SAN RAMON SCZ,"anticoncepcion, prevencion de its y de cancer de cuello uterino",pildora: usuarias nuevas,2016-01-01,0,1,3,0,0,4
SANTA ANA,"anticoncepcion, prevencion de its y de cancer de cuello uterino",pildora: usuarias nuevas,2016-01-01,0,11,24,9,0,44
SANTA CRUZ DE LA SIERRA,"anticoncepcion, prevencion de its y de cancer de cuello uterino",pildora: usuarias nuevas,2016-01-01,5,31,143,22,0,201
SANTA ROSA,"anticoncepcion, prevencion de its y de cancer de cuello uterino",pildora: usuarias nuevas,2016-01-01,1,4,5,4,0,14
SANTA ROSA DEL SARA,"anticoncepcion, prevencion de its y de cancer de cuello uterino",pildora: usuarias nuevas,2016-01-01,0,2,15,7,1,25
SANTIAGO DE MACHACA,"anticoncepcion, prevencion de its y de cancer de cuello uterino",pildora: usuarias nuevas,2016-01-01,0,0,1,0,0,1
SANTIVAÑES,"anticoncepcion, prevencion de its y de cancer de cuello uterino",pildora: usuarias nuevas,2016-01-01,0,0,3,0,0,3
SANTUARIO DE QUILLACAS,"anticoncepcion, prevencion de its y de cancer de cuello uterino",pildora: usuarias nuevas,2016-01-01,0,1,3,1,0,5
SENA,"anticoncepcion, prevencion de its y de cancer de cuello uterino",pildora: usuarias nuevas,2016-01-01,0,0,4,0,0,4
SHINAOTA,"anticoncepcion, prevencion de its y de cancer de cuello uterino",pildora: usuarias nuevas,2016-01-01,0,0,0,1,0,1
SICA SICA (VILLA AROMA),"anticoncepcion, prevencion de its y de cancer de cuello uterino",pildora: usuarias nuevas,2016-01-01,0,0,2,0,0,2
SIPE SIPE,"anticoncepcion, prevencion de its y de cancer de cuello uterino",pildora: usuarias nuevas,2016-01-01,0,5,13,6,0,24
SOPACHUY,"anticoncepcion, prevencion de its y de cancer de cuello uterino",pildora: usuarias nuevas,2016-01-01,0,1,0,1,0,2
SORATA,"anticoncepcion, prevencion de its y de cancer de cuello uterino",pildora: usuarias nuevas,2016-01-01,0,0,4,0,0,4
SUCRE,"anticoncepcion, prevencion de its y de cancer de cuello uterino",pildora: usuarias nuevas,2016-01-01,2,8,39,7,0,56
TACACOMA,"anticoncepcion, prevencion de its y de cancer de cuello uterino",pildora: usuarias nuevas,2016-01-01,0,0,2,0,0,2
TAPACARI,"anticoncepcion, prevencion de its y de cancer de cuello uterino",pildora: usuarias nuevas,2016-01-01,0,1,2,1,0,4
TARABUCO,"anticoncepcion, prevencion de its y de cancer de cuello uterino",pildora: usuarias nuevas,2016-01-01,0,1,1,0,0,2
TARATA,"anticoncepcion, prevencion de its y de cancer de cuello uterino",pildora: usuarias nuevas,2016-01-01,0,0,1,0,0,1
TARIJA,"anticoncepcion, prevencion de its y de cancer de cuello uterino",pildora: usuarias nuevas,2016-01-01,0,2,18,5,0,25
TARVITA,"anticoncepcion, prevencion de its y de cancer de cuello uterino",pildora: usuarias nuevas,2016-01-01,0,1,4,3,0,8
TEOPONTE,"anticoncepcion, prevencion de its y de cancer de cuello uterino",pildora: usuarias nuevas,2016-01-01,0,1,3,1,0,5
TIAWANACU,"anticoncepcion, prevencion de its y de cancer de cuello uterino",pildora: usuarias nuevas,2016-01-01,0,0,1,2,0,3
TIPUANI,"anticoncepcion, prevencion de its y de cancer de cuello uterino",pildora: usuarias nuevas,2016-01-01,0,0,2,0,0,2
TIQUIPAYA,"anticoncepcion, prevencion de its y de cancer de cuello uterino",pildora: usuarias nuevas,2016-01-01,0,2,9,0,0,11
TOLATA,"anticoncepcion, prevencion de its y de cancer de cuello uterino",pildora: usuarias nuevas,2016-01-01,0,0,1,0,0,1
TOMINA,"anticoncepcion, prevencion de its y de cancer de cuello uterino",pildora: usuarias nuevas,2016-01-01,0,1,2,1,0,4
TOTORA(CBBA),"anticoncepcion, prevencion de its y de cancer de cuello uterino",pildora: usuarias nuevas,2016-01-01,0,2,2,0,0,4
TRINIDAD,"anticoncepcion, prevencion de its y de cancer de cuello uterino",pildora: usuarias nuevas,2016-01-01,0,3,7,4,0,14
TUPIZA,"anticoncepcion, prevencion de its y de cancer de cuello uterino",pildora: usuarias nuevas,2016-01-01,0,0,4,1,0,5
UMALA,"anticoncepcion, prevencion de its y de cancer de cuello uterino",pildora: usuarias nuevas,2016-01-01,0,0,3,1,0,4
UNCIA,"anticoncepcion, prevencion de its y de cancer de cuello uterino",pildora: usuarias nuevas,2016-01-01,0,2,6,0,0,8
URIONDO (A. CONCEPCION),"anticoncepcion, prevencion de its y de cancer de cuello uterino",pildora: usuarias nuevas,2016-01-01,0,0,0,1,0,1
URUBICHA,"anticoncepcion, prevencion de its y de cancer de cuello uterino",pildora: usuarias nuevas,2016-01-01,0,0,3,1,0,4
UYUNI,"anticoncepcion, prevencion de its y de cancer de cuello uterino",pildora: usuarias nuevas,2016-01-01,0,1,4,0,0,5
VALLEGRANDE,"anticoncepcion, prevencion de its y de cancer de cuello uterino",pildora: usuarias nuevas,2016-01-01,0,1,1,0,0,2
VIACHA,"anticoncepcion, prevencion de its y de cancer de cuello uterino",pildora: usuarias nuevas,2016-01-01,0,1,4,1,0,6
VILA VILA,"anticoncepcion, prevencion de its y de cancer de cuello uterino",pildora: usuarias nuevas,2016-01-01,0,0,1,0,0,1
VILLA CHARCAS,"anticoncepcion, prevencion de its y de cancer de cuello uterino",pildora: usuarias nuevas,2016-01-01,0,0,4,0,0,4
VILLA MONTES,"anticoncepcion, prevencion de its y de cancer de cuello uterino",pildora: usuarias nuevas,2016-01-01,0,1,5,1,0,7
VILLA NUEVA (LOMA ALTA),"anticoncepcion, prevencion de its y de cancer de cuello uterino",pildora: usuarias nuevas,2016-01-01,0,1,0,0,0,1
VILLA SERRANO,"anticoncepcion, prevencion de its y de cancer de cuello uterino",pildora: usuarias nuevas,2016-01-01,0,0,3,2,0,5
VILLA TUNARI,"anticoncepcion, prevencion de its y de cancer de cuello uterino",pildora: usuarias nuevas,2016-01-01,0,3,23,3,0,29
VILLA VACA GUZMAN (MUYUPAMPA),"anticoncepcion, prevencion de its y de cancer de cuello uterino",pildora: usuarias nuevas,2016-01-01,1,0,3,0,1,5
VILLAZON,"anticoncepcion, prevencion de its y de cancer de cuello uterino",pildora: usuarias nuevas,2016-01-01,0,0,4,2,0,6
VINTO,"anticoncepcion, prevencion de its y de cancer de cuello uterino",pildora: usuarias nuevas,2016-01-01,0,1,3,0,0,4
WARNES,"anticoncepcion, prevencion de its y de cancer de cuello uterino",pildora: usuarias nuevas,2016-01-01,1,0,13,4,0,18
YACO,"anticoncepcion, prevencion de its y de cancer de cuello uterino",pildora: usuarias nuevas,2016-01-01,0,0,2,0,0,2
YACUIBA,"anticoncepcion, prevencion de its y de cancer de cuello uterino",pildora: usuarias nuevas,2016-01-01,0,2,11,0,0,13
YAMPARAEZ,"anticoncepcion, prevencion de its y de cancer de cuello uterino",pildora: usuarias nuevas,2016-01-01,0,1,0,0,0,1
YAPACANI,"anticoncepcion, prevencion de its y de cancer de cuello uterino",pildora: usuarias nuevas,2016-01-01,0,3,15,2,0,20
YOCALLA,"anticoncepcion, prevencion de its y de cancer de cuello uterino",pildora: usuarias nuevas,2016-01-01,0,0,0,1,0,1
ACACIO,"anticoncepcion, prevencion de its y de cancer de cuello uterino",pildora: usuarias nuevas,2016-02-01,0,0,1,0,0,1
ACHACACHI,"anticoncepcion, prevencion de its y de cancer de cuello uterino",pildora: usuarias nuevas,2016-02-01,0,1,1,1,0,3
ACHOCALLA,"anticoncepcion, prevencion de its y de cancer de cuello uterino",pildora: usuarias nuevas,2016-02-01,0,0,4,0,0,4
AIQUILE,"anticoncepcion, prevencion de its y de cancer de cuello uterino",pildora: usuarias nuevas,2016-02-01,0,0,3,0,0,3
ALCALA,"anticoncepcion, prevencion de its y de cancer de cuello uterino",pildora: usuarias nuevas,2016-02-01,0,0,0,1,0,1
ALTO BENI,"anticoncepcion, prevencion de its y de cancer de cuello uterino",pildora: usuarias nuevas,2016-02-01,0,0,2,0,0,2
ANCORAIMES,"anticoncepcion, prevencion de its y de cancer de cuello uterino",pildora: usuarias nuevas,2016-02-01,0,0,3,1,0,4
ANDAMARCA,"anticoncepcion, prevencion de its y de cancer de cuello uterino",pildora: usuarias nuevas,2016-02-01,0,0,2,0,0,2
APOLO,"anticoncepcion, prevencion de its y de cancer de cuello uterino",pildora: usuarias nuevas,2016-02-01,0,2,0,1,0,3
ARAMPAMPA,"anticoncepcion, prevencion de its y de cancer de cuello uterino",pildora: usuarias nuevas,2016-02-01,0,0,1,0,0,1
ARANI,"anticoncepcion, prevencion de its y de cancer de cuello uterino",pildora: usuarias nuevas,2016-02-01,0,0,0,2,0,2
ARBIETO,"anticoncepcion, prevencion de its y de cancer de cuello uterino",pildora: usuarias nuevas,2016-02-01,0,1,3,0,0,4
ASCENCION DE GUARAYOS,"anticoncepcion, prevencion de its y de cancer de cuello uterino",pildora: usuarias nuevas,2016-02-01,1,2,10,3,0,16
AUCAPATA,"anticoncepcion, prevencion de its y de cancer de cuello uterino",pildora: usuarias nuevas,2016-02-01,0,0,0,1,0,1
AYATA,"anticoncepcion, prevencion de its y de cancer de cuello uterino",pildora: usuarias nuevas,2016-02-01,0,0,2,0,0,2
AYO AYO,"anticoncepcion, prevencion de its y de cancer de cuello uterino",pildora: usuarias nuevas,2016-02-01,0,0,1,0,0,1
AYOPAYA (V. DE INDEPENDENCIA),"anticoncepcion, prevencion de its y de cancer de cuello uterino",pildora: usuarias nuevas,2016-02-01,0,3,3,0,0,6
AZURDUY,"anticoncepcion, prevencion de its y de cancer de cuello uterino",pildora: usuarias nuevas,2016-02-01,0,1,3,0,0,4
BATALLAS,"anticoncepcion, prevencion de its y de cancer de cuello uterino",pildora: usuarias nuevas,2016-02-01,0,2,0,0,0,2
BAURES,"anticoncepcion, prevencion de its y de cancer de cuello uterino",pildora: usuarias nuevas,2016-02-01,0,0,2,3,0,5
BELEN DE URMIRI,"anticoncepcion, prevencion de its y de cancer de cuello uterino",pildora: usuarias nuevas,2016-02-01,0,0,0,1,0,1
BERMEJO,"anticoncepcion, prevencion de its y de cancer de cuello uterino",pildora: usuarias nuevas,2016-02-01,0,1,7,2,0,10
BETANZOS,"anticoncepcion, prevencion de its y de cancer de cuello uterino",pildora: usuarias nuevas,2016-02-01,0,0,3,1,0,4
BOYUIBE,"anticoncepcion, prevencion de its y de cancer de cuello uterino",pildora: usuarias nuevas,2016-02-01,0,0,3,0,0,3
BUENA VISTA,"anticoncepcion, prevencion de its y de cancer de cuello uterino",pildora: usuarias nuevas,2016-02-01,0,5,5,0,0,10
CABEZAS,"anticoncepcion, prevencion de its y de cancer de cuello uterino",pildora: usuarias nuevas,2016-02-01,1,5,14,2,0,22
CAIROMA,"anticoncepcion, prevencion de its y de cancer de cuello uterino",pildora: usuarias nuevas,2016-02-01,0,0,1,1,0,2
"CAIZA ""D""","anticoncepcion, prevencion de its y de cancer de cuello uterino",pildora: usuarias nuevas,2016-02-01,0,1,1,0,0,2
CALAMARCA,"anticoncepcion, prevencion de its y de cancer de cuello uterino",pildora: usuarias nuevas,2016-02-01,0,3,8,3,0,14
CAMARGO,"anticoncepcion, prevencion de its y de cancer de cuello uterino",pildora: usuarias nuevas,2016-02-01,0,0,1,1,0,2
CAMIRI,"anticoncepcion, prevencion de its y de cancer de cuello uterino",pildora: usuarias nuevas,2016-02-01,0,0,1,1,0,2
CAQUIAVIRI,"anticoncepcion, prevencion de its y de cancer de cuello uterino",pildora: usuarias nuevas,2016-02-01,0,0,1,0,0,1
CARAPARI,"anticoncepcion, prevencion de its y de cancer de cuello uterino",pildora: usuarias nuevas,2016-02-01,0,0,1,0,0,1
CARIPUYO,"anticoncepcion, prevencion de its y de cancer de cuello uterino",pildora: usuarias nuevas,2016-02-01,0,1,0,1,0,2
CARMEN RIVERO TORREZ,"anticoncepcion, prevencion de its y de cancer de cuello uterino",pildora: usuarias nuevas,2016-02-01,0,0,3,0,0,3
CHARAGUA,"anticoncepcion, prevencion de its y de cancer de cuello uterino",pildora: usuarias nuevas,2016-02-01,0,1,4,0,0,5
CHAYANTA,"anticoncepcion, prevencion de its y de cancer de cuello uterino",pildora: usuarias nuevas,2016-02-01,0,0,2,0,0,2
CHIMORE,"anticoncepcion, prevencion de its y de cancer de cuello uterino",pildora: usuarias nuevas,2016-02-01,0,2,4,1,0,7
CHIPAYA,"anticoncepcion, prevencion de its y de cancer de cuello uterino",pildora: usuarias nuevas,2016-02-01,0,0,1,0,0,1
CHOQUE COTA,"anticoncepcion, prevencion de its y de cancer de cuello uterino",pildora: usuarias nuevas,2016-02-01,0,0,3,0,0,3
CHUA COCANI,"anticoncepcion, prevencion de its y de cancer de cuello uterino",pildora: usuarias nuevas,2016-02-01,0,0,1,0,0,1
CHUMA,"anticoncepcion, prevencion de its y de cancer de cuello uterino",pildora: usuarias nuevas,2016-02-01,0,0,3,1,0,4
CHUQUIHUTA AYLLU JUCUMANI,"anticoncepcion, prevencion de its y de cancer de cuello uterino",pildora: usuarias nuevas,2016-02-01,0,0,2,0,0,2
CLIZA,"anticoncepcion, prevencion de its y de cancer de cuello uterino",pildora: usuarias nuevas,2016-02-01,0,0,3,1,0,4
COBIJA,"anticoncepcion, prevencion de its y de cancer de cuello uterino",pildora: usuarias nuevas,2016-02-01,0,0,6,1,0,7
COCAPATA,"anticoncepcion, prevencion de its y de cancer de cuello uterino",pildora: usuarias nuevas,2016-02-01,0,2,4,2,0,8
COCHABAMBA,"anticoncepcion, prevencion de its y de cancer de cuello uterino",pildora: usuarias nuevas,2016-02-01,0,6,153,80,0,239
COLCAPIRHUA,"anticoncepcion, prevencion de its y de cancer de cuello uterino",pildora: usuarias nuevas,2016-02-01,0,3,4,2,0,9
"COLCHA ""K""","anticoncepcion, prevencion de its y de cancer de cuello uterino",pildora: usuarias nuevas,2016-02-01,0,0,5,1,0,6
COLOMI,"anticoncepcion, prevencion de its y de cancer de cuello uterino",pildora: usuarias nuevas,2016-02-01,0,0,1,1,0,2
COLPA BELGICA,"anticoncepcion, prevencion de its y de cancer de cuello uterino",pildora: usuarias nuevas,2016-02-01,0,0,1,1,0,2
COLQUECHACA,"anticoncepcion, prevencion de its y de cancer de cuello uterino",pildora: usuarias nuevas,2016-02-01,0,0,2,0,0,2
COLQUENCHA,"anticoncepcion, prevencion de its y de cancer de cuello uterino",pildora: usuarias nuevas,2016-02-01,0,0,1,0,0,1
COLQUIRI,"anticoncepcion, prevencion de its y de cancer de cuello uterino",pildora: usuarias nuevas,2016-02-01,0,0,3,1,0,4
COMARAPA,"anticoncepcion, prevencion de its y de cancer de cuello uterino",pildora: usuarias nuevas,2016-02-01,1,2,2,0,0,5
CONCEPCION,"anticoncepcion, prevencion de its y de cancer de cuello uterino",pildora: usuarias nuevas,2016-02-01,0,1,1,1,0,3
COPACABANA,"anticoncepcion, prevencion de its y de cancer de cuello uterino",pildora: usuarias nuevas,2016-02-01,0,0,2,0,0,2
CORIPATA,"anticoncepcion, prevencion de its y de cancer de cuello uterino",pildora: usuarias nuevas,2016-02-01,0,0,2,0,0,2
CORO CORO,"anticoncepcion, prevencion de its y de cancer de cuello uterino",pildora: usuarias nuevas,2016-02-01,0,0,1,0,0,1
COTAGAITA,"anticoncepcion, prevencion de its y de cancer de cuello uterino",pildora: usuarias nuevas,2016-02-01,0,0,4,0,0,4
COTOCA,"anticoncepcion, prevencion de its y de cancer de cuello uterino",pildora: usuarias nuevas,2016-02-01,0,5,20,4,1,30
CUATRO CAÑADAS,"anticoncepcion, prevencion de its y de cancer de cuello uterino",pildora: usuarias nuevas,2016-02-01,0,2,6,1,0,9
CUEVO,"anticoncepcion, prevencion de its y de cancer de cuello uterino",pildora: usuarias nuevas,2016-02-01,0,0,1,0,0,1
CULPINA,"anticoncepcion, prevencion de its y de cancer de cuello uterino",pildora: usuarias nuevas,2016-02-01,0,0,3,1,0,4
CURAHUARA DE CARANGAS,"anticoncepcion, prevencion de its y de cancer de cuello uterino",pildora: usuarias nuevas,2016-02-01,0,0,1,0,0,1
DESAGUADERO,"anticoncepcion, prevencion de its y de cancer de cuello uterino",pildora: usuarias nuevas,2016-02-01,0,0,0,1,0,1
EL ALTO,"anticoncepcion, prevencion de its y de cancer de cuello uterino",pildora: usuarias nuevas,2016-02-01,0,16,111,25,0,152
EL PUENTE(STC),"anticoncepcion, prevencion de its y de cancer de cuello uterino",pildora: usuarias nuevas,2016-02-01,0,0,6,1,0,7
EL PUENTE(TJA),"anticoncepcion, prevencion de its y de cancer de cuello uterino",pildora: usuarias nuevas,2016-02-01,0,0,0,1,0,1
EL TORNO,"anticoncepcion, prevencion de its y de cancer de cuello uterino",pildora: usuarias nuevas,2016-02-01,2,3,12,1,0,18
EL VILLAR,"anticoncepcion, prevencion de its y de cancer de cuello uterino",pildora: usuarias nuevas,2016-02-01,0,1,0,1,0,2
ENTRE RIOS TRJ,"anticoncepcion, prevencion de its y de cancer de cuello uterino",pildora: usuarias nuevas,2016-02-01,0,1,4,0,0,5
ENTRE RIOS CBBA,"anticoncepcion, prevencion de its y de cancer de cuello uterino",pildora: usuarias nuevas,2016-02-01,0,1,3,2,0,6
ESCARA,"anticoncepcion, prevencion de its y de cancer de cuello uterino",pildora: usuarias nuevas,2016-02-01,0,0,2,1,0,3
EUREKA (SANTOS MERCADO),"anticoncepcion, prevencion de its y de cancer de cuello uterino",pildora: usuarias nuevas,2016-02-01,0,0,1,0,0,1
FERNANDEZ ALONSO,"anticoncepcion, prevencion de its y de cancer de cuello uterino",pildora: usuarias nuevas,2016-02-01,0,0,7,1,0,8
FILADELFIA,"anticoncepcion, prevencion de its y de cancer de cuello uterino",pildora: usuarias nuevas,2016-02-01,0,0,1,0,0,1
GENERAL SAAVEDRA,"anticoncepcion, prevencion de its y de cancer de cuello uterino",pildora: usuarias nuevas,2016-02-01,0,0,7,0,0,7
GRAL. J.J. PEREZ (CHARAZANI),"anticoncepcion, prevencion de its y de cancer de cuello uterino",pildora: usuarias nuevas,2016-02-01,0,0,1,0,0,1
GUANAY,"anticoncepcion, prevencion de its y de cancer de cuello uterino",pildora: usuarias nuevas,2016-02-01,0,0,2,0,0,2
GUAQUI,"anticoncepcion, prevencion de its y de cancer de cuello uterino",pildora: usuarias nuevas,2016-02-01,0,1,0,1,0,2
GUAYARAMERIN,"anticoncepcion, prevencion de its y de cancer de cuello uterino",pildora: usuarias nuevas,2016-02-01,0,1,14,3,0,18
GUTIERREZ,"anticoncepcion, prevencion de its y de cancer de cuello uterino",pildora: usuarias nuevas,2016-02-01,0,1,1,0,0,2
HUACARETA,"anticoncepcion, prevencion de its y de cancer de cuello uterino",pildora: usuarias nuevas,2016-02-01,0,1,7,3,0,11
HUACAYA (VILLA DE HUACAYA),"anticoncepcion, prevencion de its y de cancer de cuello uterino",pildora: usuarias nuevas,2016-02-01,0,0,2,0,0,2
HUANUNI,"anticoncepcion, prevencion de its y de cancer de cuello uterino",pildora: usuarias nuevas,2016-02-01,0,0,1,0,0,1
HUARACAJE,"anticoncepcion, prevencion de its y de cancer de cuello uterino",pildora: usuarias nuevas,2016-02-01,0,2,2,1,0,5
HUAYLLAMARCA,"anticoncepcion, prevencion de its y de cancer de cuello uterino",pildora: usuarias nuevas,2016-02-01,0,0,2,0,0,2
HUMANATA,"anticoncepcion, prevencion de its y de cancer de cuello uterino",pildora: usuarias nuevas,2016-02-01,0,0,1,0,0,1
INCAHUASI,"anticoncepcion, prevencion de its y de cancer de cuello uterino",pildora: usuarias nuevas,2016-02-01,0,0,1,3,0,4
INGAVI (HUMAITA),"anticoncepcion, prevencion de its y de cancer de cuello uterino",pildora: usuarias nuevas,2016-02-01,0,0,1,0,0,1
INQUISIVI,"anticoncepcion, prevencion de its y de cancer de cuello uterino",pildora: usuarias nuevas,2016-02-01,0,1,2,0,0,3
IRUPANA (VILLA DE LANZA),"anticoncepcion, prevencion de its y de cancer de cuello uterino",pildora: usuarias nuevas,2016-02-01,0,0,6,1,0,7
IXIAMAS,"anticoncepcion, prevencion de its y de cancer de cuello uterino",pildora: usuarias nuevas,2016-02-01,0,0,1,0,0,1
LA ASUNTA,"anticoncepcion, prevencion de its y de cancer de cuello uterino",pildora: usuarias nuevas,2016-02-01,0,0,1,1,0,2
LA GUARDIA,"anticoncepcion, prevencion de its y de cancer de cuello uterino",pildora: usuarias nuevas,2016-02-01,0,3,17,6,0,26
LA PAZ,"anticoncepcion, prevencion de its y de cancer de cuello uterino",pildora: usuarias nuevas,2016-02-01,0,19,108,47,0,174
LAGUNILLAS,"anticoncepcion, prevencion de its y de cancer de cuello uterino",pildora: usuarias nuevas,2016-02-01,0,0,2,0,0,2
LAJA,"anticoncepcion, prevencion de its y de cancer de cuello uterino",pildora: usuarias nuevas,2016-02-01,0,0,5,1,0,6
LLALLAGUA,"anticoncepcion, prevencion de its y de cancer de cuello uterino",pildora: usuarias nuevas,2016-02-01,0,1,6,4,0,11
LORETO,"anticoncepcion, prevencion de its y de cancer de cuello uterino",pildora: usuarias nuevas,2016-02-01,0,1,0,2,0,3
MACHARETI,"anticoncepcion, prevencion de its y de cancer de cuello uterino",pildora: usuarias nuevas,2016-02-01,0,2,5,1,0,8
MAGDALENA,"anticoncepcion, prevencion de its y de cancer de cuello uterino",pildora: usuarias nuevas,2016-02-01,0,2,1,0,0,3
MAPIRI,"anticoncepcion, prevencion de its y de cancer de cuello uterino",pildora: usuarias nuevas,2016-02-01,0,0,1,0,0,1
MECAPACA,"anticoncepcion, prevencion de its y de cancer de cuello uterino",pildora: usuarias nuevas,2016-02-01,0,0,1,1,0,2
MIZQUE,"anticoncepcion, prevencion de its y de cancer de cuello uterino",pildora: usuarias nuevas,2016-02-01,0,2,2,1,0,5
MONTEAGUDO,"anticoncepcion, prevencion de its y de cancer de cuello uterino",pildora: usuarias nuevas,2016-02-01,0,0,4,5,0,9
MONTERO,"anticoncepcion, prevencion de its y de cancer de cuello uterino",pildora: usuarias nuevas,2016-02-01,0,9,24,3,0,36
MOROCHATA,"anticoncepcion, prevencion de its y de cancer de cuello uterino",pildora: usuarias nuevas,2016-02-01,0,1,1,1,0,3
NUEVO MANOA (NUEVA ESPERANZA),"anticoncepcion, prevencion de its y de cancer de cuello uterino",pildora: usuarias nuevas,2016-02-01,0,0,1,1,0,2
OCURI,"anticoncepcion, prevencion de its y de cancer de cuello uterino",pildora: usuarias nuevas,2016-02-01,0,0,1,1,0,2
OKINAWA,"anticoncepcion, prevencion de its y de cancer de cuello uterino",pildora: usuarias nuevas,2016-02-01,0,0,2,0,0,2
OMEREQUE,"anticoncepcion, prevencion de its y de cancer de cuello uterino",pildora: usuarias nuevas,2016-02-01,0,0,2,1,0,3
ORURO,"anticoncepcion, prevencion de its y de cancer de cuello uterino",pildora: usuarias nuevas,2016-02-01,0,3,19,3,1,26
PADCAYA,"anticoncepcion, prevencion de its y de cancer de cuello uterino",pildora: usuarias nuevas,2016-02-01,0,0,2,0,0,2
PADILLA,"anticoncepcion, prevencion de its y de cancer de cuello uterino",pildora: usuarias nuevas,2016-02-01,0,1,3,0,0,4
PAILON,"anticoncepcion, prevencion de its y de cancer de cuello uterino",pildora: usuarias nuevas,2016-02-01,0,4,4,0,0,8
PALCA,"anticoncepcion, prevencion de its y de cancer de cuello uterino",pildora: usuarias nuevas,2016-02-01,0,4,5,2,0,11
PALOS BLANCOS,"anticoncepcion, prevencion de its y de cancer de cuello uterino",pildora: usuarias nuevas,2016-02-01,0,0,6,3,0,9
PAMPA AULLAGAS,"anticoncepcion, prevencion de its y de cancer de cuello uterino",pildora: usuarias nuevas,2016-02-01,0,0,1,0,0,1
PASORAPA,"anticoncepcion, prevencion de its y de cancer de cuello uterino",pildora: usuarias nuevas,2016-02-01,0,0,1,0,0,1
PAZÑA,"anticoncepcion, prevencion de its y de cancer de cuello uterino",pildora: usuarias nuevas,2016-02-01,0,1,0,1,0,2
PELECHUCO,"anticoncepcion, prevencion de its y de cancer de cuello uterino",pildora: usuarias nuevas,2016-02-01,0,0,1,1,0,2
POCOATA,"anticoncepcion, prevencion de its y de cancer de cuello uterino",pildora: usuarias nuevas,2016-02-01,0,0,1,2,0,3
POCONA,"anticoncepcion, prevencion de its y de cancer de cuello uterino",pildora: usuarias nuevas,2016-02-01,0,1,3,1,0,5
POJO (CBBA),"anticoncepcion, prevencion de its y de cancer de cuello uterino",pildora: usuarias nuevas,2016-02-01,0,0,4,0,0,4
PORCO,"anticoncepcion, prevencion de its y de cancer de cuello uterino",pildora: usuarias nuevas,2016-02-01,0,1,2,0,0,3
PORONGO,"anticoncepcion, prevencion de its y de cancer de cuello uterino",pildora: usuarias nuevas,2016-02-01,0,2,8,3,0,13
PORTACHUELO,"anticoncepcion, prevencion de its y de cancer de cuello uterino",pildora: usuarias nuevas,2016-02-01,0,2,1,0,0,3
PORVENIR,"anticoncepcion, prevencion de its y de cancer de cuello uterino",pildora: usuarias nuevas,2016-02-01,0,0,0,1,0,1
POTOSI,"anticoncepcion, prevencion de its y de cancer de cuello uterino",pildora: usuarias nuevas,2016-02-01,0,3,35,5,0,43
PUCARANI,"anticoncepcion, prevencion de its y de cancer de cuello uterino",pildora: usuarias nuevas,2016-02-01,0,1,2,0,0,3
PUERTO GONZALO MORENO,"anticoncepcion, prevencion de its y de cancer de cuello uterino",pildora: usuarias nuevas,2016-02-01,0,0,1,0,0,1
PUERTO RICO,"anticoncepcion, prevencion de its y de cancer de cuello uterino",pildora: usuarias nuevas,2016-02-01,0,0,1,0,0,1
PUERTO SUAREZ,"anticoncepcion, prevencion de its y de cancer de cuello uterino",pildora: usuarias nuevas,2016-02-01,0,0,3,2,0,5
PUERTO VILLARROEL,"anticoncepcion, prevencion de its y de cancer de cuello uterino",pildora: usuarias nuevas,2016-02-01,0,0,4,1,0,5
PUNA,"anticoncepcion, prevencion de its y de cancer de cuello uterino",pildora: usuarias nuevas,2016-02-01,0,0,1,1,0,2
PUNATA,"anticoncepcion, prevencion de its y de cancer de cuello uterino",pildora: usuarias nuevas,2016-02-01,0,0,3,0,0,3
QUILLACOLLO,"anticoncepcion, prevencion de its y de cancer de cuello uterino",pildora: usuarias nuevas,2016-02-01,0,14,45,12,0,71
QUIME,"anticoncepcion, prevencion de its y de cancer de cuello uterino",pildora: usuarias nuevas,2016-02-01,0,1,2,1,1,5
RAVELO,"anticoncepcion, prevencion de its y de cancer de cuello uterino",pildora: usuarias nuevas,2016-02-01,0,0,1,1,0,2
REYES,"anticoncepcion, prevencion de its y de cancer de cuello uterino",pildora: usuarias nuevas,2016-02-01,0,6,12,2,0,20
RIBERALTA,"anticoncepcion, prevencion de its y de cancer de cuello uterino",pildora: usuarias nuevas,2016-02-01,1,9,29,7,0,46
ROBORE,"anticoncepcion, prevencion de its y de cancer de cuello uterino",pildora: usuarias nuevas,2016-02-01,0,2,5,2,0,9
RURRENABAQUE,"anticoncepcion, prevencion de its y de cancer de cuello uterino",pildora: usuarias nuevas,2016-02-01,0,0,2,1,0,3
SABAYA,"anticoncepcion, prevencion de its y de cancer de cuello uterino",pildora: usuarias nuevas,2016-02-01,0,0,3,0,0,3
SACABA,"anticoncepcion, prevencion de its y de cancer de cuello uterino",pildora: usuarias nuevas,2016-02-01,0,0,7,3,0,10
SACACA,"anticoncepcion, prevencion de its y de cancer de cuello uterino",pildora: usuarias nuevas,2016-02-01,0,1,6,3,0,10
SALINAS DE GARCI MENDOZA,"anticoncepcion, prevencion de its y de cancer de cuello uterino",pildora: usuarias nuevas,2016-02-01,0,1,1,1,0,3
SAMAIPATA,"anticoncepcion, prevencion de its y de cancer de cuello uterino",pildora: usuarias nuevas,2016-02-01,0,0,3,0,0,3
SAN ANDRES,"anticoncepcion, prevencion de its y de cancer de cuello uterino",pildora: usuarias nuevas,2016-02-01,0,1,7,2,0,10
SAN ANTONIO DE LOMERIO,"anticoncepcion, prevencion de its y de cancer de cuello uterino",pildora: usuarias nuevas,2016-02-01,0,0,2,1,0,3
SAN BORJA,"anticoncepcion, prevencion de its y de cancer de cuello uterino",pildora: usuarias nuevas,2016-02-01,0,4,12,1,0,17
SAN BUENA VENTURA,"anticoncepcion, prevencion de its y de cancer de cuello uterino",pildora: usuarias nuevas,2016-02-01,0,0,1,1,0,2
SAN CARLOS,"anticoncepcion, prevencion de its y de cancer de cuello uterino",pildora: usuarias nuevas,2016-02-01,0,3,3,2,0,8
SAN IGNACIO,"anticoncepcion, prevencion de its y de cancer de cuello uterino",pildora: usuarias nuevas,2016-02-01,1,5,9,2,0,17
SAN IGNACIO DE VELASCO,"anticoncepcion, prevencion de its y de cancer de cuello uterino",pildora: usuarias nuevas,2016-02-01,0,4,3,1,0,8
SAN JAVIER(BNI),"anticoncepcion, prevencion de its y de cancer de cuello uterino",pildora: usuarias nuevas,2016-02-01,0,1,2,0,0,3
SAN JAVIER(STC),"anticoncepcion, prevencion de its y de cancer de cuello uterino",pildora: usuarias nuevas,2016-02-01,1,2,4,0,0,7
SAN JOSE DE CHIQUITOS,"anticoncepcion, prevencion de its y de cancer de cuello uterino",pildora: usuarias nuevas,2016-02-01,0,1,2,2,0,5
SAN JUAN DE YAPACANI,"anticoncepcion, prevencion de its y de cancer de cuello uterino",pildora: usuarias nuevas,2016-02-01,0,1,2,1,0,4
SAN JULIAN,"anticoncepcion, prevencion de its y de cancer de cuello uterino",pildora: usuarias nuevas,2016-02-01,0,2,2,2,0,6
SAN LORENZO(PND),"anticoncepcion, prevencion de its y de cancer de cuello uterino",pildora: usuarias nuevas,2016-02-01,0,0,1,0,0,1
SAN LORENZO(TJA),"anticoncepcion, prevencion de its y de cancer de cuello uterino",pildora: usuarias nuevas,2016-02-01,1,2,1,2,1,7
SAN LUCAS,"anticoncepcion, prevencion de its y de cancer de cuello uterino",pildora: usuarias nuevas,2016-02-01,0,1,1,1,0,3
SAN MATIAS,"anticoncepcion, prevencion de its y de cancer de cuello uterino",pildora: usuarias nuevas,2016-02-01,0,1,3,2,0,6
SAN MIGUEL DE VELASCO,"anticoncepcion, prevencion de its y de cancer de cuello uterino",pildora: usuarias nuevas,2016-02-01,0,1,2,1,0,4
SAN PEDRO,"anticoncepcion, prevencion de its y de cancer de cuello uterino",pildora: usuarias nuevas,2016-02-01,0,0,4,1,0,5
SAN PEDRO DE BUENA VISTA,"anticoncepcion, prevencion de its y de cancer de cuello uterino",pildora: usuarias nuevas,2016-02-01,0,0,2,3,0,5
SAN PEDRO DE CURAHUARA,"anticoncepcion, prevencion de its y de cancer de cuello uterino",pildora: usuarias nuevas,2016-02-01,0,0,2,1,0,3
SAN RAFAEL,"anticoncepcion, prevencion de its y de cancer de cuello uterino",pildora: usuarias nuevas,2016-02-01,0,2,7,0,0,9
SAN RAMON SCZ,"anticoncepcion, prevencion de its y de cancer de cuello uterino",pildora: usuarias nuevas,2016-02-01,0,0,1,1,0,2
SANTA ANA,"anticoncepcion, prevencion de its y de cancer de cuello uterino",pildora: usuarias nuevas,2016-02-01,0,4,9,1,0,14
SANTA CRUZ DE LA SIERRA,"anticoncepcion, prevencion de its y de cancer de cuello uterino",pildora: usuarias nuevas,2016-02-01,2,32,208,35,0,277
SANTA ROSA,"anticoncepcion, prevencion de its y de cancer de cuello uterino",pildora: usuarias nuevas,2016-02-01,0,0,15,2,0,17
SANTA ROSA DEL SARA,"anticoncepcion, prevencion de its y de cancer de cuello uterino",pildora: usuarias nuevas,2016-02-01,0,0,7,2,0,9
SANTIAGO DE CALLAPA,"anticoncepcion, prevencion de its y de cancer de cuello uterino",pildora: usuarias nuevas,2016-02-01,0,0,1,0,0,1
SANTIAGO DE HUARI,"anticoncepcion, prevencion de its y de cancer de cuello uterino",pildora: usuarias nuevas,2016-02-01,0,2,6,1,0,9
SANTIAGO DE HUATA,"anticoncepcion, prevencion de its y de cancer de cuello uterino",pildora: usuarias nuevas,2016-02-01,0,1,0,0,0,1
SANTIAGO DE MACHACA,"anticoncepcion, prevencion de its y de cancer de cuello uterino",pildora: usuarias nuevas,2016-02-01,0,0,1,0,0,1
SANTIVAÑES,"anticoncepcion, prevencion de its y de cancer de cuello uterino",pildora: usuarias nuevas,2016-02-01,0,1,0,1,0,2
SANTUARIO DE QUILLACAS,"anticoncepcion, prevencion de its y de cancer de cuello uterino",pildora: usuarias nuevas,2016-02-01,0,0,0,1,0,1
SAPAHAQUI,"anticoncepcion, prevencion de its y de cancer de cuello uterino",pildora: usuarias nuevas,2016-02-01,0,1,0,2,0,3
SHINAOTA,"anticoncepcion, prevencion de its y de cancer de cuello uterino",pildora: usuarias nuevas,2016-02-01,0,0,2,0,0,2
SICA SICA (VILLA AROMA),"anticoncepcion, prevencion de its y de cancer de cuello uterino",pildora: usuarias nuevas,2016-02-01,0,0,5,2,0,7
SIPE SIPE,"anticoncepcion, prevencion de its y de cancer de cuello uterino",pildora: usuarias nuevas,2016-02-01,0,0,8,3,0,11
SOPACHUY,"anticoncepcion, prevencion de its y de cancer de cuello uterino",pildora: usuarias nuevas,2016-02-01,0,1,3,2,0,6
SORATA,"anticoncepcion, prevencion de its y de cancer de cuello uterino",pildora: usuarias nuevas,2016-02-01,0,0,0,1,0,1
SUCRE,"anticoncepcion, prevencion de its y de cancer de cuello uterino",pildora: usuarias nuevas,2016-02-01,0,12,36,3,0,51
TACACOMA,"anticoncepcion, prevencion de its y de cancer de cuello uterino",pildora: usuarias nuevas,2016-02-01,0,0,4,0,0,4
TACOPAYA,"anticoncepcion, prevencion de its y de cancer de cuello uterino",pildora: usuarias nuevas,2016-02-01,1,0,1,0,0,2
TAHUA,"anticoncepcion, prevencion de its y de cancer de cuello uterino",pildora: usuarias nuevas,2016-02-01,0,0,1,0,0,1
TAPACARI,"anticoncepcion, prevencion de its y de cancer de cuello uterino",pildora: usuarias nuevas,2016-02-01,0,0,0,1,0,1
TARATA,"anticoncepcion, prevencion de its y de cancer de cuello uterino",pildora: usuarias nuevas,2016-02-01,0,0,2,0,0,2
TARIJA,"anticoncepcion, prevencion de its y de cancer de cuello uterino",pildora: usuarias nuevas,2016-02-01,0,5,18,14,0,37
TARVITA,"anticoncepcion, prevencion de its y de cancer de cuello uterino",pildora: usuarias nuevas,2016-02-01,0,0,4,0,0,4
TEOPONTE,"anticoncepcion, prevencion de its y de cancer de cuello uterino",pildora: usuarias nuevas,2016-02-01,0,1,0,0,0,1
TIAWANACU,"anticoncepcion, prevencion de its y de cancer de cuello uterino",pildora: usuarias nuevas,2016-02-01,0,1,1,2,0,4
TIPUANI,"anticoncepcion, prevencion de its y de cancer de cuello uterino",pildora: usuarias nuevas,2016-02-01,0,0,1,0,0,1
TIQUIPAYA,"anticoncepcion, prevencion de its y de cancer de cuello uterino",pildora: usuarias nuevas,2016-02-01,0,1,10,1,0,12
TODOS SANTOS,"anticoncepcion, prevencion de its y de cancer de cuello uterino",pildora: usuarias nuevas,2016-02-01,0,0,1,0,0,1
TOLATA,"anticoncepcion, prevencion de its y de cancer de cuello uterino",pildora: usuarias nuevas,2016-02-01,0,1,1,0,0,2
TOLEDO,"anticoncepcion, prevencion de its y de cancer de cuello uterino",pildora: usuarias nuevas,2016-02-01,0,0,1,0,0,1
TOMAVE,"anticoncepcion, prevencion de its y de cancer de cuello uterino",pildora: usuarias nuevas,2016-02-01,0,1,1,0,0,2
TOMINA,"anticoncepcion, prevencion de its y de cancer de cuello uterino",pildora: usuarias nuevas,2016-02-01,1,0,0,1,0,2
TORO TORO,"anticoncepcion, prevencion de its y de cancer de cuello uterino",pildora: usuarias nuevas,2016-02-01,0,0,1,0,0,1
TOTORA(CBBA),"anticoncepcion, prevencion de its y de cancer de cuello uterino",pildora: usuarias nuevas,2016-02-01,0,3,12,0,0,15
TOTORA(ORR),"anticoncepcion, prevencion de its y de cancer de cuello uterino",pildora: usuarias nuevas,2016-02-01,0,0,2,0,0,2
TRINIDAD,"anticoncepcion, prevencion de its y de cancer de cuello uterino",pildora: usuarias nuevas,2016-02-01,0,1,22,10,0,33
TUPIZA,"anticoncepcion, prevencion de its y de cancer de cuello uterino",pildora: usuarias nuevas,2016-02-01,0,0,7,0,0,7
UMALA,"anticoncepcion, prevencion de its y de cancer de cuello uterino",pildora: usuarias nuevas,2016-02-01,0,0,3,0,0,3
UNCIA,"anticoncepcion, prevencion de its y de cancer de cuello uterino",pildora: usuarias nuevas,2016-02-01,0,0,2,0,0,2
URIONDO (A. CONCEPCION),"anticoncepcion, prevencion de its y de cancer de cuello uterino",pildora: usuarias nuevas,2016-02-01,0,0,2,0,0,2
URUBICHA,"anticoncepcion, prevencion de its y de cancer de cuello uterino",pildora: usuarias nuevas,2016-02-01,0,0,2,0,0,2
UYUNI,"anticoncepcion, prevencion de its y de cancer de cuello uterino",pildora: usuarias nuevas,2016-02-01,0,2,3,0,0,5
VALLEGRANDE,"anticoncepcion, prevencion de its y de cancer de cuello uterino",pildora: usuarias nuevas,2016-02-01,0,1,0,1,0,2
VIACHA,"anticoncepcion, prevencion de its y de cancer de cuello uterino",pildora: usuarias nuevas,2016-02-01,0,0,2,5,0,7
VILA VILA,"anticoncepcion, prevencion de its y de cancer de cuello uterino",pildora: usuarias nuevas,2016-02-01,0,1,0,0,0,1
VILLA CHARCAS,"anticoncepcion, prevencion de its y de cancer de cuello uterino",pildora: usuarias nuevas,2016-02-01,0,2,4,0,0,6
VILLA MONTES,"anticoncepcion, prevencion de its y de cancer de cuello uterino",pildora: usuarias nuevas,2016-02-01,0,0,3,1,0,4
VILLA NUEVA (LOMA ALTA),"anticoncepcion, prevencion de its y de cancer de cuello uterino",pildora: usuarias nuevas,2016-02-01,1,0,0,0,0,1
VILLA SERRANO,"anticoncepcion, prevencion de its y de cancer de cuello uterino",pildora: usuarias nuevas,2016-02-01,0,1,13,1,0,15
VILLA TUNARI,"anticoncepcion, prevencion de its y de cancer de cuello uterino",pildora: usuarias nuevas,2016-02-01,0,6,17,3,0,26
VILLA VACA GUZMAN (MUYUPAMPA),"anticoncepcion, prevencion de its y de cancer de cuello uterino",pildora: usuarias nuevas,2016-02-01,0,0,1,0,0,1
VILLAZON,"anticoncepcion, prevencion de its y de cancer de cuello uterino",pildora: usuarias nuevas,2016-02-01,0,1,2,0,0,3
VINTO,"anticoncepcion, prevencion de its y de cancer de cuello uterino",pildora: usuarias nuevas,2016-02-01,0,2,17,1,0,20
WARNES,"anticoncepcion, prevencion de its y de cancer de cuello uterino",pildora: usuarias nuevas,2016-02-01,0,7,14,8,0,29
YACO,"anticoncepcion, prevencion de its y de cancer de cuello uterino",pildora: usuarias nuevas,2016-02-01,0,0,1,0,0,1
YACUIBA,"anticoncepcion, prevencion de its y de cancer de cuello uterino",pildora: usuarias nuevas,2016-02-01,0,0,6,2,0,8
YANACACHI,"anticoncepcion, prevencion de its y de cancer de cuello uterino",pildora: usuarias nuevas,2016-02-01,0,0,1,0,0,1
YAPACANI,"anticoncepcion, prevencion de its y de cancer de cuello uterino",pildora: usuarias nuevas,2016-02-01,0,4,11,0,0,15
YOCALLA,"anticoncepcion, prevencion de its y de cancer de cuello uterino",pildora: usuarias nuevas,2016-02-01,0,0,1,0,0,1
YUNCHARA,"anticoncepcion, prevencion de its y de cancer de cuello uterino",pildora: usuarias nuevas,2016-02-01,0,0,0,1,0,1
ZUDAÑEZ,"anticoncepcion, prevencion de its y de cancer de cuello uterino",pildora: usuarias nuevas,2016-02-01,0,1,2,0,0,3
ACHACACHI,"anticoncepcion, prevencion de its y de cancer de cuello uterino",pildora: usuarias nuevas,2016-03-01,0,0,2,1,0,3
ACHOCALLA,"anticoncepcion, prevencion de its y de cancer de cuello uterino",pildora: usuarias nuevas,2016-03-01,0,0,4,0,0,4
AIQUILE,"anticoncepcion, prevencion de its y de cancer de cuello uterino",pildora: usuarias nuevas,2016-03-01,0,1,2,0,0,3
ALTO BENI,"anticoncepcion, prevencion de its y de cancer de cuello uterino",pildora: usuarias nuevas,2016-03-01,0,0,2,1,0,3
ANCORAIMES,"anticoncepcion, prevencion de its y de cancer de cuello uterino",pildora: usuarias nuevas,2016-03-01,0,0,1,0,0,1
ANDAMARCA,"anticoncepcion, prevencion de its y de cancer de cuello uterino",pildora: usuarias nuevas,2016-03-01,0,0,2,0,0,2
APOLO,"anticoncepcion, prevencion de its y de cancer de cuello uterino",pildora: usuarias nuevas,2016-03-01,0,0,2,0,0,2
ARANI,"anticoncepcion, prevencion de its y de cancer de cuello uterino",pildora: usuarias nuevas,2016-03-01,0,0,1,0,0,1
ARBIETO,"anticoncepcion, prevencion de its y de cancer de cuello uterino",pildora: usuarias nuevas,2016-03-01,0,5,5,3,0,13
ARQUE,"anticoncepcion, prevencion de its y de cancer de cuello uterino",pildora: usuarias nuevas,2016-03-01,0,0,0,1,0,1
ASCENCION DE GUARAYOS,"anticoncepcion, prevencion de its y de cancer de cuello uterino",pildora: usuarias nuevas,2016-03-01,0,2,9,5,0,16
ATOCHA,"anticoncepcion, prevencion de its y de cancer de cuello uterino",pildora: usuarias nuevas,2016-03-01,0,1,2,2,0,5
AUCAPATA,"anticoncepcion, prevencion de its y de cancer de cuello uterino",pildora: usuarias nuevas,2016-03-01,0,0,0,1,0,1
AYATA,"anticoncepcion, prevencion de its y de cancer de cuello uterino",pildora: usuarias nuevas,2016-03-01,0,0,1,1,0,2
AYO AYO,"anticoncepcion, prevencion de its y de cancer de cuello uterino",pildora: usuarias nuevas,2016-03-01,0,0,4,0,0,4
AYOPAYA (V. DE INDEPENDENCIA),"anticoncepcion, prevencion de its y de cancer de cuello uterino",pildora: usuarias nuevas,2016-03-01,0,1,1,1,0,3
AZURDUY,"anticoncepcion, prevencion de its y de cancer de cuello uterino",pildora: usuarias nuevas,2016-03-01,0,1,1,1,0,3
BATALLAS,"anticoncepcion, prevencion de its y de cancer de cuello uterino",pildora: usuarias nuevas,2016-03-01,0,0,1,0,0,1
BERMEJO,"anticoncepcion, prevencion de its y de cancer de cuello uterino",pildora: usuarias nuevas,2016-03-01,0,2,12,5,0,19
BETANZOS,"anticoncepcion, prevencion de its y de cancer de cuello uterino",pildora: usuarias nuevas,2016-03-01,0,0,1,0,0,1
BOYUIBE,"anticoncepcion, prevencion de its y de cancer de cuello uterino",pildora: usuarias nuevas,2016-03-01,0,0,2,0,0,2
BUENA VISTA,"anticoncepcion, prevencion de its y de cancer de cuello uterino",pildora: usuarias nuevas,2016-03-01,0,1,7,1,0,9
CABEZAS,"anticoncepcion, prevencion de its y de cancer de cuello uterino",pildora: usuarias nuevas,2016-03-01,0,3,19,6,0,28
"CAIZA ""D""","anticoncepcion, prevencion de its y de cancer de cuello uterino",pildora: usuarias nuevas,2016-03-01,0,0,1,0,0,1
CALACOTO,"anticoncepcion, prevencion de its y de cancer de cuello uterino",pildora: usuarias nuevas,2016-03-01,0,0,1,0,0,1
CAMARGO,"anticoncepcion, prevencion de its y de cancer de cuello uterino",pildora: usuarias nuevas,2016-03-01,0,1,1,1,0,3
CAMIRI,"anticoncepcion, prevencion de its y de cancer de cuello uterino",pildora: usuarias nuevas,2016-03-01,0,0,3,1,0,4
CAPINOTA,"anticoncepcion, prevencion de its y de cancer de cuello uterino",pildora: usuarias nuevas,2016-03-01,0,1,6,1,0,8
CAQUIAVIRI,"anticoncepcion, prevencion de its y de cancer de cuello uterino",pildora: usuarias nuevas,2016-03-01,0,0,1,0,0,1
CARACOLLO,"anticoncepcion, prevencion de its y de cancer de cuello uterino",pildora: usuarias nuevas,2016-03-01,0,2,0,0,0,2
CARANAVI,"anticoncepcion, prevencion de its y de cancer de cuello uterino",pildora: usuarias nuevas,2016-03-01,0,0,1,0,0,1
CARAPARI,"anticoncepcion, prevencion de its y de cancer de cuello uterino",pildora: usuarias nuevas,2016-03-01,0,0,3,1,0,4
CARIPUYO,"anticoncepcion, prevencion de its y de cancer de cuello uterino",pildora: usuarias nuevas,2016-03-01,0,1,2,0,0,3
CARMEN RIVERO TORREZ,"anticoncepcion, prevencion de its y de cancer de cuello uterino",pildora: usuarias nuevas,2016-03-01,0,0,1,0,0,1
CHALLAPATA,"anticoncepcion, prevencion de its y de cancer de cuello uterino",pildora: usuarias nuevas,2016-03-01,0,0,1,1,0,2
CHARAGUA,"anticoncepcion, prevencion de its y de cancer de cuello uterino",pildora: usuarias nuevas,2016-03-01,0,2,7,3,0,12
CHAYANTA,"anticoncepcion, prevencion de its y de cancer de cuello uterino",pildora: usuarias nuevas,2016-03-01,0,1,2,1,0,4
CHIMORE,"anticoncepcion, prevencion de its y de cancer de cuello uterino",pildora: usuarias nuevas,2016-03-01,0,3,4,1,0,8
CHOQUE COTA,"anticoncepcion, prevencion de its y de cancer de cuello uterino",pildora: usuarias nuevas,2016-03-01,0,0,0,1,0,1
CHUA COCANI,"anticoncepcion, prevencion de its y de cancer de cuello uterino",pildora: usuarias nuevas,2016-03-01,0,0,1,0,0,1
CHULUMANI (V. DE LA LIBERTAD),"anticoncepcion, prevencion de its y de cancer de cuello uterino",pildora: usuarias nuevas,2016-03-01,0,0,0,1,0,1
CHUMA,"anticoncepcion, prevencion de its y de cancer de cuello uterino",pildora: usuarias nuevas,2016-03-01,0,0,1,0,0,1
CHUQUIHUTA AYLLU JUCUMANI,"anticoncepcion, prevencion de its y de cancer de cuello uterino",pildora: usuarias nuevas,2016-03-01,0,0,3,0,0,3
CLIZA,"anticoncepcion, prevencion de its y de cancer de cuello uterino",pildora: usuarias nuevas,2016-03-01,0,2,1,0,0,3
COBIJA,"anticoncepcion, prevencion de its y de cancer de cuello uterino",pildora: usuarias nuevas,2016-03-01,0,1,2,0,0,3
COCAPATA,"anticoncepcion, prevencion de its y de cancer de cuello uterino",pildora: usuarias nuevas,2016-03-01,0,2,6,5,0,13
COCHABAMBA,"anticoncepcion, prevencion de its y de cancer de cuello uterino",pildora: usuarias nuevas,2016-03-01,1,32,211,167,0,411
COLCAPIRHUA,"anticoncepcion, prevencion de its y de cancer de cuello uterino",pildora: usuarias nuevas,2016-03-01,0,2,6,1,0,9
"COLCHA ""K""","anticoncepcion, prevencion de its y de cancer de cuello uterino",pildora: usuarias nuevas,2016-03-01,0,0,2,0,0,2
COLLANA,"anticoncepcion, prevencion de its y de cancer de cuello uterino",pildora: usuarias nuevas,2016-03-01,0,2,0,0,0,2
COLOMI,"anticoncepcion, prevencion de its y de cancer de cuello uterino",pildora: usuarias nuevas,2016-03-01,0,0,4,0,0,4
COLPA BELGICA,"anticoncepcion, prevencion de its y de cancer de cuello uterino",pildora: usuarias nuevas,2016-03-01,0,2,4,2,0,8
COLQUECHACA,"anticoncepcion, prevencion de its y de cancer de cuello uterino",pildora: usuarias nuevas,2016-03-01,0,0,9,2,0,11
COLQUENCHA,"anticoncepcion, prevencion de its y de cancer de cuello uterino",pildora: usuarias nuevas,2016-03-01,0,0,1,0,0,1
COLQUIRI,"anticoncepcion, prevencion de its y de cancer de cuello uterino",pildora: usuarias nuevas,2016-03-01,0,0,7,1,0,8
COMARAPA,"anticoncepcion, prevencion de its y de cancer de cuello uterino",pildora: usuarias nuevas,2016-03-01,0,0,5,0,0,5
CONCEPCION,"anticoncepcion, prevencion de its y de cancer de cuello uterino",pildora: usuarias nuevas,2016-03-01,0,0,3,0,0,3
COPACABANA,"anticoncepcion, prevencion de its y de cancer de cuello uterino",pildora: usuarias nuevas,2016-03-01,0,0,2,1,0,3
CORIPATA,"anticoncepcion, prevencion de its y de cancer de cuello uterino",pildora: usuarias nuevas,2016-03-01,0,0,3,0,0,3
CORQUE,"anticoncepcion, prevencion de its y de cancer de cuello uterino",pildora: usuarias nuevas,2016-03-01,0,2,0,0,0,2
COTAGAITA,"anticoncepcion, prevencion de its y de cancer de cuello uterino",pildora: usuarias nuevas,2016-03-01,0,1,0,1,0,2
COTOCA,"anticoncepcion, prevencion de its y de cancer de cuello uterino",pildora: usuarias nuevas,2016-03-01,0,3,13,2,0,18
CUATRO CAÑADAS,"anticoncepcion, prevencion de its y de cancer de cuello uterino",pildora: usuarias nuevas,2016-03-01,0,3,10,2,0,15
CUEVO,"anticoncepcion, prevencion de its y de cancer de cuello uterino",pildora: usuarias nuevas,2016-03-01,0,1,1,1,0,3
CULPINA,"anticoncepcion, prevencion de its y de cancer de cuello uterino",pildora: usuarias nuevas,2016-03-01,0,0,1,0,0,1
CURAHUARA DE CARANGAS,"anticoncepcion, prevencion de its y de cancer de cuello uterino",pildora: usuarias nuevas,2016-03-01,0,0,0,1,0,1
CURVA,"anticoncepcion, prevencion de its y de cancer de cuello uterino",pildora: usuarias nuevas,2016-03-01,0,0,1,0,0,1
DESAGUADERO,"anticoncepcion, prevencion de its y de cancer de cuello uterino",pildora: usuarias nuevas,2016-03-01,0,1,2,0,0,3
EL ALTO,"anticoncepcion, prevencion de its y de cancer de cuello uterino",pildora: usuarias nuevas,2016-03-01,1,18,114,49,0,182
EL PUENTE(STC),"anticoncepcion, prevencion de its y de cancer de cuello uterino",pildora: usuarias nuevas,2016-03-01,0,2,5,3,0,10
EL PUENTE(TJA),"anticoncepcion, prevencion de its y de cancer de cuello uterino",pildora: usuarias nuevas,2016-03-01,0,0,3,0,0,3
EL TORNO,"anticoncepcion, prevencion de its y de cancer de cuello uterino",pildora: usuarias nuevas,2016-03-01,2,4,17,3,0,26
EL VILLAR,"anticoncepcion, prevencion de its y de cancer de cuello uterino",pildora: usuarias nuevas,2016-03-01,0,0,1,0,0,1
ENTRE RIOS TRJ,"anticoncepcion, prevencion de its y de cancer de cuello uterino",pildora: usuarias nuevas,2016-03-01,0,3,14,2,0,19
ENTRE RIOS CBBA,"anticoncepcion, prevencion de its y de cancer de cuello uterino",pildora: usuarias nuevas,2016-03-01,0,3,3,1,0,7
ESCARA,"anticoncepcion, prevencion de its y de cancer de cuello uterino",pildora: usuarias nuevas,2016-03-01,0,0,1,0,0,1
ESMERALDA,"anticoncepcion, prevencion de its y de cancer de cuello uterino",pildora: usuarias nuevas,2016-03-01,0,0,0,1,0,1
EUCALIPTUS,"anticoncepcion, prevencion de its y de cancer de cuello uterino",pildora: usuarias nuevas,2016-03-01,0,0,1,0,0,1
EXALTACION,"anticoncepcion, prevencion de its y de cancer de cuello uterino",pildora: usuarias nuevas,2016-03-01,0,1,1,0,0,2
FERNANDEZ ALONSO,"anticoncepcion, prevencion de its y de cancer de cuello uterino",pildora: usuarias nuevas,2016-03-01,0,0,9,2,0,11
FILADELFIA,"anticoncepcion, prevencion de its y de cancer de cuello uterino",pildora: usuarias nuevas,2016-03-01,0,0,0,1,0,1
GENERAL SAAVEDRA,"anticoncepcion, prevencion de its y de cancer de cuello uterino",pildora: usuarias nuevas,2016-03-01,0,1,3,1,0,5
GRAL. J.J. PEREZ (CHARAZANI),"anticoncepcion, prevencion de its y de cancer de cuello uterino",pildora: usuarias nuevas,2016-03-01,0,0,3,1,0,4
GUANAY,"anticoncepcion, prevencion de its y de cancer de cuello uterino",pildora: usuarias nuevas,2016-03-01,0,1,0,0,0,1
GUAQUI,"anticoncepcion, prevencion de its y de cancer de cuello uterino",pildora: usuarias nuevas,2016-03-01,0,0,2,0,0,2
GUAYARAMERIN,"anticoncepcion, prevencion de its y de cancer de cuello uterino",pildora: usuarias nuevas,2016-03-01,0,7,28,23,0,58
GUTIERREZ,"anticoncepcion, prevencion de its y de cancer de cuello uterino",pildora: usuarias nuevas,2016-03-01,0,0,3,0,0,3
HUACARETA,"anticoncepcion, prevencion de its y de cancer de cuello uterino",pildora: usuarias nuevas,2016-03-01,0,0,2,1,0,3
HUACAYA (VILLA DE HUACAYA),"anticoncepcion, prevencion de its y de cancer de cuello uterino",pildora: usuarias nuevas,2016-03-01,0,0,0,2,0,2
HUACHACALLA,"anticoncepcion, prevencion de its y de cancer de cuello uterino",pildora: usuarias nuevas,2016-03-01,0,0,1,2,0,3
HUANUNI,"anticoncepcion, prevencion de its y de cancer de cuello uterino",pildora: usuarias nuevas,2016-03-01,0,0,1,0,0,1
HUARACAJE,"anticoncepcion, prevencion de its y de cancer de cuello uterino",pildora: usuarias nuevas,2016-03-01,1,0,4,2,0,7
HUARINA,"anticoncepcion, prevencion de its y de cancer de cuello uterino",pildora: usuarias nuevas,2016-03-01,0,0,1,0,0,1
HUATAJATA,"anticoncepcion, prevencion de its y de cancer de cuello uterino",pildora: usuarias nuevas,2016-03-01,0,1,0,0,0,1
HUMANATA,"anticoncepcion, prevencion de its y de cancer de cuello uterino",pildora: usuarias nuevas,2016-03-01,0,0,0,1,0,1
ICHOCA,"anticoncepcion, prevencion de its y de cancer de cuello uterino",pildora: usuarias nuevas,2016-03-01,0,1,1,1,0,3
ICLA,"anticoncepcion, prevencion de its y de cancer de cuello uterino",pildora: usuarias nuevas,2016-03-01,0,0,5,0,0,5
INCAHUASI,"anticoncepcion, prevencion de its y de cancer de cuello uterino",pildora: usuarias nuevas,2016-03-01,0,1,2,0,0,3
INGAVI (HUMAITA),"anticoncepcion, prevencion de its y de cancer de cuello uterino",pildora: usuarias nuevas,2016-03-01,0,0,3,0,0,3
IRUPANA (VILLA DE LANZA),"anticoncepcion, prevencion de its y de cancer de cuello uterino",pildora: usuarias nuevas,2016-03-01,0,1,3,2,0,6
IXIAMAS,"anticoncepcion, prevencion de its y de cancer de cuello uterino",pildora: usuarias nuevas,2016-03-01,0,0,3,0,0,3
JESUS DE MACHACA,"anticoncepcion, prevencion de its y de cancer de cuello uterino",pildora: usuarias nuevas,2016-03-01,0,0,4,3,0,7
LA ASUNTA,"anticoncepcion, prevencion de its y de cancer de cuello uterino",pildora: usuarias nuevas,2016-03-01,0,0,8,2,0,10
LA GUARDIA,"anticoncepcion, prevencion de its y de cancer de cuello uterino",pildora: usuarias nuevas,2016-03-01,0,8,37,8,0,53
LA PAZ,"anticoncepcion, prevencion de its y de cancer de cuello uterino",pildora: usuarias nuevas,2016-03-01,0,14,169,126,2,311
LAGUNILLAS,"anticoncepcion, prevencion de its y de cancer de cuello uterino",pildora: usuarias nuevas,2016-03-01,1,0,2,0,0,3
LAJA,"anticoncepcion, prevencion de its y de cancer de cuello uterino",pildora: usuarias nuevas,2016-03-01,0,0,2,1,0,3
LAS CARRERAS,"anticoncepcion, prevencion de its y de cancer de cuello uterino",pildora: usuarias nuevas,2016-03-01,0,1,2,0,0,3
LLALLAGUA,"anticoncepcion, prevencion de its y de cancer de cuello uterino",pildora: usuarias nuevas,2016-03-01,0,1,11,2,0,14
LURIBAY,"anticoncepcion, prevencion de its y de cancer de cuello uterino",pildora: usuarias nuevas,2016-03-01,0,0,1,0,0,1
MACHARETI,"anticoncepcion, prevencion de its y de cancer de cuello uterino",pildora: usuarias nuevas,2016-03-01,0,2,1,1,1,5
MAGDALENA,"anticoncepcion, prevencion de its y de cancer de cuello uterino",pildora: usuarias nuevas,2016-03-01,0,2,6,0,0,8
MAIRANA,"anticoncepcion, prevencion de its y de cancer de cuello uterino",pildora: usuarias nuevas,2016-03-01,0,0,4,1,0,5
MAPIRI,"anticoncepcion, prevencion de its y de cancer de cuello uterino",pildora: usuarias nuevas,2016-03-01,0,0,1,0,0,1
MECAPACA,"anticoncepcion, prevencion de its y de cancer de cuello uterino",pildora: usuarias nuevas,2016-03-01,0,0,3,0,0,3
MINEROS,"anticoncepcion, prevencion de its y de cancer de cuello uterino",pildora: usuarias nuevas,2016-03-01,0,1,3,1,0,5
MIZQUE,"anticoncepcion, prevencion de its y de cancer de cuello uterino",pildora: usuarias nuevas,2016-03-01,1,2,8,4,0,15
MOCOMOCO,"anticoncepcion, prevencion de its y de cancer de cuello uterino",pildora: usuarias nuevas,2016-03-01,0,1,0,1,0,2
MOJOCOYA,"anticoncepcion, prevencion de its y de cancer de cuello uterino",pildora: usuarias nuevas,2016-03-01,0,0,1,1,0,2
MONTEAGUDO,"anticoncepcion, prevencion de its y de cancer de cuello uterino",pildora: usuarias nuevas,2016-03-01,0,0,8,1,0,9
MONTERO,"anticoncepcion, prevencion de its y de cancer de cuello uterino",pildora: usuarias nuevas,2016-03-01,0,11,31,4,0,46
MORO MORO,"anticoncepcion, prevencion de its y de cancer de cuello uterino",pildora: usuarias nuevas,2016-03-01,0,1,0,0,0,1
MOROCHATA,"anticoncepcion, prevencion de its y de cancer de cuello uterino",pildora: usuarias nuevas,2016-03-01,0,2,7,2,0,11
NACEBE (SANTA ROSA DEL ABUNA),"anticoncepcion, prevencion de its y de cancer de cuello uterino",pildora: usuarias nuevas,2016-03-01,0,1,0,0,0,1
OCURI,"anticoncepcion, prevencion de its y de cancer de cuello uterino",pildora: usuarias nuevas,2016-03-01,0,2,2,0,0,4
OKINAWA,"anticoncepcion, prevencion de its y de cancer de cuello uterino",pildora: usuarias nuevas,2016-03-01,1,2,2,1,0,6
OMEREQUE,"anticoncepcion, prevencion de its y de cancer de cuello uterino",pildora: usuarias nuevas,2016-03-01,0,0,2,0,0,2
ORURO,"anticoncepcion, prevencion de its y de cancer de cuello uterino",pildora: usuarias nuevas,2016-03-01,0,0,33,9,0,42
PADCAYA,"anticoncepcion, prevencion de its y de cancer de cuello uterino",pildora: usuarias nuevas,2016-03-01,1,1,3,3,0,8
PADILLA,"anticoncepcion, prevencion de its y de cancer de cuello uterino",pildora: usuarias nuevas,2016-03-01,0,1,6,2,0,9
PAILON,"anticoncepcion, prevencion de its y de cancer de cuello uterino",pildora: usuarias nuevas,2016-03-01,0,0,8,2,0,10
PALOS BLANCOS,"anticoncepcion, prevencion de its y de cancer de cuello uterino",pildora: usuarias nuevas,2016-03-01,0,1,7,3,0,11
PAMPA AULLAGAS,"anticoncepcion, prevencion de its y de cancer de cuello uterino",pildora: usuarias nuevas,2016-03-01,0,0,2,0,0,2
PELECHUCO,"anticoncepcion, prevencion de its y de cancer de cuello uterino",pildora: usuarias nuevas,2016-03-01,0,3,2,0,0,5
POCOATA,"anticoncepcion, prevencion de its y de cancer de cuello uterino",pildora: usuarias nuevas,2016-03-01,0,0,1,1,0,2
POCONA,"anticoncepcion, prevencion de its y de cancer de cuello uterino",pildora: usuarias nuevas,2016-03-01,0,1,5,1,0,7
POJO (CBBA),"anticoncepcion, prevencion de its y de cancer de cuello uterino",pildora: usuarias nuevas,2016-03-01,0,0,0,2,0,2
POOPO,"anticoncepcion, prevencion de its y de cancer de cuello uterino",pildora: usuarias nuevas,2016-03-01,0,0,1,0,0,1
PORCO,"anticoncepcion, prevencion de its y de cancer de cuello uterino",pildora: usuarias nuevas,2016-03-01,0,1,2,0,0,3
PORONGO,"anticoncepcion, prevencion de its y de cancer de cuello uterino",pildora: usuarias nuevas,2016-03-01,1,2,21,1,0,25
PORTACHUELO,"anticoncepcion, prevencion de its y de cancer de cuello uterino",pildora: usuarias nuevas,2016-03-01,0,1,1,0,0,2
POSTRER VALLE,"anticoncepcion, prevencion de its y de cancer de cuello uterino",pildora: usuarias nuevas,2016-03-01,0,0,1,0,0,1
POTOSI,"anticoncepcion, prevencion de its y de cancer de cuello uterino",pildora: usuarias nuevas,2016-03-01,0,4,47,7,0,58
PUCARANI,"anticoncepcion, prevencion de its y de cancer de cuello uterino",pildora: usuarias nuevas,2016-03-01,0,0,1,0,0,1
PUERTO ACOSTA,"anticoncepcion, prevencion de its y de cancer de cuello uterino",pildora: usuarias nuevas,2016-03-01,0,0,1,0,0,1
PUERTO CARABUCO,"anticoncepcion, prevencion de its y de cancer de cuello uterino",pildora: usuarias nuevas,2016-03-01,0,0,1,0,0,1
PUERTO GONZALO MORENO,"anticoncepcion, prevencion de its y de cancer de cuello uterino",pildora: usuarias nuevas,2016-03-01,0,2,5,0,0,7
PUERTO PEREZ,"anticoncepcion, prevencion de its y de cancer de cuello uterino",pildora: usuarias nuevas,2016-03-01,0,0,1,0,0,1
PUERTO QUIJARRO,"anticoncepcion, prevencion de its y de cancer de cuello uterino",pildora: usuarias nuevas,2016-03-01,0,0,2,0,0,2
PUERTO RICO,"anticoncepcion, prevencion de its y de cancer de cuello uterino",pildora: usuarias nuevas,2016-03-01,0,1,2,0,0,3
PUERTO SILES,"anticoncepcion, prevencion de its y de cancer de cuello uterino",pildora: usuarias nuevas,2016-03-01,0,1,2,0,0,3
PUERTO SUAREZ,"anticoncepcion, prevencion de its y de cancer de cuello uterino",pildora: usuarias nuevas,2016-03-01,0,0,3,0,0,3
PUERTO VILLARROEL,"anticoncepcion, prevencion de its y de cancer de cuello uterino",pildora: usuarias nuevas,2016-03-01,0,0,4,4,0,8
PUNATA,"anticoncepcion, prevencion de its y de cancer de cuello uterino",pildora: usuarias nuevas,2016-03-01,0,4,12,2,0,18
QUILLACOLLO,"anticoncepcion, prevencion de its y de cancer de cuello uterino",pildora: usuarias nuevas,2016-03-01,0,3,17,7,0,27
QUIME,"anticoncepcion, prevencion de its y de cancer de cuello uterino",pildora: usuarias nuevas,2016-03-01,0,0,1,0,0,1
QUIRUSILLAS,"anticoncepcion, prevencion de its y de cancer de cuello uterino",pildora: usuarias nuevas,2016-03-01,0,0,0,1,0,1
RAVELO,"anticoncepcion, prevencion de its y de cancer de cuello uterino",pildora: usuarias nuevas,2016-03-01,0,0,1,1,0,2
REYES,"anticoncepcion, prevencion de its y de cancer de cuello uterino",pildora: usuarias nuevas,2016-03-01,0,6,11,4,0,21
RIBERALTA,"anticoncepcion, prevencion de its y de cancer de cuello uterino",pildora: usuarias nuevas,2016-03-01,1,10,57,1,0,69
ROBORE,"anticoncepcion, prevencion de its y de cancer de cuello uterino",pildora: usuarias nuevas,2016-03-01,0,1,9,0,0,10
RURRENABAQUE,"anticoncepcion, prevencion de its y de cancer de cuello uterino",pildora: usuarias nuevas,2016-03-01,0,0,1,1,0,2
SABAYA,"anticoncepcion, prevencion de its y de cancer de cuello uterino",pildora: usuarias nuevas,2016-03-01,0,0,0,1,0,1
SACABA,"anticoncepcion, prevencion de its y de cancer de cuello uterino",pildora: usuarias nuevas,2016-03-01,0,0,13,3,0,16
SACABAMBA,"anticoncepcion, prevencion de its y de cancer de cuello uterino",pildora: usuarias nuevas,2016-03-01,0,0,1,0,0,1
SACACA,"anticoncepcion, prevencion de its y de cancer de cuello uterino",pildora: usuarias nuevas,2016-03-01,0,1,8,1,0,10
SAIPINA,"anticoncepcion, prevencion de its y de cancer de cuello uterino",pildora: usuarias nuevas,2016-03-01,0,0,2,0,0,2
SALINAS DE GARCI MENDOZA,"anticoncepcion, prevencion de its y de cancer de cuello uterino",pildora: usuarias nuevas,2016-03-01,0,1,6,3,0,10
SAMAIPATA,"anticoncepcion, prevencion de its y de cancer de cuello uterino",pildora: usuarias nuevas,2016-03-01,0,0,2,0,0,2
SAN AGUSTIN,"anticoncepcion, prevencion de its y de cancer de cuello uterino",pildora: usuarias nuevas,2016-03-01,0,0,2,0,0,2
SAN ANDRES,"anticoncepcion, prevencion de its y de cancer de cuello uterino",pildora: usuarias nuevas,2016-03-01,0,2,24,1,0,27
SAN ANTONIO DE LOMERIO,"anticoncepcion, prevencion de its y de cancer de cuello uterino",pildora: usuarias nuevas,2016-03-01,0,2,2,4,0,8
SAN BENITO,"anticoncepcion, prevencion de its y de cancer de cuello uterino",pildora: usuarias nuevas,2016-03-01,0,0,0,2,0,2
SAN BORJA,"anticoncepcion, prevencion de its y de cancer de cuello uterino",pildora: usuarias nuevas,2016-03-01,1,3,13,2,0,19
SAN BUENA VENTURA,"anticoncepcion, prevencion de its y de cancer de cuello uterino",pildora: usuarias nuevas,2016-03-01,0,1,0,0,0,1
SAN CARLOS,"anticoncepcion, prevencion de its y de cancer de cuello uterino",pildora: usuarias nuevas,2016-03-01,0,4,7,1,0,12
SAN IGNACIO,"anticoncepcion, prevencion de its y de cancer de cuello uterino",pildora: usuarias nuevas,2016-03-01,0,2,8,2,0,12
SAN IGNACIO DE VELASCO,"anticoncepcion, prevencion de its y de cancer de cuello uterino",pildora: usuarias nuevas,2016-03-01,0,0,8,1,0,9
SAN JAVIER(BNI),"anticoncepcion, prevencion de its y de cancer de cuello uterino",pildora: usuarias nuevas,2016-03-01,0,1,1,2,0,4
SAN JAVIER(STC),"anticoncepcion, prevencion de its y de cancer de cuello uterino",pildora: usuarias nuevas,2016-03-01,0,3,9,1,0,13
SAN JOSE DE CHIQUITOS,"anticoncepcion, prevencion de its y de cancer de cuello uterino",pildora: usuarias nuevas,2016-03-01,1,2,9,5,0,17
SAN JUAN DE YAPACANI,"anticoncepcion, prevencion de its y de cancer de cuello uterino",pildora: usuarias nuevas,2016-03-01,0,0,1,0,0,1
SAN JULIAN,"anticoncepcion, prevencion de its y de cancer de cuello uterino",pildora: usuarias nuevas,2016-03-01,0,1,9,5,0,15
SAN LORENZO(TJA),"anticoncepcion, prevencion de its y de cancer de cuello uterino",pildora: usuarias nuevas,2016-03-01,0,0,3,1,0,4
SAN LUCAS,"anticoncepcion, prevencion de its y de cancer de cuello uterino",pildora: usuarias nuevas,2016-03-01,0,0,9,4,0,13
SAN MATIAS,"anticoncepcion, prevencion de its y de cancer de cuello uterino",pildora: usuarias nuevas,2016-03-01,0,0,4,0,0,4
SAN PEDRO,"anticoncepcion, prevencion de its y de cancer de cuello uterino",pildora: usuarias nuevas,2016-03-01,0,3,14,6,0,23
SAN PEDRO DE BUENA VISTA,"anticoncepcion, prevencion de its y de cancer de cuello uterino",pildora: usuarias nuevas,2016-03-01,0,0,3,1,0,4
SAN PEDRO DE CURAHUARA,"anticoncepcion, prevencion de its y de cancer de cuello uterino",pildora: usuarias nuevas,2016-03-01,0,0,1,0,0,1
SAN RAFAEL,"anticoncepcion, prevencion de its y de cancer de cuello uterino",pildora: usuarias nuevas,2016-03-01,0,3,6,2,0,11
SAN RAMON BENI,"anticoncepcion, prevencion de its y de cancer de cuello uterino",pildora: usuarias nuevas,2016-03-01,0,0,1,0,0,1
SAN RAMON SCZ,"anticoncepcion, prevencion de its y de cancer de cuello uterino",pildora: usuarias nuevas,2016-03-01,0,2,4,2,0,8
SANTA ANA,"anticoncepcion, prevencion de its y de cancer de cuello uterino",pildora: usuarias nuevas,2016-03-01,1,5,19,6,0,31
SANTA CRUZ DE LA SIERRA,"anticoncepcion, prevencion de its y de cancer de cuello uterino",pildora: usuarias nuevas,2016-03-01,8,62,211,218,0,499
SANTA ROSA,"anticoncepcion, prevencion de its y de cancer de cuello uterino",pildora: usuarias nuevas,2016-03-01,0,0,2,0,0,2
SANTA ROSA DEL SARA,"anticoncepcion, prevencion de its y de cancer de cuello uterino",pildora: usuarias nuevas,2016-03-01,0,5,7,0,0,12
SANTIAGO DE HUARI,"anticoncepcion, prevencion de its y de cancer de cuello uterino",pildora: usuarias nuevas,2016-03-01,0,1,1,0,0,2
SANTIVAÑES,"anticoncepcion, prevencion de its y de cancer de cuello uterino",pildora: usuarias nuevas,2016-03-01,0,0,1,0,0,1
SANTUARIO DE QUILLACAS,"anticoncepcion, prevencion de its y de cancer de cuello uterino",pildora: usuarias nuevas,2016-03-01,0,0,3,0,0,3
SAPAHAQUI,"anticoncepcion, prevencion de its y de cancer de cuello uterino",pildora: usuarias nuevas,2016-03-01,0,0,1,0,0,1
SENA,"anticoncepcion, prevencion de its y de cancer de cuello uterino",pildora: usuarias nuevas,2016-03-01,0,1,8,1,0,10
SHINAOTA,"anticoncepcion, prevencion de its y de cancer de cuello uterino",pildora: usuarias nuevas,2016-03-01,0,1,1,0,0,2
SICA SICA (VILLA AROMA),"anticoncepcion, prevencion de its y de cancer de cuello uterino",pildora: usuarias nuevas,2016-03-01,0,0,4,0,0,4
SIPE SIPE,"anticoncepcion, prevencion de its y de cancer de cuello uterino",pildora: usuarias nuevas,2016-03-01,0,3,8,3,0,14
SOPACHUY,"anticoncepcion, prevencion de its y de cancer de cuello uterino",pildora: usuarias nuevas,2016-03-01,0,2,0,0,0,2
SORATA,"anticoncepcion, prevencion de its y de cancer de cuello uterino",pildora: usuarias nuevas,2016-03-01,0,0,2,1,0,3
SUCRE,"anticoncepcion, prevencion de its y de cancer de cuello uterino",pildora: usuarias nuevas,2016-03-01,1,15,61,13,0,90
TACACOMA,"anticoncepcion, prevencion de its y de cancer de cuello uterino",pildora: usuarias nuevas,2016-03-01,0,0,2,0,0,2
TAHUA,"anticoncepcion, prevencion de its y de cancer de cuello uterino",pildora: usuarias nuevas,2016-03-01,0,0,1,1,0,2
TAPACARI,"anticoncepcion, prevencion de its y de cancer de cuello uterino",pildora: usuarias nuevas,2016-03-01,0,0,9,1,0,10
TARABUCO,"anticoncepcion, prevencion de its y de cancer de cuello uterino",pildora: usuarias nuevas,2016-03-01,0,1,2,0,0,3
TARACO,"anticoncepcion, prevencion de its y de cancer de cuello uterino",pildora: usuarias nuevas,2016-03-01,0,0,1,0,0,1
TARATA,"anticoncepcion, prevencion de its y de cancer de cuello uterino",pildora: usuarias nuevas,2016-03-01,0,0,2,0,0,2
TARIJA,"anticoncepcion, prevencion de its y de cancer de cuello uterino",pildora: usuarias nuevas,2016-03-01,0,9,37,10,0,56
TARVITA,"anticoncepcion, prevencion de its y de cancer de cuello uterino",pildora: usuarias nuevas,2016-03-01,0,0,1,1,0,2
TEOPONTE,"anticoncepcion, prevencion de its y de cancer de cuello uterino",pildora: usuarias nuevas,2016-03-01,0,2,3,0,0,5
TIAWANACU,"anticoncepcion, prevencion de its y de cancer de cuello uterino",pildora: usuarias nuevas,2016-03-01,0,1,0,1,0,2
TIPUANI,"anticoncepcion, prevencion de its y de cancer de cuello uterino",pildora: usuarias nuevas,2016-03-01,0,0,1,0,0,1
TIQUIPAYA,"anticoncepcion, prevencion de its y de cancer de cuello uterino",pildora: usuarias nuevas,2016-03-01,0,0,4,1,0,5
TOLATA,"anticoncepcion, prevencion de its y de cancer de cuello uterino",pildora: usuarias nuevas,2016-03-01,0,0,1,0,0,1
TOMAVE,"anticoncepcion, prevencion de its y de cancer de cuello uterino",pildora: usuarias nuevas,2016-03-01,0,0,1,0,0,1
TOMINA,"anticoncepcion, prevencion de its y de cancer de cuello uterino",pildora: usuarias nuevas,2016-03-01,1,0,3,1,0,5
TORO TORO,"anticoncepcion, prevencion de its y de cancer de cuello uterino",pildora: usuarias nuevas,2016-03-01,0,1,3,0,0,4
TOTORA(CBBA),"anticoncepcion, prevencion de its y de cancer de cuello uterino",pildora: usuarias nuevas,2016-03-01,0,1,5,0,0,6
TOTORA(ORR),"anticoncepcion, prevencion de its y de cancer de cuello uterino",pildora: usuarias nuevas,2016-03-01,0,0,1,0,0,1
TRINIDAD,"anticoncepcion, prevencion de its y de cancer de cuello uterino",pildora: usuarias nuevas,2016-03-01,0,6,14,2,0,22
TUPIZA,"anticoncepcion, prevencion de its y de cancer de cuello uterino",pildora: usuarias nuevas,2016-03-01,0,1,9,1,0,11
UNCIA,"anticoncepcion, prevencion de its y de cancer de cuello uterino",pildora: usuarias nuevas,2016-03-01,0,0,4,1,0,5
URIONDO (A. CONCEPCION),"anticoncepcion, prevencion de its y de cancer de cuello uterino",pildora: usuarias nuevas,2016-03-01,0,0,4,1,0,5
URUBICHA,"anticoncepcion, prevencion de its y de cancer de cuello uterino",pildora: usuarias nuevas,2016-03-01,0,0,1,1,0,2
UYUNI,"anticoncepcion, prevencion de its y de cancer de cuello uterino",pildora: usuarias nuevas,2016-03-01,0,1,0,0,0,1
VALLEGRANDE,"anticoncepcion, prevencion de its y de cancer de cuello uterino",pildora: usuarias nuevas,2016-03-01,0,0,2,1,0,3
VIACHA,"anticoncepcion, prevencion de its y de cancer de cuello uterino",pildora: usuarias nuevas,2016-03-01,0,0,15,5,0,20
VILLA CHARCAS,"anticoncepcion, prevencion de its y de cancer de cuello uterino",pildora: usuarias nuevas,2016-03-01,0,0,4,1,0,5
VILLA MONTES,"anticoncepcion, prevencion de its y de cancer de cuello uterino",pildora: usuarias nuevas,2016-03-01,0,1,8,0,0,9
VILLA NUEVA (LOMA ALTA),"anticoncepcion, prevencion de its y de cancer de cuello uterino",pildora: usuarias nuevas,2016-03-01,0,0,2,0,0,2
VILLA RIVERO,"anticoncepcion, prevencion de its y de cancer de cuello uterino",pildora: usuarias nuevas,2016-03-01,0,0,0,1,0,1
VILLA SERRANO,"anticoncepcion, prevencion de its y de cancer de cuello uterino",pildora: usuarias nuevas,2016-03-01,0,0,2,1,0,3
VILLA TUNARI,"anticoncepcion, prevencion de its y de cancer de cuello uterino",pildora: usuarias nuevas,2016-03-01,0,4,20,5,0,29
VILLA VACA GUZMAN (MUYUPAMPA),"anticoncepcion, prevencion de its y de cancer de cuello uterino",pildora: usuarias nuevas,2016-03-01,0,0,2,0,0,2
VILLAZON,"anticoncepcion, prevencion de its y de cancer de cuello uterino",pildora: usuarias nuevas,2016-03-01,0,0,4,0,0,4
VINTO,"anticoncepcion, prevencion de its y de cancer de cuello uterino",pildora: usuarias nuevas,2016-03-01,0,0,17,12,0,29
VITICHI,"anticoncepcion, prevencion de its y de cancer de cuello uterino",pildora: usuarias nuevas,2016-03-01,0,0,2,0,0,2
WARNES,"anticoncepcion, prevencion de its y de cancer de cuello uterino",pildora: usuarias nuevas,2016-03-01,1,3,17,2,0,23
YACUIBA,"anticoncepcion, prevencion de its y de cancer de cuello uterino",pildora: usuarias nuevas,2016-03-01,0,1,7,1,0,9
YANACACHI,"anticoncepcion, prevencion de its y de cancer de cuello uterino",pildora: usuarias nuevas,2016-03-01,0,0,1,0,0,1
YAPACANI,"anticoncepcion, prevencion de its y de cancer de cuello uterino",pildora: usuarias nuevas,2016-03-01,0,8,16,1,0,25
YOCALLA,"anticoncepcion, prevencion de its y de cancer de cuello uterino",pildora: usuarias nuevas,2016-03-01,0,0,1,1,0,2
YOTALA,"anticoncepcion, prevencion de its y de cancer de cuello uterino",pildora: usuarias nuevas,2016-03-01,0,1,1,0,0,2
YUNCHARA,"anticoncepcion, prevencion de its y de cancer de cuello uterino",pildora: usuarias nuevas,2016-03-01,0,0,2,0,0,2
ACHACACHI,"anticoncepcion, prevencion de its y de cancer de cuello uterino",pildora: usuarias nuevas,2016-04-01,0,0,2,1,0,3
ACHOCALLA,"anticoncepcion, prevencion de its y de cancer de cuello uterino",pildora: usuarias nuevas,2016-04-01,0,0,4,0,0,4
AIQUILE,"anticoncepcion, prevencion de its y de cancer de cuello uterino",pildora: usuarias nuevas,2016-04-01,0,0,2,0,0,2
ALCALA,"anticoncepcion, prevencion de its y de cancer de cuello uterino",pildora: usuarias nuevas,2016-04-01,0,1,1,0,0,2
ALTO BENI,"anticoncepcion, prevencion de its y de cancer de cuello uterino",pildora: usuarias nuevas,2016-04-01,0,0,1,0,0,1
ANCORAIMES,"anticoncepcion, prevencion de its y de cancer de cuello uterino",pildora: usuarias nuevas,2016-04-01,0,0,1,0,0,1
ANDAMARCA,"anticoncepcion, prevencion de its y de cancer de cuello uterino",pildora: usuarias nuevas,2016-04-01,0,0,1,0,0,1
APOLO,"anticoncepcion, prevencion de its y de cancer de cuello uterino",pildora: usuarias nuevas,2016-04-01,0,1,0,0,0,1
ARANI,"anticoncepcion, prevencion de its y de cancer de cuello uterino",pildora: usuarias nuevas,2016-04-01,0,1,0,0,0,1
ARBIETO,"anticoncepcion, prevencion de its y de cancer de cuello uterino",pildora: usuarias nuevas,2016-04-01,0,0,2,1,0,3
ARQUE,"anticoncepcion, prevencion de its y de cancer de cuello uterino",pildora: usuarias nuevas,2016-04-01,0,0,1,0,0,1
ASCENCION DE GUARAYOS,"anticoncepcion, prevencion de its y de cancer de cuello uterino",pildora: usuarias nuevas,2016-04-01,0,2,7,2,0,11
ATOCHA,"anticoncepcion, prevencion de its y de cancer de cuello uterino",pildora: usuarias nuevas,2016-04-01,0,0,3,3,0,6
AUCAPATA,"anticoncepcion, prevencion de its y de cancer de cuello uterino",pildora: usuarias nuevas,2016-04-01,0,0,4,0,0,4
AYATA,"anticoncepcion, prevencion de its y de cancer de cuello uterino",pildora: usuarias nuevas,2016-04-01,0,0,1,0,0,1
AYO AYO,"anticoncepcion, prevencion de its y de cancer de cuello uterino",pildora: usuarias nuevas,2016-04-01,0,0,4,1,0,5
AYOPAYA (V. DE INDEPENDENCIA),"anticoncepcion, prevencion de its y de cancer de cuello uterino",pildora: usuarias nuevas,2016-04-01,0,1,4,2,0,7
AZURDUY,"anticoncepcion, prevencion de its y de cancer de cuello uterino",pildora: usuarias nuevas,2016-04-01,0,1,2,1,0,4
BATALLAS,"anticoncepcion, prevencion de its y de cancer de cuello uterino",pildora: usuarias nuevas,2016-04-01,0,1,1,1,0,3
BAURES,"anticoncepcion, prevencion de its y de cancer de cuello uterino",pildora: usuarias nuevas,2016-04-01,1,0,1,0,0,2
BELLA FLOR,"anticoncepcion, prevencion de its y de cancer de cuello uterino",pildora: usuarias nuevas,2016-04-01,1,1,3,0,0,5
BERMEJO,"anticoncepcion, prevencion de its y de cancer de cuello uterino",pildora: usuarias nuevas,2016-04-01,0,3,8,3,0,14
BETANZOS,"anticoncepcion, prevencion de its y de cancer de cuello uterino",pildora: usuarias nuevas,2016-04-01,0,0,1,1,0,2
BOYUIBE,"anticoncepcion, prevencion de its y de cancer de cuello uterino",pildora: usuarias nuevas,2016-04-01,0,0,0,1,0,1
BUENA VISTA,"anticoncepcion, prevencion de its y de cancer de cuello uterino",pildora: usuarias nuevas,2016-04-01,0,1,1,0,0,2
CABEZAS,"anticoncepcion, prevencion de its y de cancer de cuello uterino",pildora: usuarias nuevas,2016-04-01,1,5,9,3,0,18
"CAIZA ""D""","anticoncepcion, prevencion de its y de cancer de cuello uterino",pildora: usuarias nuevas,2016-04-01,1,0,0,0,0,1
CAJUATA,"anticoncepcion, prevencion de its y de cancer de cuello uterino",pildora: usuarias nuevas,2016-04-01,0,1,1,0,0,2
CALAMARCA,"anticoncepcion, prevencion de its y de cancer de cuello uterino",pildora: usuarias nuevas,2016-04-01,0,0,1,1,0,2
CAMARGO,"anticoncepcion, prevencion de its y de cancer de cuello uterino",pildora: usuarias nuevas,2016-04-01,0,0,2,0,0,2
CAMATAQUI (C. VILLA ABECIA),"anticoncepcion, prevencion de its y de cancer de cuello uterino",pildora: usuarias nuevas,2016-04-01,0,0,1,1,0,2
CAMIRI,"anticoncepcion, prevencion de its y de cancer de cuello uterino",pildora: usuarias nuevas,2016-04-01,0,12,0,12,0,24
CAPINOTA,"anticoncepcion, prevencion de its y de cancer de cuello uterino",pildora: usuarias nuevas,2016-04-01,0,0,8,1,0,9
CARANAVI,"anticoncepcion, prevencion de its y de cancer de cuello uterino",pildora: usuarias nuevas,2016-04-01,0,4,8,2,0,14
CARAPARI,"anticoncepcion, prevencion de its y de cancer de cuello uterino",pildora: usuarias nuevas,2016-04-01,0,2,7,1,0,10
CARIPUYO,"anticoncepcion, prevencion de its y de cancer de cuello uterino",pildora: usuarias nuevas,2016-04-01,0,1,1,1,0,3
CARMEN RIVERO TORREZ,"anticoncepcion, prevencion de its y de cancer de cuello uterino",pildora: usuarias nuevas,2016-04-01,0,0,1,0,0,1
CHARAGUA,"anticoncepcion, prevencion de its y de cancer de cuello uterino",pildora: usuarias nuevas,2016-04-01,0,1,5,5,0,11
CHARAÑA,"anticoncepcion, prevencion de its y de cancer de cuello uterino",pildora: usuarias nuevas,2016-04-01,0,0,1,0,0,1
CHAYANTA,"anticoncepcion, prevencion de its y de cancer de cuello uterino",pildora: usuarias nuevas,2016-04-01,0,0,3,0,0,3
CHIMORE,"anticoncepcion, prevencion de its y de cancer de cuello uterino",pildora: usuarias nuevas,2016-04-01,0,0,10,2,0,12
CHULUMANI (V. DE LA LIBERTAD),"anticoncepcion, prevencion de its y de cancer de cuello uterino",pildora: usuarias nuevas,2016-04-01,0,0,4,1,0,5
CHUMA,"anticoncepcion, prevencion de its y de cancer de cuello uterino",pildora: usuarias nuevas,2016-04-01,0,0,0,1,0,1
CHUQUIHUTA AYLLU JUCUMANI,"anticoncepcion, prevencion de its y de cancer de cuello uterino",pildora: usuarias nuevas,2016-04-01,0,0,2,0,1,3
CLIZA,"anticoncepcion, prevencion de its y de cancer de cuello uterino",pildora: usuarias nuevas,2016-04-01,0,0,1,0,0,1
COBIJA,"anticoncepcion, prevencion de its y de cancer de cuello uterino",pildora: usuarias nuevas,2016-04-01,0,0,3,0,0,3
COCAPATA,"anticoncepcion, prevencion de its y de cancer de cuello uterino",pildora: usuarias nuevas,2016-04-01,2,0,4,1,0,7
COCHABAMBA,"anticoncepcion, prevencion de its y de cancer de cuello uterino",pildora: usuarias nuevas,2016-04-01,0,14,186,13,0,213
COLCAPIRHUA,"anticoncepcion, prevencion de its y de cancer de cuello uterino",pildora: usuarias nuevas,2016-04-01,0,0,2,1,0,3
"COLCHA ""K""","anticoncepcion, prevencion de its y de cancer de cuello uterino",pildora: usuarias nuevas,2016-04-01,0,0,2,0,0,2
COLLANA,"anticoncepcion, prevencion de its y de cancer de cuello uterino",pildora: usuarias nuevas,2016-04-01,0,0,0,1,0,1
COLOMI,"anticoncepcion, prevencion de its y de cancer de cuello uterino",pildora: usuarias nuevas,2016-04-01,0,0,1,0,0,1
COLPA BELGICA,"anticoncepcion, prevencion de its y de cancer de cuello uterino",pildora: usuarias nuevas,2016-04-01,0,0,1,0,0,1
COLQUECHACA,"anticoncepcion, prevencion de its y de cancer de cuello uterino",pildora: usuarias nuevas,2016-04-01,0,1,4,2,0,7
COLQUENCHA,"anticoncepcion, prevencion de its y de cancer de cuello uterino",pildora: usuarias nuevas,2016-04-01,0,0,1,0,0,1
COLQUIRI,"anticoncepcion, prevencion de its y de cancer de cuello uterino",pildora: usuarias nuevas,2016-04-01,0,0,2,2,0,4
COMANCHE,"anticoncepcion, prevencion de its y de cancer de cuello uterino",pildora: usuarias nuevas,2016-04-01,0,1,0,0,0,1
COMARAPA,"anticoncepcion, prevencion de its y de cancer de cuello uterino",pildora: usuarias nuevas,2016-04-01,0,0,2,0,0,2
CONCEPCION,"anticoncepcion, prevencion de its y de cancer de cuello uterino",pildora: usuarias nuevas,2016-04-01,0,0,4,0,0,4
CORIPATA,"anticoncepcion, prevencion de its y de cancer de cuello uterino",pildora: usuarias nuevas,2016-04-01,0,0,1,0,0,1
CORQUE,"anticoncepcion, prevencion de its y de cancer de cuello uterino",pildora: usuarias nuevas,2016-04-01,0,0,0,1,0,1
COTAGAITA,"anticoncepcion, prevencion de its y de cancer de cuello uterino",pildora: usuarias nuevas,2016-04-01,0,0,3,1,0,4
COTOCA,"anticoncepcion, prevencion de its y de cancer de cuello uterino",pildora: usuarias nuevas,2016-04-01,0,3,17,3,0,23
CUATRO CAÑADAS,"anticoncepcion, prevencion de its y de cancer de cuello uterino",pildora: usuarias nuevas,2016-04-01,0,0,3,2,0,5
CUEVO,"anticoncepcion, prevencion de its y de cancer de cuello uterino",pildora: usuarias nuevas,2016-04-01,0,2,2,1,0,5
CULPINA,"anticoncepcion, prevencion de its y de cancer de cuello uterino",pildora: usuarias nuevas,2016-04-01,0,0,0,1,0,1
DESAGUADERO,"anticoncepcion, prevencion de its y de cancer de cuello uterino",pildora: usuarias nuevas,2016-04-01,0,0,2,0,0,2
EL ALTO,"anticoncepcion, prevencion de its y de cancer de cuello uterino",pildora: usuarias nuevas,2016-04-01,0,23,110,31,1,165
EL PUENTE(STC),"anticoncepcion, prevencion de its y de cancer de cuello uterino",pildora: usuarias nuevas,2016-04-01,0,4,0,1,0,5
EL PUENTE(TJA),"anticoncepcion, prevencion de its y de cancer de cuello uterino",pildora: usuarias nuevas,2016-04-01,0,1,2,0,0,3
EL TORNO,"anticoncepcion, prevencion de its y de cancer de cuello uterino",pildora: usuarias nuevas,2016-04-01,1,3,7,2,1,14
EL VILLAR,"anticoncepcion, prevencion de its y de cancer de cuello uterino",pildora: usuarias nuevas,2016-04-01,0,4,2,2,0,8
ENTRE RIOS TRJ,"anticoncepcion, prevencion de its y de cancer de cuello uterino",pildora: usuarias nuevas,2016-04-01,0,1,6,4,0,11
ENTRE RIOS CBBA,"anticoncepcion, prevencion de its y de cancer de cuello uterino",pildora: usuarias nuevas,2016-04-01,0,1,6,2,0,9
ESMERALDA,"anticoncepcion, prevencion de its y de cancer de cuello uterino",pildora: usuarias nuevas,2016-04-01,0,0,0,1,0,1
EUCALIPTUS,"anticoncepcion, prevencion de its y de cancer de cuello uterino",pildora: usuarias nuevas,2016-04-01,0,0,1,0,0,1
EUREKA (SANTOS MERCADO),"anticoncepcion, prevencion de its y de cancer de cuello uterino",pildora: usuarias nuevas,2016-04-01,0,0,2,1,0,3
EXALTACION,"anticoncepcion, prevencion de its y de cancer de cuello uterino",pildora: usuarias nuevas,2016-04-01,0,0,1,0,0,1
FERNANDEZ ALONSO,"anticoncepcion, prevencion de its y de cancer de cuello uterino",pildora: usuarias nuevas,2016-04-01,0,0,3,1,0,4
FILADELFIA,"anticoncepcion, prevencion de its y de cancer de cuello uterino",pildora: usuarias nuevas,2016-04-01,0,0,2,0,0,2
GENERAL SAAVEDRA,"anticoncepcion, prevencion de its y de cancer de cuello uterino",pildora: usuarias nuevas,2016-04-01,0,1,3,1,0,5
GRAL. J.J. PEREZ (CHARAZANI),"anticoncepcion, prevencion de its y de cancer de cuello uterino",pildora: usuarias nuevas,2016-04-01,0,0,1,0,0,1
GUANAY,"anticoncepcion, prevencion de its y de cancer de cuello uterino",pildora: usuarias nuevas,2016-04-01,0,1,1,0,0,2
GUAQUI,"anticoncepcion, prevencion de its y de cancer de cuello uterino",pildora: usuarias nuevas,2016-04-01,0,0,1,0,0,1
GUAYARAMERIN,"anticoncepcion, prevencion de its y de cancer de cuello uterino",pildora: usuarias nuevas,2016-04-01,0,6,24,8,0,38
HUACARETA,"anticoncepcion, prevencion de its y de cancer de cuello uterino",pildora: usuarias nuevas,2016-04-01,0,0,5,1,0,6
HUACAYA (VILLA DE HUACAYA),"anticoncepcion, prevencion de its y de cancer de cuello uterino",pildora: usuarias nuevas,2016-04-01,0,2,1,1,0,4
HUANUNI,"anticoncepcion, prevencion de its y de cancer de cuello uterino",pildora: usuarias nuevas,2016-04-01,0,1,4,1,0,6
HUARACAJE,"anticoncepcion, prevencion de its y de cancer de cuello uterino",pildora: usuarias nuevas,2016-04-01,0,0,3,0,0,3
HUARINA,"anticoncepcion, prevencion de its y de cancer de cuello uterino",pildora: usuarias nuevas,2016-04-01,0,0,1,0,0,1
HUAYLLAMARCA,"anticoncepcion, prevencion de its y de cancer de cuello uterino",pildora: usuarias nuevas,2016-04-01,0,0,1,0,0,1
HUMANATA,"anticoncepcion, prevencion de its y de cancer de cuello uterino",pildora: usuarias nuevas,2016-04-01,0,1,0,0,0,1
ICHOCA,"anticoncepcion, prevencion de its y de cancer de cuello uterino",pildora: usuarias nuevas,2016-04-01,0,0,1,0,0,1
ICLA,"anticoncepcion, prevencion de its y de cancer de cuello uterino",pildora: usuarias nuevas,2016-04-01,0,0,0,1,0,1
INCAHUASI,"anticoncepcion, prevencion de its y de cancer de cuello uterino",pildora: usuarias nuevas,2016-04-01,1,1,4,0,0,6
INQUISIVI,"anticoncepcion, prevencion de its y de cancer de cuello uterino",pildora: usuarias nuevas,2016-04-01,0,0,0,2,0,2
IRUPANA (VILLA DE LANZA),"anticoncepcion, prevencion de its y de cancer de cuello uterino",pildora: usuarias nuevas,2016-04-01,0,2,4,1,0,7
IXIAMAS,"anticoncepcion, prevencion de its y de cancer de cuello uterino",pildora: usuarias nuevas,2016-04-01,0,1,3,0,0,4
LA ASUNTA,"anticoncepcion, prevencion de its y de cancer de cuello uterino",pildora: usuarias nuevas,2016-04-01,0,2,2,2,0,6
LA GUARDIA,"anticoncepcion, prevencion de its y de cancer de cuello uterino",pildora: usuarias nuevas,2016-04-01,1,4,17,6,0,28
LA PAZ,"anticoncepcion, prevencion de its y de cancer de cuello uterino",pildora: usuarias nuevas,2016-04-01,0,19,144,55,1,219
LAGUNILLAS,"anticoncepcion, prevencion de its y de cancer de cuello uterino",pildora: usuarias nuevas,2016-04-01,0,0,1,0,0,1
LAJA,"anticoncepcion, prevencion de its y de cancer de cuello uterino",pildora: usuarias nuevas,2016-04-01,1,2,4,0,0,7
LAS CARRERAS,"anticoncepcion, prevencion de its y de cancer de cuello uterino",pildora: usuarias nuevas,2016-04-01,0,0,0,1,0,1
LLALLAGUA,"anticoncepcion, prevencion de its y de cancer de cuello uterino",pildora: usuarias nuevas,2016-04-01,0,0,17,1,0,18
LLICA,"anticoncepcion, prevencion de its y de cancer de cuello uterino",pildora: usuarias nuevas,2016-04-01,0,0,2,0,0,2
LORETO,"anticoncepcion, prevencion de its y de cancer de cuello uterino",pildora: usuarias nuevas,2016-04-01,0,2,4,0,0,6
LURIBAY,"anticoncepcion, prevencion de its y de cancer de cuello uterino",pildora: usuarias nuevas,2016-04-01,0,0,1,1,0,2
MACHACAMARCA,"anticoncepcion, prevencion de its y de cancer de cuello uterino",pildora: usuarias nuevas,2016-04-01,0,0,0,1,0,1
MACHARETI,"anticoncepcion, prevencion de its y de cancer de cuello uterino",pildora: usuarias nuevas,2016-04-01,0,4,8,1,0,13
MAGDALENA,"anticoncepcion, prevencion de its y de cancer de cuello uterino",pildora: usuarias nuevas,2016-04-01,0,2,3,0,0,5
MAIRANA,"anticoncepcion, prevencion de its y de cancer de cuello uterino",pildora: usuarias nuevas,2016-04-01,0,0,1,0,0,1
MAPIRI,"anticoncepcion, prevencion de its y de cancer de cuello uterino",pildora: usuarias nuevas,2016-04-01,0,0,1,0,0,1
MECAPACA,"anticoncepcion, prevencion de its y de cancer de cuello uterino",pildora: usuarias nuevas,2016-04-01,0,0,1,0,0,1
MINEROS,"anticoncepcion, prevencion de its y de cancer de cuello uterino",pildora: usuarias nuevas,2016-04-01,0,2,1,1,0,4
MIZQUE,"anticoncepcion, prevencion de its y de cancer de cuello uterino",pildora: usuarias nuevas,2016-04-01,0,2,4,1,0,7
MOJOCOYA,"anticoncepcion, prevencion de its y de cancer de cuello uterino",pildora: usuarias nuevas,2016-04-01,0,0,1,0,0,1
MONTEAGUDO,"anticoncepcion, prevencion de its y de cancer de cuello uterino",pildora: usuarias nuevas,2016-04-01,0,5,8,3,0,16
MONTERO,"anticoncepcion, prevencion de its y de cancer de cuello uterino",pildora: usuarias nuevas,2016-04-01,0,5,34,4,0,43
MOROCHATA,"anticoncepcion, prevencion de its y de cancer de cuello uterino",pildora: usuarias nuevas,2016-04-01,0,0,3,0,0,3
NUEVO MANOA (NUEVA ESPERANZA),"anticoncepcion, prevencion de its y de cancer de cuello uterino",pildora: usuarias nuevas,2016-04-01,0,0,5,0,0,5
OCURI,"anticoncepcion, prevencion de its y de cancer de cuello uterino",pildora: usuarias nuevas,2016-04-01,0,2,2,2,0,6
OKINAWA,"anticoncepcion, prevencion de its y de cancer de cuello uterino",pildora: usuarias nuevas,2016-04-01,0,0,1,0,0,1
ORURO,"anticoncepcion, prevencion de its y de cancer de cuello uterino",pildora: usuarias nuevas,2016-04-01,0,3,37,9,0,49
PADCAYA,"anticoncepcion, prevencion de its y de cancer de cuello uterino",pildora: usuarias nuevas,2016-04-01,0,3,3,1,0,7
PADILLA,"anticoncepcion, prevencion de its y de cancer de cuello uterino",pildora: usuarias nuevas,2016-04-01,0,0,7,2,0,9
PAILON,"anticoncepcion, prevencion de its y de cancer de cuello uterino",pildora: usuarias nuevas,2016-04-01,0,2,8,3,0,13
PALCA,"anticoncepcion, prevencion de its y de cancer de cuello uterino",pildora: usuarias nuevas,2016-04-01,0,2,2,0,0,4
PALOS BLANCOS,"anticoncepcion, prevencion de its y de cancer de cuello uterino",pildora: usuarias nuevas,2016-04-01,0,1,20,2,0,23
PAMPA GRANDE,"anticoncepcion, prevencion de its y de cancer de cuello uterino",pildora: usuarias nuevas,2016-04-01,0,0,1,0,0,1
PAPEL PAMPA,"anticoncepcion, prevencion de its y de cancer de cuello uterino",pildora: usuarias nuevas,2016-04-01,0,1,0,0,0,1
PASORAPA,"anticoncepcion, prevencion de its y de cancer de cuello uterino",pildora: usuarias nuevas,2016-04-01,0,0,1,0,0,1
PATACAMAYA,"anticoncepcion, prevencion de its y de cancer de cuello uterino",pildora: usuarias nuevas,2016-04-01,0,0,1,0,0,1
PELECHUCO,"anticoncepcion, prevencion de its y de cancer de cuello uterino",pildora: usuarias nuevas,2016-04-01,0,0,1,1,0,2
POCOATA,"anticoncepcion, prevencion de its y de cancer de cuello uterino",pildora: usuarias nuevas,2016-04-01,0,0,1,0,0,1
POCONA,"anticoncepcion, prevencion de its y de cancer de cuello uterino",pildora: usuarias nuevas,2016-04-01,0,0,2,0,0,2
POJO (CBBA),"anticoncepcion, prevencion de its y de cancer de cuello uterino",pildora: usuarias nuevas,2016-04-01,0,0,1,0,0,1
PORCO,"anticoncepcion, prevencion de its y de cancer de cuello uterino",pildora: usuarias nuevas,2016-04-01,0,0,1,0,0,1
POROMA,"anticoncepcion, prevencion de its y de cancer de cuello uterino",pildora: usuarias nuevas,2016-04-01,0,1,0,2,0,3
PORONGO,"anticoncepcion, prevencion de its y de cancer de cuello uterino",pildora: usuarias nuevas,2016-04-01,1,5,7,4,0,17
PORTACHUELO,"anticoncepcion, prevencion de its y de cancer de cuello uterino",pildora: usuarias nuevas,2016-04-01,0,0,2,0,0,2
PORVENIR,"anticoncepcion, prevencion de its y de cancer de cuello uterino",pildora: usuarias nuevas,2016-04-01,0,1,0,0,0,1
POSTRER VALLE,"anticoncepcion, prevencion de its y de cancer de cuello uterino",pildora: usuarias nuevas,2016-04-01,0,0,1,0,0,1
POTOSI,"anticoncepcion, prevencion de its y de cancer de cuello uterino",pildora: usuarias nuevas,2016-04-01,0,6,36,3,0,45
PRESTO,"anticoncepcion, prevencion de its y de cancer de cuello uterino",pildora: usuarias nuevas,2016-04-01,0,0,0,2,0,2
PUCARANI,"anticoncepcion, prevencion de its y de cancer de cuello uterino",pildora: usuarias nuevas,2016-04-01,0,0,1,0,0,1
PUERTO ACOSTA,"anticoncepcion, prevencion de its y de cancer de cuello uterino",pildora: usuarias nuevas,2016-04-01,0,0,1,0,0,1
PUERTO CARABUCO,"anticoncepcion, prevencion de its y de cancer de cuello uterino",pildora: usuarias nuevas,2016-04-01,0,0,2,0,0,2
PUERTO GONZALO MORENO,"anticoncepcion, prevencion de its y de cancer de cuello uterino",pildora: usuarias nuevas,2016-04-01,1,1,1,0,0,3
PUERTO QUIJARRO,"anticoncepcion, prevencion de its y de cancer de cuello uterino",pildora: usuarias nuevas,2016-04-01,0,0,2,0,0,2
PUERTO RICO,"anticoncepcion, prevencion de its y de cancer de cuello uterino",pildora: usuarias nuevas,2016-04-01,0,0,1,0,0,1
PUERTO SILES,"anticoncepcion, prevencion de its y de cancer de cuello uterino",pildora: usuarias nuevas,2016-04-01,0,0,1,1,0,2
PUERTO SUAREZ,"anticoncepcion, prevencion de its y de cancer de cuello uterino",pildora: usuarias nuevas,2016-04-01,0,0,0,1,0,1
PUERTO VILLARROEL,"anticoncepcion, prevencion de its y de cancer de cuello uterino",pildora: usuarias nuevas,2016-04-01,0,1,5,0,0,6
PUNA,"anticoncepcion, prevencion de its y de cancer de cuello uterino",pildora: usuarias nuevas,2016-04-01,0,0,0,1,0,1
PUNATA,"anticoncepcion, prevencion de its y de cancer de cuello uterino",pildora: usuarias nuevas,2016-04-01,0,1,4,2,0,7
QUILLACOLLO,"anticoncepcion, prevencion de its y de cancer de cuello uterino",pildora: usuarias nuevas,2016-04-01,0,14,32,0,0,46
QUIME,"anticoncepcion, prevencion de its y de cancer de cuello uterino",pildora: usuarias nuevas,2016-04-01,0,0,0,1,0,1
RAVELO,"anticoncepcion, prevencion de its y de cancer de cuello uterino",pildora: usuarias nuevas,2016-04-01,0,0,1,0,0,1
REYES,"anticoncepcion, prevencion de its y de cancer de cuello uterino",pildora: usuarias nuevas,2016-04-01,6,6,23,8,0,43
RIBERALTA,"anticoncepcion, prevencion de its y de cancer de cuello uterino",pildora: usuarias nuevas,2016-04-01,0,11,34,7,0,52
ROBORE,"anticoncepcion, prevencion de its y de cancer de cuello uterino",pildora: usuarias nuevas,2016-04-01,0,1,3,3,0,7
RURRENABAQUE,"anticoncepcion, prevencion de its y de cancer de cuello uterino",pildora: usuarias nuevas,2016-04-01,0,0,6,2,0,8
SABAYA,"anticoncepcion, prevencion de its y de cancer de cuello uterino",pildora: usuarias nuevas,2016-04-01,0,0,0,1,0,1
SACABA,"anticoncepcion, prevencion de its y de cancer de cuello uterino",pildora: usuarias nuevas,2016-04-01,0,1,9,6,0,16
SACABAMBA,"anticoncepcion, prevencion de its y de cancer de cuello uterino",pildora: usuarias nuevas,2016-04-01,0,0,1,0,0,1
SACACA,"anticoncepcion, prevencion de its y de cancer de cuello uterino",pildora: usuarias nuevas,2016-04-01,0,0,17,1,0,18
SAIPINA,"anticoncepcion, prevencion de its y de cancer de cuello uterino",pildora: usuarias nuevas,2016-04-01,0,0,2,0,0,2
SALINAS DE GARCI MENDOZA,"anticoncepcion, prevencion de its y de cancer de cuello uterino",pildora: usuarias nuevas,2016-04-01,0,1,0,0,0,1
SAN AGUSTIN,"anticoncepcion, prevencion de its y de cancer de cuello uterino",pildora: usuarias nuevas,2016-04-01,0,0,1,1,0,2
SAN ANDRES,"anticoncepcion, prevencion de its y de cancer de cuello uterino",pildora: usuarias nuevas,2016-04-01,0,3,1,1,0,5
SAN ANTONIO DE LOMERIO,"anticoncepcion, prevencion de its y de cancer de cuello uterino",pildora: usuarias nuevas,2016-04-01,0,0,4,2,0,6
SAN BORJA,"anticoncepcion, prevencion de its y de cancer de cuello uterino",pildora: usuarias nuevas,2016-04-01,1,8,6,0,0,15
SAN BUENA VENTURA,"anticoncepcion, prevencion de its y de cancer de cuello uterino",pildora: usuarias nuevas,2016-04-01,0,0,2,1,0,3
SAN CARLOS,"anticoncepcion, prevencion de its y de cancer de cuello uterino",pildora: usuarias nuevas,2016-04-01,1,1,8,3,0,13
SAN IGNACIO,"anticoncepcion, prevencion de its y de cancer de cuello uterino",pildora: usuarias nuevas,2016-04-01,1,1,11,5,0,18
SAN IGNACIO DE VELASCO,"anticoncepcion, prevencion de its y de cancer de cuello uterino",pildora: usuarias nuevas,2016-04-01,1,0,4,1,0,6
SAN JAVIER(BNI),"anticoncepcion, prevencion de its y de cancer de cuello uterino",pildora: usuarias nuevas,2016-04-01,0,0,3,0,0,3
SAN JAVIER(STC),"anticoncepcion, prevencion de its y de cancer de cuello uterino",pildora: usuarias nuevas,2016-04-01,0,1,4,0,0,5
SAN JOAQUIN,"anticoncepcion, prevencion de its y de cancer de cuello uterino",pildora: usuarias nuevas,2016-04-01,0,0,3,0,0,3
SAN JOSE DE CHIQUITOS,"anticoncepcion, prevencion de its y de cancer de cuello uterino",pildora: usuarias nuevas,2016-04-01,0,1,1,1,0,3
SAN JUAN DE YAPACANI,"anticoncepcion, prevencion de its y de cancer de cuello uterino",pildora: usuarias nuevas,2016-04-01,0,0,3,1,0,4
SAN JULIAN,"anticoncepcion, prevencion de its y de cancer de cuello uterino",pildora: usuarias nuevas,2016-04-01,0,1,16,4,0,21
SAN LORENZO(PND),"anticoncepcion, prevencion de its y de cancer de cuello uterino",pildora: usuarias nuevas,2016-04-01,0,0,3,2,0,5
SAN LORENZO(TJA),"anticoncepcion, prevencion de its y de cancer de cuello uterino",pildora: usuarias nuevas,2016-04-01,0,1,0,1,0,2
SAN LUCAS,"anticoncepcion, prevencion de its y de cancer de cuello uterino",pildora: usuarias nuevas,2016-04-01,0,1,1,1,0,3
SAN MATIAS,"anticoncepcion, prevencion de its y de cancer de cuello uterino",pildora: usuarias nuevas,2016-04-01,0,2,0,0,0,2
SAN MIGUEL DE VELASCO,"anticoncepcion, prevencion de its y de cancer de cuello uterino",pildora: usuarias nuevas,2016-04-01,0,0,1,0,0,1
SAN PABLO DE LIPEZ,"anticoncepcion, prevencion de its y de cancer de cuello uterino",pildora: usuarias nuevas,2016-04-01,0,0,1,0,0,1
SAN PEDRO,"anticoncepcion, prevencion de its y de cancer de cuello uterino",pildora: usuarias nuevas,2016-04-01,0,1,2,3,0,6
SAN PEDRO DE BUENA VISTA,"anticoncepcion, prevencion de its y de cancer de cuello uterino",pildora: usuarias nuevas,2016-04-01,0,3,2,3,0,8
SAN PEDRO DE QUEMES,"anticoncepcion, prevencion de its y de cancer de cuello uterino",pildora: usuarias nuevas,2016-04-01,0,0,1,0,0,1
SAN RAFAEL,"anticoncepcion, prevencion de its y de cancer de cuello uterino",pildora: usuarias nuevas,2016-04-01,0,2,7,3,0,12
SAN RAMON BENI,"anticoncepcion, prevencion de its y de cancer de cuello uterino",pildora: usuarias nuevas,2016-04-01,0,1,3,0,0,4
SAN RAMON SCZ,"anticoncepcion, prevencion de its y de cancer de cuello uterino",pildora: usuarias nuevas,2016-04-01,0,1,1,1,0,3
SANTA ANA,"anticoncepcion, prevencion de its y de cancer de cuello uterino",pildora: usuarias nuevas,2016-04-01,0,2,7,1,0,10
SANTA CRUZ DE LA SIERRA,"anticoncepcion, prevencion de its y de cancer de cuello uterino",pildora: usuarias nuevas,2016-04-01,1,56,238,51,0,346
SANTA ROSA,"anticoncepcion, prevencion de its y de cancer de cuello uterino",pildora: usuarias nuevas,2016-04-01,0,1,11,2,0,14
SANTA ROSA DEL SARA,"anticoncepcion, prevencion de its y de cancer de cuello uterino",pildora: usuarias nuevas,2016-04-01,0,11,10,2,0,23
SANTIAGO DE HUARI,"anticoncepcion, prevencion de its y de cancer de cuello uterino",pildora: usuarias nuevas,2016-04-01,0,0,4,0,0,4
SANTIAGO DE HUATA,"anticoncepcion, prevencion de its y de cancer de cuello uterino",pildora: usuarias nuevas,2016-04-01,0,0,1,0,0,1
SANTIVAÑES,"anticoncepcion, prevencion de its y de cancer de cuello uterino",pildora: usuarias nuevas,2016-04-01,0,1,2,0,0,3
SANTUARIO DE QUILLACAS,"anticoncepcion, prevencion de its y de cancer de cuello uterino",pildora: usuarias nuevas,2016-04-01,0,0,2,1,0,3
SAPAHAQUI,"anticoncepcion, prevencion de its y de cancer de cuello uterino",pildora: usuarias nuevas,2016-04-01,0,0,2,0,0,2
SICA SICA (VILLA AROMA),"anticoncepcion, prevencion de its y de cancer de cuello uterino",pildora: usuarias nuevas,2016-04-01,1,0,2,0,0,3
SICAYA,"anticoncepcion, prevencion de its y de cancer de cuello uterino",pildora: usuarias nuevas,2016-04-01,0,0,2,0,0,2
SIPE SIPE,"anticoncepcion, prevencion de its y de cancer de cuello uterino",pildora: usuarias nuevas,2016-04-01,0,1,10,1,0,12
SOPACHUY,"anticoncepcion, prevencion de its y de cancer de cuello uterino",pildora: usuarias nuevas,2016-04-01,0,1,3,1,0,5
SORATA,"anticoncepcion, prevencion de its y de cancer de cuello uterino",pildora: usuarias nuevas,2016-04-01,0,1,3,0,0,4
SUCRE,"anticoncepcion, prevencion de its y de cancer de cuello uterino",pildora: usuarias nuevas,2016-04-01,0,17,54,12,0,83
TACACOMA,"anticoncepcion, prevencion de its y de cancer de cuello uterino",pildora: usuarias nuevas,2016-04-01,0,0,1,0,0,1
TAHUA,"anticoncepcion, prevencion de its y de cancer de cuello uterino",pildora: usuarias nuevas,2016-04-01,0,0,1,0,0,1
TAPACARI,"anticoncepcion, prevencion de its y de cancer de cuello uterino",pildora: usuarias nuevas,2016-04-01,0,1,1,0,0,2
TARABUCO,"anticoncepcion, prevencion de its y de cancer de cuello uterino",pildora: usuarias nuevas,2016-04-01,0,0,2,0,0,2
TARATA,"anticoncepcion, prevencion de its y de cancer de cuello uterino",pildora: usuarias nuevas,2016-04-01,0,0,0,1,0,1
TARIJA,"anticoncepcion, prevencion de its y de cancer de cuello uterino",pildora: usuarias nuevas,2016-04-01,0,6,31,20,0,57
TARVITA,"anticoncepcion, prevencion de its y de cancer de cuello uterino",pildora: usuarias nuevas,2016-04-01,0,3,3,1,0,7
TEOPONTE,"anticoncepcion, prevencion de its y de cancer de cuello uterino",pildora: usuarias nuevas,2016-04-01,0,0,1,0,0,1
TIAWANACU,"anticoncepcion, prevencion de its y de cancer de cuello uterino",pildora: usuarias nuevas,2016-04-01,0,0,0,1,0,1
TIPUANI,"anticoncepcion, prevencion de its y de cancer de cuello uterino",pildora: usuarias nuevas,2016-04-01,0,0,2,0,0,2
TIQUIPAYA,"anticoncepcion, prevencion de its y de cancer de cuello uterino",pildora: usuarias nuevas,2016-04-01,0,0,12,2,0,14
TOCO,"anticoncepcion, prevencion de its y de cancer de cuello uterino",pildora: usuarias nuevas,2016-04-01,0,0,1,0,0,1
TOLATA,"anticoncepcion, prevencion de its y de cancer de cuello uterino",pildora: usuarias nuevas,2016-04-01,0,0,1,0,0,1
TOLEDO,"anticoncepcion, prevencion de its y de cancer de cuello uterino",pildora: usuarias nuevas,2016-04-01,0,0,1,0,0,1
TOMAVE,"anticoncepcion, prevencion de its y de cancer de cuello uterino",pildora: usuarias nuevas,2016-04-01,0,0,1,0,0,1
TOMINA,"anticoncepcion, prevencion de its y de cancer de cuello uterino",pildora: usuarias nuevas,2016-04-01,0,0,2,0,0,2
TORO TORO,"anticoncepcion, prevencion de its y de cancer de cuello uterino",pildora: usuarias nuevas,2016-04-01,0,0,0,1,0,1
TOTORA(CBBA),"anticoncepcion, prevencion de its y de cancer de cuello uterino",pildora: usuarias nuevas,2016-04-01,0,1,5,0,0,6
TOTORA(ORR),"anticoncepcion, prevencion de its y de cancer de cuello uterino",pildora: usuarias nuevas,2016-04-01,0,0,2,0,0,2
TRIGAL,"anticoncepcion, prevencion de its y de cancer de cuello uterino",pildora: usuarias nuevas,2016-04-01,0,0,1,0,0,1
TRINIDAD,"anticoncepcion, prevencion de its y de cancer de cuello uterino",pildora: usuarias nuevas,2016-04-01,0,2,10,1,0,13
TUPIZA,"anticoncepcion, prevencion de its y de cancer de cuello uterino",pildora: usuarias nuevas,2016-04-01,0,7,11,0,0,18
TURCO,"anticoncepcion, prevencion de its y de cancer de cuello uterino",pildora: usuarias nuevas,2016-04-01,0,0,1,0,0,1
UNCIA,"anticoncepcion, prevencion de its y de cancer de cuello uterino",pildora: usuarias nuevas,2016-04-01,0,0,8,0,0,8
URIONDO (A. CONCEPCION),"anticoncepcion, prevencion de its y de cancer de cuello uterino",pildora: usuarias nuevas,2016-04-01,0,1,3,1,0,5
URUBICHA,"anticoncepcion, prevencion de its y de cancer de cuello uterino",pildora: usuarias nuevas,2016-04-01,0,0,1,0,0,1
UYUNI,"anticoncepcion, prevencion de its y de cancer de cuello uterino",pildora: usuarias nuevas,2016-04-01,0,0,3,0,0,3
VACAS,"anticoncepcion, prevencion de its y de cancer de cuello uterino",pildora: usuarias nuevas,2016-04-01,0,0,0,1,0,1
VALLEGRANDE,"anticoncepcion, prevencion de its y de cancer de cuello uterino",pildora: usuarias nuevas,2016-04-01,0,2,3,4,0,9
VIACHA,"anticoncepcion, prevencion de its y de cancer de cuello uterino",pildora: usuarias nuevas,2016-04-01,0,0,7,1,0,8
VILA VILA,"anticoncepcion, prevencion de its y de cancer de cuello uterino",pildora: usuarias nuevas,2016-04-01,0,0,1,1,0,2
VILLA CHARCAS,"anticoncepcion, prevencion de its y de cancer de cuello uterino",pildora: usuarias nuevas,2016-04-01,0,1,0,1,0,2
VILLA MONTES,"anticoncepcion, prevencion de its y de cancer de cuello uterino",pildora: usuarias nuevas,2016-04-01,0,3,11,4,0,18
VILLA NUEVA (LOMA ALTA),"anticoncepcion, prevencion de its y de cancer de cuello uterino",pildora: usuarias nuevas,2016-04-01,0,0,0,3,0,3
VILLA TUNARI,"anticoncepcion, prevencion de its y de cancer de cuello uterino",pildora: usuarias nuevas,2016-04-01,0,6,35,9,0,50
VILLAZON,"anticoncepcion, prevencion de its y de cancer de cuello uterino",pildora: usuarias nuevas,2016-04-01,0,2,4,0,0,6
VINTO,"anticoncepcion, prevencion de its y de cancer de cuello uterino",pildora: usuarias nuevas,2016-04-01,0,0,6,0,0,6
WARNES,"anticoncepcion, prevencion de its y de cancer de cuello uterino",pildora: usuarias nuevas,2016-04-01,0,5,16,2,0,23
YACO,"anticoncepcion, prevencion de its y de cancer de cuello uterino",pildora: usuarias nuevas,2016-04-01,0,0,0,1,0,1
YACUIBA,"anticoncepcion, prevencion de its y de cancer de cuello uterino",pildora: usuarias nuevas,2016-04-01,0,1,3,1,0,5
YAMPARAEZ,"anticoncepcion, prevencion de its y de cancer de cuello uterino",pildora: usuarias nuevas,2016-04-01,0,0,1,0,0,1
YANACACHI,"anticoncepcion, prevencion de its y de cancer de cuello uterino",pildora: usuarias nuevas,2016-04-01,0,0,1,0,0,1
YAPACANI,"anticoncepcion, prevencion de its y de cancer de cuello uterino",pildora: usuarias nuevas,2016-04-01,0,6,13,3,0,22
YOCALLA,"anticoncepcion, prevencion de its y de cancer de cuello uterino",pildora: usuarias nuevas,2016-04-01,0,0,2,0,0,2
YOTALA,"anticoncepcion, prevencion de its y de cancer de cuello uterino",pildora: usuarias nuevas,2016-04-01,0,0,1,0,0,1
ACACIO,"anticoncepcion, prevencion de its y de cancer de cuello uterino",pildora: usuarias nuevas,2016-05-01,0,0,1,0,0,1
ACHACACHI,"anticoncepcion, prevencion de its y de cancer de cuello uterino",pildora: usuarias nuevas,2016-05-01,0,0,2,0,0,2
ACHOCALLA,"anticoncepcion, prevencion de its y de cancer de cuello uterino",pildora: usuarias nuevas,2016-05-01,0,0,7,0,0,7
AIQUILE,"anticoncepcion, prevencion de its y de cancer de cuello uterino",pildora: usuarias nuevas,2016-05-01,0,1,0,0,0,1
ALCALA,"anticoncepcion, prevencion de its y de cancer de cuello uterino",pildora: usuarias nuevas,2016-05-01,0,0,1,0,0,1
ALTO BENI,"anticoncepcion, prevencion de its y de cancer de cuello uterino",pildora: usuarias nuevas,2016-05-01,0,0,5,0,0,5
ANCORAIMES,"anticoncepcion, prevencion de its y de cancer de cuello uterino",pildora: usuarias nuevas,2016-05-01,0,0,2,0,0,2
APOLO,"anticoncepcion, prevencion de its y de cancer de cuello uterino",pildora: usuarias nuevas,2016-05-01,0,1,1,0,0,2
ARANI,"anticoncepcion, prevencion de its y de cancer de cuello uterino",pildora: usuarias nuevas,2016-05-01,0,1,2,0,0,3
ARBIETO,"anticoncepcion, prevencion de its y de cancer de cuello uterino",pildora: usuarias nuevas,2016-05-01,0,0,7,1,0,8
ARQUE,"anticoncepcion, prevencion de its y de cancer de cuello uterino",pildora: usuarias nuevas,2016-05-01,0,0,0,1,0,1
ASCENCION DE GUARAYOS,"anticoncepcion, prevencion de its y de cancer de cuello uterino",pildora: usuarias nuevas,2016-05-01,0,0,5,0,0,5
ATOCHA,"anticoncepcion, prevencion de its y de cancer de cuello uterino",pildora: usuarias nuevas,2016-05-01,0,1,4,2,0,7
AUCAPATA,"anticoncepcion, prevencion de its y de cancer de cuello uterino",pildora: usuarias nuevas,2016-05-01,0,1,0,0,0,1
AYATA,"anticoncepcion, prevencion de its y de cancer de cuello uterino",pildora: usuarias nuevas,2016-05-01,0,0,1,1,0,2
AYOPAYA (V. DE INDEPENDENCIA),"anticoncepcion, prevencion de its y de cancer de cuello uterino",pildora: usuarias nuevas,2016-05-01,0,1,9,1,0,11
AZURDUY,"anticoncepcion, prevencion de its y de cancer de cuello uterino",pildora: usuarias nuevas,2016-05-01,0,1,1,0,0,2
BATALLAS,"anticoncepcion, prevencion de its y de cancer de cuello uterino",pildora: usuarias nuevas,2016-05-01,0,2,1,0,0,3
BAURES,"anticoncepcion, prevencion de its y de cancer de cuello uterino",pildora: usuarias nuevas,2016-05-01,0,0,1,0,0,1
BELLA FLOR,"anticoncepcion, prevencion de its y de cancer de cuello uterino",pildora: usuarias nuevas,2016-05-01,0,0,1,0,0,1
BERMEJO,"anticoncepcion, prevencion de its y de cancer de cuello uterino",pildora: usuarias nuevas,2016-05-01,0,0,8,0,0,8
BETANZOS,"anticoncepcion, prevencion de its y de cancer de cuello uterino",pildora: usuarias nuevas,2016-05-01,0,0,1,0,0,1
BOLIVAR,"anticoncepcion, prevencion de its y de cancer de cuello uterino",pildora: usuarias nuevas,2016-05-01,0,0,1,0,0,1
BOYUIBE,"anticoncepcion, prevencion de its y de cancer de cuello uterino",pildora: usuarias nuevas,2016-05-01,0,0,2,0,0,2
BUENA VISTA,"anticoncepcion, prevencion de its y de cancer de cuello uterino",pildora: usuarias nuevas,2016-05-01,0,0,1,1,0,2
CABEZAS,"anticoncepcion, prevencion de its y de cancer de cuello uterino",pildora: usuarias nuevas,2016-05-01,0,6,10,0,0,16
CAIROMA,"anticoncepcion, prevencion de its y de cancer de cuello uterino",pildora: usuarias nuevas,2016-05-01,0,1,0,1,0,2
CAJUATA,"anticoncepcion, prevencion de its y de cancer de cuello uterino",pildora: usuarias nuevas,2016-05-01,0,0,2,0,0,2
CALAMARCA,"anticoncepcion, prevencion de its y de cancer de cuello uterino",pildora: usuarias nuevas,2016-05-01,0,1,3,0,0,4
CAMARGO,"anticoncepcion, prevencion de its y de cancer de cuello uterino",pildora: usuarias nuevas,2016-05-01,0,1,0,0,0,1
CAMIRI,"anticoncepcion, prevencion de its y de cancer de cuello uterino",pildora: usuarias nuevas,2016-05-01,0,0,2,0,0,2
CAPINOTA,"anticoncepcion, prevencion de its y de cancer de cuello uterino",pildora: usuarias nuevas,2016-05-01,0,1,2,2,0,5
CARACOLLO,"anticoncepcion, prevencion de its y de cancer de cuello uterino",pildora: usuarias nuevas,2016-05-01,0,0,3,0,0,3
CARANAVI,"anticoncepcion, prevencion de its y de cancer de cuello uterino",pildora: usuarias nuevas,2016-05-01,0,1,2,0,0,3
CARANGAS,"anticoncepcion, prevencion de its y de cancer de cuello uterino",pildora: usuarias nuevas,2016-05-01,0,0,1,1,0,2
CARAPARI,"anticoncepcion, prevencion de its y de cancer de cuello uterino",pildora: usuarias nuevas,2016-05-01,0,0,2,0,0,2
CARIPUYO,"anticoncepcion, prevencion de its y de cancer de cuello uterino",pildora: usuarias nuevas,2016-05-01,0,0,0,1,0,1
CARMEN RIVERO TORREZ,"anticoncepcion, prevencion de its y de cancer de cuello uterino",pildora: usuarias nuevas,2016-05-01,0,0,1,0,0,1
CHALLAPATA,"anticoncepcion, prevencion de its y de cancer de cuello uterino",pildora: usuarias nuevas,2016-05-01,0,2,2,0,0,4
CHARAGUA,"anticoncepcion, prevencion de its y de cancer de cuello uterino",pildora: usuarias nuevas,2016-05-01,0,0,4,5,0,9
CHAYANTA,"anticoncepcion, prevencion de its y de cancer de cuello uterino",pildora: usuarias nuevas,2016-05-01,0,0,8,0,0,8
CHIMORE,"anticoncepcion, prevencion de its y de cancer de cuello uterino",pildora: usuarias nuevas,2016-05-01,0,6,11,0,0,17
CHOQUE COTA,"anticoncepcion, prevencion de its y de cancer de cuello uterino",pildora: usuarias nuevas,2016-05-01,0,0,1,0,0,1
CHULUMANI (V. DE LA LIBERTAD),"anticoncepcion, prevencion de its y de cancer de cuello uterino",pildora: usuarias nuevas,2016-05-01,0,0,7,0,0,7
CHUMA,"anticoncepcion, prevencion de its y de cancer de cuello uterino",pildora: usuarias nuevas,2016-05-01,0,0,3,1,0,4
CHUQUIHUTA AYLLU JUCUMANI,"anticoncepcion, prevencion de its y de cancer de cuello uterino",pildora: usuarias nuevas,2016-05-01,0,0,1,0,0,1
CLIZA,"anticoncepcion, prevencion de its y de cancer de cuello uterino",pildora: usuarias nuevas,2016-05-01,0,0,2,0,0,2
COBIJA,"anticoncepcion, prevencion de its y de cancer de cuello uterino",pildora: usuarias nuevas,2016-05-01,0,1,2,0,0,3
COCAPATA,"anticoncepcion, prevencion de its y de cancer de cuello uterino",pildora: usuarias nuevas,2016-05-01,0,4,5,1,0,10
COCHABAMBA,"anticoncepcion, prevencion de its y de cancer de cuello uterino",pildora: usuarias nuevas,2016-05-01,0,12,115,85,2,214
COIPASA,"anticoncepcion, prevencion de its y de cancer de cuello uterino",pildora: usuarias nuevas,2016-05-01,0,0,2,0,0,2
COLCAPIRHUA,"anticoncepcion, prevencion de its y de cancer de cuello uterino",pildora: usuarias nuevas,2016-05-01,0,1,9,1,0,11
"COLCHA ""K""","anticoncepcion, prevencion de its y de cancer de cuello uterino",pildora: usuarias nuevas,2016-05-01,0,2,1,1,0,4
COLOMI,"anticoncepcion, prevencion de its y de cancer de cuello uterino",pildora: usuarias nuevas,2016-05-01,0,0,2,0,0,2
COLQUECHACA,"anticoncepcion, prevencion de its y de cancer de cuello uterino",pildora: usuarias nuevas,2016-05-01,0,1,1,0,0,2
COLQUENCHA,"anticoncepcion, prevencion de its y de cancer de cuello uterino",pildora: usuarias nuevas,2016-05-01,0,0,0,1,0,1
COLQUIRI,"anticoncepcion, prevencion de its y de cancer de cuello uterino",pildora: usuarias nuevas,2016-05-01,0,0,2,0,0,2
COMARAPA,"anticoncepcion, prevencion de its y de cancer de cuello uterino",pildora: usuarias nuevas,2016-05-01,0,1,4,1,0,6
CONCEPCION,"anticoncepcion, prevencion de its y de cancer de cuello uterino",pildora: usuarias nuevas,2016-05-01,0,0,0,1,0,1
CORIPATA,"anticoncepcion, prevencion de its y de cancer de cuello uterino",pildora: usuarias nuevas,2016-05-01,0,1,3,0,0,4
COTAGAITA,"anticoncepcion, prevencion de its y de cancer de cuello uterino",pildora: usuarias nuevas,2016-05-01,0,0,2,2,0,4
COTOCA,"anticoncepcion, prevencion de its y de cancer de cuello uterino",pildora: usuarias nuevas,2016-05-01,1,7,18,7,0,33
CUATRO CAÑADAS,"anticoncepcion, prevencion de its y de cancer de cuello uterino",pildora: usuarias nuevas,2016-05-01,0,0,1,0,0,1
CUEVO,"anticoncepcion, prevencion de its y de cancer de cuello uterino",pildora: usuarias nuevas,2016-05-01,0,1,0,0,0,1
CULPINA,"anticoncepcion, prevencion de its y de cancer de cuello uterino",pildora: usuarias nuevas,2016-05-01,0,0,3,1,0,4
CURAHUARA DE CARANGAS,"anticoncepcion, prevencion de its y de cancer de cuello uterino",pildora: usuarias nuevas,2016-05-01,0,0,1,0,0,1
CURVA,"anticoncepcion, prevencion de its y de cancer de cuello uterino",pildora: usuarias nuevas,2016-05-01,0,0,2,0,0,2
DESAGUADERO,"anticoncepcion, prevencion de its y de cancer de cuello uterino",pildora: usuarias nuevas,2016-05-01,0,0,0,1,0,1
EL ALTO,"anticoncepcion, prevencion de its y de cancer de cuello uterino",pildora: usuarias nuevas,2016-05-01,0,15,105,37,0,157
EL PUENTE(STC),"anticoncepcion, prevencion de its y de cancer de cuello uterino",pildora: usuarias nuevas,2016-05-01,0,1,3,0,0,4
EL PUENTE(TJA),"anticoncepcion, prevencion de its y de cancer de cuello uterino",pildora: usuarias nuevas,2016-05-01,0,0,3,1,0,4
EL TORNO,"anticoncepcion, prevencion de its y de cancer de cuello uterino",pildora: usuarias nuevas,2016-05-01,1,5,14,9,0,29
EL VILLAR,"anticoncepcion, prevencion de its y de cancer de cuello uterino",pildora: usuarias nuevas,2016-05-01,0,0,1,1,0,2
ENTRE RIOS TRJ,"anticoncepcion, prevencion de its y de cancer de cuello uterino",pildora: usuarias nuevas,2016-05-01,0,4,8,4,0,16
ENTRE RIOS CBBA,"anticoncepcion, prevencion de its y de cancer de cuello uterino",pildora: usuarias nuevas,2016-05-01,0,1,3,4,0,8
EUREKA (SANTOS MERCADO),"anticoncepcion, prevencion de its y de cancer de cuello uterino",pildora: usuarias nuevas,2016-05-01,0,3,0,0,0,3
EXALTACION,"anticoncepcion, prevencion de its y de cancer de cuello uterino",pildora: usuarias nuevas,2016-05-01,0,0,1,0,0,1
FERNANDEZ ALONSO,"anticoncepcion, prevencion de its y de cancer de cuello uterino",pildora: usuarias nuevas,2016-05-01,1,1,1,0,0,3
FILADELFIA,"anticoncepcion, prevencion de its y de cancer de cuello uterino",pildora: usuarias nuevas,2016-05-01,0,0,4,1,0,5
GENERAL SAAVEDRA,"anticoncepcion, prevencion de its y de cancer de cuello uterino",pildora: usuarias nuevas,2016-05-01,0,1,8,3,0,12
GRAL. J.J. PEREZ (CHARAZANI),"anticoncepcion, prevencion de its y de cancer de cuello uterino",pildora: usuarias nuevas,2016-05-01,0,0,1,0,0,1
GUANAY,"anticoncepcion, prevencion de its y de cancer de cuello uterino",pildora: usuarias nuevas,2016-05-01,0,0,0,1,0,1
GUAYARAMERIN,"anticoncepcion, prevencion de its y de cancer de cuello uterino",pildora: usuarias nuevas,2016-05-01,1,2,14,2,0,19
GUTIERREZ,"anticoncepcion, prevencion de its y de cancer de cuello uterino",pildora: usuarias nuevas,2016-05-01,0,0,1,0,0,1
HUACARETA,"anticoncepcion, prevencion de its y de cancer de cuello uterino",pildora: usuarias nuevas,2016-05-01,0,0,1,0,0,1
HUACAYA (VILLA DE HUACAYA),"anticoncepcion, prevencion de its y de cancer de cuello uterino",pildora: usuarias nuevas,2016-05-01,0,0,1,0,0,1
HUARACAJE,"anticoncepcion, prevencion de its y de cancer de cuello uterino",pildora: usuarias nuevas,2016-05-01,0,0,5,0,0,5
ICHOCA,"anticoncepcion, prevencion de its y de cancer de cuello uterino",pildora: usuarias nuevas,2016-05-01,0,0,1,0,0,1
ICLA,"anticoncepcion, prevencion de its y de cancer de cuello uterino",pildora: usuarias nuevas,2016-05-01,0,1,0,1,0,2
INCAHUASI,"anticoncepcion, prevencion de its y de cancer de cuello uterino",pildora: usuarias nuevas,2016-05-01,0,0,1,0,0,1
INGAVI (HUMAITA),"anticoncepcion, prevencion de its y de cancer de cuello uterino",pildora: usuarias nuevas,2016-05-01,0,0,1,0,0,1
INQUISIVI,"anticoncepcion, prevencion de its y de cancer de cuello uterino",pildora: usuarias nuevas,2016-05-01,0,3,3,1,0,7
IRUPANA (VILLA DE LANZA),"anticoncepcion, prevencion de its y de cancer de cuello uterino",pildora: usuarias nuevas,2016-05-01,0,0,6,3,0,9
IXIAMAS,"anticoncepcion, prevencion de its y de cancer de cuello uterino",pildora: usuarias nuevas,2016-05-01,0,1,2,0,0,3
JESUS DE MACHACA,"anticoncepcion, prevencion de its y de cancer de cuello uterino",pildora: usuarias nuevas,2016-05-01,0,0,1,0,0,1
LA ASUNTA,"anticoncepcion, prevencion de its y de cancer de cuello uterino",pildora: usuarias nuevas,2016-05-01,0,3,5,2,0,10
LA GUARDIA,"anticoncepcion, prevencion de its y de cancer de cuello uterino",pildora: usuarias nuevas,2016-05-01,1,14,32,6,0,53
LA PAZ,"anticoncepcion, prevencion de its y de cancer de cuello uterino",pildora: usuarias nuevas,2016-05-01,0,7,177,46,0,230
LAGUNILLAS,"anticoncepcion, prevencion de its y de cancer de cuello uterino",pildora: usuarias nuevas,2016-05-01,0,0,4,0,0,4
LAJA,"anticoncepcion, prevencion de its y de cancer de cuello uterino",pildora: usuarias nuevas,2016-05-01,0,0,2,0,0,2
LICOMA PAMPA,"anticoncepcion, prevencion de its y de cancer de cuello uterino",pildora: usuarias nuevas,2016-05-01,0,1,1,0,0,2
LLALLAGUA,"anticoncepcion, prevencion de its y de cancer de cuello uterino",pildora: usuarias nuevas,2016-05-01,0,0,6,3,0,9
LORETO,"anticoncepcion, prevencion de its y de cancer de cuello uterino",pildora: usuarias nuevas,2016-05-01,0,0,14,2,0,16
LURIBAY,"anticoncepcion, prevencion de its y de cancer de cuello uterino",pildora: usuarias nuevas,2016-05-01,0,0,0,2,0,2
MACHACAMARCA,"anticoncepcion, prevencion de its y de cancer de cuello uterino",pildora: usuarias nuevas,2016-05-01,0,0,0,1,0,1
MACHARETI,"anticoncepcion, prevencion de its y de cancer de cuello uterino",pildora: usuarias nuevas,2016-05-01,0,2,6,0,0,8
MAGDALENA,"anticoncepcion, prevencion de its y de cancer de cuello uterino",pildora: usuarias nuevas,2016-05-01,0,0,3,0,0,3
MAIRANA,"anticoncepcion, prevencion de its y de cancer de cuello uterino",pildora: usuarias nuevas,2016-05-01,1,0,2,1,0,4
MALLA,"anticoncepcion, prevencion de its y de cancer de cuello uterino",pildora: usuarias nuevas,2016-05-01,0,0,1,0,0,1
MAPIRI,"anticoncepcion, prevencion de its y de cancer de cuello uterino",pildora: usuarias nuevas,2016-05-01,0,0,1,0,0,1
MINEROS,"anticoncepcion, prevencion de its y de cancer de cuello uterino",pildora: usuarias nuevas,2016-05-01,0,1,5,0,0,6
MIZQUE,"anticoncepcion, prevencion de its y de cancer de cuello uterino",pildora: usuarias nuevas,2016-05-01,0,3,4,1,0,8
MOJOCOYA,"anticoncepcion, prevencion de its y de cancer de cuello uterino",pildora: usuarias nuevas,2016-05-01,0,1,1,0,0,2
MONTEAGUDO,"anticoncepcion, prevencion de its y de cancer de cuello uterino",pildora: usuarias nuevas,2016-05-01,0,3,8,2,0,13
MONTERO,"anticoncepcion, prevencion de its y de cancer de cuello uterino",pildora: usuarias nuevas,2016-05-01,1,16,33,14,0,64
MOROCHATA,"anticoncepcion, prevencion de its y de cancer de cuello uterino",pildora: usuarias nuevas,2016-05-01,0,0,0,2,0,2
NUEVO MANOA (NUEVA ESPERANZA),"anticoncepcion, prevencion de its y de cancer de cuello uterino",pildora: usuarias nuevas,2016-05-01,0,0,1,0,0,1
OCURI,"anticoncepcion, prevencion de its y de cancer de cuello uterino",pildora: usuarias nuevas,2016-05-01,0,1,12,3,0,16
OKINAWA,"anticoncepcion, prevencion de its y de cancer de cuello uterino",pildora: usuarias nuevas,2016-05-01,0,1,1,0,0,2
ORURO,"anticoncepcion, prevencion de its y de cancer de cuello uterino",pildora: usuarias nuevas,2016-05-01,0,2,38,11,0,51
PADCAYA,"anticoncepcion, prevencion de its y de cancer de cuello uterino",pildora: usuarias nuevas,2016-05-01,1,1,3,3,0,8
PADILLA,"anticoncepcion, prevencion de its y de cancer de cuello uterino",pildora: usuarias nuevas,2016-05-01,0,2,10,2,0,14
PAILON,"anticoncepcion, prevencion de its y de cancer de cuello uterino",pildora: usuarias nuevas,2016-05-01,0,2,11,1,0,14
PALOS BLANCOS,"anticoncepcion, prevencion de its y de cancer de cuello uterino",pildora: usuarias nuevas,2016-05-01,0,0,9,4,0,13
PAMPA GRANDE,"anticoncepcion, prevencion de its y de cancer de cuello uterino",pildora: usuarias nuevas,2016-05-01,0,1,1,0,0,2
PAPEL PAMPA,"anticoncepcion, prevencion de its y de cancer de cuello uterino",pildora: usuarias nuevas,2016-05-01,0,0,0,1,0,1
PASORAPA,"anticoncepcion, prevencion de its y de cancer de cuello uterino",pildora: usuarias nuevas,2016-05-01,0,0,2,0,0,2
PAZÑA,"anticoncepcion, prevencion de its y de cancer de cuello uterino",pildora: usuarias nuevas,2016-05-01,0,0,1,0,0,1
PELECHUCO,"anticoncepcion, prevencion de its y de cancer de cuello uterino",pildora: usuarias nuevas,2016-05-01,0,1,9,2,0,12
POCOATA,"anticoncepcion, prevencion de its y de cancer de cuello uterino",pildora: usuarias nuevas,2016-05-01,0,1,2,2,0,5
POCONA,"anticoncepcion, prevencion de its y de cancer de cuello uterino",pildora: usuarias nuevas,2016-05-01,0,1,1,0,0,2
POJO (CBBA),"anticoncepcion, prevencion de its y de cancer de cuello uterino",pildora: usuarias nuevas,2016-05-01,0,0,1,0,0,1
POOPO,"anticoncepcion, prevencion de its y de cancer de cuello uterino",pildora: usuarias nuevas,2016-05-01,0,1,1,0,0,2
POROMA,"anticoncepcion, prevencion de its y de cancer de cuello uterino",pildora: usuarias nuevas,2016-05-01,0,0,3,2,0,5
PORONGO,"anticoncepcion, prevencion de its y de cancer de cuello uterino",pildora: usuarias nuevas,2016-05-01,0,3,18,6,0,27
PORTACHUELO,"anticoncepcion, prevencion de its y de cancer de cuello uterino",pildora: usuarias nuevas,2016-05-01,0,3,3,1,0,7
PORVENIR,"anticoncepcion, prevencion de its y de cancer de cuello uterino",pildora: usuarias nuevas,2016-05-01,0,1,1,0,0,2
POSTRER VALLE,"anticoncepcion, prevencion de its y de cancer de cuello uterino",pildora: usuarias nuevas,2016-05-01,0,0,1,0,0,1
POTOSI,"anticoncepcion, prevencion de its y de cancer de cuello uterino",pildora: usuarias nuevas,2016-05-01,0,11,48,25,0,84
PRESTO,"anticoncepcion, prevencion de its y de cancer de cuello uterino",pildora: usuarias nuevas,2016-05-01,0,0,5,0,0,5
PUCARANI,"anticoncepcion, prevencion de its y de cancer de cuello uterino",pildora: usuarias nuevas,2016-05-01,0,1,0,1,0,2
PUERTO CARABUCO,"anticoncepcion, prevencion de its y de cancer de cuello uterino",pildora: usuarias nuevas,2016-05-01,0,0,1,1,0,2
PUERTO GONZALO MORENO,"anticoncepcion, prevencion de its y de cancer de cuello uterino",pildora: usuarias nuevas,2016-05-01,1,1,0,0,0,2
PUERTO QUIJARRO,"anticoncepcion, prevencion de its y de cancer de cuello uterino",pildora: usuarias nuevas,2016-05-01,0,0,3,1,0,4
PUERTO RICO,"anticoncepcion, prevencion de its y de cancer de cuello uterino",pildora: usuarias nuevas,2016-05-01,0,2,2,1,0,5
PUERTO SILES,"anticoncepcion, prevencion de its y de cancer de cuello uterino",pildora: usuarias nuevas,2016-05-01,0,2,1,0,0,3
PUERTO SUAREZ,"anticoncepcion, prevencion de its y de cancer de cuello uterino",pildora: usuarias nuevas,2016-05-01,0,1,3,0,0,4
PUERTO VILLARROEL,"anticoncepcion, prevencion de its y de cancer de cuello uterino",pildora: usuarias nuevas,2016-05-01,0,1,12,1,1,15
PUNA,"anticoncepcion, prevencion de its y de cancer de cuello uterino",pildora: usuarias nuevas,2016-05-01,0,0,2,1,0,3
PUNATA,"anticoncepcion, prevencion de its y de cancer de cuello uterino",pildora: usuarias nuevas,2016-05-01,0,4,3,0,0,7
QUILLACOLLO,"anticoncepcion, prevencion de its y de cancer de cuello uterino",pildora: usuarias nuevas,2016-05-01,0,2,24,4,0,30
QUIME,"anticoncepcion, prevencion de its y de cancer de cuello uterino",pildora: usuarias nuevas,2016-05-01,0,0,1,0,0,1
REYES,"anticoncepcion, prevencion de its y de cancer de cuello uterino",pildora: usuarias nuevas,2016-05-01,0,3,4,0,0,7
RIBERALTA,"anticoncepcion, prevencion de its y de cancer de cuello uterino",pildora: usuarias nuevas,2016-05-01,1,5,25,4,0,35
ROBORE,"anticoncepcion, prevencion de its y de cancer de cuello uterino",pildora: usuarias nuevas,2016-05-01,0,0,8,1,0,9
RURRENABAQUE,"anticoncepcion, prevencion de its y de cancer de cuello uterino",pildora: usuarias nuevas,2016-05-01,0,0,2,0,0,2
SACABA,"anticoncepcion, prevencion de its y de cancer de cuello uterino",pildora: usuarias nuevas,2016-05-01,0,4,15,2,0,21
SACABAMBA,"anticoncepcion, prevencion de its y de cancer de cuello uterino",pildora: usuarias nuevas,2016-05-01,0,0,1,0,0,1
SACACA,"anticoncepcion, prevencion de its y de cancer de cuello uterino",pildora: usuarias nuevas,2016-05-01,0,1,5,1,0,7
SALINAS DE GARCI MENDOZA,"anticoncepcion, prevencion de its y de cancer de cuello uterino",pildora: usuarias nuevas,2016-05-01,1,1,3,0,0,5
SAMAIPATA,"anticoncepcion, prevencion de its y de cancer de cuello uterino",pildora: usuarias nuevas,2016-05-01,0,0,1,0,0,1
SAN ANDRES,"anticoncepcion, prevencion de its y de cancer de cuello uterino",pildora: usuarias nuevas,2016-05-01,0,2,5,2,0,9
SAN ANTONIO DE LOMERIO,"anticoncepcion, prevencion de its y de cancer de cuello uterino",pildora: usuarias nuevas,2016-05-01,0,0,3,0,0,3
SAN BORJA,"anticoncepcion, prevencion de its y de cancer de cuello uterino",pildora: usuarias nuevas,2016-05-01,0,3,15,4,0,22
SAN BUENA VENTURA,"anticoncepcion, prevencion de its y de cancer de cuello uterino",pildora: usuarias nuevas,2016-05-01,0,0,2,0,0,2
SAN CARLOS,"anticoncepcion, prevencion de its y de cancer de cuello uterino",pildora: usuarias nuevas,2016-05-01,0,3,4,2,0,9
SAN IGNACIO,"anticoncepcion, prevencion de its y de cancer de cuello uterino",pildora: usuarias nuevas,2016-05-01,0,2,10,1,0,13
SAN IGNACIO DE VELASCO,"anticoncepcion, prevencion de its y de cancer de cuello uterino",pildora: usuarias nuevas,2016-05-01,0,2,6,3,0,11
SAN JAVIER(STC),"anticoncepcion, prevencion de its y de cancer de cuello uterino",pildora: usuarias nuevas,2016-05-01,1,2,1,0,0,4
SAN JOSE DE CHIQUITOS,"anticoncepcion, prevencion de its y de cancer de cuello uterino",pildora: usuarias nuevas,2016-05-01,0,2,5,2,0,9
SAN JUAN DE YAPACANI,"anticoncepcion, prevencion de its y de cancer de cuello uterino",pildora: usuarias nuevas,2016-05-01,0,2,3,0,0,5
SAN JULIAN,"anticoncepcion, prevencion de its y de cancer de cuello uterino",pildora: usuarias nuevas,2016-05-01,0,2,13,4,0,19
SAN LORENZO(TJA),"anticoncepcion, prevencion de its y de cancer de cuello uterino",pildora: usuarias nuevas,2016-05-01,0,2,4,0,0,6
SAN LUCAS,"anticoncepcion, prevencion de its y de cancer de cuello uterino",pildora: usuarias nuevas,2016-05-01,1,1,0,25,1,28
SAN MATIAS,"anticoncepcion, prevencion de its y de cancer de cuello uterino",pildora: usuarias nuevas,2016-05-01,0,0,3,0,0,3
SAN MIGUEL DE VELASCO,"anticoncepcion, prevencion de its y de cancer de cuello uterino",pildora: usuarias nuevas,2016-05-01,0,0,6,3,0,9
SAN PABLO DE LIPEZ,"anticoncepcion, prevencion de its y de cancer de cuello uterino",pildora: usuarias nuevas,2016-05-01,0,1,0,0,0,1
SAN PEDRO,"anticoncepcion, prevencion de its y de cancer de cuello uterino",pildora: usuarias nuevas,2016-05-01,0,2,4,2,0,8
SAN PEDRO DE CURAHUARA,"anticoncepcion, prevencion de its y de cancer de cuello uterino",pildora: usuarias nuevas,2016-05-01,0,0,0,1,0,1
SAN PEDRO DE TIQUINA,"anticoncepcion, prevencion de its y de cancer de cuello uterino",pildora: usuarias nuevas,2016-05-01,0,0,1,0,0,1
SAN RAFAEL,"anticoncepcion, prevencion de its y de cancer de cuello uterino",pildora: usuarias nuevas,2016-05-01,0,3,6,1,0,10
SAN RAMON BENI,"anticoncepcion, prevencion de its y de cancer de cuello uterino",pildora: usuarias nuevas,2016-05-01,0,1,0,1,0,2
SAN RAMON SCZ,"anticoncepcion, prevencion de its y de cancer de cuello uterino",pildora: usuarias nuevas,2016-05-01,0,1,1,0,0,2
SANTA ANA,"anticoncepcion, prevencion de its y de cancer de cuello uterino",pildora: usuarias nuevas,2016-05-01,1,16,17,7,0,41
SANTA CRUZ DE LA SIERRA,"anticoncepcion, prevencion de its y de cancer de cuello uterino",pildora: usuarias nuevas,2016-05-01,0,66,247,63,0,376
SANTA ROSA,"anticoncepcion, prevencion de its y de cancer de cuello uterino",pildora: usuarias nuevas,2016-05-01,0,4,8,3,0,15
SANTA ROSA DEL SARA,"anticoncepcion, prevencion de its y de cancer de cuello uterino",pildora: usuarias nuevas,2016-05-01,1,1,7,1,0,10
SANTIAGO DE HUATA,"anticoncepcion, prevencion de its y de cancer de cuello uterino",pildora: usuarias nuevas,2016-05-01,0,0,1,2,0,3
SANTIVAÑES,"anticoncepcion, prevencion de its y de cancer de cuello uterino",pildora: usuarias nuevas,2016-05-01,0,0,1,1,0,2
SANTUARIO DE QUILLACAS,"anticoncepcion, prevencion de its y de cancer de cuello uterino",pildora: usuarias nuevas,2016-05-01,0,0,13,0,0,13
SAPAHAQUI,"anticoncepcion, prevencion de its y de cancer de cuello uterino",pildora: usuarias nuevas,2016-05-01,0,0,2,1,0,3
SENA,"anticoncepcion, prevencion de its y de cancer de cuello uterino",pildora: usuarias nuevas,2016-05-01,0,1,2,2,0,5
SHINAOTA,"anticoncepcion, prevencion de its y de cancer de cuello uterino",pildora: usuarias nuevas,2016-05-01,0,1,1,1,0,3
SICA SICA (VILLA AROMA),"anticoncepcion, prevencion de its y de cancer de cuello uterino",pildora: usuarias nuevas,2016-05-01,0,0,2,0,0,2
SIPE SIPE,"anticoncepcion, prevencion de its y de cancer de cuello uterino",pildora: usuarias nuevas,2016-05-01,0,2,9,6,0,17
SOPACHUY,"anticoncepcion, prevencion de its y de cancer de cuello uterino",pildora: usuarias nuevas,2016-05-01,0,2,3,0,0,5
SORATA,"anticoncepcion, prevencion de its y de cancer de cuello uterino",pildora: usuarias nuevas,2016-05-01,0,0,3,1,0,4
SUCRE,"anticoncepcion, prevencion de its y de cancer de cuello uterino",pildora: usuarias nuevas,2016-05-01,0,11,71,10,0,92
TACACOMA,"anticoncepcion, prevencion de its y de cancer de cuello uterino",pildora: usuarias nuevas,2016-05-01,0,0,0,1,0,1
TAHUA,"anticoncepcion, prevencion de its y de cancer de cuello uterino",pildora: usuarias nuevas,2016-05-01,0,0,1,0,0,1
TAPACARI,"anticoncepcion, prevencion de its y de cancer de cuello uterino",pildora: usuarias nuevas,2016-05-01,0,0,0,1,0,1
TARATA,"anticoncepcion, prevencion de its y de cancer de cuello uterino",pildora: usuarias nuevas,2016-05-01,0,0,1,0,0,1
TARIJA,"anticoncepcion, prevencion de its y de cancer de cuello uterino",pildora: usuarias nuevas,2016-05-01,0,2,15,48,1,66
TARVITA,"anticoncepcion, prevencion de its y de cancer de cuello uterino",pildora: usuarias nuevas,2016-05-01,0,2,2,1,0,5
TEOPONTE,"anticoncepcion, prevencion de its y de cancer de cuello uterino",pildora: usuarias nuevas,2016-05-01,0,3,3,2,0,8
TIPUANI,"anticoncepcion, prevencion de its y de cancer de cuello uterino",pildora: usuarias nuevas,2016-05-01,0,1,0,0,0,1
TIQUIPAYA,"anticoncepcion, prevencion de its y de cancer de cuello uterino",pildora: usuarias nuevas,2016-05-01,0,1,16,1,0,18
TIRAQUE (CBBA),"anticoncepcion, prevencion de its y de cancer de cuello uterino",pildora: usuarias nuevas,2016-05-01,1,0,1,0,0,2
TOCO,"anticoncepcion, prevencion de its y de cancer de cuello uterino",pildora: usuarias nuevas,2016-05-01,0,0,1,0,0,1
TOLATA,"anticoncepcion, prevencion de its y de cancer de cuello uterino",pildora: usuarias nuevas,2016-05-01,0,1,1,0,0,2
TOMINA,"anticoncepcion, prevencion de its y de cancer de cuello uterino",pildora: usuarias nuevas,2016-05-01,0,1,1,1,0,3
TORO TORO,"anticoncepcion, prevencion de its y de cancer de cuello uterino",pildora: usuarias nuevas,2016-05-01,0,0,1,1,0,2
TOTORA(CBBA),"anticoncepcion, prevencion de its y de cancer de cuello uterino",pildora: usuarias nuevas,2016-05-01,0,1,5,1,0,7
TOTORA(ORR),"anticoncepcion, prevencion de its y de cancer de cuello uterino",pildora: usuarias nuevas,2016-05-01,0,1,0,0,0,1
TRINIDAD,"anticoncepcion, prevencion de its y de cancer de cuello uterino",pildora: usuarias nuevas,2016-05-01,0,7,21,5,0,33
TUPIZA,"anticoncepcion, prevencion de its y de cancer de cuello uterino",pildora: usuarias nuevas,2016-05-01,0,0,4,3,0,7
TURCO,"anticoncepcion, prevencion de its y de cancer de cuello uterino",pildora: usuarias nuevas,2016-05-01,0,0,0,1,0,1
UMALA,"anticoncepcion, prevencion de its y de cancer de cuello uterino",pildora: usuarias nuevas,2016-05-01,0,0,3,1,0,4
UNCIA,"anticoncepcion, prevencion de its y de cancer de cuello uterino",pildora: usuarias nuevas,2016-05-01,0,0,6,5,0,11
URIONDO (A. CONCEPCION),"anticoncepcion, prevencion de its y de cancer de cuello uterino",pildora: usuarias nuevas,2016-05-01,0,2,3,0,0,5
UYUNI,"anticoncepcion, prevencion de its y de cancer de cuello uterino",pildora: usuarias nuevas,2016-05-01,0,0,4,0,0,4
VACAS,"anticoncepcion, prevencion de its y de cancer de cuello uterino",pildora: usuarias nuevas,2016-05-01,0,0,1,0,0,1
VALLEGRANDE,"anticoncepcion, prevencion de its y de cancer de cuello uterino",pildora: usuarias nuevas,2016-05-01,0,0,1,0,0,1
VIACHA,"anticoncepcion, prevencion de its y de cancer de cuello uterino",pildora: usuarias nuevas,2016-05-01,0,2,27,13,0,42
VILLA CHARCAS,"anticoncepcion, prevencion de its y de cancer de cuello uterino",pildora: usuarias nuevas,2016-05-01,0,0,6,1,0,7
VILLA MONTES,"anticoncepcion, prevencion de its y de cancer de cuello uterino",pildora: usuarias nuevas,2016-05-01,0,4,8,1,0,13
VILLA RIVERO,"anticoncepcion, prevencion de its y de cancer de cuello uterino",pildora: usuarias nuevas,2016-05-01,0,0,0,2,0,2
VILLA SERRANO,"anticoncepcion, prevencion de its y de cancer de cuello uterino",pildora: usuarias nuevas,2016-05-01,0,2,5,1,0,8
VILLA TUNARI,"anticoncepcion, prevencion de its y de cancer de cuello uterino",pildora: usuarias nuevas,2016-05-01,21,24,24,5,0,74
VILLA VACA GUZMAN (MUYUPAMPA),"anticoncepcion, prevencion de its y de cancer de cuello uterino",pildora: usuarias nuevas,2016-05-01,0,0,1,1,0,2
VILLAZON,"anticoncepcion, prevencion de its y de cancer de cuello uterino",pildora: usuarias nuevas,2016-05-01,0,0,1,0,0,1
VINTO,"anticoncepcion, prevencion de its y de cancer de cuello uterino",pildora: usuarias nuevas,2016-05-01,0,0,7,0,0,7
VITICHI,"anticoncepcion, prevencion de its y de cancer de cuello uterino",pildora: usuarias nuevas,2016-05-01,0,0,1,0,0,1
WALDO BALLIVIAN,"anticoncepcion, prevencion de its y de cancer de cuello uterino",pildora: usuarias nuevas,2016-05-01,0,0,0,1,0,1
WARNES,"anticoncepcion, prevencion de its y de cancer de cuello uterino",pildora: usuarias nuevas,2016-05-01,0,6,16,6,0,28
YACUIBA,"anticoncepcion, prevencion de its y de cancer de cuello uterino",pildora: usuarias nuevas,2016-05-01,0,0,3,2,0,5
YAPACANI,"anticoncepcion, prevencion de its y de cancer de cuello uterino",pildora: usuarias nuevas,2016-05-01,0,3,18,1,0,22
YOCALLA,"anticoncepcion, prevencion de its y de cancer de cuello uterino",pildora: usuarias nuevas,2016-05-01,0,0,3,0,0,3
YOTALA,"anticoncepcion, prevencion de its y de cancer de cuello uterino",pildora: usuarias nuevas,2016-05-01,0,0,3,0,0,3
ZUDAÑEZ,"anticoncepcion, prevencion de its y de cancer de cuello uterino",pildora: usuarias nuevas,2016-05-01,0,1,2,0,0,3
ACACIO,"anticoncepcion, prevencion de its y de cancer de cuello uterino",pildora: usuarias nuevas,2016-06-01,0,0,0,1,0,1
ACHACACHI,"anticoncepcion, prevencion de its y de cancer de cuello uterino",pildora: usuarias nuevas,2016-06-01,0,1,0,1,0,2
ACHOCALLA,"anticoncepcion, prevencion de its y de cancer de cuello uterino",pildora: usuarias nuevas,2016-06-01,0,0,2,0,0,2
AIQUILE,"anticoncepcion, prevencion de its y de cancer de cuello uterino",pildora: usuarias nuevas,2016-06-01,0,1,1,0,0,2
ALTO BENI,"anticoncepcion, prevencion de its y de cancer de cuello uterino",pildora: usuarias nuevas,2016-06-01,1,0,3,0,0,4
ANCORAIMES,"anticoncepcion, prevencion de its y de cancer de cuello uterino",pildora: usuarias nuevas,2016-06-01,0,0,1,0,0,1
ANZALDO,"anticoncepcion, prevencion de its y de cancer de cuello uterino",pildora: usuarias nuevas,2016-06-01,0,0,1,0,0,1
ARANI,"anticoncepcion, prevencion de its y de cancer de cuello uterino",pildora: usuarias nuevas,2016-06-01,0,0,2,0,0,2
ARQUE,"anticoncepcion, prevencion de its y de cancer de cuello uterino",pildora: usuarias nuevas,2016-06-01,0,1,1,0,0,2
ASCENCION DE GUARAYOS,"anticoncepcion, prevencion de its y de cancer de cuello uterino",pildora: usuarias nuevas,2016-06-01,0,0,7,6,0,13
ATOCHA,"anticoncepcion, prevencion de its y de cancer de cuello uterino",pildora: usuarias nuevas,2016-06-01,0,0,2,3,0,5
AYATA,"anticoncepcion, prevencion de its y de cancer de cuello uterino",pildora: usuarias nuevas,2016-06-01,0,0,2,0,0,2
AYO AYO,"anticoncepcion, prevencion de its y de cancer de cuello uterino",pildora: usuarias nuevas,2016-06-01,0,0,0,1,0,1
AYOPAYA (V. DE INDEPENDENCIA),"anticoncepcion, prevencion de its y de cancer de cuello uterino",pildora: usuarias nuevas,2016-06-01,0,3,4,3,0,10
AZURDUY,"anticoncepcion, prevencion de its y de cancer de cuello uterino",pildora: usuarias nuevas,2016-06-01,0,0,1,3,0,4
BATALLAS,"anticoncepcion, prevencion de its y de cancer de cuello uterino",pildora: usuarias nuevas,2016-06-01,0,0,1,0,0,1
BELLA FLOR,"anticoncepcion, prevencion de its y de cancer de cuello uterino",pildora: usuarias nuevas,2016-06-01,0,1,0,0,0,1
BERMEJO,"anticoncepcion, prevencion de its y de cancer de cuello uterino",pildora: usuarias nuevas,2016-06-01,0,1,11,2,0,14
BETANZOS,"anticoncepcion, prevencion de its y de cancer de cuello uterino",pildora: usuarias nuevas,2016-06-01,0,2,1,1,0,4
BUENA VISTA,"anticoncepcion, prevencion de its y de cancer de cuello uterino",pildora: usuarias nuevas,2016-06-01,0,2,6,1,0,9
CABEZAS,"anticoncepcion, prevencion de its y de cancer de cuello uterino",pildora: usuarias nuevas,2016-06-01,0,2,11,0,0,13
CAIROMA,"anticoncepcion, prevencion de its y de cancer de cuello uterino",pildora: usuarias nuevas,2016-06-01,0,2,0,0,0,2
"CAIZA ""D""","anticoncepcion, prevencion de its y de cancer de cuello uterino",pildora: usuarias nuevas,2016-06-01,0,1,0,0,0,1
CALACOTO,"anticoncepcion, prevencion de its y de cancer de cuello uterino",pildora: usuarias nuevas,2016-06-01,0,1,0,1,0,2
CALAMARCA,"anticoncepcion, prevencion de its y de cancer de cuello uterino",pildora: usuarias nuevas,2016-06-01,0,0,2,0,0,2
CAMARGO,"anticoncepcion, prevencion de its y de cancer de cuello uterino",pildora: usuarias nuevas,2016-06-01,0,0,5,2,0,7
CAMIRI,"anticoncepcion, prevencion de its y de cancer de cuello uterino",pildora: usuarias nuevas,2016-06-01,0,1,6,0,1,8
CAPINOTA,"anticoncepcion, prevencion de its y de cancer de cuello uterino",pildora: usuarias nuevas,2016-06-01,0,0,3,1,0,4
CARACOLLO,"anticoncepcion, prevencion de its y de cancer de cuello uterino",pildora: usuarias nuevas,2016-06-01,0,0,1,2,0,3
CARANAVI,"anticoncepcion, prevencion de its y de cancer de cuello uterino",pildora: usuarias nuevas,2016-06-01,0,0,5,0,0,5
CARAPARI,"anticoncepcion, prevencion de its y de cancer de cuello uterino",pildora: usuarias nuevas,2016-06-01,1,21,11,92,0,125
CARIPUYO,"anticoncepcion, prevencion de its y de cancer de cuello uterino",pildora: usuarias nuevas,2016-06-01,0,0,0,1,0,1
CARMEN RIVERO TORREZ,"anticoncepcion, prevencion de its y de cancer de cuello uterino",pildora: usuarias nuevas,2016-06-01,0,0,3,0,0,3
CHALLAPATA,"anticoncepcion, prevencion de its y de cancer de cuello uterino",pildora: usuarias nuevas,2016-06-01,0,1,0,0,0,1
CHARAGUA,"anticoncepcion, prevencion de its y de cancer de cuello uterino",pildora: usuarias nuevas,2016-06-01,0,1,5,1,0,7
CHAYANTA,"anticoncepcion, prevencion de its y de cancer de cuello uterino",pildora: usuarias nuevas,2016-06-01,0,0,0,1,0,1
CHIMORE,"anticoncepcion, prevencion de its y de cancer de cuello uterino",pildora: usuarias nuevas,2016-06-01,0,0,2,0,0,2
CHUA COCANI,"anticoncepcion, prevencion de its y de cancer de cuello uterino",pildora: usuarias nuevas,2016-06-01,0,0,1,1,0,2
CHULUMANI (V. DE LA LIBERTAD),"anticoncepcion, prevencion de its y de cancer de cuello uterino",pildora: usuarias nuevas,2016-06-01,0,0,3,0,0,3
CHUMA,"anticoncepcion, prevencion de its y de cancer de cuello uterino",pildora: usuarias nuevas,2016-06-01,0,0,2,0,0,2
CHUQUIHUTA AYLLU JUCUMANI,"anticoncepcion, prevencion de its y de cancer de cuello uterino",pildora: usuarias nuevas,2016-06-01,0,1,1,2,0,4
CLIZA,"anticoncepcion, prevencion de its y de cancer de cuello uterino",pildora: usuarias nuevas,2016-06-01,0,0,1,1,0,2
COBIJA,"anticoncepcion, prevencion de its y de cancer de cuello uterino",pildora: usuarias nuevas,2016-06-01,0,0,3,2,0,5
COCAPATA,"anticoncepcion, prevencion de its y de cancer de cuello uterino",pildora: usuarias nuevas,2016-06-01,0,0,6,1,0,7
COCHABAMBA,"anticoncepcion, prevencion de its y de cancer de cuello uterino",pildora: usuarias nuevas,2016-06-01,0,22,201,41,0,264
COLCAPIRHUA,"anticoncepcion, prevencion de its y de cancer de cuello uterino",pildora: usuarias nuevas,2016-06-01,0,2,6,1,0,9
"COLCHA ""K""","anticoncepcion, prevencion de its y de cancer de cuello uterino",pildora: usuarias nuevas,2016-06-01,0,0,4,0,0,4
COLLANA,"anticoncepcion, prevencion de its y de cancer de cuello uterino",pildora: usuarias nuevas,2016-06-01,0,0,1,0,0,1
COLOMI,"anticoncepcion, prevencion de its y de cancer de cuello uterino",pildora: usuarias nuevas,2016-06-01,0,0,4,0,0,4
COLPA BELGICA,"anticoncepcion, prevencion de its y de cancer de cuello uterino",pildora: usuarias nuevas,2016-06-01,0,1,1,0,0,2
COLQUECHACA,"anticoncepcion, prevencion de its y de cancer de cuello uterino",pildora: usuarias nuevas,2016-06-01,0,0,2,1,0,3
COLQUENCHA,"anticoncepcion, prevencion de its y de cancer de cuello uterino",pildora: usuarias nuevas,2016-06-01,0,0,1,0,0,1
COLQUIRI,"anticoncepcion, prevencion de its y de cancer de cuello uterino",pildora: usuarias nuevas,2016-06-01,2,0,0,0,0,2
COMANCHE,"anticoncepcion, prevencion de its y de cancer de cuello uterino",pildora: usuarias nuevas,2016-06-01,0,0,1,0,0,1
COMARAPA,"anticoncepcion, prevencion de its y de cancer de cuello uterino",pildora: usuarias nuevas,2016-06-01,0,1,6,0,0,7
COMBAYA,"anticoncepcion, prevencion de its y de cancer de cuello uterino",pildora: usuarias nuevas,2016-06-01,0,0,0,1,0,1
CONCEPCION,"anticoncepcion, prevencion de its y de cancer de cuello uterino",pildora: usuarias nuevas,2016-06-01,0,0,0,1,0,1
CORIPATA,"anticoncepcion, prevencion de its y de cancer de cuello uterino",pildora: usuarias nuevas,2016-06-01,0,1,3,1,0,5
COROICO,"anticoncepcion, prevencion de its y de cancer de cuello uterino",pildora: usuarias nuevas,2016-06-01,0,0,8,0,0,8
COTAGAITA,"anticoncepcion, prevencion de its y de cancer de cuello uterino",pildora: usuarias nuevas,2016-06-01,0,1,1,0,0,2
COTOCA,"anticoncepcion, prevencion de its y de cancer de cuello uterino",pildora: usuarias nuevas,2016-06-01,0,5,18,3,0,26
CUATRO CAÑADAS,"anticoncepcion, prevencion de its y de cancer de cuello uterino",pildora: usuarias nuevas,2016-06-01,0,1,5,2,0,8
CULPINA,"anticoncepcion, prevencion de its y de cancer de cuello uterino",pildora: usuarias nuevas,2016-06-01,0,1,3,2,0,6
CURVA,"anticoncepcion, prevencion de its y de cancer de cuello uterino",pildora: usuarias nuevas,2016-06-01,0,1,1,0,0,2
EL ALTO,"anticoncepcion, prevencion de its y de cancer de cuello uterino",pildora: usuarias nuevas,2016-06-01,1,14,112,43,1,171
EL PUENTE(STC),"anticoncepcion, prevencion de its y de cancer de cuello uterino",pildora: usuarias nuevas,2016-06-01,0,0,2,0,0,2
EL PUENTE(TJA),"anticoncepcion, prevencion de its y de cancer de cuello uterino",pildora: usuarias nuevas,2016-06-01,0,1,1,0,0,2
EL TORNO,"anticoncepcion, prevencion de its y de cancer de cuello uterino",pildora: usuarias nuevas,2016-06-01,3,5,12,3,0,23
EL VILLAR,"anticoncepcion, prevencion de its y de cancer de cuello uterino",pildora: usuarias nuevas,2016-06-01,0,0,0,1,0,1
ENTRE RIOS TRJ,"anticoncepcion, prevencion de its y de cancer de cuello uterino",pildora: usuarias nuevas,2016-06-01,0,0,4,2,0,6
ENTRE RIOS CBBA,"anticoncepcion, prevencion de its y de cancer de cuello uterino",pildora: usuarias nuevas,2016-06-01,0,0,2,0,0,2
EUREKA (SANTOS MERCADO),"anticoncepcion, prevencion de its y de cancer de cuello uterino",pildora: usuarias nuevas,2016-06-01,0,1,0,0,0,1
EXALTACION,"anticoncepcion, prevencion de its y de cancer de cuello uterino",pildora: usuarias nuevas,2016-06-01,1,1,1,1,0,4
FERNANDEZ ALONSO,"anticoncepcion, prevencion de its y de cancer de cuello uterino",pildora: usuarias nuevas,2016-06-01,0,1,4,0,0,5
FILADELFIA,"anticoncepcion, prevencion de its y de cancer de cuello uterino",pildora: usuarias nuevas,2016-06-01,0,1,2,0,0,3
GENERAL SAAVEDRA,"anticoncepcion, prevencion de its y de cancer de cuello uterino",pildora: usuarias nuevas,2016-06-01,0,1,3,0,0,4
GRAL. J.J. PEREZ (CHARAZANI),"anticoncepcion, prevencion de its y de cancer de cuello uterino",pildora: usuarias nuevas,2016-06-01,0,0,1,0,0,1
GUANAY,"anticoncepcion, prevencion de its y de cancer de cuello uterino",pildora: usuarias nuevas,2016-06-01,0,0,1,0,0,1
GUAQUI,"anticoncepcion, prevencion de its y de cancer de cuello uterino",pildora: usuarias nuevas,2016-06-01,0,0,1,0,0,1
GUAYARAMERIN,"anticoncepcion, prevencion de its y de cancer de cuello uterino",pildora: usuarias nuevas,2016-06-01,0,2,15,3,0,20
GUTIERREZ,"anticoncepcion, prevencion de its y de cancer de cuello uterino",pildora: usuarias nuevas,2016-06-01,0,0,1,1,0,2
HUACARETA,"anticoncepcion, prevencion de its y de cancer de cuello uterino",pildora: usuarias nuevas,2016-06-01,0,2,2,1,0,5
HUACHACALLA,"anticoncepcion, prevencion de its y de cancer de cuello uterino",pildora: usuarias nuevas,2016-06-01,0,0,1,0,0,1
HUARACAJE,"anticoncepcion, prevencion de its y de cancer de cuello uterino",pildora: usuarias nuevas,2016-06-01,0,1,3,0,0,4
HUATAJATA,"anticoncepcion, prevencion de its y de cancer de cuello uterino",pildora: usuarias nuevas,2016-06-01,0,0,2,0,0,2
ICHOCA,"anticoncepcion, prevencion de its y de cancer de cuello uterino",pildora: usuarias nuevas,2016-06-01,0,0,1,0,0,1
ICLA,"anticoncepcion, prevencion de its y de cancer de cuello uterino",pildora: usuarias nuevas,2016-06-01,0,1,0,0,0,1
IRUPANA (VILLA DE LANZA),"anticoncepcion, prevencion de its y de cancer de cuello uterino",pildora: usuarias nuevas,2016-06-01,0,1,4,9,0,14
IXIAMAS,"anticoncepcion, prevencion de its y de cancer de cuello uterino",pildora: usuarias nuevas,2016-06-01,0,0,4,0,0,4
JESUS DE MACHACA,"anticoncepcion, prevencion de its y de cancer de cuello uterino",pildora: usuarias nuevas,2016-06-01,0,0,0,0,1,1
LA ASUNTA,"anticoncepcion, prevencion de its y de cancer de cuello uterino",pildora: usuarias nuevas,2016-06-01,0,1,3,0,0,4
LA GUARDIA,"anticoncepcion, prevencion de its y de cancer de cuello uterino",pildora: usuarias nuevas,2016-06-01,0,6,28,10,0,44
LA PAZ,"anticoncepcion, prevencion de its y de cancer de cuello uterino",pildora: usuarias nuevas,2016-06-01,0,6,92,62,0,160
LAGUNILLAS,"anticoncepcion, prevencion de its y de cancer de cuello uterino",pildora: usuarias nuevas,2016-06-01,0,0,5,1,0,6
LAJA,"anticoncepcion, prevencion de its y de cancer de cuello uterino",pildora: usuarias nuevas,2016-06-01,0,1,0,0,0,1
LLALLAGUA,"anticoncepcion, prevencion de its y de cancer de cuello uterino",pildora: usuarias nuevas,2016-06-01,0,3,13,3,0,19
LLICA,"anticoncepcion, prevencion de its y de cancer de cuello uterino",pildora: usuarias nuevas,2016-06-01,0,0,3,0,0,3
LORETO,"anticoncepcion, prevencion de its y de cancer de cuello uterino",pildora: usuarias nuevas,2016-06-01,0,1,1,0,0,2
MACHARETI,"anticoncepcion, prevencion de its y de cancer de cuello uterino",pildora: usuarias nuevas,2016-06-01,0,2,3,1,1,7
MAGDALENA,"anticoncepcion, prevencion de its y de cancer de cuello uterino",pildora: usuarias nuevas,2016-06-01,0,0,2,1,0,3
MAIRANA,"anticoncepcion, prevencion de its y de cancer de cuello uterino",pildora: usuarias nuevas,2016-06-01,0,0,2,0,0,2
MAPIRI,"anticoncepcion, prevencion de its y de cancer de cuello uterino",pildora: usuarias nuevas,2016-06-01,0,0,2,0,0,2
MECAPACA,"anticoncepcion, prevencion de its y de cancer de cuello uterino",pildora: usuarias nuevas,2016-06-01,0,0,1,0,0,1
MINEROS,"anticoncepcion, prevencion de its y de cancer de cuello uterino",pildora: usuarias nuevas,2016-06-01,0,0,4,0,0,4
MIZQUE,"anticoncepcion, prevencion de its y de cancer de cuello uterino",pildora: usuarias nuevas,2016-06-01,0,4,3,3,0,10
MOJOCOYA,"anticoncepcion, prevencion de its y de cancer de cuello uterino",pildora: usuarias nuevas,2016-06-01,0,0,0,1,0,1
MONTEAGUDO,"anticoncepcion, prevencion de its y de cancer de cuello uterino",pildora: usuarias nuevas,2016-06-01,0,3,5,1,0,9
MONTERO,"anticoncepcion, prevencion de its y de cancer de cuello uterino",pildora: usuarias nuevas,2016-06-01,1,20,48,9,0,78
MORO MORO,"anticoncepcion, prevencion de its y de cancer de cuello uterino",pildora: usuarias nuevas,2016-06-01,0,1,0,0,0,1
MOROCHATA,"anticoncepcion, prevencion de its y de cancer de cuello uterino",pildora: usuarias nuevas,2016-06-01,0,0,3,0,0,3
NACEBE (SANTA ROSA DEL ABUNA),"anticoncepcion, prevencion de its y de cancer de cuello uterino",pildora: usuarias nuevas,2016-06-01,0,0,1,1,0,2
NUEVO MANOA (NUEVA ESPERANZA),"anticoncepcion, prevencion de its y de cancer de cuello uterino",pildora: usuarias nuevas,2016-06-01,0,1,3,1,0,5
OCURI,"anticoncepcion, prevencion de its y de cancer de cuello uterino",pildora: usuarias nuevas,2016-06-01,0,0,1,7,0,8
OKINAWA,"anticoncepcion, prevencion de its y de cancer de cuello uterino",pildora: usuarias nuevas,2016-06-01,0,2,2,0,0,4
OMEREQUE,"anticoncepcion, prevencion de its y de cancer de cuello uterino",pildora: usuarias nuevas,2016-06-01,1,1,2,0,0,4
ORURO,"anticoncepcion, prevencion de its y de cancer de cuello uterino",pildora: usuarias nuevas,2016-06-01,0,14,44,43,0,101
PADCAYA,"anticoncepcion, prevencion de its y de cancer de cuello uterino",pildora: usuarias nuevas,2016-06-01,0,1,8,3,0,12
PADILLA,"anticoncepcion, prevencion de its y de cancer de cuello uterino",pildora: usuarias nuevas,2016-06-01,0,1,1,2,0,4
PAILON,"anticoncepcion, prevencion de its y de cancer de cuello uterino",pildora: usuarias nuevas,2016-06-01,1,3,11,1,0,16
PALCA,"anticoncepcion, prevencion de its y de cancer de cuello uterino",pildora: usuarias nuevas,2016-06-01,0,2,1,0,0,3
PALOS BLANCOS,"anticoncepcion, prevencion de its y de cancer de cuello uterino",pildora: usuarias nuevas,2016-06-01,0,2,5,2,0,9
PASORAPA,"anticoncepcion, prevencion de its y de cancer de cuello uterino",pildora: usuarias nuevas,2016-06-01,0,0,1,0,0,1
PATACAMAYA,"anticoncepcion, prevencion de its y de cancer de cuello uterino",pildora: usuarias nuevas,2016-06-01,0,1,2,0,0,3
PAZÑA,"anticoncepcion, prevencion de its y de cancer de cuello uterino",pildora: usuarias nuevas,2016-06-01,0,0,2,1,0,3
PELECHUCO,"anticoncepcion, prevencion de its y de cancer de cuello uterino",pildora: usuarias nuevas,2016-06-01,0,1,3,0,0,4
POCOATA,"anticoncepcion, prevencion de its y de cancer de cuello uterino",pildora: usuarias nuevas,2016-06-01,0,0,1,0,0,1
POCONA,"anticoncepcion, prevencion de its y de cancer de cuello uterino",pildora: usuarias nuevas,2016-06-01,0,0,3,2,0,5
POJO (CBBA),"anticoncepcion, prevencion de its y de cancer de cuello uterino",pildora: usuarias nuevas,2016-06-01,0,0,1,0,0,1
POOPO,"anticoncepcion, prevencion de its y de cancer de cuello uterino",pildora: usuarias nuevas,2016-06-01,0,0,1,0,0,1
PORCO,"anticoncepcion, prevencion de its y de cancer de cuello uterino",pildora: usuarias nuevas,2016-06-01,0,1,0,0,0,1
POROMA,"anticoncepcion, prevencion de its y de cancer de cuello uterino",pildora: usuarias nuevas,2016-06-01,0,0,0,2,0,2
PORONGO,"anticoncepcion, prevencion de its y de cancer de cuello uterino",pildora: usuarias nuevas,2016-06-01,1,1,6,4,0,12
PORTACHUELO,"anticoncepcion, prevencion de its y de cancer de cuello uterino",pildora: usuarias nuevas,2016-06-01,0,0,3,0,0,3
PORVENIR,"anticoncepcion, prevencion de its y de cancer de cuello uterino",pildora: usuarias nuevas,2016-06-01,0,0,1,0,0,1
POTOSI,"anticoncepcion, prevencion de its y de cancer de cuello uterino",pildora: usuarias nuevas,2016-06-01,0,4,35,10,0,49
PRESTO,"anticoncepcion, prevencion de its y de cancer de cuello uterino",pildora: usuarias nuevas,2016-06-01,0,1,0,0,0,1
PUCARANI,"anticoncepcion, prevencion de its y de cancer de cuello uterino",pildora: usuarias nuevas,2016-06-01,0,0,1,0,0,1
PUERTO CARABUCO,"anticoncepcion, prevencion de its y de cancer de cuello uterino",pildora: usuarias nuevas,2016-06-01,0,0,1,1,0,2
PUERTO GONZALO MORENO,"anticoncepcion, prevencion de its y de cancer de cuello uterino",pildora: usuarias nuevas,2016-06-01,0,4,2,0,0,6
PUERTO PEREZ,"anticoncepcion, prevencion de its y de cancer de cuello uterino",pildora: usuarias nuevas,2016-06-01,0,0,2,0,0,2
PUERTO QUIJARRO,"anticoncepcion, prevencion de its y de cancer de cuello uterino",pildora: usuarias nuevas,2016-06-01,0,0,6,1,0,7
PUERTO RICO,"anticoncepcion, prevencion de its y de cancer de cuello uterino",pildora: usuarias nuevas,2016-06-01,0,0,5,0,0,5
PUERTO SUAREZ,"anticoncepcion, prevencion de its y de cancer de cuello uterino",pildora: usuarias nuevas,2016-06-01,0,0,5,0,0,5
PUERTO VILLARROEL,"anticoncepcion, prevencion de its y de cancer de cuello uterino",pildora: usuarias nuevas,2016-06-01,0,2,3,2,0,7
PUNA,"anticoncepcion, prevencion de its y de cancer de cuello uterino",pildora: usuarias nuevas,2016-06-01,0,0,1,0,0,1
PUNATA,"anticoncepcion, prevencion de its y de cancer de cuello uterino",pildora: usuarias nuevas,2016-06-01,0,1,1,0,0,2
QUILLACOLLO,"anticoncepcion, prevencion de its y de cancer de cuello uterino",pildora: usuarias nuevas,2016-06-01,0,1,12,2,0,15
QUIME,"anticoncepcion, prevencion de its y de cancer de cuello uterino",pildora: usuarias nuevas,2016-06-01,0,0,1,1,0,2
RAVELO,"anticoncepcion, prevencion de its y de cancer de cuello uterino",pildora: usuarias nuevas,2016-06-01,0,0,0,1,0,1
REYES,"anticoncepcion, prevencion de its y de cancer de cuello uterino",pildora: usuarias nuevas,2016-06-01,0,5,13,2,0,20
RIBERALTA,"anticoncepcion, prevencion de its y de cancer de cuello uterino",pildora: usuarias nuevas,2016-06-01,0,1,18,1,0,20
ROBORE,"anticoncepcion, prevencion de its y de cancer de cuello uterino",pildora: usuarias nuevas,2016-06-01,0,1,8,1,0,10
RURRENABAQUE,"anticoncepcion, prevencion de its y de cancer de cuello uterino",pildora: usuarias nuevas,2016-06-01,1,1,3,1,0,6
SABAYA,"anticoncepcion, prevencion de its y de cancer de cuello uterino",pildora: usuarias nuevas,2016-06-01,0,0,2,0,0,2
SACABA,"anticoncepcion, prevencion de its y de cancer de cuello uterino",pildora: usuarias nuevas,2016-06-01,0,0,15,7,0,22
SACABAMBA,"anticoncepcion, prevencion de its y de cancer de cuello uterino",pildora: usuarias nuevas,2016-06-01,0,0,3,0,0,3
SACACA,"anticoncepcion, prevencion de its y de cancer de cuello uterino",pildora: usuarias nuevas,2016-06-01,0,0,27,15,0,42
SAIPINA,"anticoncepcion, prevencion de its y de cancer de cuello uterino",pildora: usuarias nuevas,2016-06-01,0,0,2,1,0,3
SALINAS DE GARCI MENDOZA,"anticoncepcion, prevencion de its y de cancer de cuello uterino",pildora: usuarias nuevas,2016-06-01,0,1,1,0,0,2
SAMAIPATA,"anticoncepcion, prevencion de its y de cancer de cuello uterino",pildora: usuarias nuevas,2016-06-01,0,0,3,4,0,7
SAN AGUSTIN,"anticoncepcion, prevencion de its y de cancer de cuello uterino",pildora: usuarias nuevas,2016-06-01,0,0,0,1,0,1
SAN ANDRES,"anticoncepcion, prevencion de its y de cancer de cuello uterino",pildora: usuarias nuevas,2016-06-01,0,2,6,3,0,11
SAN ANTONIO DE LOMERIO,"anticoncepcion, prevencion de its y de cancer de cuello uterino",pildora: usuarias nuevas,2016-06-01,0,2,4,1,0,7
SAN BORJA,"anticoncepcion, prevencion de its y de cancer de cuello uterino",pildora: usuarias nuevas,2016-06-01,1,1,7,3,0,12
SAN BUENA VENTURA,"anticoncepcion, prevencion de its y de cancer de cuello uterino",pildora: usuarias nuevas,2016-06-01,0,0,1,0,0,1
SAN CARLOS,"anticoncepcion, prevencion de its y de cancer de cuello uterino",pildora: usuarias nuevas,2016-06-01,0,2,3,2,0,7
SAN IGNACIO,"anticoncepcion, prevencion de its y de cancer de cuello uterino",pildora: usuarias nuevas,2016-06-01,0,9,6,4,0,19
SAN IGNACIO DE VELASCO,"anticoncepcion, prevencion de its y de cancer de cuello uterino",pildora: usuarias nuevas,2016-06-01,0,4,14,4,0,22
SAN JAVIER(BNI),"anticoncepcion, prevencion de its y de cancer de cuello uterino",pildora: usuarias nuevas,2016-06-01,0,0,9,1,0,10
SAN JAVIER(STC),"anticoncepcion, prevencion de its y de cancer de cuello uterino",pildora: usuarias nuevas,2016-06-01,0,3,3,1,0,7
SAN JOAQUIN,"anticoncepcion, prevencion de its y de cancer de cuello uterino",pildora: usuarias nuevas,2016-06-01,0,0,4,0,0,4
SAN JOSE DE CHIQUITOS,"anticoncepcion, prevencion de its y de cancer de cuello uterino",pildora: usuarias nuevas,2016-06-01,1,0,4,1,0,6
SAN JUAN DE YAPACANI,"anticoncepcion, prevencion de its y de cancer de cuello uterino",pildora: usuarias nuevas,2016-06-01,0,0,1,1,0,2
SAN JULIAN,"anticoncepcion, prevencion de its y de cancer de cuello uterino",pildora: usuarias nuevas,2016-06-01,0,2,10,2,0,14
SAN LORENZO(PND),"anticoncepcion, prevencion de its y de cancer de cuello uterino",pildora: usuarias nuevas,2016-06-01,0,0,2,0,0,2
SAN LORENZO(TJA),"anticoncepcion, prevencion de its y de cancer de cuello uterino",pildora: usuarias nuevas,2016-06-01,0,1,2,3,0,6
SAN LUCAS,"anticoncepcion, prevencion de its y de cancer de cuello uterino",pildora: usuarias nuevas,2016-06-01,0,0,4,2,0,6
SAN MATIAS,"anticoncepcion, prevencion de its y de cancer de cuello uterino",pildora: usuarias nuevas,2016-06-01,1,0,3,0,0,4
SAN MIGUEL DE VELASCO,"anticoncepcion, prevencion de its y de cancer de cuello uterino",pildora: usuarias nuevas,2016-06-01,0,0,5,0,0,5
SAN PEDRO,"anticoncepcion, prevencion de its y de cancer de cuello uterino",pildora: usuarias nuevas,2016-06-01,0,1,4,1,0,6
SAN PEDRO DE BUENA VISTA,"anticoncepcion, prevencion de its y de cancer de cuello uterino",pildora: usuarias nuevas,2016-06-01,0,0,0,1,0,1
SAN PEDRO DE CURAHUARA,"anticoncepcion, prevencion de its y de cancer de cuello uterino",pildora: usuarias nuevas,2016-06-01,0,0,0,1,0,1
SAN PEDRO DE TIQUINA,"anticoncepcion, prevencion de its y de cancer de cuello uterino",pildora: usuarias nuevas,2016-06-01,0,1,1,0,0,2
SAN RAFAEL,"anticoncepcion, prevencion de its y de cancer de cuello uterino",pildora: usuarias nuevas,2016-06-01,0,2,9,3,0,14
SAN RAMON BENI,"anticoncepcion, prevencion de its y de cancer de cuello uterino",pildora: usuarias nuevas,2016-06-01,0,3,1,0,0,4
SAN RAMON SCZ,"anticoncepcion, prevencion de its y de cancer de cuello uterino",pildora: usuarias nuevas,2016-06-01,0,1,0,0,0,1
SANTA ANA,"anticoncepcion, prevencion de its y de cancer de cuello uterino",pildora: usuarias nuevas,2016-06-01,0,0,7,3,0,10
SANTA CRUZ DE LA SIERRA,"anticoncepcion, prevencion de its y de cancer de cuello uterino",pildora: usuarias nuevas,2016-06-01,1,120,204,83,8,416
SANTA ROSA,"anticoncepcion, prevencion de its y de cancer de cuello uterino",pildora: usuarias nuevas,2016-06-01,0,0,1,1,0,2
SANTA ROSA DEL SARA,"anticoncepcion, prevencion de its y de cancer de cuello uterino",pildora: usuarias nuevas,2016-06-01,1,1,14,2,0,18
SANTIAGO DE HUARI,"anticoncepcion, prevencion de its y de cancer de cuello uterino",pildora: usuarias nuevas,2016-06-01,0,0,1,0,0,1
SANTIAGO DE HUATA,"anticoncepcion, prevencion de its y de cancer de cuello uterino",pildora: usuarias nuevas,2016-06-01,0,0,1,0,0,1
SANTIAGO DE MACHACA,"anticoncepcion, prevencion de its y de cancer de cuello uterino",pildora: usuarias nuevas,2016-06-01,0,1,1,0,0,2
SANTUARIO DE QUILLACAS,"anticoncepcion, prevencion de its y de cancer de cuello uterino",pildora: usuarias nuevas,2016-06-01,0,0,1,1,0,2
SAPAHAQUI,"anticoncepcion, prevencion de its y de cancer de cuello uterino",pildora: usuarias nuevas,2016-06-01,0,0,3,0,0,3
SENA,"anticoncepcion, prevencion de its y de cancer de cuello uterino",pildora: usuarias nuevas,2016-06-01,0,0,1,0,0,1
SHINAOTA,"anticoncepcion, prevencion de its y de cancer de cuello uterino",pildora: usuarias nuevas,2016-06-01,0,1,0,0,0,1
SICA SICA (VILLA AROMA),"anticoncepcion, prevencion de its y de cancer de cuello uterino",pildora: usuarias nuevas,2016-06-01,0,0,2,1,0,3
SICAYA,"anticoncepcion, prevencion de its y de cancer de cuello uterino",pildora: usuarias nuevas,2016-06-01,0,0,3,0,0,3
SIPE SIPE,"anticoncepcion, prevencion de its y de cancer de cuello uterino",pildora: usuarias nuevas,2016-06-01,0,1,11,4,0,16
SOPACHUY,"anticoncepcion, prevencion de its y de cancer de cuello uterino",pildora: usuarias nuevas,2016-06-01,0,2,4,2,0,8
SORATA,"anticoncepcion, prevencion de its y de cancer de cuello uterino",pildora: usuarias nuevas,2016-06-01,0,0,4,1,0,5
SUCRE,"anticoncepcion, prevencion de its y de cancer de cuello uterino",pildora: usuarias nuevas,2016-06-01,1,18,57,10,0,86
TACACOMA,"anticoncepcion, prevencion de its y de cancer de cuello uterino",pildora: usuarias nuevas,2016-06-01,1,1,2,2,0,6
TAHUA,"anticoncepcion, prevencion de its y de cancer de cuello uterino",pildora: usuarias nuevas,2016-06-01,0,0,1,0,0,1
TAPACARI,"anticoncepcion, prevencion de its y de cancer de cuello uterino",pildora: usuarias nuevas,2016-06-01,0,1,3,0,0,4
TARABUCO,"anticoncepcion, prevencion de its y de cancer de cuello uterino",pildora: usuarias nuevas,2016-06-01,0,0,2,0,0,2
TARACO,"anticoncepcion, prevencion de its y de cancer de cuello uterino",pildora: usuarias nuevas,2016-06-01,0,0,0,1,0,1
TARATA,"anticoncepcion, prevencion de its y de cancer de cuello uterino",pildora: usuarias nuevas,2016-06-01,0,0,1,1,0,2
TARIJA,"anticoncepcion, prevencion de its y de cancer de cuello uterino",pildora: usuarias nuevas,2016-06-01,0,8,28,21,0,57
TARVITA,"anticoncepcion, prevencion de its y de cancer de cuello uterino",pildora: usuarias nuevas,2016-06-01,0,1,2,1,0,4
TEOPONTE,"anticoncepcion, prevencion de its y de cancer de cuello uterino",pildora: usuarias nuevas,2016-06-01,0,0,2,0,0,2
TIAWANACU,"anticoncepcion, prevencion de its y de cancer de cuello uterino",pildora: usuarias nuevas,2016-06-01,0,1,1,1,0,3
TIPUANI,"anticoncepcion, prevencion de its y de cancer de cuello uterino",pildora: usuarias nuevas,2016-06-01,0,0,0,2,0,2
TIQUIPAYA,"anticoncepcion, prevencion de its y de cancer de cuello uterino",pildora: usuarias nuevas,2016-06-01,0,1,16,6,0,23
TIRAQUE (CBBA),"anticoncepcion, prevencion de its y de cancer de cuello uterino",pildora: usuarias nuevas,2016-06-01,0,1,2,0,0,3
TITO YUPANQUI (PARQUIPUJIO),"anticoncepcion, prevencion de its y de cancer de cuello uterino",pildora: usuarias nuevas,2016-06-01,0,0,0,1,0,1
TOCO,"anticoncepcion, prevencion de its y de cancer de cuello uterino",pildora: usuarias nuevas,2016-06-01,0,0,1,0,0,1
TOLATA,"anticoncepcion, prevencion de its y de cancer de cuello uterino",pildora: usuarias nuevas,2016-06-01,0,0,2,0,0,2
TOLEDO,"anticoncepcion, prevencion de its y de cancer de cuello uterino",pildora: usuarias nuevas,2016-06-01,0,0,1,0,0,1
TOMAVE,"anticoncepcion, prevencion de its y de cancer de cuello uterino",pildora: usuarias nuevas,2016-06-01,0,0,1,1,0,2
TOMINA,"anticoncepcion, prevencion de its y de cancer de cuello uterino",pildora: usuarias nuevas,2016-06-01,0,2,2,0,0,4
TORO TORO,"anticoncepcion, prevencion de its y de cancer de cuello uterino",pildora: usuarias nuevas,2016-06-01,0,1,10,3,0,14
TRINIDAD,"anticoncepcion, prevencion de its y de cancer de cuello uterino",pildora: usuarias nuevas,2016-06-01,0,4,8,4,0,16
TUPIZA,"anticoncepcion, prevencion de its y de cancer de cuello uterino",pildora: usuarias nuevas,2016-06-01,0,1,5,0,0,6
TURCO,"anticoncepcion, prevencion de its y de cancer de cuello uterino",pildora: usuarias nuevas,2016-06-01,0,0,0,1,0,1
UNCIA,"anticoncepcion, prevencion de its y de cancer de cuello uterino",pildora: usuarias nuevas,2016-06-01,0,0,5,0,0,5
URIONDO (A. CONCEPCION),"anticoncepcion, prevencion de its y de cancer de cuello uterino",pildora: usuarias nuevas,2016-06-01,2,0,3,0,0,5
URUBICHA,"anticoncepcion, prevencion de its y de cancer de cuello uterino",pildora: usuarias nuevas,2016-06-01,0,1,0,0,0,1
UYUNI,"anticoncepcion, prevencion de its y de cancer de cuello uterino",pildora: usuarias nuevas,2016-06-01,0,0,3,2,0,5
VACAS,"anticoncepcion, prevencion de its y de cancer de cuello uterino",pildora: usuarias nuevas,2016-06-01,0,1,0,0,0,1
VALLEGRANDE,"anticoncepcion, prevencion de its y de cancer de cuello uterino",pildora: usuarias nuevas,2016-06-01,0,6,3,1,0,10
VIACHA,"anticoncepcion, prevencion de its y de cancer de cuello uterino",pildora: usuarias nuevas,2016-06-01,0,3,14,2,0,19
VILA VILA,"anticoncepcion, prevencion de its y de cancer de cuello uterino",pildora: usuarias nuevas,2016-06-01,0,0,1,0,0,1
VILLA CHARCAS,"anticoncepcion, prevencion de its y de cancer de cuello uterino",pildora: usuarias nuevas,2016-06-01,0,2,4,0,0,6
VILLA MONTES,"anticoncepcion, prevencion de its y de cancer de cuello uterino",pildora: usuarias nuevas,2016-06-01,1,2,7,2,1,13
VILLA SERRANO,"anticoncepcion, prevencion de its y de cancer de cuello uterino",pildora: usuarias nuevas,2016-06-01,0,2,3,3,0,8
VILLA TUNARI,"anticoncepcion, prevencion de its y de cancer de cuello uterino",pildora: usuarias nuevas,2016-06-01,0,4,19,5,0,28
VILLA VACA GUZMAN (MUYUPAMPA),"anticoncepcion, prevencion de its y de cancer de cuello uterino",pildora: usuarias nuevas,2016-06-01,0,0,4,1,0,5
VILLAZON,"anticoncepcion, prevencion de its y de cancer de cuello uterino",pildora: usuarias nuevas,2016-06-01,0,1,6,1,0,8
VINTO,"anticoncepcion, prevencion de its y de cancer de cuello uterino",pildora: usuarias nuevas,2016-06-01,0,1,3,2,0,6
WALDO BALLIVIAN,"anticoncepcion, prevencion de its y de cancer de cuello uterino",pildora: usuarias nuevas,2016-06-01,0,0,0,1,0,1
WARNES,"anticoncepcion, prevencion de its y de cancer de cuello uterino",pildora: usuarias nuevas,2016-06-01,1,6,18,4,0,29
YACO,"anticoncepcion, prevencion de its y de cancer de cuello uterino",pildora: usuarias nuevas,2016-06-01,0,1,1,0,0,2
YACUIBA,"anticoncepcion, prevencion de its y de cancer de cuello uterino",pildora: usuarias nuevas,2016-06-01,0,2,13,6,0,21
YAMPARAEZ,"anticoncepcion, prevencion de its y de cancer de cuello uterino",pildora: usuarias nuevas,2016-06-01,0,1,0,0,0,1
YANACACHI,"anticoncepcion, prevencion de its y de cancer de cuello uterino",pildora: usuarias nuevas,2016-06-01,0,0,1,2,0,3
YAPACANI,"anticoncepcion, prevencion de its y de cancer de cuello uterino",pildora: usuarias nuevas,2016-06-01,0,3,20,6,0,29
YOCALLA,"anticoncepcion, prevencion de its y de cancer de cuello uterino",pildora: usuarias nuevas,2016-06-01,0,0,1,0,0,1
YOTALA,"anticoncepcion, prevencion de its y de cancer de cuello uterino",pildora: usuarias nuevas,2016-06-01,0,0,0,1,0,1
ZUDAÑEZ,"anticoncepcion, prevencion de its y de cancer de cuello uterino",pildora: usuarias nuevas,2016-06-01,0,0,2,0,0,2
ACACIO,"anticoncepcion, prevencion de its y de cancer de cuello uterino",pildora: usuarias nuevas,2016-07-01,0,0,1,0,0,1
ACHACACHI,"anticoncepcion, prevencion de its y de cancer de cuello uterino",pildora: usuarias nuevas,2016-07-01,0,0,2,0,0,2
ACHOCALLA,"anticoncepcion, prevencion de its y de cancer de cuello uterino",pildora: usuarias nuevas,2016-07-01,0,1,1,1,0,3
AIQUILE,"anticoncepcion, prevencion de its y de cancer de cuello uterino",pildora: usuarias nuevas,2016-07-01,0,1,1,0,0,2
ALCALA,"anticoncepcion, prevencion de its y de cancer de cuello uterino",pildora: usuarias nuevas,2016-07-01,0,0,2,0,0,2
ALTO BENI,"anticoncepcion, prevencion de its y de cancer de cuello uterino",pildora: usuarias nuevas,2016-07-01,0,2,0,0,0,2
APOLO,"anticoncepcion, prevencion de its y de cancer de cuello uterino",pildora: usuarias nuevas,2016-07-01,0,0,0,1,0,1
ARANI,"anticoncepcion, prevencion de its y de cancer de cuello uterino",pildora: usuarias nuevas,2016-07-01,0,0,2,0,0,2
ARBIETO,"anticoncepcion, prevencion de its y de cancer de cuello uterino",pildora: usuarias nuevas,2016-07-01,0,0,4,2,0,6
ARQUE,"anticoncepcion, prevencion de its y de cancer de cuello uterino",pildora: usuarias nuevas,2016-07-01,0,1,1,0,0,2
ASCENCION DE GUARAYOS,"anticoncepcion, prevencion de its y de cancer de cuello uterino",pildora: usuarias nuevas,2016-07-01,0,0,5,2,0,7
ATOCHA,"anticoncepcion, prevencion de its y de cancer de cuello uterino",pildora: usuarias nuevas,2016-07-01,0,0,2,1,0,3
AYOPAYA (V. DE INDEPENDENCIA),"anticoncepcion, prevencion de its y de cancer de cuello uterino",pildora: usuarias nuevas,2016-07-01,0,0,5,4,0,9
AZURDUY,"anticoncepcion, prevencion de its y de cancer de cuello uterino",pildora: usuarias nuevas,2016-07-01,0,1,1,0,0,2
BATALLAS,"anticoncepcion, prevencion de its y de cancer de cuello uterino",pildora: usuarias nuevas,2016-07-01,0,0,2,1,0,3
BAURES,"anticoncepcion, prevencion de its y de cancer de cuello uterino",pildora: usuarias nuevas,2016-07-01,0,0,1,0,0,1
BELLA FLOR,"anticoncepcion, prevencion de its y de cancer de cuello uterino",pildora: usuarias nuevas,2016-07-01,0,1,2,0,0,3
BERMEJO,"anticoncepcion, prevencion de its y de cancer de cuello uterino",pildora: usuarias nuevas,2016-07-01,0,3,14,1,0,18
BETANZOS,"anticoncepcion, prevencion de its y de cancer de cuello uterino",pildora: usuarias nuevas,2016-07-01,0,0,2,1,0,3
BUENA VISTA,"anticoncepcion, prevencion de its y de cancer de cuello uterino",pildora: usuarias nuevas,2016-07-01,0,0,3,0,0,3
CABEZAS,"anticoncepcion, prevencion de its y de cancer de cuello uterino",pildora: usuarias nuevas,2016-07-01,0,3,9,2,0,14
CAIROMA,"anticoncepcion, prevencion de its y de cancer de cuello uterino",pildora: usuarias nuevas,2016-07-01,0,1,2,0,0,3
"CAIZA ""D""","anticoncepcion, prevencion de its y de cancer de cuello uterino",pildora: usuarias nuevas,2016-07-01,0,0,4,0,0,4
CAJUATA,"anticoncepcion, prevencion de its y de cancer de cuello uterino",pildora: usuarias nuevas,2016-07-01,0,0,3,0,0,3
CALAMARCA,"anticoncepcion, prevencion de its y de cancer de cuello uterino",pildora: usuarias nuevas,2016-07-01,0,0,3,3,0,6
CAMARGO,"anticoncepcion, prevencion de its y de cancer de cuello uterino",pildora: usuarias nuevas,2016-07-01,0,0,4,1,0,5
CAMIRI,"anticoncepcion, prevencion de its y de cancer de cuello uterino",pildora: usuarias nuevas,2016-07-01,0,0,1,0,0,1
CAPINOTA,"anticoncepcion, prevencion de its y de cancer de cuello uterino",pildora: usuarias nuevas,2016-07-01,0,3,2,0,0,5
CARACOLLO,"anticoncepcion, prevencion de its y de cancer de cuello uterino",pildora: usuarias nuevas,2016-07-01,0,0,6,0,0,6
CARANAVI,"anticoncepcion, prevencion de its y de cancer de cuello uterino",pildora: usuarias nuevas,2016-07-01,0,1,6,3,0,10
CARAPARI,"anticoncepcion, prevencion de its y de cancer de cuello uterino",pildora: usuarias nuevas,2016-07-01,0,0,3,0,0,3
CHALLAPATA,"anticoncepcion, prevencion de its y de cancer de cuello uterino",pildora: usuarias nuevas,2016-07-01,0,1,1,1,0,3
CHARAGUA,"anticoncepcion, prevencion de its y de cancer de cuello uterino",pildora: usuarias nuevas,2016-07-01,0,0,4,0,0,4
CHAYANTA,"anticoncepcion, prevencion de its y de cancer de cuello uterino",pildora: usuarias nuevas,2016-07-01,0,0,1,0,0,1
CHIMORE,"anticoncepcion, prevencion de its y de cancer de cuello uterino",pildora: usuarias nuevas,2016-07-01,0,6,2,3,0,11
CHUA COCANI,"anticoncepcion, prevencion de its y de cancer de cuello uterino",pildora: usuarias nuevas,2016-07-01,0,0,2,0,0,2
CHULUMANI (V. DE LA LIBERTAD),"anticoncepcion, prevencion de its y de cancer de cuello uterino",pildora: usuarias nuevas,2016-07-01,0,0,4,1,0,5
CHUQUIHUTA AYLLU JUCUMANI,"anticoncepcion, prevencion de its y de cancer de cuello uterino",pildora: usuarias nuevas,2016-07-01,0,0,1,1,0,2
CLIZA,"anticoncepcion, prevencion de its y de cancer de cuello uterino",pildora: usuarias nuevas,2016-07-01,0,0,3,0,0,3
COBIJA,"anticoncepcion, prevencion de its y de cancer de cuello uterino",pildora: usuarias nuevas,2016-07-01,0,1,6,1,0,8
COCAPATA,"anticoncepcion, prevencion de its y de cancer de cuello uterino",pildora: usuarias nuevas,2016-07-01,0,0,11,9,0,20
COCHABAMBA,"anticoncepcion, prevencion de its y de cancer de cuello uterino",pildora: usuarias nuevas,2016-07-01,0,27,210,24,0,261
COIPASA,"anticoncepcion, prevencion de its y de cancer de cuello uterino",pildora: usuarias nuevas,2016-07-01,0,0,1,0,0,1
COLCAPIRHUA,"anticoncepcion, prevencion de its y de cancer de cuello uterino",pildora: usuarias nuevas,2016-07-01,0,0,6,0,0,6
COLLANA,"anticoncepcion, prevencion de its y de cancer de cuello uterino",pildora: usuarias nuevas,2016-07-01,0,0,1,0,0,1
COLOMI,"anticoncepcion, prevencion de its y de cancer de cuello uterino",pildora: usuarias nuevas,2016-07-01,0,0,2,0,0,2
COLPA BELGICA,"anticoncepcion, prevencion de its y de cancer de cuello uterino",pildora: usuarias nuevas,2016-07-01,0,0,1,0,0,1
COLQUECHACA,"anticoncepcion, prevencion de its y de cancer de cuello uterino",pildora: usuarias nuevas,2016-07-01,0,0,3,0,0,3
COLQUENCHA,"anticoncepcion, prevencion de its y de cancer de cuello uterino",pildora: usuarias nuevas,2016-07-01,0,0,5,1,0,6
COLQUIRI,"anticoncepcion, prevencion de its y de cancer de cuello uterino",pildora: usuarias nuevas,2016-07-01,0,2,3,0,0,5
COMARAPA,"anticoncepcion, prevencion de its y de cancer de cuello uterino",pildora: usuarias nuevas,2016-07-01,0,1,6,0,0,7
CONCEPCION,"anticoncepcion, prevencion de its y de cancer de cuello uterino",pildora: usuarias nuevas,2016-07-01,0,1,4,0,0,5
CORIPATA,"anticoncepcion, prevencion de its y de cancer de cuello uterino",pildora: usuarias nuevas,2016-07-01,0,1,0,0,0,1
COROICO,"anticoncepcion, prevencion de its y de cancer de cuello uterino",pildora: usuarias nuevas,2016-07-01,0,1,0,0,0,1
COTAGAITA,"anticoncepcion, prevencion de its y de cancer de cuello uterino",pildora: usuarias nuevas,2016-07-01,0,0,2,2,0,4
COTOCA,"anticoncepcion, prevencion de its y de cancer de cuello uterino",pildora: usuarias nuevas,2016-07-01,0,11,24,6,0,41
CUATRO CAÑADAS,"anticoncepcion, prevencion de its y de cancer de cuello uterino",pildora: usuarias nuevas,2016-07-01,0,2,2,0,0,4
CULPINA,"anticoncepcion, prevencion de its y de cancer de cuello uterino",pildora: usuarias nuevas,2016-07-01,0,2,10,2,1,15
CURVA,"anticoncepcion, prevencion de its y de cancer de cuello uterino",pildora: usuarias nuevas,2016-07-01,0,0,1,0,0,1
DESAGUADERO,"anticoncepcion, prevencion de its y de cancer de cuello uterino",pildora: usuarias nuevas,2016-07-01,0,0,1,0,0,1
EL ALTO,"anticoncepcion, prevencion de its y de cancer de cuello uterino",pildora: usuarias nuevas,2016-07-01,1,18,116,21,0,156
EL CHORO,"anticoncepcion, prevencion de its y de cancer de cuello uterino",pildora: usuarias nuevas,2016-07-01,0,2,0,0,0,2
EL PUENTE(STC),"anticoncepcion, prevencion de its y de cancer de cuello uterino",pildora: usuarias nuevas,2016-07-01,0,1,2,2,0,5
EL PUENTE(TJA),"anticoncepcion, prevencion de its y de cancer de cuello uterino",pildora: usuarias nuevas,2016-07-01,0,0,2,1,0,3
EL TORNO,"anticoncepcion, prevencion de its y de cancer de cuello uterino",pildora: usuarias nuevas,2016-07-01,1,4,23,1,0,29
EL VILLAR,"anticoncepcion, prevencion de its y de cancer de cuello uterino",pildora: usuarias nuevas,2016-07-01,0,0,1,0,0,1
ENTRE RIOS TRJ,"anticoncepcion, prevencion de its y de cancer de cuello uterino",pildora: usuarias nuevas,2016-07-01,0,1,5,2,0,8
ENTRE RIOS CBBA,"anticoncepcion, prevencion de its y de cancer de cuello uterino",pildora: usuarias nuevas,2016-07-01,0,2,9,1,0,12
ESCARA,"anticoncepcion, prevencion de its y de cancer de cuello uterino",pildora: usuarias nuevas,2016-07-01,0,0,2,1,0,3
ESMERALDA,"anticoncepcion, prevencion de its y de cancer de cuello uterino",pildora: usuarias nuevas,2016-07-01,0,0,2,0,0,2
EUCALIPTUS,"anticoncepcion, prevencion de its y de cancer de cuello uterino",pildora: usuarias nuevas,2016-07-01,0,0,1,0,0,1
EXALTACION,"anticoncepcion, prevencion de its y de cancer de cuello uterino",pildora: usuarias nuevas,2016-07-01,0,0,1,1,0,2
FERNANDEZ ALONSO,"anticoncepcion, prevencion de its y de cancer de cuello uterino",pildora: usuarias nuevas,2016-07-01,0,0,1,0,0,1
FILADELFIA,"anticoncepcion, prevencion de its y de cancer de cuello uterino",pildora: usuarias nuevas,2016-07-01,0,1,1,0,0,2
GENERAL SAAVEDRA,"anticoncepcion, prevencion de its y de cancer de cuello uterino",pildora: usuarias nuevas,2016-07-01,0,2,9,1,0,12
GRAL. J.J. PEREZ (CHARAZANI),"anticoncepcion, prevencion de its y de cancer de cuello uterino",pildora: usuarias nuevas,2016-07-01,0,0,1,1,0,2
GUANAY,"anticoncepcion, prevencion de its y de cancer de cuello uterino",pildora: usuarias nuevas,2016-07-01,0,0,3,0,0,3
GUAYARAMERIN,"anticoncepcion, prevencion de its y de cancer de cuello uterino",pildora: usuarias nuevas,2016-07-01,1,1,13,1,0,16
GUTIERREZ,"anticoncepcion, prevencion de its y de cancer de cuello uterino",pildora: usuarias nuevas,2016-07-01,0,1,2,2,0,5
HUACARETA,"anticoncepcion, prevencion de its y de cancer de cuello uterino",pildora: usuarias nuevas,2016-07-01,0,0,5,0,0,5
HUANUNI,"anticoncepcion, prevencion de its y de cancer de cuello uterino",pildora: usuarias nuevas,2016-07-01,0,1,0,0,0,1
HUARACAJE,"anticoncepcion, prevencion de its y de cancer de cuello uterino",pildora: usuarias nuevas,2016-07-01,0,0,5,2,0,7
HUAYLLAMARCA,"anticoncepcion, prevencion de its y de cancer de cuello uterino",pildora: usuarias nuevas,2016-07-01,0,0,0,1,0,1
ICHOCA,"anticoncepcion, prevencion de its y de cancer de cuello uterino",pildora: usuarias nuevas,2016-07-01,0,0,2,0,0,2
ICLA,"anticoncepcion, prevencion de its y de cancer de cuello uterino",pildora: usuarias nuevas,2016-07-01,0,0,2,0,0,2
INCAHUASI,"anticoncepcion, prevencion de its y de cancer de cuello uterino",pildora: usuarias nuevas,2016-07-01,0,0,1,1,0,2
IRUPANA (VILLA DE LANZA),"anticoncepcion, prevencion de its y de cancer de cuello uterino",pildora: usuarias nuevas,2016-07-01,0,0,2,1,0,3
IXIAMAS,"anticoncepcion, prevencion de its y de cancer de cuello uterino",pildora: usuarias nuevas,2016-07-01,0,2,4,1,0,7
JESUS DE MACHACA,"anticoncepcion, prevencion de its y de cancer de cuello uterino",pildora: usuarias nuevas,2016-07-01,0,1,0,0,0,1
LA ASUNTA,"anticoncepcion, prevencion de its y de cancer de cuello uterino",pildora: usuarias nuevas,2016-07-01,1,0,5,2,0,8
LA GUARDIA,"anticoncepcion, prevencion de its y de cancer de cuello uterino",pildora: usuarias nuevas,2016-07-01,1,7,28,5,0,41
LA PAZ,"anticoncepcion, prevencion de its y de cancer de cuello uterino",pildora: usuarias nuevas,2016-07-01,1,8,112,67,1,189
LAGUNILLAS,"anticoncepcion, prevencion de its y de cancer de cuello uterino",pildora: usuarias nuevas,2016-07-01,0,0,2,5,0,7
LAJA,"anticoncepcion, prevencion de its y de cancer de cuello uterino",pildora: usuarias nuevas,2016-07-01,1,0,1,1,0,3
LAS CARRERAS,"anticoncepcion, prevencion de its y de cancer de cuello uterino",pildora: usuarias nuevas,2016-07-01,0,0,0,1,0,1
LLALLAGUA,"anticoncepcion, prevencion de its y de cancer de cuello uterino",pildora: usuarias nuevas,2016-07-01,0,2,17,4,1,24
LLICA,"anticoncepcion, prevencion de its y de cancer de cuello uterino",pildora: usuarias nuevas,2016-07-01,0,0,3,0,0,3
LORETO,"anticoncepcion, prevencion de its y de cancer de cuello uterino",pildora: usuarias nuevas,2016-07-01,0,0,1,1,0,2
LURIBAY,"anticoncepcion, prevencion de its y de cancer de cuello uterino",pildora: usuarias nuevas,2016-07-01,0,0,1,0,0,1
MACHACAMARCA,"anticoncepcion, prevencion de its y de cancer de cuello uterino",pildora: usuarias nuevas,2016-07-01,0,0,1,1,0,2
MACHARETI,"anticoncepcion, prevencion de its y de cancer de cuello uterino",pildora: usuarias nuevas,2016-07-01,0,1,10,1,0,12
MAGDALENA,"anticoncepcion, prevencion de its y de cancer de cuello uterino",pildora: usuarias nuevas,2016-07-01,1,4,15,3,0,23
MAIRANA,"anticoncepcion, prevencion de its y de cancer de cuello uterino",pildora: usuarias nuevas,2016-07-01,0,0,1,0,0,1
MECAPACA,"anticoncepcion, prevencion de its y de cancer de cuello uterino",pildora: usuarias nuevas,2016-07-01,0,0,2,1,0,3
MINEROS,"anticoncepcion, prevencion de its y de cancer de cuello uterino",pildora: usuarias nuevas,2016-07-01,0,0,3,0,0,3
MIZQUE,"anticoncepcion, prevencion de its y de cancer de cuello uterino",pildora: usuarias nuevas,2016-07-01,0,1,8,1,0,10
MONTEAGUDO,"anticoncepcion, prevencion de its y de cancer de cuello uterino",pildora: usuarias nuevas,2016-07-01,1,0,5,2,0,8
MONTERO,"anticoncepcion, prevencion de its y de cancer de cuello uterino",pildora: usuarias nuevas,2016-07-01,0,10,40,9,0,59
MORO MORO,"anticoncepcion, prevencion de its y de cancer de cuello uterino",pildora: usuarias nuevas,2016-07-01,0,0,1,0,0,1
MOROCHATA,"anticoncepcion, prevencion de its y de cancer de cuello uterino",pildora: usuarias nuevas,2016-07-01,0,0,1,0,0,1
NACEBE (SANTA ROSA DEL ABUNA),"anticoncepcion, prevencion de its y de cancer de cuello uterino",pildora: usuarias nuevas,2016-07-01,0,4,0,0,0,4
NUEVO MANOA (NUEVA ESPERANZA),"anticoncepcion, prevencion de its y de cancer de cuello uterino",pildora: usuarias nuevas,2016-07-01,0,0,4,0,0,4
OCURI,"anticoncepcion, prevencion de its y de cancer de cuello uterino",pildora: usuarias nuevas,2016-07-01,0,1,0,1,0,2
OKINAWA,"anticoncepcion, prevencion de its y de cancer de cuello uterino",pildora: usuarias nuevas,2016-07-01,0,2,4,0,0,6
OMEREQUE,"anticoncepcion, prevencion de its y de cancer de cuello uterino",pildora: usuarias nuevas,2016-07-01,0,0,4,0,0,4
ORURO,"anticoncepcion, prevencion de its y de cancer de cuello uterino",pildora: usuarias nuevas,2016-07-01,0,7,40,17,0,64
PADCAYA,"anticoncepcion, prevencion de its y de cancer de cuello uterino",pildora: usuarias nuevas,2016-07-01,0,3,3,1,0,7
PADILLA,"anticoncepcion, prevencion de its y de cancer de cuello uterino",pildora: usuarias nuevas,2016-07-01,1,0,6,6,0,13
PAILON,"anticoncepcion, prevencion de its y de cancer de cuello uterino",pildora: usuarias nuevas,2016-07-01,0,2,7,5,0,14
PALOS BLANCOS,"anticoncepcion, prevencion de its y de cancer de cuello uterino",pildora: usuarias nuevas,2016-07-01,0,0,4,0,0,4
PAMPA AULLAGAS,"anticoncepcion, prevencion de its y de cancer de cuello uterino",pildora: usuarias nuevas,2016-07-01,0,0,1,0,0,1
PAMPA GRANDE,"anticoncepcion, prevencion de its y de cancer de cuello uterino",pildora: usuarias nuevas,2016-07-01,0,1,1,0,0,2
PAPEL PAMPA,"anticoncepcion, prevencion de its y de cancer de cuello uterino",pildora: usuarias nuevas,2016-07-01,0,0,1,1,0,2
PATACAMAYA,"anticoncepcion, prevencion de its y de cancer de cuello uterino",pildora: usuarias nuevas,2016-07-01,0,0,1,0,0,1
PAZÑA,"anticoncepcion, prevencion de its y de cancer de cuello uterino",pildora: usuarias nuevas,2016-07-01,0,1,5,2,0,8
PELECHUCO,"anticoncepcion, prevencion de its y de cancer de cuello uterino",pildora: usuarias nuevas,2016-07-01,0,0,4,0,0,4
POCONA,"anticoncepcion, prevencion de its y de cancer de cuello uterino",pildora: usuarias nuevas,2016-07-01,0,2,1,1,0,4
PORONGO,"anticoncepcion, prevencion de its y de cancer de cuello uterino",pildora: usuarias nuevas,2016-07-01,0,3,13,0,0,16
PORTACHUELO,"anticoncepcion, prevencion de its y de cancer de cuello uterino",pildora: usuarias nuevas,2016-07-01,0,0,1,0,0,1
PORVENIR,"anticoncepcion, prevencion de its y de cancer de cuello uterino",pildora: usuarias nuevas,2016-07-01,0,2,2,0,0,4
POTOSI,"anticoncepcion, prevencion de its y de cancer de cuello uterino",pildora: usuarias nuevas,2016-07-01,0,4,38,8,0,50
PRESTO,"anticoncepcion, prevencion de its y de cancer de cuello uterino",pildora: usuarias nuevas,2016-07-01,0,0,1,0,0,1
PUCARANI,"anticoncepcion, prevencion de its y de cancer de cuello uterino",pildora: usuarias nuevas,2016-07-01,0,0,1,0,0,1
PUERTO ACOSTA,"anticoncepcion, prevencion de its y de cancer de cuello uterino",pildora: usuarias nuevas,2016-07-01,0,0,0,1,0,1
PUERTO CARABUCO,"anticoncepcion, prevencion de its y de cancer de cuello uterino",pildora: usuarias nuevas,2016-07-01,0,0,0,1,0,1
PUERTO GONZALO MORENO,"anticoncepcion, prevencion de its y de cancer de cuello uterino",pildora: usuarias nuevas,2016-07-01,0,1,1,0,0,2
PUERTO QUIJARRO,"anticoncepcion, prevencion de its y de cancer de cuello uterino",pildora: usuarias nuevas,2016-07-01,0,1,2,0,0,3
PUERTO SILES,"anticoncepcion, prevencion de its y de cancer de cuello uterino",pildora: usuarias nuevas,2016-07-01,1,1,2,1,0,5
PUERTO SUAREZ,"anticoncepcion, prevencion de its y de cancer de cuello uterino",pildora: usuarias nuevas,2016-07-01,0,0,1,0,0,1
PUERTO VILLARROEL,"anticoncepcion, prevencion de its y de cancer de cuello uterino",pildora: usuarias nuevas,2016-07-01,0,0,7,1,0,8
PUNATA,"anticoncepcion, prevencion de its y de cancer de cuello uterino",pildora: usuarias nuevas,2016-07-01,0,3,2,0,0,5
QUILLACOLLO,"anticoncepcion, prevencion de its y de cancer de cuello uterino",pildora: usuarias nuevas,2016-07-01,0,2,26,3,0,31
QUIME,"anticoncepcion, prevencion de its y de cancer de cuello uterino",pildora: usuarias nuevas,2016-07-01,0,0,1,0,0,1
RAVELO,"anticoncepcion, prevencion de its y de cancer de cuello uterino",pildora: usuarias nuevas,2016-07-01,0,0,1,0,1,2
REYES,"anticoncepcion, prevencion de its y de cancer de cuello uterino",pildora: usuarias nuevas,2016-07-01,2,0,5,1,0,8
RIBERALTA,"anticoncepcion, prevencion de its y de cancer de cuello uterino",pildora: usuarias nuevas,2016-07-01,1,9,74,8,0,92
ROBORE,"anticoncepcion, prevencion de its y de cancer de cuello uterino",pildora: usuarias nuevas,2016-07-01,0,1,8,0,1,10
RURRENABAQUE,"anticoncepcion, prevencion de its y de cancer de cuello uterino",pildora: usuarias nuevas,2016-07-01,0,0,2,1,0,3
SABAYA,"anticoncepcion, prevencion de its y de cancer de cuello uterino",pildora: usuarias nuevas,2016-07-01,0,0,1,0,0,1
SACABA,"anticoncepcion, prevencion de its y de cancer de cuello uterino",pildora: usuarias nuevas,2016-07-01,0,3,22,7,0,32
SACACA,"anticoncepcion, prevencion de its y de cancer de cuello uterino",pildora: usuarias nuevas,2016-07-01,0,0,4,2,0,6
SAIPINA,"anticoncepcion, prevencion de its y de cancer de cuello uterino",pildora: usuarias nuevas,2016-07-01,0,0,1,0,0,1
SALINAS DE GARCI MENDOZA,"anticoncepcion, prevencion de its y de cancer de cuello uterino",pildora: usuarias nuevas,2016-07-01,0,0,2,0,0,2
SAMAIPATA,"anticoncepcion, prevencion de its y de cancer de cuello uterino",pildora: usuarias nuevas,2016-07-01,0,0,2,1,0,3
SAN ANDRES,"anticoncepcion, prevencion de its y de cancer de cuello uterino",pildora: usuarias nuevas,2016-07-01,0,0,7,0,0,7
SAN ANDRES DE MACHACA,"anticoncepcion, prevencion de its y de cancer de cuello uterino",pildora: usuarias nuevas,2016-07-01,0,0,1,0,0,1
SAN ANTONIO DE LOMERIO,"anticoncepcion, prevencion de its y de cancer de cuello uterino",pildora: usuarias nuevas,2016-07-01,0,0,3,1,0,4
SAN BORJA,"anticoncepcion, prevencion de its y de cancer de cuello uterino",pildora: usuarias nuevas,2016-07-01,1,4,7,2,0,14
SAN CARLOS,"anticoncepcion, prevencion de its y de cancer de cuello uterino",pildora: usuarias nuevas,2016-07-01,0,0,4,1,0,5
SAN IGNACIO,"anticoncepcion, prevencion de its y de cancer de cuello uterino",pildora: usuarias nuevas,2016-07-01,1,1,13,1,0,16
SAN IGNACIO DE VELASCO,"anticoncepcion, prevencion de its y de cancer de cuello uterino",pildora: usuarias nuevas,2016-07-01,0,4,14,2,0,20
SAN JAVIER(BNI),"anticoncepcion, prevencion de its y de cancer de cuello uterino",pildora: usuarias nuevas,2016-07-01,0,0,8,3,0,11
SAN JAVIER(STC),"anticoncepcion, prevencion de its y de cancer de cuello uterino",pildora: usuarias nuevas,2016-07-01,0,1,11,1,0,13
SAN JOAQUIN,"anticoncepcion, prevencion de its y de cancer de cuello uterino",pildora: usuarias nuevas,2016-07-01,0,3,0,0,0,3
SAN JOSE DE CHIQUITOS,"anticoncepcion, prevencion de its y de cancer de cuello uterino",pildora: usuarias nuevas,2016-07-01,0,2,2,0,0,4
SAN JUAN DE YAPACANI,"anticoncepcion, prevencion de its y de cancer de cuello uterino",pildora: usuarias nuevas,2016-07-01,0,0,2,0,0,2
SAN JULIAN,"anticoncepcion, prevencion de its y de cancer de cuello uterino",pildora: usuarias nuevas,2016-07-01,0,2,9,3,0,14
SAN LORENZO(PND),"anticoncepcion, prevencion de its y de cancer de cuello uterino",pildora: usuarias nuevas,2016-07-01,0,1,1,0,0,2
SAN LORENZO(TJA),"anticoncepcion, prevencion de its y de cancer de cuello uterino",pildora: usuarias nuevas,2016-07-01,0,1,9,0,0,10
SAN LUCAS,"anticoncepcion, prevencion de its y de cancer de cuello uterino",pildora: usuarias nuevas,2016-07-01,0,0,1,2,0,3
SAN MATIAS,"anticoncepcion, prevencion de its y de cancer de cuello uterino",pildora: usuarias nuevas,2016-07-01,0,3,0,1,0,4
SAN MIGUEL DE VELASCO,"anticoncepcion, prevencion de its y de cancer de cuello uterino",pildora: usuarias nuevas,2016-07-01,0,0,2,0,0,2
SAN PEDRO,"anticoncepcion, prevencion de its y de cancer de cuello uterino",pildora: usuarias nuevas,2016-07-01,0,0,3,0,0,3
SAN PEDRO DE BUENA VISTA,"anticoncepcion, prevencion de its y de cancer de cuello uterino",pildora: usuarias nuevas,2016-07-01,0,0,1,0,0,1
SAN PEDRO DE QUEMES,"anticoncepcion, prevencion de its y de cancer de cuello uterino",pildora: usuarias nuevas,2016-07-01,0,0,0,1,0,1
SAN PEDRO DE TIQUINA,"anticoncepcion, prevencion de its y de cancer de cuello uterino",pildora: usuarias nuevas,2016-07-01,0,2,0,0,0,2
SAN RAFAEL,"anticoncepcion, prevencion de its y de cancer de cuello uterino",pildora: usuarias nuevas,2016-07-01,0,1,9,4,0,14
SAN RAMON BENI,"anticoncepcion, prevencion de its y de cancer de cuello uterino",pildora: usuarias nuevas,2016-07-01,0,3,5,0,0,8
SAN RAMON SCZ,"anticoncepcion, prevencion de its y de cancer de cuello uterino",pildora: usuarias nuevas,2016-07-01,0,0,2,1,0,3
SANTA ANA,"anticoncepcion, prevencion de its y de cancer de cuello uterino",pildora: usuarias nuevas,2016-07-01,0,1,13,9,0,23
SANTA CRUZ DE LA SIERRA,"anticoncepcion, prevencion de its y de cancer de cuello uterino",pildora: usuarias nuevas,2016-07-01,11,67,206,111,0,395
SANTA ROSA,"anticoncepcion, prevencion de its y de cancer de cuello uterino",pildora: usuarias nuevas,2016-07-01,0,1,0,0,0,1
SANTA ROSA DEL SARA,"anticoncepcion, prevencion de its y de cancer de cuello uterino",pildora: usuarias nuevas,2016-07-01,0,3,12,3,0,18
SANTIAGO DE HUARI,"anticoncepcion, prevencion de its y de cancer de cuello uterino",pildora: usuarias nuevas,2016-07-01,0,0,2,0,0,2
SANTIAGO DE MACHACA,"anticoncepcion, prevencion de its y de cancer de cuello uterino",pildora: usuarias nuevas,2016-07-01,0,1,0,0,0,1
SAPAHAQUI,"anticoncepcion, prevencion de its y de cancer de cuello uterino",pildora: usuarias nuevas,2016-07-01,0,0,0,1,0,1
SHINAOTA,"anticoncepcion, prevencion de its y de cancer de cuello uterino",pildora: usuarias nuevas,2016-07-01,0,1,1,0,0,2
SICA SICA (VILLA AROMA),"anticoncepcion, prevencion de its y de cancer de cuello uterino",pildora: usuarias nuevas,2016-07-01,0,0,1,1,0,2
SICAYA,"anticoncepcion, prevencion de its y de cancer de cuello uterino",pildora: usuarias nuevas,2016-07-01,0,0,1,0,0,1
SIPE SIPE,"anticoncepcion, prevencion de its y de cancer de cuello uterino",pildora: usuarias nuevas,2016-07-01,0,0,13,2,0,15
SOPACHUY,"anticoncepcion, prevencion de its y de cancer de cuello uterino",pildora: usuarias nuevas,2016-07-01,0,1,0,2,0,3
SORATA,"anticoncepcion, prevencion de its y de cancer de cuello uterino",pildora: usuarias nuevas,2016-07-01,0,0,4,0,0,4
SUCRE,"anticoncepcion, prevencion de its y de cancer de cuello uterino",pildora: usuarias nuevas,2016-07-01,0,13,53,23,0,89
TACACOMA,"anticoncepcion, prevencion de its y de cancer de cuello uterino",pildora: usuarias nuevas,2016-07-01,0,0,3,1,0,4
TAPACARI,"anticoncepcion, prevencion de its y de cancer de cuello uterino",pildora: usuarias nuevas,2016-07-01,0,3,1,1,0,5
TARACO,"anticoncepcion, prevencion de its y de cancer de cuello uterino",pildora: usuarias nuevas,2016-07-01,0,0,0,1,0,1
TARIJA,"anticoncepcion, prevencion de its y de cancer de cuello uterino",pildora: usuarias nuevas,2016-07-01,0,7,27,28,0,62
TARVITA,"anticoncepcion, prevencion de its y de cancer de cuello uterino",pildora: usuarias nuevas,2016-07-01,0,1,5,0,0,6
TEOPONTE,"anticoncepcion, prevencion de its y de cancer de cuello uterino",pildora: usuarias nuevas,2016-07-01,0,0,1,0,0,1
TIAWANACU,"anticoncepcion, prevencion de its y de cancer de cuello uterino",pildora: usuarias nuevas,2016-07-01,0,1,1,1,0,3
TIPUANI,"anticoncepcion, prevencion de its y de cancer de cuello uterino",pildora: usuarias nuevas,2016-07-01,0,0,1,0,0,1
TIQUIPAYA,"anticoncepcion, prevencion de its y de cancer de cuello uterino",pildora: usuarias nuevas,2016-07-01,0,2,13,5,0,20
TOLATA,"anticoncepcion, prevencion de its y de cancer de cuello uterino",pildora: usuarias nuevas,2016-07-01,0,0,2,0,0,2
TOMINA,"anticoncepcion, prevencion de its y de cancer de cuello uterino",pildora: usuarias nuevas,2016-07-01,0,4,2,0,0,6
TORO TORO,"anticoncepcion, prevencion de its y de cancer de cuello uterino",pildora: usuarias nuevas,2016-07-01,0,1,10,5,0,16
TOTORA(CBBA),"anticoncepcion, prevencion de its y de cancer de cuello uterino",pildora: usuarias nuevas,2016-07-01,0,0,1,0,0,1
TOTORA(ORR),"anticoncepcion, prevencion de its y de cancer de cuello uterino",pildora: usuarias nuevas,2016-07-01,0,0,2,0,0,2
TRINIDAD,"anticoncepcion, prevencion de its y de cancer de cuello uterino",pildora: usuarias nuevas,2016-07-01,0,4,13,4,0,21
TUPIZA,"anticoncepcion, prevencion de its y de cancer de cuello uterino",pildora: usuarias nuevas,2016-07-01,0,4,4,0,0,8
TURCO,"anticoncepcion, prevencion de its y de cancer de cuello uterino",pildora: usuarias nuevas,2016-07-01,0,0,0,1,0,1
UNCIA,"anticoncepcion, prevencion de its y de cancer de cuello uterino",pildora: usuarias nuevas,2016-07-01,0,2,2,0,0,4
URIONDO (A. CONCEPCION),"anticoncepcion, prevencion de its y de cancer de cuello uterino",pildora: usuarias nuevas,2016-07-01,0,1,2,0,0,3
URUBICHA,"anticoncepcion, prevencion de its y de cancer de cuello uterino",pildora: usuarias nuevas,2016-07-01,0,0,2,1,0,3
UYUNI,"anticoncepcion, prevencion de its y de cancer de cuello uterino",pildora: usuarias nuevas,2016-07-01,0,3,2,0,0,5
VACAS,"anticoncepcion, prevencion de its y de cancer de cuello uterino",pildora: usuarias nuevas,2016-07-01,0,0,1,1,0,2
VALLEGRANDE,"anticoncepcion, prevencion de its y de cancer de cuello uterino",pildora: usuarias nuevas,2016-07-01,0,1,1,0,0,2
VIACHA,"anticoncepcion, prevencion de its y de cancer de cuello uterino",pildora: usuarias nuevas,2016-07-01,0,3,14,2,0,19
VILA VILA,"anticoncepcion, prevencion de its y de cancer de cuello uterino",pildora: usuarias nuevas,2016-07-01,0,1,1,0,0,2
VILLA CHARCAS,"anticoncepcion, prevencion de its y de cancer de cuello uterino",pildora: usuarias nuevas,2016-07-01,0,0,3,0,0,3
VILLA MONTES,"anticoncepcion, prevencion de its y de cancer de cuello uterino",pildora: usuarias nuevas,2016-07-01,0,2,4,1,0,7
VILLA SERRANO,"anticoncepcion, prevencion de its y de cancer de cuello uterino",pildora: usuarias nuevas,2016-07-01,0,1,1,0,0,2
VILLA TUNARI,"anticoncepcion, prevencion de its y de cancer de cuello uterino",pildora: usuarias nuevas,2016-07-01,0,8,18,11,0,37
VILLA VACA GUZMAN (MUYUPAMPA),"anticoncepcion, prevencion de its y de cancer de cuello uterino",pildora: usuarias nuevas,2016-07-01,0,1,2,0,0,3
VILLAZON,"anticoncepcion, prevencion de its y de cancer de cuello uterino",pildora: usuarias nuevas,2016-07-01,0,1,3,1,0,5
VINTO,"anticoncepcion, prevencion de its y de cancer de cuello uterino",pildora: usuarias nuevas,2016-07-01,0,1,6,0,0,7
WALDO BALLIVIAN,"anticoncepcion, prevencion de its y de cancer de cuello uterino",pildora: usuarias nuevas,2016-07-01,0,0,0,1,0,1
WARNES,"anticoncepcion, prevencion de its y de cancer de cuello uterino",pildora: usuarias nuevas,2016-07-01,0,4,15,4,0,23
YACO,"anticoncepcion, prevencion de its y de cancer de cuello uterino",pildora: usuarias nuevas,2016-07-01,0,0,1,1,0,2
YACUIBA,"anticoncepcion, prevencion de its y de cancer de cuello uterino",pildora: usuarias nuevas,2016-07-01,0,4,7,4,0,15
YAPACANI,"anticoncepcion, prevencion de its y de cancer de cuello uterino",pildora: usuarias nuevas,2016-07-01,0,5,23,4,0,32
YOCALLA,"anticoncepcion, prevencion de its y de cancer de cuello uterino",pildora: usuarias nuevas,2016-07-01,0,1,0,1,0,2
YOTALA,"anticoncepcion, prevencion de its y de cancer de cuello uterino",pildora: usuarias nuevas,2016-07-01,0,0,1,0,0,1
YUNCHARA,"anticoncepcion, prevencion de its y de cancer de cuello uterino",pildora: usuarias nuevas,2016-07-01,0,1,0,0,0,1
ACACIO,"anticoncepcion, prevencion de its y de cancer de cuello uterino",pildora: usuarias nuevas,2016-08-01,0,1,0,0,0,1
ACHACACHI,"anticoncepcion, prevencion de its y de cancer de cuello uterino",pildora: usuarias nuevas,2016-08-01,0,0,1,0,0,1
ACHOCALLA,"anticoncepcion, prevencion de its y de cancer de cuello uterino",pildora: usuarias nuevas,2016-08-01,0,1,2,1,0,4
AIQUILE,"anticoncepcion, prevencion de its y de cancer de cuello uterino",pildora: usuarias nuevas,2016-08-01,0,2,3,4,0,9
ALCALA,"anticoncepcion, prevencion de its y de cancer de cuello uterino",pildora: usuarias nuevas,2016-08-01,0,0,1,1,0,2
ALTO BENI,"anticoncepcion, prevencion de its y de cancer de cuello uterino",pildora: usuarias nuevas,2016-08-01,0,0,2,0,0,2
ANDAMARCA,"anticoncepcion, prevencion de its y de cancer de cuello uterino",pildora: usuarias nuevas,2016-08-01,0,0,0,3,0,3
APOLO,"anticoncepcion, prevencion de its y de cancer de cuello uterino",pildora: usuarias nuevas,2016-08-01,0,3,2,0,0,5
ARAMPAMPA,"anticoncepcion, prevencion de its y de cancer de cuello uterino",pildora: usuarias nuevas,2016-08-01,0,0,1,1,0,2
ARBIETO,"anticoncepcion, prevencion de its y de cancer de cuello uterino",pildora: usuarias nuevas,2016-08-01,0,1,5,0,0,6
ARQUE,"anticoncepcion, prevencion de its y de cancer de cuello uterino",pildora: usuarias nuevas,2016-08-01,0,0,2,0,0,2
ASCENCION DE GUARAYOS,"anticoncepcion, prevencion de its y de cancer de cuello uterino",pildora: usuarias nuevas,2016-08-01,0,2,15,2,0,19
ATOCHA,"anticoncepcion, prevencion de its y de cancer de cuello uterino",pildora: usuarias nuevas,2016-08-01,0,1,4,3,0,8
AUCAPATA,"anticoncepcion, prevencion de its y de cancer de cuello uterino",pildora: usuarias nuevas,2016-08-01,0,2,0,0,0,2
AYATA,"anticoncepcion, prevencion de its y de cancer de cuello uterino",pildora: usuarias nuevas,2016-08-01,0,0,1,0,0,1
AYO AYO,"anticoncepcion, prevencion de its y de cancer de cuello uterino",pildora: usuarias nuevas,2016-08-01,0,0,1,1,0,2
AYOPAYA (V. DE INDEPENDENCIA),"anticoncepcion, prevencion de its y de cancer de cuello uterino",pildora: usuarias nuevas,2016-08-01,0,0,1,0,0,1
AZURDUY,"anticoncepcion, prevencion de its y de cancer de cuello uterino",pildora: usuarias nuevas,2016-08-01,1,0,2,0,0,3
BATALLAS,"anticoncepcion, prevencion de its y de cancer de cuello uterino",pildora: usuarias nuevas,2016-08-01,0,0,1,0,0,1
BAURES,"anticoncepcion, prevencion de its y de cancer de cuello uterino",pildora: usuarias nuevas,2016-08-01,0,0,1,0,0,1
BELLA FLOR,"anticoncepcion, prevencion de its y de cancer de cuello uterino",pildora: usuarias nuevas,2016-08-01,0,1,2,0,0,3
BERMEJO,"anticoncepcion, prevencion de its y de cancer de cuello uterino",pildora: usuarias nuevas,2016-08-01,0,5,9,0,0,14
BETANZOS,"anticoncepcion, prevencion de its y de cancer de cuello uterino",pildora: usuarias nuevas,2016-08-01,0,0,1,1,0,2
BOLPEBRA,"anticoncepcion, prevencion de its y de cancer de cuello uterino",pildora: usuarias nuevas,2016-08-01,0,1,0,0,0,1
BOYUIBE,"anticoncepcion, prevencion de its y de cancer de cuello uterino",pildora: usuarias nuevas,2016-08-01,0,0,1,0,0,1
BUENA VISTA,"anticoncepcion, prevencion de its y de cancer de cuello uterino",pildora: usuarias nuevas,2016-08-01,0,3,8,3,0,14
CABEZAS,"anticoncepcion, prevencion de its y de cancer de cuello uterino",pildora: usuarias nuevas,2016-08-01,0,4,11,3,0,18
CAIROMA,"anticoncepcion, prevencion de its y de cancer de cuello uterino",pildora: usuarias nuevas,2016-08-01,0,0,1,0,0,1
"CAIZA ""D""","anticoncepcion, prevencion de its y de cancer de cuello uterino",pildora: usuarias nuevas,2016-08-01,0,0,2,2,0,4
CAJUATA,"anticoncepcion, prevencion de its y de cancer de cuello uterino",pildora: usuarias nuevas,2016-08-01,0,0,1,0,0,1
CALAMARCA,"anticoncepcion, prevencion de its y de cancer de cuello uterino",pildora: usuarias nuevas,2016-08-01,0,1,4,0,0,5
CAMARGO,"anticoncepcion, prevencion de its y de cancer de cuello uterino",pildora: usuarias nuevas,2016-08-01,0,0,1,1,0,2
CAMATAQUI (C. VILLA ABECIA),"anticoncepcion, prevencion de its y de cancer de cuello uterino",pildora: usuarias nuevas,2016-08-01,0,0,0,1,0,1
CAMIRI,"anticoncepcion, prevencion de its y de cancer de cuello uterino",pildora: usuarias nuevas,2016-08-01,0,0,2,1,0,3
CAPINOTA,"anticoncepcion, prevencion de its y de cancer de cuello uterino",pildora: usuarias nuevas,2016-08-01,0,0,1,1,0,2
CAQUIAVIRI,"anticoncepcion, prevencion de its y de cancer de cuello uterino",pildora: usuarias nuevas,2016-08-01,0,0,0,1,0,1
CARACOLLO,"anticoncepcion, prevencion de its y de cancer de cuello uterino",pildora: usuarias nuevas,2016-08-01,0,0,1,0,0,1
CARANAVI,"anticoncepcion, prevencion de its y de cancer de cuello uterino",pildora: usuarias nuevas,2016-08-01,0,5,10,1,0,16
CARAPARI,"anticoncepcion, prevencion de its y de cancer de cuello uterino",pildora: usuarias nuevas,2016-08-01,0,2,2,0,0,4
CARIPUYO,"anticoncepcion, prevencion de its y de cancer de cuello uterino",pildora: usuarias nuevas,2016-08-01,0,1,2,3,0,6
CARMEN RIVERO TORREZ,"anticoncepcion, prevencion de its y de cancer de cuello uterino",pildora: usuarias nuevas,2016-08-01,0,1,1,1,0,3
CATACORA,"anticoncepcion, prevencion de its y de cancer de cuello uterino",pildora: usuarias nuevas,2016-08-01,0,0,1,0,0,1
CHACARILLA,"anticoncepcion, prevencion de its y de cancer de cuello uterino",pildora: usuarias nuevas,2016-08-01,0,0,1,0,0,1
CHALLAPATA,"anticoncepcion, prevencion de its y de cancer de cuello uterino",pildora: usuarias nuevas,2016-08-01,0,0,2,0,0,2
CHARAGUA,"anticoncepcion, prevencion de its y de cancer de cuello uterino",pildora: usuarias nuevas,2016-08-01,0,2,4,3,0,9
CHAYANTA,"anticoncepcion, prevencion de its y de cancer de cuello uterino",pildora: usuarias nuevas,2016-08-01,0,1,0,1,0,2
CHIMORE,"anticoncepcion, prevencion de its y de cancer de cuello uterino",pildora: usuarias nuevas,2016-08-01,0,2,7,2,0,11
CHUA COCANI,"anticoncepcion, prevencion de its y de cancer de cuello uterino",pildora: usuarias nuevas,2016-08-01,0,0,0,1,0,1
CHULUMANI (V. DE LA LIBERTAD),"anticoncepcion, prevencion de its y de cancer de cuello uterino",pildora: usuarias nuevas,2016-08-01,0,0,2,0,0,2
CHUMA,"anticoncepcion, prevencion de its y de cancer de cuello uterino",pildora: usuarias nuevas,2016-08-01,0,1,0,1,0,2
CHUQUIHUTA AYLLU JUCUMANI,"anticoncepcion, prevencion de its y de cancer de cuello uterino",pildora: usuarias nuevas,2016-08-01,0,0,2,0,0,2
CLIZA,"anticoncepcion, prevencion de its y de cancer de cuello uterino",pildora: usuarias nuevas,2016-08-01,0,2,4,0,0,6
COBIJA,"anticoncepcion, prevencion de its y de cancer de cuello uterino",pildora: usuarias nuevas,2016-08-01,0,0,6,2,0,8
COCAPATA,"anticoncepcion, prevencion de its y de cancer de cuello uterino",pildora: usuarias nuevas,2016-08-01,0,4,3,0,0,7
COCHABAMBA,"anticoncepcion, prevencion de its y de cancer de cuello uterino",pildora: usuarias nuevas,2016-08-01,45,12,116,33,0,206
COIPASA,"anticoncepcion, prevencion de its y de cancer de cuello uterino",pildora: usuarias nuevas,2016-08-01,0,0,1,0,0,1
COLCAPIRHUA,"anticoncepcion, prevencion de its y de cancer de cuello uterino",pildora: usuarias nuevas,2016-08-01,0,1,12,0,0,13
"COLCHA ""K""","anticoncepcion, prevencion de its y de cancer de cuello uterino",pildora: usuarias nuevas,2016-08-01,0,0,3,0,0,3
COLOMI,"anticoncepcion, prevencion de its y de cancer de cuello uterino",pildora: usuarias nuevas,2016-08-01,0,1,2,0,0,3
COLPA BELGICA,"anticoncepcion, prevencion de its y de cancer de cuello uterino",pildora: usuarias nuevas,2016-08-01,0,1,5,0,0,6
COLQUECHACA,"anticoncepcion, prevencion de its y de cancer de cuello uterino",pildora: usuarias nuevas,2016-08-01,0,0,3,0,0,3
COLQUENCHA,"anticoncepcion, prevencion de its y de cancer de cuello uterino",pildora: usuarias nuevas,2016-08-01,0,0,2,2,0,4
COLQUIRI,"anticoncepcion, prevencion de its y de cancer de cuello uterino",pildora: usuarias nuevas,2016-08-01,0,1,3,1,0,5
COMANCHE,"anticoncepcion, prevencion de its y de cancer de cuello uterino",pildora: usuarias nuevas,2016-08-01,0,0,1,1,0,2
COMARAPA,"anticoncepcion, prevencion de its y de cancer de cuello uterino",pildora: usuarias nuevas,2016-08-01,0,0,6,1,0,7
COMBAYA,"anticoncepcion, prevencion de its y de cancer de cuello uterino",pildora: usuarias nuevas,2016-08-01,0,0,1,0,0,1
CONCEPCION,"anticoncepcion, prevencion de its y de cancer de cuello uterino",pildora: usuarias nuevas,2016-08-01,0,1,3,1,0,5
COPACABANA,"anticoncepcion, prevencion de its y de cancer de cuello uterino",pildora: usuarias nuevas,2016-08-01,0,1,3,0,0,4
CORIPATA,"anticoncepcion, prevencion de its y de cancer de cuello uterino",pildora: usuarias nuevas,2016-08-01,0,0,4,0,0,4
CORO CORO,"anticoncepcion, prevencion de its y de cancer de cuello uterino",pildora: usuarias nuevas,2016-08-01,0,0,1,0,0,1
COROICO,"anticoncepcion, prevencion de its y de cancer de cuello uterino",pildora: usuarias nuevas,2016-08-01,0,0,1,0,0,1
CORQUE,"anticoncepcion, prevencion de its y de cancer de cuello uterino",pildora: usuarias nuevas,2016-08-01,0,0,0,1,0,1
COTOCA,"anticoncepcion, prevencion de its y de cancer de cuello uterino",pildora: usuarias nuevas,2016-08-01,0,10,21,5,0,36
CRUZ DE MACHACAMARCA,"anticoncepcion, prevencion de its y de cancer de cuello uterino",pildora: usuarias nuevas,2016-08-01,0,0,1,0,0,1
CUATRO CAÑADAS,"anticoncepcion, prevencion de its y de cancer de cuello uterino",pildora: usuarias nuevas,2016-08-01,0,2,3,0,0,5
CUEVO,"anticoncepcion, prevencion de its y de cancer de cuello uterino",pildora: usuarias nuevas,2016-08-01,0,0,2,0,0,2
CULPINA,"anticoncepcion, prevencion de its y de cancer de cuello uterino",pildora: usuarias nuevas,2016-08-01,0,2,12,3,0,17
CURAHUARA DE CARANGAS,"anticoncepcion, prevencion de its y de cancer de cuello uterino",pildora: usuarias nuevas,2016-08-01,0,0,1,0,0,1
CURVA,"anticoncepcion, prevencion de its y de cancer de cuello uterino",pildora: usuarias nuevas,2016-08-01,0,0,1,0,0,1
DESAGUADERO,"anticoncepcion, prevencion de its y de cancer de cuello uterino",pildora: usuarias nuevas,2016-08-01,0,0,1,0,0,1
EL ALTO,"anticoncepcion, prevencion de its y de cancer de cuello uterino",pildora: usuarias nuevas,2016-08-01,0,10,106,36,1,153
EL PUENTE(STC),"anticoncepcion, prevencion de its y de cancer de cuello uterino",pildora: usuarias nuevas,2016-08-01,0,1,3,1,0,5
EL PUENTE(TJA),"anticoncepcion, prevencion de its y de cancer de cuello uterino",pildora: usuarias nuevas,2016-08-01,0,1,2,0,0,3
EL TORNO,"anticoncepcion, prevencion de its y de cancer de cuello uterino",pildora: usuarias nuevas,2016-08-01,2,8,13,4,2,29
EL VILLAR,"anticoncepcion, prevencion de its y de cancer de cuello uterino",pildora: usuarias nuevas,2016-08-01,0,1,1,2,0,4
ENTRE RIOS TRJ,"anticoncepcion, prevencion de its y de cancer de cuello uterino",pildora: usuarias nuevas,2016-08-01,0,27,7,5,0,39
ENTRE RIOS CBBA,"anticoncepcion, prevencion de its y de cancer de cuello uterino",pildora: usuarias nuevas,2016-08-01,1,2,4,0,0,7
ESCARA,"anticoncepcion, prevencion de its y de cancer de cuello uterino",pildora: usuarias nuevas,2016-08-01,0,0,3,0,0,3
EUCALIPTUS,"anticoncepcion, prevencion de its y de cancer de cuello uterino",pildora: usuarias nuevas,2016-08-01,0,1,1,0,0,2
EXALTACION,"anticoncepcion, prevencion de its y de cancer de cuello uterino",pildora: usuarias nuevas,2016-08-01,0,2,6,1,0,9
FERNANDEZ ALONSO,"anticoncepcion, prevencion de its y de cancer de cuello uterino",pildora: usuarias nuevas,2016-08-01,0,1,3,2,0,6
FILADELFIA,"anticoncepcion, prevencion de its y de cancer de cuello uterino",pildora: usuarias nuevas,2016-08-01,0,0,1,0,0,1
GENERAL SAAVEDRA,"anticoncepcion, prevencion de its y de cancer de cuello uterino",pildora: usuarias nuevas,2016-08-01,0,1,7,2,0,10
GRAL. J.J. PEREZ (CHARAZANI),"anticoncepcion, prevencion de its y de cancer de cuello uterino",pildora: usuarias nuevas,2016-08-01,0,0,0,3,0,3
GUANAY,"anticoncepcion, prevencion de its y de cancer de cuello uterino",pildora: usuarias nuevas,2016-08-01,0,1,0,1,0,2
GUAQUI,"anticoncepcion, prevencion de its y de cancer de cuello uterino",pildora: usuarias nuevas,2016-08-01,0,0,1,1,0,2
GUAYARAMERIN,"anticoncepcion, prevencion de its y de cancer de cuello uterino",pildora: usuarias nuevas,2016-08-01,0,4,11,1,0,16
GUTIERREZ,"anticoncepcion, prevencion de its y de cancer de cuello uterino",pildora: usuarias nuevas,2016-08-01,0,2,5,2,0,9
HUACARETA,"anticoncepcion, prevencion de its y de cancer de cuello uterino",pildora: usuarias nuevas,2016-08-01,0,2,3,2,0,7
HUANUNI,"anticoncepcion, prevencion de its y de cancer de cuello uterino",pildora: usuarias nuevas,2016-08-01,0,0,3,1,0,4
HUARACAJE,"anticoncepcion, prevencion de its y de cancer de cuello uterino",pildora: usuarias nuevas,2016-08-01,0,0,2,1,0,3
ICLA,"anticoncepcion, prevencion de its y de cancer de cuello uterino",pildora: usuarias nuevas,2016-08-01,0,2,0,0,0,2
INCAHUASI,"anticoncepcion, prevencion de its y de cancer de cuello uterino",pildora: usuarias nuevas,2016-08-01,0,1,1,0,0,2
INQUISIVI,"anticoncepcion, prevencion de its y de cancer de cuello uterino",pildora: usuarias nuevas,2016-08-01,0,0,1,0,0,1
IRUPANA (VILLA DE LANZA),"anticoncepcion, prevencion de its y de cancer de cuello uterino",pildora: usuarias nuevas,2016-08-01,0,0,5,1,0,6
IXIAMAS,"anticoncepcion, prevencion de its y de cancer de cuello uterino",pildora: usuarias nuevas,2016-08-01,0,1,1,0,0,2
JESUS DE MACHACA,"anticoncepcion, prevencion de its y de cancer de cuello uterino",pildora: usuarias nuevas,2016-08-01,0,0,0,1,0,1
LA ASUNTA,"anticoncepcion, prevencion de its y de cancer de cuello uterino",pildora: usuarias nuevas,2016-08-01,0,0,7,2,0,9
LA GUARDIA,"anticoncepcion, prevencion de its y de cancer de cuello uterino",pildora: usuarias nuevas,2016-08-01,0,6,19,3,0,28
LA PAZ,"anticoncepcion, prevencion de its y de cancer de cuello uterino",pildora: usuarias nuevas,2016-08-01,1,8,128,91,0,228
LAGUNILLAS,"anticoncepcion, prevencion de its y de cancer de cuello uterino",pildora: usuarias nuevas,2016-08-01,0,1,0,0,0,1
LAJA,"anticoncepcion, prevencion de its y de cancer de cuello uterino",pildora: usuarias nuevas,2016-08-01,0,0,0,2,0,2
LLALLAGUA,"anticoncepcion, prevencion de its y de cancer de cuello uterino",pildora: usuarias nuevas,2016-08-01,0,2,11,2,0,15
LLICA,"anticoncepcion, prevencion de its y de cancer de cuello uterino",pildora: usuarias nuevas,2016-08-01,0,1,1,0,0,2
LORETO,"anticoncepcion, prevencion de its y de cancer de cuello uterino",pildora: usuarias nuevas,2016-08-01,0,1,0,2,0,3
LURIBAY,"anticoncepcion, prevencion de its y de cancer de cuello uterino",pildora: usuarias nuevas,2016-08-01,0,0,0,1,0,1
MACHARETI,"anticoncepcion, prevencion de its y de cancer de cuello uterino",pildora: usuarias nuevas,2016-08-01,0,4,1,1,0,6
MAGDALENA,"anticoncepcion, prevencion de its y de cancer de cuello uterino",pildora: usuarias nuevas,2016-08-01,0,1,10,0,0,11
MAPIRI,"anticoncepcion, prevencion de its y de cancer de cuello uterino",pildora: usuarias nuevas,2016-08-01,0,0,2,1,0,3
MECAPACA,"anticoncepcion, prevencion de its y de cancer de cuello uterino",pildora: usuarias nuevas,2016-08-01,0,1,1,0,0,2
MINEROS,"anticoncepcion, prevencion de its y de cancer de cuello uterino",pildora: usuarias nuevas,2016-08-01,0,1,1,1,0,3
MIZQUE,"anticoncepcion, prevencion de its y de cancer de cuello uterino",pildora: usuarias nuevas,2016-08-01,0,2,3,2,0,7
MOJOCOYA,"anticoncepcion, prevencion de its y de cancer de cuello uterino",pildora: usuarias nuevas,2016-08-01,0,2,1,1,0,4
MONTEAGUDO,"anticoncepcion, prevencion de its y de cancer de cuello uterino",pildora: usuarias nuevas,2016-08-01,0,2,6,1,0,9
MONTERO,"anticoncepcion, prevencion de its y de cancer de cuello uterino",pildora: usuarias nuevas,2016-08-01,2,9,43,10,0,64
MORO MORO,"anticoncepcion, prevencion de its y de cancer de cuello uterino",pildora: usuarias nuevas,2016-08-01,0,0,0,1,0,1
MOROCHATA,"anticoncepcion, prevencion de its y de cancer de cuello uterino",pildora: usuarias nuevas,2016-08-01,0,0,1,1,0,2
OCURI,"anticoncepcion, prevencion de its y de cancer de cuello uterino",pildora: usuarias nuevas,2016-08-01,0,0,1,0,0,1
OKINAWA,"anticoncepcion, prevencion de its y de cancer de cuello uterino",pildora: usuarias nuevas,2016-08-01,0,2,2,0,0,4
OMEREQUE,"anticoncepcion, prevencion de its y de cancer de cuello uterino",pildora: usuarias nuevas,2016-08-01,0,0,1,0,0,1
ORURO,"anticoncepcion, prevencion de its y de cancer de cuello uterino",pildora: usuarias nuevas,2016-08-01,0,6,39,24,1,70
PADCAYA,"anticoncepcion, prevencion de its y de cancer de cuello uterino",pildora: usuarias nuevas,2016-08-01,1,1,6,1,0,9
PADILLA,"anticoncepcion, prevencion de its y de cancer de cuello uterino",pildora: usuarias nuevas,2016-08-01,0,4,4,2,0,10
PAILON,"anticoncepcion, prevencion de its y de cancer de cuello uterino",pildora: usuarias nuevas,2016-08-01,0,4,3,2,0,9
PALOS BLANCOS,"anticoncepcion, prevencion de its y de cancer de cuello uterino",pildora: usuarias nuevas,2016-08-01,0,1,5,0,0,6
PAMPA AULLAGAS,"anticoncepcion, prevencion de its y de cancer de cuello uterino",pildora: usuarias nuevas,2016-08-01,0,0,1,0,0,1
PAMPA GRANDE,"anticoncepcion, prevencion de its y de cancer de cuello uterino",pildora: usuarias nuevas,2016-08-01,0,1,0,0,0,1
PASORAPA,"anticoncepcion, prevencion de its y de cancer de cuello uterino",pildora: usuarias nuevas,2016-08-01,1,0,0,0,0,1
PATACAMAYA,"anticoncepcion, prevencion de its y de cancer de cuello uterino",pildora: usuarias nuevas,2016-08-01,0,0,2,0,0,2
PAZÑA,"anticoncepcion, prevencion de its y de cancer de cuello uterino",pildora: usuarias nuevas,2016-08-01,0,0,1,0,1,2
PELECHUCO,"anticoncepcion, prevencion de its y de cancer de cuello uterino",pildora: usuarias nuevas,2016-08-01,0,0,5,2,0,7
POCONA,"anticoncepcion, prevencion de its y de cancer de cuello uterino",pildora: usuarias nuevas,2016-08-01,0,1,10,0,0,11
POJO (CBBA),"anticoncepcion, prevencion de its y de cancer de cuello uterino",pildora: usuarias nuevas,2016-08-01,0,0,1,0,0,1
PORCO,"anticoncepcion, prevencion de its y de cancer de cuello uterino",pildora: usuarias nuevas,2016-08-01,0,1,2,1,0,4
POROMA,"anticoncepcion, prevencion de its y de cancer de cuello uterino",pildora: usuarias nuevas,2016-08-01,0,0,0,1,0,1
PORONGO,"anticoncepcion, prevencion de its y de cancer de cuello uterino",pildora: usuarias nuevas,2016-08-01,0,3,10,3,0,16
PORTACHUELO,"anticoncepcion, prevencion de its y de cancer de cuello uterino",pildora: usuarias nuevas,2016-08-01,0,2,3,0,0,5
PORVENIR,"anticoncepcion, prevencion de its y de cancer de cuello uterino",pildora: usuarias nuevas,2016-08-01,0,1,1,0,0,2
POTOSI,"anticoncepcion, prevencion de its y de cancer de cuello uterino",pildora: usuarias nuevas,2016-08-01,0,4,34,3,0,41
PRESTO,"anticoncepcion, prevencion de its y de cancer de cuello uterino",pildora: usuarias nuevas,2016-08-01,0,0,1,2,0,3
PUCARANI,"anticoncepcion, prevencion de its y de cancer de cuello uterino",pildora: usuarias nuevas,2016-08-01,0,1,2,0,0,3
PUERTO ACOSTA,"anticoncepcion, prevencion de its y de cancer de cuello uterino",pildora: usuarias nuevas,2016-08-01,0,1,1,0,0,2
PUERTO CARABUCO,"anticoncepcion, prevencion de its y de cancer de cuello uterino",pildora: usuarias nuevas,2016-08-01,0,0,0,1,0,1
PUERTO GONZALO MORENO,"anticoncepcion, prevencion de its y de cancer de cuello uterino",pildora: usuarias nuevas,2016-08-01,0,1,1,0,0,2
PUERTO PEREZ,"anticoncepcion, prevencion de its y de cancer de cuello uterino",pildora: usuarias nuevas,2016-08-01,0,0,1,0,0,1
PUERTO QUIJARRO,"anticoncepcion, prevencion de its y de cancer de cuello uterino",pildora: usuarias nuevas,2016-08-01,0,0,3,1,0,4
PUERTO RICO,"anticoncepcion, prevencion de its y de cancer de cuello uterino",pildora: usuarias nuevas,2016-08-01,0,2,1,0,0,3
PUERTO SILES,"anticoncepcion, prevencion de its y de cancer de cuello uterino",pildora: usuarias nuevas,2016-08-01,0,5,7,1,0,13
PUERTO SUAREZ,"anticoncepcion, prevencion de its y de cancer de cuello uterino",pildora: usuarias nuevas,2016-08-01,0,2,3,0,0,5
PUERTO VILLARROEL,"anticoncepcion, prevencion de its y de cancer de cuello uterino",pildora: usuarias nuevas,2016-08-01,0,2,20,1,0,23
PUNA,"anticoncepcion, prevencion de its y de cancer de cuello uterino",pildora: usuarias nuevas,2016-08-01,0,0,1,2,0,3
PUNATA,"anticoncepcion, prevencion de its y de cancer de cuello uterino",pildora: usuarias nuevas,2016-08-01,0,0,2,0,0,2
QUILLACOLLO,"anticoncepcion, prevencion de its y de cancer de cuello uterino",pildora: usuarias nuevas,2016-08-01,0,1,17,4,0,22
QUIME,"anticoncepcion, prevencion de its y de cancer de cuello uterino",pildora: usuarias nuevas,2016-08-01,0,0,3,1,0,4
RAVELO,"anticoncepcion, prevencion de its y de cancer de cuello uterino",pildora: usuarias nuevas,2016-08-01,0,0,1,0,0,1
REYES,"anticoncepcion, prevencion de its y de cancer de cuello uterino",pildora: usuarias nuevas,2016-08-01,0,3,11,5,0,19
RIBERALTA,"anticoncepcion, prevencion de its y de cancer de cuello uterino",pildora: usuarias nuevas,2016-08-01,0,24,64,21,0,109
ROBORE,"anticoncepcion, prevencion de its y de cancer de cuello uterino",pildora: usuarias nuevas,2016-08-01,0,2,3,0,0,5
RURRENABAQUE,"anticoncepcion, prevencion de its y de cancer de cuello uterino",pildora: usuarias nuevas,2016-08-01,0,1,2,2,0,5
SABAYA,"anticoncepcion, prevencion de its y de cancer de cuello uterino",pildora: usuarias nuevas,2016-08-01,0,0,1,1,0,2
SACABA,"anticoncepcion, prevencion de its y de cancer de cuello uterino",pildora: usuarias nuevas,2016-08-01,0,3,15,6,0,24
SACABAMBA,"anticoncepcion, prevencion de its y de cancer de cuello uterino",pildora: usuarias nuevas,2016-08-01,0,0,1,0,0,1
SACACA,"anticoncepcion, prevencion de its y de cancer de cuello uterino",pildora: usuarias nuevas,2016-08-01,0,0,1,1,0,2
SAIPINA,"anticoncepcion, prevencion de its y de cancer de cuello uterino",pildora: usuarias nuevas,2016-08-01,0,2,0,0,0,2
SALINAS DE GARCI MENDOZA,"anticoncepcion, prevencion de its y de cancer de cuello uterino",pildora: usuarias nuevas,2016-08-01,0,1,0,0,0,1
SAMAIPATA,"anticoncepcion, prevencion de its y de cancer de cuello uterino",pildora: usuarias nuevas,2016-08-01,0,0,0,1,0,1
SAN ANDRES,"anticoncepcion, prevencion de its y de cancer de cuello uterino",pildora: usuarias nuevas,2016-08-01,0,4,4,2,0,10
SAN ANTONIO DE ESMORUCO,"anticoncepcion, prevencion de its y de cancer de cuello uterino",pildora: usuarias nuevas,2016-08-01,0,0,1,0,0,1
SAN ANTONIO DE LOMERIO,"anticoncepcion, prevencion de its y de cancer de cuello uterino",pildora: usuarias nuevas,2016-08-01,0,1,9,2,0,12
SAN BORJA,"anticoncepcion, prevencion de its y de cancer de cuello uterino",pildora: usuarias nuevas,2016-08-01,2,4,11,3,0,20
SAN BUENA VENTURA,"anticoncepcion, prevencion de its y de cancer de cuello uterino",pildora: usuarias nuevas,2016-08-01,0,1,3,0,0,4
SAN CARLOS,"anticoncepcion, prevencion de its y de cancer de cuello uterino",pildora: usuarias nuevas,2016-08-01,0,2,12,1,0,15
SAN IGNACIO,"anticoncepcion, prevencion de its y de cancer de cuello uterino",pildora: usuarias nuevas,2016-08-01,0,6,19,4,0,29
SAN IGNACIO DE VELASCO,"anticoncepcion, prevencion de its y de cancer de cuello uterino",pildora: usuarias nuevas,2016-08-01,0,5,5,2,0,12
SAN JAVIER(BNI),"anticoncepcion, prevencion de its y de cancer de cuello uterino",pildora: usuarias nuevas,2016-08-01,0,1,7,1,0,9
SAN JAVIER(STC),"anticoncepcion, prevencion de its y de cancer de cuello uterino",pildora: usuarias nuevas,2016-08-01,0,2,2,0,0,4
SAN JOAQUIN,"anticoncepcion, prevencion de its y de cancer de cuello uterino",pildora: usuarias nuevas,2016-08-01,0,1,4,0,0,5
SAN JOSE DE CHIQUITOS,"anticoncepcion, prevencion de its y de cancer de cuello uterino",pildora: usuarias nuevas,2016-08-01,0,3,5,0,0,8
SAN JUAN DE YAPACANI,"anticoncepcion, prevencion de its y de cancer de cuello uterino",pildora: usuarias nuevas,2016-08-01,0,2,1,1,0,4
SAN JULIAN,"anticoncepcion, prevencion de its y de cancer de cuello uterino",pildora: usuarias nuevas,2016-08-01,0,4,6,4,0,14
SAN LORENZO(PND),"anticoncepcion, prevencion de its y de cancer de cuello uterino",pildora: usuarias nuevas,2016-08-01,1,2,6,1,0,10
SAN LORENZO(TJA),"anticoncepcion, prevencion de its y de cancer de cuello uterino",pildora: usuarias nuevas,2016-08-01,0,0,4,1,0,5
SAN LUCAS,"anticoncepcion, prevencion de its y de cancer de cuello uterino",pildora: usuarias nuevas,2016-08-01,0,2,1,0,0,3
SAN MATIAS,"anticoncepcion, prevencion de its y de cancer de cuello uterino",pildora: usuarias nuevas,2016-08-01,1,0,3,0,0,4
SAN PEDRO,"anticoncepcion, prevencion de its y de cancer de cuello uterino",pildora: usuarias nuevas,2016-08-01,0,1,10,0,0,11
SAN PEDRO DE CURAHUARA,"anticoncepcion, prevencion de its y de cancer de cuello uterino",pildora: usuarias nuevas,2016-08-01,0,0,1,0,0,1
SAN PEDRO DE TIQUINA,"anticoncepcion, prevencion de its y de cancer de cuello uterino",pildora: usuarias nuevas,2016-08-01,0,0,3,0,0,3
SAN RAFAEL,"anticoncepcion, prevencion de its y de cancer de cuello uterino",pildora: usuarias nuevas,2016-08-01,0,0,5,2,0,7
SAN RAMON SCZ,"anticoncepcion, prevencion de its y de cancer de cuello uterino",pildora: usuarias nuevas,2016-08-01,0,1,1,2,0,4
SANTA ANA,"anticoncepcion, prevencion de its y de cancer de cuello uterino",pildora: usuarias nuevas,2016-08-01,0,1,11,2,1,15
SANTA CRUZ DE LA SIERRA,"anticoncepcion, prevencion de its y de cancer de cuello uterino",pildora: usuarias nuevas,2016-08-01,6,66,207,75,5,359
SANTA ROSA DEL SARA,"anticoncepcion, prevencion de its y de cancer de cuello uterino",pildora: usuarias nuevas,2016-08-01,0,3,8,4,0,15
SANTIAGO DE HUATA,"anticoncepcion, prevencion de its y de cancer de cuello uterino",pildora: usuarias nuevas,2016-08-01,0,0,1,0,0,1
SANTIVAÑES,"anticoncepcion, prevencion de its y de cancer de cuello uterino",pildora: usuarias nuevas,2016-08-01,0,0,0,1,0,1
SAPAHAQUI,"anticoncepcion, prevencion de its y de cancer de cuello uterino",pildora: usuarias nuevas,2016-08-01,0,0,2,0,0,2
SENA,"anticoncepcion, prevencion de its y de cancer de cuello uterino",pildora: usuarias nuevas,2016-08-01,0,2,5,2,0,9
SHINAOTA,"anticoncepcion, prevencion de its y de cancer de cuello uterino",pildora: usuarias nuevas,2016-08-01,0,0,0,2,0,2
SICA SICA (VILLA AROMA),"anticoncepcion, prevencion de its y de cancer de cuello uterino",pildora: usuarias nuevas,2016-08-01,0,0,2,2,0,4
SIPE SIPE,"anticoncepcion, prevencion de its y de cancer de cuello uterino",pildora: usuarias nuevas,2016-08-01,0,2,16,5,0,23
SOPACHUY,"anticoncepcion, prevencion de its y de cancer de cuello uterino",pildora: usuarias nuevas,2016-08-01,0,1,2,1,0,4
SORACACHI,"anticoncepcion, prevencion de its y de cancer de cuello uterino",pildora: usuarias nuevas,2016-08-01,0,0,1,0,0,1
SORATA,"anticoncepcion, prevencion de its y de cancer de cuello uterino",pildora: usuarias nuevas,2016-08-01,0,0,1,1,0,2
SUCRE,"anticoncepcion, prevencion de its y de cancer de cuello uterino",pildora: usuarias nuevas,2016-08-01,0,19,60,7,0,86
TACACOMA,"anticoncepcion, prevencion de its y de cancer de cuello uterino",pildora: usuarias nuevas,2016-08-01,0,0,4,0,0,4
TAHUA,"anticoncepcion, prevencion de its y de cancer de cuello uterino",pildora: usuarias nuevas,2016-08-01,0,0,0,1,0,1
TAPACARI,"anticoncepcion, prevencion de its y de cancer de cuello uterino",pildora: usuarias nuevas,2016-08-01,0,0,2,1,0,3
TARABUCO,"anticoncepcion, prevencion de its y de cancer de cuello uterino",pildora: usuarias nuevas,2016-08-01,0,0,1,0,0,1
TARACO,"anticoncepcion, prevencion de its y de cancer de cuello uterino",pildora: usuarias nuevas,2016-08-01,0,0,1,0,0,1
TARIJA,"anticoncepcion, prevencion de its y de cancer de cuello uterino",pildora: usuarias nuevas,2016-08-01,0,14,34,9,0,57
TARVITA,"anticoncepcion, prevencion de its y de cancer de cuello uterino",pildora: usuarias nuevas,2016-08-01,0,0,0,2,0,2
TEOPONTE,"anticoncepcion, prevencion de its y de cancer de cuello uterino",pildora: usuarias nuevas,2016-08-01,0,0,1,0,0,1
TIAWANACU,"anticoncepcion, prevencion de its y de cancer de cuello uterino",pildora: usuarias nuevas,2016-08-01,0,1,4,1,0,6
TIPUANI,"anticoncepcion, prevencion de its y de cancer de cuello uterino",pildora: usuarias nuevas,2016-08-01,0,0,1,0,0,1
TIQUIPAYA,"anticoncepcion, prevencion de its y de cancer de cuello uterino",pildora: usuarias nuevas,2016-08-01,1,1,21,1,0,24
TOLATA,"anticoncepcion, prevencion de its y de cancer de cuello uterino",pildora: usuarias nuevas,2016-08-01,0,0,3,0,0,3
TOMAVE,"anticoncepcion, prevencion de its y de cancer de cuello uterino",pildora: usuarias nuevas,2016-08-01,0,0,1,2,0,3
TOMINA,"anticoncepcion, prevencion de its y de cancer de cuello uterino",pildora: usuarias nuevas,2016-08-01,0,2,1,1,0,4
TORO TORO,"anticoncepcion, prevencion de its y de cancer de cuello uterino",pildora: usuarias nuevas,2016-08-01,0,0,8,2,0,10
TOTORA(CBBA),"anticoncepcion, prevencion de its y de cancer de cuello uterino",pildora: usuarias nuevas,2016-08-01,0,0,1,2,0,3
TOTORA(ORR),"anticoncepcion, prevencion de its y de cancer de cuello uterino",pildora: usuarias nuevas,2016-08-01,0,1,2,0,0,3
TRINIDAD,"anticoncepcion, prevencion de its y de cancer de cuello uterino",pildora: usuarias nuevas,2016-08-01,0,2,14,8,0,24
TUPIZA,"anticoncepcion, prevencion de its y de cancer de cuello uterino",pildora: usuarias nuevas,2016-08-01,0,1,8,2,0,11
UNCIA,"anticoncepcion, prevencion de its y de cancer de cuello uterino",pildora: usuarias nuevas,2016-08-01,0,1,4,1,0,6
URIONDO (A. CONCEPCION),"anticoncepcion, prevencion de its y de cancer de cuello uterino",pildora: usuarias nuevas,2016-08-01,0,0,3,1,0,4
UYUNI,"anticoncepcion, prevencion de its y de cancer de cuello uterino",pildora: usuarias nuevas,2016-08-01,0,0,2,0,0,2
VACAS,"anticoncepcion, prevencion de its y de cancer de cuello uterino",pildora: usuarias nuevas,2016-08-01,0,0,2,0,0,2
VALLEGRANDE,"anticoncepcion, prevencion de its y de cancer de cuello uterino",pildora: usuarias nuevas,2016-08-01,0,2,4,12,0,18
VIACHA,"anticoncepcion, prevencion de its y de cancer de cuello uterino",pildora: usuarias nuevas,2016-08-01,0,1,5,2,0,8
VILA VILA,"anticoncepcion, prevencion de its y de cancer de cuello uterino",pildora: usuarias nuevas,2016-08-01,0,0,1,1,0,2
VILLA CHARCAS,"anticoncepcion, prevencion de its y de cancer de cuello uterino",pildora: usuarias nuevas,2016-08-01,0,0,1,2,0,3
VILLA MONTES,"anticoncepcion, prevencion de its y de cancer de cuello uterino",pildora: usuarias nuevas,2016-08-01,0,1,7,1,0,9
VILLA RIVERO,"anticoncepcion, prevencion de its y de cancer de cuello uterino",pildora: usuarias nuevas,2016-08-01,0,0,1,0,0,1
VILLA SERRANO,"anticoncepcion, prevencion de its y de cancer de cuello uterino",pildora: usuarias nuevas,2016-08-01,0,0,3,0,0,3
VILLA TUNARI,"anticoncepcion, prevencion de its y de cancer de cuello uterino",pildora: usuarias nuevas,2016-08-01,2,4,13,7,0,26
VILLA VACA GUZMAN (MUYUPAMPA),"anticoncepcion, prevencion de its y de cancer de cuello uterino",pildora: usuarias nuevas,2016-08-01,0,0,3,1,0,4
VILLAZON,"anticoncepcion, prevencion de its y de cancer de cuello uterino",pildora: usuarias nuevas,2016-08-01,0,1,1,0,0,2
VINTO,"anticoncepcion, prevencion de its y de cancer de cuello uterino",pildora: usuarias nuevas,2016-08-01,0,1,3,0,0,4
WALDO BALLIVIAN,"anticoncepcion, prevencion de its y de cancer de cuello uterino",pildora: usuarias nuevas,2016-08-01,0,0,0,1,0,1
WARNES,"anticoncepcion, prevencion de its y de cancer de cuello uterino",pildora: usuarias nuevas,2016-08-01,0,7,29,6,0,42
YACO,"anticoncepcion, prevencion de its y de cancer de cuello uterino",pildora: usuarias nuevas,2016-08-01,0,0,0,1,0,1
YACUIBA,"anticoncepcion, prevencion de its y de cancer de cuello uterino",pildora: usuarias nuevas,2016-08-01,0,3,18,2,0,23
YAMPARAEZ,"anticoncepcion, prevencion de its y de cancer de cuello uterino",pildora: usuarias nuevas,2016-08-01,0,0,0,1,0,1
YAPACANI,"anticoncepcion, prevencion de its y de cancer de cuello uterino",pildora: usuarias nuevas,2016-08-01,0,2,13,0,0,15
YOCALLA,"anticoncepcion, prevencion de its y de cancer de cuello uterino",pildora: usuarias nuevas,2016-08-01,0,0,2,2,0,4
YOTALA,"anticoncepcion, prevencion de its y de cancer de cuello uterino",pildora: usuarias nuevas,2016-08-01,0,1,2,0,0,3
YUNCHARA,"anticoncepcion, prevencion de its y de cancer de cuello uterino",pildora: usuarias nuevas,2016-08-01,0,0,1,0,0,1
ZUDAÑEZ,"anticoncepcion, prevencion de its y de cancer de cuello uterino",pildora: usuarias nuevas,2016-08-01,0,1,0,0,0,1
ACHACACHI,"anticoncepcion, prevencion de its y de cancer de cuello uterino",pildora: usuarias nuevas,2016-09-01,0,1,4,1,3,9
ACHOCALLA,"anticoncepcion, prevencion de its y de cancer de cuello uterino",pildora: usuarias nuevas,2016-09-01,0,0,3,0,0,3
AIQUILE,"anticoncepcion, prevencion de its y de cancer de cuello uterino",pildora: usuarias nuevas,2016-09-01,0,2,3,1,0,6
ALCALA,"anticoncepcion, prevencion de its y de cancer de cuello uterino",pildora: usuarias nuevas,2016-09-01,0,0,1,0,0,1
ALTO BENI,"anticoncepcion, prevencion de its y de cancer de cuello uterino",pildora: usuarias nuevas,2016-09-01,0,0,3,0,0,3
ANDAMARCA,"anticoncepcion, prevencion de its y de cancer de cuello uterino",pildora: usuarias nuevas,2016-09-01,0,0,0,1,0,1
APOLO,"anticoncepcion, prevencion de its y de cancer de cuello uterino",pildora: usuarias nuevas,2016-09-01,0,0,1,1,0,2
ARAMPAMPA,"anticoncepcion, prevencion de its y de cancer de cuello uterino",pildora: usuarias nuevas,2016-09-01,0,0,3,1,0,4
ARBIETO,"anticoncepcion, prevencion de its y de cancer de cuello uterino",pildora: usuarias nuevas,2016-09-01,0,4,4,3,0,11
ARQUE,"anticoncepcion, prevencion de its y de cancer de cuello uterino",pildora: usuarias nuevas,2016-09-01,0,0,1,0,0,1
ASCENCION DE GUARAYOS,"anticoncepcion, prevencion de its y de cancer de cuello uterino",pildora: usuarias nuevas,2016-09-01,0,0,9,1,0,10
ATOCHA,"anticoncepcion, prevencion de its y de cancer de cuello uterino",pildora: usuarias nuevas,2016-09-01,0,0,6,1,0,7
AUCAPATA,"anticoncepcion, prevencion de its y de cancer de cuello uterino",pildora: usuarias nuevas,2016-09-01,0,0,1,0,0,1
AYATA,"anticoncepcion, prevencion de its y de cancer de cuello uterino",pildora: usuarias nuevas,2016-09-01,0,0,0,2,0,2
AYOPAYA (V. DE INDEPENDENCIA),"anticoncepcion, prevencion de its y de cancer de cuello uterino",pildora: usuarias nuevas,2016-09-01,1,2,1,0,0,4
AZURDUY,"anticoncepcion, prevencion de its y de cancer de cuello uterino",pildora: usuarias nuevas,2016-09-01,0,0,3,0,0,3
BATALLAS,"anticoncepcion, prevencion de its y de cancer de cuello uterino",pildora: usuarias nuevas,2016-09-01,0,0,1,1,0,2
BAURES,"anticoncepcion, prevencion de its y de cancer de cuello uterino",pildora: usuarias nuevas,2016-09-01,0,0,2,0,0,2
BELLA FLOR,"anticoncepcion, prevencion de its y de cancer de cuello uterino",pildora: usuarias nuevas,2016-09-01,0,0,0,1,0,1
BERMEJO,"anticoncepcion, prevencion de its y de cancer de cuello uterino",pildora: usuarias nuevas,2016-09-01,0,3,10,1,0,14
BETANZOS,"anticoncepcion, prevencion de its y de cancer de cuello uterino",pildora: usuarias nuevas,2016-09-01,0,1,1,1,0,3
BOYUIBE,"anticoncepcion, prevencion de its y de cancer de cuello uterino",pildora: usuarias nuevas,2016-09-01,0,0,3,0,0,3
BUENA VISTA,"anticoncepcion, prevencion de its y de cancer de cuello uterino",pildora: usuarias nuevas,2016-09-01,0,1,10,2,0,13
CABEZAS,"anticoncepcion, prevencion de its y de cancer de cuello uterino",pildora: usuarias nuevas,2016-09-01,0,0,6,1,0,7
CAIROMA,"anticoncepcion, prevencion de its y de cancer de cuello uterino",pildora: usuarias nuevas,2016-09-01,0,0,3,0,0,3
CAJUATA,"anticoncepcion, prevencion de its y de cancer de cuello uterino",pildora: usuarias nuevas,2016-09-01,0,0,1,0,0,1
CALAMARCA,"anticoncepcion, prevencion de its y de cancer de cuello uterino",pildora: usuarias nuevas,2016-09-01,0,0,2,0,0,2
CAMARGO,"anticoncepcion, prevencion de its y de cancer de cuello uterino",pildora: usuarias nuevas,2016-09-01,0,3,5,0,0,8
CAMATAQUI (C. VILLA ABECIA),"anticoncepcion, prevencion de its y de cancer de cuello uterino",pildora: usuarias nuevas,2016-09-01,0,0,1,0,0,1
CAMIRI,"anticoncepcion, prevencion de its y de cancer de cuello uterino",pildora: usuarias nuevas,2016-09-01,0,0,2,0,0,2
CAPINOTA,"anticoncepcion, prevencion de its y de cancer de cuello uterino",pildora: usuarias nuevas,2016-09-01,0,0,0,1,0,1
CARACOLLO,"anticoncepcion, prevencion de its y de cancer de cuello uterino",pildora: usuarias nuevas,2016-09-01,0,0,1,0,0,1
CARANAVI,"anticoncepcion, prevencion de its y de cancer de cuello uterino",pildora: usuarias nuevas,2016-09-01,0,1,5,0,0,6
CARAPARI,"anticoncepcion, prevencion de its y de cancer de cuello uterino",pildora: usuarias nuevas,2016-09-01,0,0,2,1,0,3
CARMEN RIVERO TORREZ,"anticoncepcion, prevencion de its y de cancer de cuello uterino",pildora: usuarias nuevas,2016-09-01,0,0,1,0,0,1
CHACARILLA,"anticoncepcion, prevencion de its y de cancer de cuello uterino",pildora: usuarias nuevas,2016-09-01,0,0,1,0,0,1
CHALLAPATA,"anticoncepcion, prevencion de its y de cancer de cuello uterino",pildora: usuarias nuevas,2016-09-01,0,0,24,1,0,25
CHARAGUA,"anticoncepcion, prevencion de its y de cancer de cuello uterino",pildora: usuarias nuevas,2016-09-01,0,2,2,2,0,6
CHIMORE,"anticoncepcion, prevencion de its y de cancer de cuello uterino",pildora: usuarias nuevas,2016-09-01,0,0,9,0,0,9
CHULUMANI (V. DE LA LIBERTAD),"anticoncepcion, prevencion de its y de cancer de cuello uterino",pildora: usuarias nuevas,2016-09-01,0,0,4,0,0,4
CHUMA,"anticoncepcion, prevencion de its y de cancer de cuello uterino",pildora: usuarias nuevas,2016-09-01,0,0,0,1,0,1
CHUQUIHUTA AYLLU JUCUMANI,"anticoncepcion, prevencion de its y de cancer de cuello uterino",pildora: usuarias nuevas,2016-09-01,0,0,2,0,0,2
CKOCHAS,"anticoncepcion, prevencion de its y de cancer de cuello uterino",pildora: usuarias nuevas,2016-09-01,0,0,1,0,0,1
CLIZA,"anticoncepcion, prevencion de its y de cancer de cuello uterino",pildora: usuarias nuevas,2016-09-01,0,0,1,0,0,1
COBIJA,"anticoncepcion, prevencion de its y de cancer de cuello uterino",pildora: usuarias nuevas,2016-09-01,1,1,3,0,0,5
COCAPATA,"anticoncepcion, prevencion de its y de cancer de cuello uterino",pildora: usuarias nuevas,2016-09-01,0,14,1,2,0,17
COCHABAMBA,"anticoncepcion, prevencion de its y de cancer de cuello uterino",pildora: usuarias nuevas,2016-09-01,0,22,164,22,0,208
COIPASA,"anticoncepcion, prevencion de its y de cancer de cuello uterino",pildora: usuarias nuevas,2016-09-01,0,0,1,0,0,1
COLCAPIRHUA,"anticoncepcion, prevencion de its y de cancer de cuello uterino",pildora: usuarias nuevas,2016-09-01,0,1,4,1,0,6
"COLCHA ""K""","anticoncepcion, prevencion de its y de cancer de cuello uterino",pildora: usuarias nuevas,2016-09-01,0,0,2,0,0,2
COLOMI,"anticoncepcion, prevencion de its y de cancer de cuello uterino",pildora: usuarias nuevas,2016-09-01,0,1,5,0,0,6
COLPA BELGICA,"anticoncepcion, prevencion de its y de cancer de cuello uterino",pildora: usuarias nuevas,2016-09-01,0,1,0,0,0,1
COLQUECHACA,"anticoncepcion, prevencion de its y de cancer de cuello uterino",pildora: usuarias nuevas,2016-09-01,0,0,2,0,0,2
COLQUIRI,"anticoncepcion, prevencion de its y de cancer de cuello uterino",pildora: usuarias nuevas,2016-09-01,0,0,8,0,0,8
COMANCHE,"anticoncepcion, prevencion de its y de cancer de cuello uterino",pildora: usuarias nuevas,2016-09-01,0,0,0,1,0,1
COMARAPA,"anticoncepcion, prevencion de its y de cancer de cuello uterino",pildora: usuarias nuevas,2016-09-01,0,0,3,0,0,3
CONCEPCION,"anticoncepcion, prevencion de its y de cancer de cuello uterino",pildora: usuarias nuevas,2016-09-01,0,1,1,0,0,2
COPACABANA,"anticoncepcion, prevencion de its y de cancer de cuello uterino",pildora: usuarias nuevas,2016-09-01,0,0,2,0,0,2
CORIPATA,"anticoncepcion, prevencion de its y de cancer de cuello uterino",pildora: usuarias nuevas,2016-09-01,0,3,11,2,0,16
COTAGAITA,"anticoncepcion, prevencion de its y de cancer de cuello uterino",pildora: usuarias nuevas,2016-09-01,0,1,2,1,0,4
COTOCA,"anticoncepcion, prevencion de its y de cancer de cuello uterino",pildora: usuarias nuevas,2016-09-01,0,7,12,5,0,24
CUEVO,"anticoncepcion, prevencion de its y de cancer de cuello uterino",pildora: usuarias nuevas,2016-09-01,0,0,1,0,0,1
CULPINA,"anticoncepcion, prevencion de its y de cancer de cuello uterino",pildora: usuarias nuevas,2016-09-01,0,5,3,1,0,9
DESAGUADERO,"anticoncepcion, prevencion de its y de cancer de cuello uterino",pildora: usuarias nuevas,2016-09-01,0,0,1,0,0,1
EL ALTO,"anticoncepcion, prevencion de its y de cancer de cuello uterino",pildora: usuarias nuevas,2016-09-01,0,19,98,21,1,139
EL PUENTE(STC),"anticoncepcion, prevencion de its y de cancer de cuello uterino",pildora: usuarias nuevas,2016-09-01,0,0,23,0,0,23
EL PUENTE(TJA),"anticoncepcion, prevencion de its y de cancer de cuello uterino",pildora: usuarias nuevas,2016-09-01,0,0,2,0,0,2
EL TORNO,"anticoncepcion, prevencion de its y de cancer de cuello uterino",pildora: usuarias nuevas,2016-09-01,2,8,12,5,1,28
EL VILLAR,"anticoncepcion, prevencion de its y de cancer de cuello uterino",pildora: usuarias nuevas,2016-09-01,0,0,1,0,0,1
ENTRE RIOS TRJ,"anticoncepcion, prevencion de its y de cancer de cuello uterino",pildora: usuarias nuevas,2016-09-01,0,3,4,4,0,11
ENTRE RIOS CBBA,"anticoncepcion, prevencion de its y de cancer de cuello uterino",pildora: usuarias nuevas,2016-09-01,0,1,9,0,1,11
FERNANDEZ ALONSO,"anticoncepcion, prevencion de its y de cancer de cuello uterino",pildora: usuarias nuevas,2016-09-01,0,1,4,1,0,6
FILADELFIA,"anticoncepcion, prevencion de its y de cancer de cuello uterino",pildora: usuarias nuevas,2016-09-01,0,1,0,3,0,4
GENERAL SAAVEDRA,"anticoncepcion, prevencion de its y de cancer de cuello uterino",pildora: usuarias nuevas,2016-09-01,0,4,11,2,0,17
GRAL. J.J. PEREZ (CHARAZANI),"anticoncepcion, prevencion de its y de cancer de cuello uterino",pildora: usuarias nuevas,2016-09-01,0,0,2,1,0,3
GUANAY,"anticoncepcion, prevencion de its y de cancer de cuello uterino",pildora: usuarias nuevas,2016-09-01,0,0,1,0,0,1
GUAQUI,"anticoncepcion, prevencion de its y de cancer de cuello uterino",pildora: usuarias nuevas,2016-09-01,0,0,1,0,0,1
GUAYARAMERIN,"anticoncepcion, prevencion de its y de cancer de cuello uterino",pildora: usuarias nuevas,2016-09-01,0,2,12,4,1,19
GUTIERREZ,"anticoncepcion, prevencion de its y de cancer de cuello uterino",pildora: usuarias nuevas,2016-09-01,0,2,1,1,0,4
HUACARETA,"anticoncepcion, prevencion de its y de cancer de cuello uterino",pildora: usuarias nuevas,2016-09-01,0,2,3,1,0,6
HUACAYA (VILLA DE HUACAYA),"anticoncepcion, prevencion de its y de cancer de cuello uterino",pildora: usuarias nuevas,2016-09-01,0,0,1,0,0,1
HUARACAJE,"anticoncepcion, prevencion de its y de cancer de cuello uterino",pildora: usuarias nuevas,2016-09-01,0,0,7,0,0,7
INCAHUASI,"anticoncepcion, prevencion de its y de cancer de cuello uterino",pildora: usuarias nuevas,2016-09-01,0,0,1,0,0,1
INQUISIVI,"anticoncepcion, prevencion de its y de cancer de cuello uterino",pildora: usuarias nuevas,2016-09-01,0,0,1,1,0,2
IRUPANA (VILLA DE LANZA),"anticoncepcion, prevencion de its y de cancer de cuello uterino",pildora: usuarias nuevas,2016-09-01,1,3,1,0,0,5
IXIAMAS,"anticoncepcion, prevencion de its y de cancer de cuello uterino",pildora: usuarias nuevas,2016-09-01,0,0,5,0,0,5
JESUS DE MACHACA,"anticoncepcion, prevencion de its y de cancer de cuello uterino",pildora: usuarias nuevas,2016-09-01,0,0,1,0,0,1
LA ASUNTA,"anticoncepcion, prevencion de its y de cancer de cuello uterino",pildora: usuarias nuevas,2016-09-01,0,0,7,1,0,8
LA GUARDIA,"anticoncepcion, prevencion de its y de cancer de cuello uterino",pildora: usuarias nuevas,2016-09-01,0,8,17,7,0,32
LA PAZ,"anticoncepcion, prevencion de its y de cancer de cuello uterino",pildora: usuarias nuevas,2016-09-01,0,2,116,57,0,175
LAGUNILLAS,"anticoncepcion, prevencion de its y de cancer de cuello uterino",pildora: usuarias nuevas,2016-09-01,0,2,2,0,0,4
LAJA,"anticoncepcion, prevencion de its y de cancer de cuello uterino",pildora: usuarias nuevas,2016-09-01,0,1,0,1,0,2
LAS CARRERAS,"anticoncepcion, prevencion de its y de cancer de cuello uterino",pildora: usuarias nuevas,2016-09-01,0,0,1,0,0,1
LLALLAGUA,"anticoncepcion, prevencion de its y de cancer de cuello uterino",pildora: usuarias nuevas,2016-09-01,0,2,11,2,0,15
LLICA,"anticoncepcion, prevencion de its y de cancer de cuello uterino",pildora: usuarias nuevas,2016-09-01,0,1,2,0,0,3
LORETO,"anticoncepcion, prevencion de its y de cancer de cuello uterino",pildora: usuarias nuevas,2016-09-01,0,2,4,1,1,8
MACHARETI,"anticoncepcion, prevencion de its y de cancer de cuello uterino",pildora: usuarias nuevas,2016-09-01,0,2,7,3,0,12
MAGDALENA,"anticoncepcion, prevencion de its y de cancer de cuello uterino",pildora: usuarias nuevas,2016-09-01,0,0,2,0,0,2
MAIRANA,"anticoncepcion, prevencion de its y de cancer de cuello uterino",pildora: usuarias nuevas,2016-09-01,0,0,2,0,0,2
MAPIRI,"anticoncepcion, prevencion de its y de cancer de cuello uterino",pildora: usuarias nuevas,2016-09-01,0,0,1,0,0,1
MECAPACA,"anticoncepcion, prevencion de its y de cancer de cuello uterino",pildora: usuarias nuevas,2016-09-01,0,0,1,0,0,1
MINEROS,"anticoncepcion, prevencion de its y de cancer de cuello uterino",pildora: usuarias nuevas,2016-09-01,0,1,6,0,0,7
MIZQUE,"anticoncepcion, prevencion de its y de cancer de cuello uterino",pildora: usuarias nuevas,2016-09-01,0,0,5,1,0,6
MONTEAGUDO,"anticoncepcion, prevencion de its y de cancer de cuello uterino",pildora: usuarias nuevas,2016-09-01,0,2,4,0,0,6
MONTERO,"anticoncepcion, prevencion de its y de cancer de cuello uterino",pildora: usuarias nuevas,2016-09-01,3,6,33,9,0,51
MOROCHATA,"anticoncepcion, prevencion de its y de cancer de cuello uterino",pildora: usuarias nuevas,2016-09-01,0,0,2,0,0,2
NACEBE (SANTA ROSA DEL ABUNA),"anticoncepcion, prevencion de its y de cancer de cuello uterino",pildora: usuarias nuevas,2016-09-01,0,1,1,0,0,2
NUEVO MANOA (NUEVA ESPERANZA),"anticoncepcion, prevencion de its y de cancer de cuello uterino",pildora: usuarias nuevas,2016-09-01,1,1,5,0,0,7
OCURI,"anticoncepcion, prevencion de its y de cancer de cuello uterino",pildora: usuarias nuevas,2016-09-01,0,0,0,1,0,1
OMEREQUE,"anticoncepcion, prevencion de its y de cancer de cuello uterino",pildora: usuarias nuevas,2016-09-01,0,0,1,0,0,1
ORURO,"anticoncepcion, prevencion de its y de cancer de cuello uterino",pildora: usuarias nuevas,2016-09-01,0,8,52,14,0,74
PADCAYA,"anticoncepcion, prevencion de its y de cancer de cuello uterino",pildora: usuarias nuevas,2016-09-01,1,4,6,0,0,11
PADILLA,"anticoncepcion, prevencion de its y de cancer de cuello uterino",pildora: usuarias nuevas,2016-09-01,0,2,2,0,0,4
PAILON,"anticoncepcion, prevencion de its y de cancer de cuello uterino",pildora: usuarias nuevas,2016-09-01,0,1,15,0,0,16
PALCA,"anticoncepcion, prevencion de its y de cancer de cuello uterino",pildora: usuarias nuevas,2016-09-01,0,1,0,0,0,1
PALOS BLANCOS,"anticoncepcion, prevencion de its y de cancer de cuello uterino",pildora: usuarias nuevas,2016-09-01,0,0,5,0,0,5
PAMPA AULLAGAS,"anticoncepcion, prevencion de its y de cancer de cuello uterino",pildora: usuarias nuevas,2016-09-01,0,0,0,1,0,1
PAMPA GRANDE,"anticoncepcion, prevencion de its y de cancer de cuello uterino",pildora: usuarias nuevas,2016-09-01,0,2,1,0,0,3
PAPEL PAMPA,"anticoncepcion, prevencion de its y de cancer de cuello uterino",pildora: usuarias nuevas,2016-09-01,0,0,1,0,0,1
PASORAPA,"anticoncepcion, prevencion de its y de cancer de cuello uterino",pildora: usuarias nuevas,2016-09-01,0,0,1,2,0,3
PATACAMAYA,"anticoncepcion, prevencion de its y de cancer de cuello uterino",pildora: usuarias nuevas,2016-09-01,0,0,4,1,0,5
PAZÑA,"anticoncepcion, prevencion de its y de cancer de cuello uterino",pildora: usuarias nuevas,2016-09-01,0,1,2,1,0,4
PELECHUCO,"anticoncepcion, prevencion de its y de cancer de cuello uterino",pildora: usuarias nuevas,2016-09-01,0,2,4,0,0,6
POCONA,"anticoncepcion, prevencion de its y de cancer de cuello uterino",pildora: usuarias nuevas,2016-09-01,0,1,4,1,0,6
POROMA,"anticoncepcion, prevencion de its y de cancer de cuello uterino",pildora: usuarias nuevas,2016-09-01,0,1,1,0,0,2
PORONGO,"anticoncepcion, prevencion de its y de cancer de cuello uterino",pildora: usuarias nuevas,2016-09-01,0,3,9,1,0,13
PORTACHUELO,"anticoncepcion, prevencion de its y de cancer de cuello uterino",pildora: usuarias nuevas,2016-09-01,0,0,3,1,0,4
PORVENIR,"anticoncepcion, prevencion de its y de cancer de cuello uterino",pildora: usuarias nuevas,2016-09-01,0,1,0,0,0,1
POSTRER VALLE,"anticoncepcion, prevencion de its y de cancer de cuello uterino",pildora: usuarias nuevas,2016-09-01,0,0,2,0,0,2
POTOSI,"anticoncepcion, prevencion de its y de cancer de cuello uterino",pildora: usuarias nuevas,2016-09-01,0,12,30,8,0,50
PRESTO,"anticoncepcion, prevencion de its y de cancer de cuello uterino",pildora: usuarias nuevas,2016-09-01,0,1,1,1,0,3
PUCARANI,"anticoncepcion, prevencion de its y de cancer de cuello uterino",pildora: usuarias nuevas,2016-09-01,0,0,1,0,0,1
PUERTO CARABUCO,"anticoncepcion, prevencion de its y de cancer de cuello uterino",pildora: usuarias nuevas,2016-09-01,0,0,0,1,0,1
PUERTO QUIJARRO,"anticoncepcion, prevencion de its y de cancer de cuello uterino",pildora: usuarias nuevas,2016-09-01,0,0,1,0,0,1
PUERTO RICO,"anticoncepcion, prevencion de its y de cancer de cuello uterino",pildora: usuarias nuevas,2016-09-01,0,1,2,0,0,3
PUERTO SILES,"anticoncepcion, prevencion de its y de cancer de cuello uterino",pildora: usuarias nuevas,2016-09-01,0,1,1,0,0,2
PUERTO SUAREZ,"anticoncepcion, prevencion de its y de cancer de cuello uterino",pildora: usuarias nuevas,2016-09-01,0,1,7,3,0,11
PUERTO VILLARROEL,"anticoncepcion, prevencion de its y de cancer de cuello uterino",pildora: usuarias nuevas,2016-09-01,0,2,2,2,0,6
PUNA,"anticoncepcion, prevencion de its y de cancer de cuello uterino",pildora: usuarias nuevas,2016-09-01,0,0,2,3,0,5
PUNATA,"anticoncepcion, prevencion de its y de cancer de cuello uterino",pildora: usuarias nuevas,2016-09-01,0,1,1,1,0,3
QUIABAYA,"anticoncepcion, prevencion de its y de cancer de cuello uterino",pildora: usuarias nuevas,2016-09-01,0,0,1,0,0,1
QUILLACOLLO,"anticoncepcion, prevencion de its y de cancer de cuello uterino",pildora: usuarias nuevas,2016-09-01,0,4,11,3,0,18
RAVELO,"anticoncepcion, prevencion de its y de cancer de cuello uterino",pildora: usuarias nuevas,2016-09-01,0,0,1,1,0,2
REYES,"anticoncepcion, prevencion de its y de cancer de cuello uterino",pildora: usuarias nuevas,2016-09-01,0,1,8,2,0,11
RIBERALTA,"anticoncepcion, prevencion de its y de cancer de cuello uterino",pildora: usuarias nuevas,2016-09-01,0,23,55,11,0,89
ROBORE,"anticoncepcion, prevencion de its y de cancer de cuello uterino",pildora: usuarias nuevas,2016-09-01,0,1,8,1,0,10
RURRENABAQUE,"anticoncepcion, prevencion de its y de cancer de cuello uterino",pildora: usuarias nuevas,2016-09-01,2,3,5,0,0,10
SABAYA,"anticoncepcion, prevencion de its y de cancer de cuello uterino",pildora: usuarias nuevas,2016-09-01,0,1,0,1,0,2
SACABA,"anticoncepcion, prevencion de its y de cancer de cuello uterino",pildora: usuarias nuevas,2016-09-01,0,2,15,4,0,21
SACABAMBA,"anticoncepcion, prevencion de its y de cancer de cuello uterino",pildora: usuarias nuevas,2016-09-01,0,0,0,1,0,1
SACACA,"anticoncepcion, prevencion de its y de cancer de cuello uterino",pildora: usuarias nuevas,2016-09-01,0,1,6,2,0,9
SAIPINA,"anticoncepcion, prevencion de its y de cancer de cuello uterino",pildora: usuarias nuevas,2016-09-01,0,0,0,1,0,1
SALINAS DE GARCI MENDOZA,"anticoncepcion, prevencion de its y de cancer de cuello uterino",pildora: usuarias nuevas,2016-09-01,0,0,2,0,0,2
SAN ANDRES,"anticoncepcion, prevencion de its y de cancer de cuello uterino",pildora: usuarias nuevas,2016-09-01,0,1,8,0,0,9
SAN ANDRES DE MACHACA,"anticoncepcion, prevencion de its y de cancer de cuello uterino",pildora: usuarias nuevas,2016-09-01,0,0,1,0,0,1
SAN ANTONIO DE LOMERIO,"anticoncepcion, prevencion de its y de cancer de cuello uterino",pildora: usuarias nuevas,2016-09-01,0,0,5,1,0,6
SAN BORJA,"anticoncepcion, prevencion de its y de cancer de cuello uterino",pildora: usuarias nuevas,2016-09-01,0,3,11,0,0,14
SAN BUENA VENTURA,"anticoncepcion, prevencion de its y de cancer de cuello uterino",pildora: usuarias nuevas,2016-09-01,0,0,4,0,0,4
SAN CARLOS,"anticoncepcion, prevencion de its y de cancer de cuello uterino",pildora: usuarias nuevas,2016-09-01,0,2,3,1,0,6
SAN IGNACIO,"anticoncepcion, prevencion de its y de cancer de cuello uterino",pildora: usuarias nuevas,2016-09-01,1,5,13,4,0,23
SAN IGNACIO DE VELASCO,"anticoncepcion, prevencion de its y de cancer de cuello uterino",pildora: usuarias nuevas,2016-09-01,0,0,10,3,0,13
SAN JAVIER(BNI),"anticoncepcion, prevencion de its y de cancer de cuello uterino",pildora: usuarias nuevas,2016-09-01,0,1,8,0,0,9
SAN JAVIER(STC),"anticoncepcion, prevencion de its y de cancer de cuello uterino",pildora: usuarias nuevas,2016-09-01,0,1,7,1,0,9
SAN JOSE DE CHIQUITOS,"anticoncepcion, prevencion de its y de cancer de cuello uterino",pildora: usuarias nuevas,2016-09-01,0,2,2,0,0,4
SAN JUAN DE YAPACANI,"anticoncepcion, prevencion de its y de cancer de cuello uterino",pildora: usuarias nuevas,2016-09-01,0,0,2,1,0,3
SAN JULIAN,"anticoncepcion, prevencion de its y de cancer de cuello uterino",pildora: usuarias nuevas,2016-09-01,0,2,8,0,0,10
SAN LORENZO(PND),"anticoncepcion, prevencion de its y de cancer de cuello uterino",pildora: usuarias nuevas,2016-09-01,0,1,0,0,0,1
SAN LORENZO(TJA),"anticoncepcion, prevencion de its y de cancer de cuello uterino",pildora: usuarias nuevas,2016-09-01,0,1,3,1,0,5
SAN LUCAS,"anticoncepcion, prevencion de its y de cancer de cuello uterino",pildora: usuarias nuevas,2016-09-01,0,1,5,3,0,9
SAN MATIAS,"anticoncepcion, prevencion de its y de cancer de cuello uterino",pildora: usuarias nuevas,2016-09-01,0,2,1,0,0,3
SAN MIGUEL DE VELASCO,"anticoncepcion, prevencion de its y de cancer de cuello uterino",pildora: usuarias nuevas,2016-09-01,0,1,1,2,0,4
SAN PABLO DE LIPEZ,"anticoncepcion, prevencion de its y de cancer de cuello uterino",pildora: usuarias nuevas,2016-09-01,0,1,1,0,0,2
SAN PEDRO,"anticoncepcion, prevencion de its y de cancer de cuello uterino",pildora: usuarias nuevas,2016-09-01,0,1,5,2,0,8
SAN PEDRO DE BUENA VISTA,"anticoncepcion, prevencion de its y de cancer de cuello uterino",pildora: usuarias nuevas,2016-09-01,0,0,2,0,0,2
SAN PEDRO DE CURAHUARA,"anticoncepcion, prevencion de its y de cancer de cuello uterino",pildora: usuarias nuevas,2016-09-01,0,0,3,2,1,6
SAN PEDRO DE TIQUINA,"anticoncepcion, prevencion de its y de cancer de cuello uterino",pildora: usuarias nuevas,2016-09-01,0,0,0,2,0,2
SAN RAFAEL,"anticoncepcion, prevencion de its y de cancer de cuello uterino",pildora: usuarias nuevas,2016-09-01,0,2,9,2,0,13
SAN RAMON BENI,"anticoncepcion, prevencion de its y de cancer de cuello uterino",pildora: usuarias nuevas,2016-09-01,0,1,0,0,0,1
SAN RAMON SCZ,"anticoncepcion, prevencion de its y de cancer de cuello uterino",pildora: usuarias nuevas,2016-09-01,0,0,4,2,0,6
SANTA CRUZ DE LA SIERRA,"anticoncepcion, prevencion de its y de cancer de cuello uterino",pildora: usuarias nuevas,2016-09-01,10,62,157,63,5,297
SANTA ROSA,"anticoncepcion, prevencion de its y de cancer de cuello uterino",pildora: usuarias nuevas,2016-09-01,0,1,4,0,0,5
SANTA ROSA DEL SARA,"anticoncepcion, prevencion de its y de cancer de cuello uterino",pildora: usuarias nuevas,2016-09-01,0,0,12,2,0,14
SANTIAGO DE HUARI,"anticoncepcion, prevencion de its y de cancer de cuello uterino",pildora: usuarias nuevas,2016-09-01,0,0,5,0,0,5
SANTIAGO DE MACHACA,"anticoncepcion, prevencion de its y de cancer de cuello uterino",pildora: usuarias nuevas,2016-09-01,0,0,1,1,0,2
SANTIVAÑES,"anticoncepcion, prevencion de its y de cancer de cuello uterino",pildora: usuarias nuevas,2016-09-01,0,1,0,0,0,1
SANTUARIO DE QUILLACAS,"anticoncepcion, prevencion de its y de cancer de cuello uterino",pildora: usuarias nuevas,2016-09-01,0,0,1,0,0,1
SAPAHAQUI,"anticoncepcion, prevencion de its y de cancer de cuello uterino",pildora: usuarias nuevas,2016-09-01,0,0,1,0,0,1
SENA,"anticoncepcion, prevencion de its y de cancer de cuello uterino",pildora: usuarias nuevas,2016-09-01,0,1,2,1,0,4
SHINAOTA,"anticoncepcion, prevencion de its y de cancer de cuello uterino",pildora: usuarias nuevas,2016-09-01,0,0,1,0,0,1
SIPE SIPE,"anticoncepcion, prevencion de its y de cancer de cuello uterino",pildora: usuarias nuevas,2016-09-01,0,3,9,2,0,14
SOPACHUY,"anticoncepcion, prevencion de its y de cancer de cuello uterino",pildora: usuarias nuevas,2016-09-01,0,0,2,1,0,3
SORACACHI,"anticoncepcion, prevencion de its y de cancer de cuello uterino",pildora: usuarias nuevas,2016-09-01,0,0,1,0,0,1
SORATA,"anticoncepcion, prevencion de its y de cancer de cuello uterino",pildora: usuarias nuevas,2016-09-01,0,1,2,1,0,4
SUCRE,"anticoncepcion, prevencion de its y de cancer de cuello uterino",pildora: usuarias nuevas,2016-09-01,0,9,57,10,0,76
TACACOMA,"anticoncepcion, prevencion de its y de cancer de cuello uterino",pildora: usuarias nuevas,2016-09-01,0,1,0,1,0,2
TACOBAMBA,"anticoncepcion, prevencion de its y de cancer de cuello uterino",pildora: usuarias nuevas,2016-09-01,0,1,0,0,0,1
TACOPAYA,"anticoncepcion, prevencion de its y de cancer de cuello uterino",pildora: usuarias nuevas,2016-09-01,0,0,1,0,0,1
TAPACARI,"anticoncepcion, prevencion de its y de cancer de cuello uterino",pildora: usuarias nuevas,2016-09-01,1,3,4,0,0,8
TARABUCO,"anticoncepcion, prevencion de its y de cancer de cuello uterino",pildora: usuarias nuevas,2016-09-01,0,0,1,0,0,1
TARATA,"anticoncepcion, prevencion de its y de cancer de cuello uterino",pildora: usuarias nuevas,2016-09-01,0,1,2,1,0,4
TARIJA,"anticoncepcion, prevencion de its y de cancer de cuello uterino",pildora: usuarias nuevas,2016-09-01,0,8,35,11,0,54
TARVITA,"anticoncepcion, prevencion de its y de cancer de cuello uterino",pildora: usuarias nuevas,2016-09-01,1,1,0,1,0,3
TEOPONTE,"anticoncepcion, prevencion de its y de cancer de cuello uterino",pildora: usuarias nuevas,2016-09-01,0,1,5,0,0,6
TIAWANACU,"anticoncepcion, prevencion de its y de cancer de cuello uterino",pildora: usuarias nuevas,2016-09-01,0,0,1,0,0,1
TIQUIPAYA,"anticoncepcion, prevencion de its y de cancer de cuello uterino",pildora: usuarias nuevas,2016-09-01,0,2,15,1,0,18
TIRAQUE (CBBA),"anticoncepcion, prevencion de its y de cancer de cuello uterino",pildora: usuarias nuevas,2016-09-01,0,0,2,0,0,2
TOCO,"anticoncepcion, prevencion de its y de cancer de cuello uterino",pildora: usuarias nuevas,2016-09-01,0,1,0,0,0,1
TOLATA,"anticoncepcion, prevencion de its y de cancer de cuello uterino",pildora: usuarias nuevas,2016-09-01,0,0,4,0,0,4
TOLEDO,"anticoncepcion, prevencion de its y de cancer de cuello uterino",pildora: usuarias nuevas,2016-09-01,0,0,1,0,0,1
TOMINA,"anticoncepcion, prevencion de its y de cancer de cuello uterino",pildora: usuarias nuevas,2016-09-01,0,0,0,1,0,1
TORO TORO,"anticoncepcion, prevencion de its y de cancer de cuello uterino",pildora: usuarias nuevas,2016-09-01,0,1,2,0,0,3
TOTORA(CBBA),"anticoncepcion, prevencion de its y de cancer de cuello uterino",pildora: usuarias nuevas,2016-09-01,0,0,3,0,0,3
TOTORA(ORR),"anticoncepcion, prevencion de its y de cancer de cuello uterino",pildora: usuarias nuevas,2016-09-01,0,2,4,0,0,6
TRINIDAD,"anticoncepcion, prevencion de its y de cancer de cuello uterino",pildora: usuarias nuevas,2016-09-01,1,2,14,5,0,22
TUPIZA,"anticoncepcion, prevencion de its y de cancer de cuello uterino",pildora: usuarias nuevas,2016-09-01,0,3,4,2,0,9
TURCO,"anticoncepcion, prevencion de its y de cancer de cuello uterino",pildora: usuarias nuevas,2016-09-01,0,0,2,0,0,2
UNCIA,"anticoncepcion, prevencion de its y de cancer de cuello uterino",pildora: usuarias nuevas,2016-09-01,0,0,3,0,0,3
URIONDO (A. CONCEPCION),"anticoncepcion, prevencion de its y de cancer de cuello uterino",pildora: usuarias nuevas,2016-09-01,0,1,3,0,0,4
URUBICHA,"anticoncepcion, prevencion de its y de cancer de cuello uterino",pildora: usuarias nuevas,2016-09-01,0,0,1,0,0,1
UYUNI,"anticoncepcion, prevencion de its y de cancer de cuello uterino",pildora: usuarias nuevas,2016-09-01,0,0,3,0,0,3
VACAS,"anticoncepcion, prevencion de its y de cancer de cuello uterino",pildora: usuarias nuevas,2016-09-01,0,0,3,0,0,3
VALLEGRANDE,"anticoncepcion, prevencion de its y de cancer de cuello uterino",pildora: usuarias nuevas,2016-09-01,0,1,1,4,0,6
VIACHA,"anticoncepcion, prevencion de its y de cancer de cuello uterino",pildora: usuarias nuevas,2016-09-01,0,0,8,3,0,11
VILA VILA,"anticoncepcion, prevencion de its y de cancer de cuello uterino",pildora: usuarias nuevas,2016-09-01,0,1,0,0,0,1
VILLA CHARCAS,"anticoncepcion, prevencion de its y de cancer de cuello uterino",pildora: usuarias nuevas,2016-09-01,0,1,2,1,0,4
VILLA MONTES,"anticoncepcion, prevencion de its y de cancer de cuello uterino",pildora: usuarias nuevas,2016-09-01,1,7,9,3,0,20
VILLA NUEVA (LOMA ALTA),"anticoncepcion, prevencion de its y de cancer de cuello uterino",pildora: usuarias nuevas,2016-09-01,0,0,1,0,0,1
VILLA SERRANO,"anticoncepcion, prevencion de its y de cancer de cuello uterino",pildora: usuarias nuevas,2016-09-01,0,0,2,1,0,3
VILLA TUNARI,"anticoncepcion, prevencion de its y de cancer de cuello uterino",pildora: usuarias nuevas,2016-09-01,0,6,15,4,0,25
VILLA VACA GUZMAN (MUYUPAMPA),"anticoncepcion, prevencion de its y de cancer de cuello uterino",pildora: usuarias nuevas,2016-09-01,0,1,5,3,0,9
VILLAZON,"anticoncepcion, prevencion de its y de cancer de cuello uterino",pildora: usuarias nuevas,2016-09-01,0,0,1,0,0,1
VINTO,"anticoncepcion, prevencion de its y de cancer de cuello uterino",pildora: usuarias nuevas,2016-09-01,0,0,3,0,0,3
VITICHI,"anticoncepcion, prevencion de its y de cancer de cuello uterino",pildora: usuarias nuevas,2016-09-01,0,1,1,0,1,3
WARNES,"anticoncepcion, prevencion de its y de cancer de cuello uterino",pildora: usuarias nuevas,2016-09-01,0,7,11,5,0,23
YACUIBA,"anticoncepcion, prevencion de its y de cancer de cuello uterino",pildora: usuarias nuevas,2016-09-01,0,5,14,6,0,25
YAMPARAEZ,"anticoncepcion, prevencion de its y de cancer de cuello uterino",pildora: usuarias nuevas,2016-09-01,0,0,1,1,0,2
YANACACHI,"anticoncepcion, prevencion de its y de cancer de cuello uterino",pildora: usuarias nuevas,2016-09-01,0,0,2,1,0,3
YAPACANI,"anticoncepcion, prevencion de its y de cancer de cuello uterino",pildora: usuarias nuevas,2016-09-01,0,3,15,4,0,22
YOCALLA,"anticoncepcion, prevencion de its y de cancer de cuello uterino",pildora: usuarias nuevas,2016-09-01,0,1,0,0,0,1
YUNCHARA,"anticoncepcion, prevencion de its y de cancer de cuello uterino",pildora: usuarias nuevas,2016-09-01,0,1,1,0,0,2
ZUDAÑEZ,"anticoncepcion, prevencion de its y de cancer de cuello uterino",pildora: usuarias nuevas,2016-09-01,0,1,0,0,0,1
ACACIO,"anticoncepcion, prevencion de its y de cancer de cuello uterino",pildora: usuarias nuevas,2016-10-01,0,0,2,1,0,3
ACHACACHI,"anticoncepcion, prevencion de its y de cancer de cuello uterino",pildora: usuarias nuevas,2016-10-01,0,1,2,0,0,3
ACHOCALLA,"anticoncepcion, prevencion de its y de cancer de cuello uterino",pildora: usuarias nuevas,2016-10-01,0,0,2,0,0,2
AIQUILE,"anticoncepcion, prevencion de its y de cancer de cuello uterino",pildora: usuarias nuevas,2016-10-01,0,2,6,1,0,9
ALCALA,"anticoncepcion, prevencion de its y de cancer de cuello uterino",pildora: usuarias nuevas,2016-10-01,0,1,1,0,0,2
ALTO BENI,"anticoncepcion, prevencion de its y de cancer de cuello uterino",pildora: usuarias nuevas,2016-10-01,0,0,2,1,0,3
ANCORAIMES,"anticoncepcion, prevencion de its y de cancer de cuello uterino",pildora: usuarias nuevas,2016-10-01,0,1,0,0,0,1
ANDAMARCA,"anticoncepcion, prevencion de its y de cancer de cuello uterino",pildora: usuarias nuevas,2016-10-01,0,0,2,0,0,2
APOLO,"anticoncepcion, prevencion de its y de cancer de cuello uterino",pildora: usuarias nuevas,2016-10-01,0,0,1,1,0,2
ARANI,"anticoncepcion, prevencion de its y de cancer de cuello uterino",pildora: usuarias nuevas,2016-10-01,0,0,2,2,0,4
ARBIETO,"anticoncepcion, prevencion de its y de cancer de cuello uterino",pildora: usuarias nuevas,2016-10-01,0,0,8,1,0,9
ARQUE,"anticoncepcion, prevencion de its y de cancer de cuello uterino",pildora: usuarias nuevas,2016-10-01,0,1,1,1,0,3
ASCENCION DE GUARAYOS,"anticoncepcion, prevencion de its y de cancer de cuello uterino",pildora: usuarias nuevas,2016-10-01,0,1,12,4,0,17
ATOCHA,"anticoncepcion, prevencion de its y de cancer de cuello uterino",pildora: usuarias nuevas,2016-10-01,0,0,1,1,0,2
AYATA,"anticoncepcion, prevencion de its y de cancer de cuello uterino",pildora: usuarias nuevas,2016-10-01,0,0,3,1,0,4
AYO AYO,"anticoncepcion, prevencion de its y de cancer de cuello uterino",pildora: usuarias nuevas,2016-10-01,1,0,0,0,0,1
AYOPAYA (V. DE INDEPENDENCIA),"anticoncepcion, prevencion de its y de cancer de cuello uterino",pildora: usuarias nuevas,2016-10-01,0,2,4,3,0,9
AZURDUY,"anticoncepcion, prevencion de its y de cancer de cuello uterino",pildora: usuarias nuevas,2016-10-01,0,1,1,2,0,4
BATALLAS,"anticoncepcion, prevencion de its y de cancer de cuello uterino",pildora: usuarias nuevas,2016-10-01,0,0,1,0,0,1
BELLA FLOR,"anticoncepcion, prevencion de its y de cancer de cuello uterino",pildora: usuarias nuevas,2016-10-01,0,0,1,0,0,1
BERMEJO,"anticoncepcion, prevencion de its y de cancer de cuello uterino",pildora: usuarias nuevas,2016-10-01,0,3,6,3,0,12
BETANZOS,"anticoncepcion, prevencion de its y de cancer de cuello uterino",pildora: usuarias nuevas,2016-10-01,0,0,2,0,0,2
BOLPEBRA,"anticoncepcion, prevencion de its y de cancer de cuello uterino",pildora: usuarias nuevas,2016-10-01,0,0,24,0,0,24
BUENA VISTA,"anticoncepcion, prevencion de its y de cancer de cuello uterino",pildora: usuarias nuevas,2016-10-01,0,0,5,0,0,5
CABEZAS,"anticoncepcion, prevencion de its y de cancer de cuello uterino",pildora: usuarias nuevas,2016-10-01,0,0,9,7,0,16
CAIROMA,"anticoncepcion, prevencion de its y de cancer de cuello uterino",pildora: usuarias nuevas,2016-10-01,0,0,2,0,0,2
"CAIZA ""D""","anticoncepcion, prevencion de its y de cancer de cuello uterino",pildora: usuarias nuevas,2016-10-01,1,1,1,1,0,4
CAJUATA,"anticoncepcion, prevencion de its y de cancer de cuello uterino",pildora: usuarias nuevas,2016-10-01,0,0,1,2,0,3
CAMARGO,"anticoncepcion, prevencion de its y de cancer de cuello uterino",pildora: usuarias nuevas,2016-10-01,0,1,7,1,0,9
CAMATAQUI (C. VILLA ABECIA),"anticoncepcion, prevencion de its y de cancer de cuello uterino",pildora: usuarias nuevas,2016-10-01,0,0,1,0,0,1
CAMIRI,"anticoncepcion, prevencion de its y de cancer de cuello uterino",pildora: usuarias nuevas,2016-10-01,0,0,4,1,0,5
CAPINOTA,"anticoncepcion, prevencion de its y de cancer de cuello uterino",pildora: usuarias nuevas,2016-10-01,0,0,1,0,0,1
CAQUIAVIRI,"anticoncepcion, prevencion de its y de cancer de cuello uterino",pildora: usuarias nuevas,2016-10-01,0,1,0,0,0,1
CARACOLLO,"anticoncepcion, prevencion de its y de cancer de cuello uterino",pildora: usuarias nuevas,2016-10-01,0,1,0,0,0,1
CARANAVI,"anticoncepcion, prevencion de its y de cancer de cuello uterino",pildora: usuarias nuevas,2016-10-01,1,1,6,3,0,11
CARAPARI,"anticoncepcion, prevencion de its y de cancer de cuello uterino",pildora: usuarias nuevas,2016-10-01,0,0,3,0,0,3
CATACORA,"anticoncepcion, prevencion de its y de cancer de cuello uterino",pildora: usuarias nuevas,2016-10-01,0,0,1,0,0,1
CHALLAPATA,"anticoncepcion, prevencion de its y de cancer de cuello uterino",pildora: usuarias nuevas,2016-10-01,0,0,1,0,0,1
CHARAGUA,"anticoncepcion, prevencion de its y de cancer de cuello uterino",pildora: usuarias nuevas,2016-10-01,0,2,7,0,0,9
CHAYANTA,"anticoncepcion, prevencion de its y de cancer de cuello uterino",pildora: usuarias nuevas,2016-10-01,0,0,1,0,0,1
CHIMORE,"anticoncepcion, prevencion de its y de cancer de cuello uterino",pildora: usuarias nuevas,2016-10-01,0,1,1,0,0,2
CHUQUIHUTA AYLLU JUCUMANI,"anticoncepcion, prevencion de its y de cancer de cuello uterino",pildora: usuarias nuevas,2016-10-01,0,0,2,0,0,2
CLIZA,"anticoncepcion, prevencion de its y de cancer de cuello uterino",pildora: usuarias nuevas,2016-10-01,0,0,3,2,0,5
COBIJA,"anticoncepcion, prevencion de its y de cancer de cuello uterino",pildora: usuarias nuevas,2016-10-01,1,1,4,2,0,8
COCAPATA,"anticoncepcion, prevencion de its y de cancer de cuello uterino",pildora: usuarias nuevas,2016-10-01,0,2,3,0,0,5
COCHABAMBA,"anticoncepcion, prevencion de its y de cancer de cuello uterino",pildora: usuarias nuevas,2016-10-01,0,28,175,16,0,219
COIPASA,"anticoncepcion, prevencion de its y de cancer de cuello uterino",pildora: usuarias nuevas,2016-10-01,0,0,1,0,0,1
COLCAPIRHUA,"anticoncepcion, prevencion de its y de cancer de cuello uterino",pildora: usuarias nuevas,2016-10-01,0,1,5,2,0,8
"COLCHA ""K""","anticoncepcion, prevencion de its y de cancer de cuello uterino",pildora: usuarias nuevas,2016-10-01,0,0,3,0,0,3
COLLANA,"anticoncepcion, prevencion de its y de cancer de cuello uterino",pildora: usuarias nuevas,2016-10-01,0,2,0,0,0,2
COLOMI,"anticoncepcion, prevencion de its y de cancer de cuello uterino",pildora: usuarias nuevas,2016-10-01,0,4,2,2,0,8
COLPA BELGICA,"anticoncepcion, prevencion de its y de cancer de cuello uterino",pildora: usuarias nuevas,2016-10-01,0,0,1,0,0,1
COLQUECHACA,"anticoncepcion, prevencion de its y de cancer de cuello uterino",pildora: usuarias nuevas,2016-10-01,0,0,3,1,1,5
COLQUENCHA,"anticoncepcion, prevencion de its y de cancer de cuello uterino",pildora: usuarias nuevas,2016-10-01,0,0,0,1,0,1
COLQUIRI,"anticoncepcion, prevencion de its y de cancer de cuello uterino",pildora: usuarias nuevas,2016-10-01,0,2,5,3,0,10
COMANCHE,"anticoncepcion, prevencion de its y de cancer de cuello uterino",pildora: usuarias nuevas,2016-10-01,0,0,0,1,0,1
COMARAPA,"anticoncepcion, prevencion de its y de cancer de cuello uterino",pildora: usuarias nuevas,2016-10-01,0,1,3,0,0,4
CONCEPCION,"anticoncepcion, prevencion de its y de cancer de cuello uterino",pildora: usuarias nuevas,2016-10-01,0,2,3,0,0,5
COPACABANA,"anticoncepcion, prevencion de its y de cancer de cuello uterino",pildora: usuarias nuevas,2016-10-01,0,0,3,0,0,3
CORIPATA,"anticoncepcion, prevencion de its y de cancer de cuello uterino",pildora: usuarias nuevas,2016-10-01,0,0,1,0,0,1
CORQUE,"anticoncepcion, prevencion de its y de cancer de cuello uterino",pildora: usuarias nuevas,2016-10-01,0,1,0,0,0,1
COTAGAITA,"anticoncepcion, prevencion de its y de cancer de cuello uterino",pildora: usuarias nuevas,2016-10-01,0,0,3,0,0,3
COTOCA,"anticoncepcion, prevencion de its y de cancer de cuello uterino",pildora: usuarias nuevas,2016-10-01,0,6,12,12,0,30
CRUZ DE MACHACAMARCA,"anticoncepcion, prevencion de its y de cancer de cuello uterino",pildora: usuarias nuevas,2016-10-01,0,0,2,0,0,2
CUATRO CAÑADAS,"anticoncepcion, prevencion de its y de cancer de cuello uterino",pildora: usuarias nuevas,2016-10-01,0,1,4,0,0,5
CUEVO,"anticoncepcion, prevencion de its y de cancer de cuello uterino",pildora: usuarias nuevas,2016-10-01,0,0,1,0,0,1
CULPINA,"anticoncepcion, prevencion de its y de cancer de cuello uterino",pildora: usuarias nuevas,2016-10-01,0,1,4,0,0,5
CURAHUARA DE CARANGAS,"anticoncepcion, prevencion de its y de cancer de cuello uterino",pildora: usuarias nuevas,2016-10-01,0,0,1,0,0,1
EL ALTO,"anticoncepcion, prevencion de its y de cancer de cuello uterino",pildora: usuarias nuevas,2016-10-01,0,18,101,28,0,147
EL CHORO,"anticoncepcion, prevencion de its y de cancer de cuello uterino",pildora: usuarias nuevas,2016-10-01,0,0,0,1,0,1
EL PUENTE(STC),"anticoncepcion, prevencion de its y de cancer de cuello uterino",pildora: usuarias nuevas,2016-10-01,0,0,1,0,0,1
EL PUENTE(TJA),"anticoncepcion, prevencion de its y de cancer de cuello uterino",pildora: usuarias nuevas,2016-10-01,0,1,3,2,0,6
EL TORNO,"anticoncepcion, prevencion de its y de cancer de cuello uterino",pildora: usuarias nuevas,2016-10-01,3,6,11,6,0,26
EL VILLAR,"anticoncepcion, prevencion de its y de cancer de cuello uterino",pildora: usuarias nuevas,2016-10-01,0,1,1,0,0,2
ENTRE RIOS TRJ,"anticoncepcion, prevencion de its y de cancer de cuello uterino",pildora: usuarias nuevas,2016-10-01,0,6,6,2,0,14
ENTRE RIOS CBBA,"anticoncepcion, prevencion de its y de cancer de cuello uterino",pildora: usuarias nuevas,2016-10-01,0,2,10,0,0,12
EUREKA (SANTOS MERCADO),"anticoncepcion, prevencion de its y de cancer de cuello uterino",pildora: usuarias nuevas,2016-10-01,0,1,1,1,0,3
FERNANDEZ ALONSO,"anticoncepcion, prevencion de its y de cancer de cuello uterino",pildora: usuarias nuevas,2016-10-01,0,1,2,0,0,3
FILADELFIA,"anticoncepcion, prevencion de its y de cancer de cuello uterino",pildora: usuarias nuevas,2016-10-01,0,2,7,1,0,10
GENERAL SAAVEDRA,"anticoncepcion, prevencion de its y de cancer de cuello uterino",pildora: usuarias nuevas,2016-10-01,0,1,3,1,0,5
GRAL. J.J. PEREZ (CHARAZANI),"anticoncepcion, prevencion de its y de cancer de cuello uterino",pildora: usuarias nuevas,2016-10-01,0,0,4,0,0,4
GUANAY,"anticoncepcion, prevencion de its y de cancer de cuello uterino",pildora: usuarias nuevas,2016-10-01,0,0,1,0,0,1
GUAQUI,"anticoncepcion, prevencion de its y de cancer de cuello uterino",pildora: usuarias nuevas,2016-10-01,0,0,1,0,0,1
GUAYARAMERIN,"anticoncepcion, prevencion de its y de cancer de cuello uterino",pildora: usuarias nuevas,2016-10-01,0,2,14,0,0,16
GUTIERREZ,"anticoncepcion, prevencion de its y de cancer de cuello uterino",pildora: usuarias nuevas,2016-10-01,0,1,4,2,0,7
HUACARETA,"anticoncepcion, prevencion de its y de cancer de cuello uterino",pildora: usuarias nuevas,2016-10-01,0,36,24,0,0,60
HUACAYA (VILLA DE HUACAYA),"anticoncepcion, prevencion de its y de cancer de cuello uterino",pildora: usuarias nuevas,2016-10-01,0,0,0,1,0,1
HUACHACALLA,"anticoncepcion, prevencion de its y de cancer de cuello uterino",pildora: usuarias nuevas,2016-10-01,0,0,2,0,0,2
HUANUNI,"anticoncepcion, prevencion de its y de cancer de cuello uterino",pildora: usuarias nuevas,2016-10-01,0,1,3,0,0,4
HUARACAJE,"anticoncepcion, prevencion de its y de cancer de cuello uterino",pildora: usuarias nuevas,2016-10-01,0,3,2,0,0,5
HUAYLLAMARCA,"anticoncepcion, prevencion de its y de cancer de cuello uterino",pildora: usuarias nuevas,2016-10-01,0,0,1,0,0,1
ICHOCA,"anticoncepcion, prevencion de its y de cancer de cuello uterino",pildora: usuarias nuevas,2016-10-01,0,0,1,0,0,1
ICLA,"anticoncepcion, prevencion de its y de cancer de cuello uterino",pildora: usuarias nuevas,2016-10-01,0,0,1,0,0,1
INCAHUASI,"anticoncepcion, prevencion de its y de cancer de cuello uterino",pildora: usuarias nuevas,2016-10-01,0,0,1,0,0,1
INGAVI (HUMAITA),"anticoncepcion, prevencion de its y de cancer de cuello uterino",pildora: usuarias nuevas,2016-10-01,0,1,0,0,0,1
INQUISIVI,"anticoncepcion, prevencion de its y de cancer de cuello uterino",pildora: usuarias nuevas,2016-10-01,0,0,0,1,0,1
IRUPANA (VILLA DE LANZA),"anticoncepcion, prevencion de its y de cancer de cuello uterino",pildora: usuarias nuevas,2016-10-01,0,0,3,1,0,4
IXIAMAS,"anticoncepcion, prevencion de its y de cancer de cuello uterino",pildora: usuarias nuevas,2016-10-01,0,0,1,0,0,1
JESUS DE MACHACA,"anticoncepcion, prevencion de its y de cancer de cuello uterino",pildora: usuarias nuevas,2016-10-01,0,0,0,1,0,1
LA ASUNTA,"anticoncepcion, prevencion de its y de cancer de cuello uterino",pildora: usuarias nuevas,2016-10-01,0,0,3,3,0,6
LA GUARDIA,"anticoncepcion, prevencion de its y de cancer de cuello uterino",pildora: usuarias nuevas,2016-10-01,0,12,20,4,0,36
LA PAZ,"anticoncepcion, prevencion de its y de cancer de cuello uterino",pildora: usuarias nuevas,2016-10-01,3,12,296,15,0,326
LAGUNILLAS,"anticoncepcion, prevencion de its y de cancer de cuello uterino",pildora: usuarias nuevas,2016-10-01,0,0,1,0,0,1
LAJA,"anticoncepcion, prevencion de its y de cancer de cuello uterino",pildora: usuarias nuevas,2016-10-01,0,1,2,1,0,4
LAS CARRERAS,"anticoncepcion, prevencion de its y de cancer de cuello uterino",pildora: usuarias nuevas,2016-10-01,0,1,0,0,0,1
LLALLAGUA,"anticoncepcion, prevencion de its y de cancer de cuello uterino",pildora: usuarias nuevas,2016-10-01,0,2,2,3,0,7
LLICA,"anticoncepcion, prevencion de its y de cancer de cuello uterino",pildora: usuarias nuevas,2016-10-01,0,0,2,0,0,2
LORETO,"anticoncepcion, prevencion de its y de cancer de cuello uterino",pildora: usuarias nuevas,2016-10-01,0,0,2,1,0,3
LURIBAY,"anticoncepcion, prevencion de its y de cancer de cuello uterino",pildora: usuarias nuevas,2016-10-01,0,0,1,0,0,1
MACHACAMARCA,"anticoncepcion, prevencion de its y de cancer de cuello uterino",pildora: usuarias nuevas,2016-10-01,0,0,0,1,0,1
MACHARETI,"anticoncepcion, prevencion de its y de cancer de cuello uterino",pildora: usuarias nuevas,2016-10-01,0,1,2,2,0,5
MAGDALENA,"anticoncepcion, prevencion de its y de cancer de cuello uterino",pildora: usuarias nuevas,2016-10-01,1,1,9,2,1,14
MAPIRI,"anticoncepcion, prevencion de its y de cancer de cuello uterino",pildora: usuarias nuevas,2016-10-01,0,0,1,1,0,2
MECAPACA,"anticoncepcion, prevencion de its y de cancer de cuello uterino",pildora: usuarias nuevas,2016-10-01,0,0,1,0,0,1
MINEROS,"anticoncepcion, prevencion de its y de cancer de cuello uterino",pildora: usuarias nuevas,2016-10-01,0,1,6,3,0,10
MIZQUE,"anticoncepcion, prevencion de its y de cancer de cuello uterino",pildora: usuarias nuevas,2016-10-01,0,0,2,1,0,3
MOCOMOCO,"anticoncepcion, prevencion de its y de cancer de cuello uterino",pildora: usuarias nuevas,2016-10-01,0,0,0,1,0,1
MOJOCOYA,"anticoncepcion, prevencion de its y de cancer de cuello uterino",pildora: usuarias nuevas,2016-10-01,0,0,2,0,0,2
MONTEAGUDO,"anticoncepcion, prevencion de its y de cancer de cuello uterino",pildora: usuarias nuevas,2016-10-01,0,2,12,2,0,16
MONTERO,"anticoncepcion, prevencion de its y de cancer de cuello uterino",pildora: usuarias nuevas,2016-10-01,2,7,22,8,0,39
MORO MORO,"anticoncepcion, prevencion de its y de cancer de cuello uterino",pildora: usuarias nuevas,2016-10-01,0,0,1,0,0,1
NACEBE (SANTA ROSA DEL ABUNA),"anticoncepcion, prevencion de its y de cancer de cuello uterino",pildora: usuarias nuevas,2016-10-01,0,0,2,0,0,2
NUEVO MANOA (NUEVA ESPERANZA),"anticoncepcion, prevencion de its y de cancer de cuello uterino",pildora: usuarias nuevas,2016-10-01,0,0,1,0,0,1
OCURI,"anticoncepcion, prevencion de its y de cancer de cuello uterino",pildora: usuarias nuevas,2016-10-01,0,1,0,1,0,2
OKINAWA,"anticoncepcion, prevencion de its y de cancer de cuello uterino",pildora: usuarias nuevas,2016-10-01,0,0,6,1,0,7
ORURO,"anticoncepcion, prevencion de its y de cancer de cuello uterino",pildora: usuarias nuevas,2016-10-01,0,18,38,12,0,68
PADCAYA,"anticoncepcion, prevencion de its y de cancer de cuello uterino",pildora: usuarias nuevas,2016-10-01,0,2,5,0,0,7
PADILLA,"anticoncepcion, prevencion de its y de cancer de cuello uterino",pildora: usuarias nuevas,2016-10-01,0,4,1,2,0,7
PAILON,"anticoncepcion, prevencion de its y de cancer de cuello uterino",pildora: usuarias nuevas,2016-10-01,0,0,5,6,0,11
PALCA,"anticoncepcion, prevencion de its y de cancer de cuello uterino",pildora: usuarias nuevas,2016-10-01,0,0,2,0,0,2
PALOS BLANCOS,"anticoncepcion, prevencion de its y de cancer de cuello uterino",pildora: usuarias nuevas,2016-10-01,0,1,4,1,0,6
PAMPA GRANDE,"anticoncepcion, prevencion de its y de cancer de cuello uterino",pildora: usuarias nuevas,2016-10-01,0,0,1,0,0,1
PASORAPA,"anticoncepcion, prevencion de its y de cancer de cuello uterino",pildora: usuarias nuevas,2016-10-01,0,1,0,0,0,1
PATACAMAYA,"anticoncepcion, prevencion de its y de cancer de cuello uterino",pildora: usuarias nuevas,2016-10-01,0,0,1,3,0,4
PELECHUCO,"anticoncepcion, prevencion de its y de cancer de cuello uterino",pildora: usuarias nuevas,2016-10-01,0,1,0,3,0,4
POCOATA,"anticoncepcion, prevencion de its y de cancer de cuello uterino",pildora: usuarias nuevas,2016-10-01,0,0,2,0,0,2
POCONA,"anticoncepcion, prevencion de its y de cancer de cuello uterino",pildora: usuarias nuevas,2016-10-01,0,2,4,0,0,6
POJO (CBBA),"anticoncepcion, prevencion de its y de cancer de cuello uterino",pildora: usuarias nuevas,2016-10-01,0,0,2,0,0,2
PORCO,"anticoncepcion, prevencion de its y de cancer de cuello uterino",pildora: usuarias nuevas,2016-10-01,0,0,1,0,0,1
POROMA,"anticoncepcion, prevencion de its y de cancer de cuello uterino",pildora: usuarias nuevas,2016-10-01,0,0,0,3,0,3
PORONGO,"anticoncepcion, prevencion de its y de cancer de cuello uterino",pildora: usuarias nuevas,2016-10-01,0,0,9,0,0,9
PORTACHUELO,"anticoncepcion, prevencion de its y de cancer de cuello uterino",pildora: usuarias nuevas,2016-10-01,0,2,3,1,0,6
PORVENIR,"anticoncepcion, prevencion de its y de cancer de cuello uterino",pildora: usuarias nuevas,2016-10-01,0,1,0,0,0,1
POTOSI,"anticoncepcion, prevencion de its y de cancer de cuello uterino",pildora: usuarias nuevas,2016-10-01,0,6,34,3,0,43
PRESTO,"anticoncepcion, prevencion de its y de cancer de cuello uterino",pildora: usuarias nuevas,2016-10-01,0,0,1,0,0,1
PUCARANI,"anticoncepcion, prevencion de its y de cancer de cuello uterino",pildora: usuarias nuevas,2016-10-01,0,0,4,3,0,7
PUERTO ACOSTA,"anticoncepcion, prevencion de its y de cancer de cuello uterino",pildora: usuarias nuevas,2016-10-01,0,0,2,2,0,4
PUERTO CARABUCO,"anticoncepcion, prevencion de its y de cancer de cuello uterino",pildora: usuarias nuevas,2016-10-01,0,0,1,0,0,1
PUERTO GONZALO MORENO,"anticoncepcion, prevencion de its y de cancer de cuello uterino",pildora: usuarias nuevas,2016-10-01,1,2,0,2,0,5
PUERTO PEREZ,"anticoncepcion, prevencion de its y de cancer de cuello uterino",pildora: usuarias nuevas,2016-10-01,0,0,1,0,0,1
PUERTO QUIJARRO,"anticoncepcion, prevencion de its y de cancer de cuello uterino",pildora: usuarias nuevas,2016-10-01,0,0,3,1,0,4
PUERTO RICO,"anticoncepcion, prevencion de its y de cancer de cuello uterino",pildora: usuarias nuevas,2016-10-01,0,1,0,1,0,2
PUERTO VILLARROEL,"anticoncepcion, prevencion de its y de cancer de cuello uterino",pildora: usuarias nuevas,2016-10-01,0,1,6,1,0,8
PUNA,"anticoncepcion, prevencion de its y de cancer de cuello uterino",pildora: usuarias nuevas,2016-10-01,0,0,3,2,0,5
PUNATA,"anticoncepcion, prevencion de its y de cancer de cuello uterino",pildora: usuarias nuevas,2016-10-01,0,1,9,2,0,12
QUILLACOLLO,"anticoncepcion, prevencion de its y de cancer de cuello uterino",pildora: usuarias nuevas,2016-10-01,0,12,10,2,0,24
QUIME,"anticoncepcion, prevencion de its y de cancer de cuello uterino",pildora: usuarias nuevas,2016-10-01,0,1,3,0,0,4
RAVELO,"anticoncepcion, prevencion de its y de cancer de cuello uterino",pildora: usuarias nuevas,2016-10-01,0,0,1,0,0,1
REYES,"anticoncepcion, prevencion de its y de cancer de cuello uterino",pildora: usuarias nuevas,2016-10-01,1,2,11,1,0,15
RIBERALTA,"anticoncepcion, prevencion de its y de cancer de cuello uterino",pildora: usuarias nuevas,2016-10-01,4,8,39,8,0,59
ROBORE,"anticoncepcion, prevencion de its y de cancer de cuello uterino",pildora: usuarias nuevas,2016-10-01,0,0,8,3,0,11
RURRENABAQUE,"anticoncepcion, prevencion de its y de cancer de cuello uterino",pildora: usuarias nuevas,2016-10-01,0,2,6,0,0,8
SACABA,"anticoncepcion, prevencion de its y de cancer de cuello uterino",pildora: usuarias nuevas,2016-10-01,0,3,8,1,0,12
SACACA,"anticoncepcion, prevencion de its y de cancer de cuello uterino",pildora: usuarias nuevas,2016-10-01,0,1,6,1,0,8
SAIPINA,"anticoncepcion, prevencion de its y de cancer de cuello uterino",pildora: usuarias nuevas,2016-10-01,0,0,3,0,0,3
SALINAS DE GARCI MENDOZA,"anticoncepcion, prevencion de its y de cancer de cuello uterino",pildora: usuarias nuevas,2016-10-01,0,0,1,0,0,1
SAMAIPATA,"anticoncepcion, prevencion de its y de cancer de cuello uterino",pildora: usuarias nuevas,2016-10-01,0,2,1,0,0,3
SAN ANDRES,"anticoncepcion, prevencion de its y de cancer de cuello uterino",pildora: usuarias nuevas,2016-10-01,0,3,3,0,0,6
SAN ANDRES DE MACHACA,"anticoncepcion, prevencion de its y de cancer de cuello uterino",pildora: usuarias nuevas,2016-10-01,0,0,1,0,0,1
SAN ANTONIO DE LOMERIO,"anticoncepcion, prevencion de its y de cancer de cuello uterino",pildora: usuarias nuevas,2016-10-01,0,3,1,0,0,4
SAN BORJA,"anticoncepcion, prevencion de its y de cancer de cuello uterino",pildora: usuarias nuevas,2016-10-01,0,1,4,1,0,6
SAN BUENA VENTURA,"anticoncepcion, prevencion de its y de cancer de cuello uterino",pildora: usuarias nuevas,2016-10-01,0,1,0,0,0,1
SAN CARLOS,"anticoncepcion, prevencion de its y de cancer de cuello uterino",pildora: usuarias nuevas,2016-10-01,0,5,5,1,0,11
SAN IGNACIO,"anticoncepcion, prevencion de its y de cancer de cuello uterino",pildora: usuarias nuevas,2016-10-01,0,2,16,4,0,22
SAN IGNACIO DE VELASCO,"anticoncepcion, prevencion de its y de cancer de cuello uterino",pildora: usuarias nuevas,2016-10-01,0,3,14,3,0,20
SAN JAVIER(BNI),"anticoncepcion, prevencion de its y de cancer de cuello uterino",pildora: usuarias nuevas,2016-10-01,0,0,2,0,0,2
SAN JAVIER(STC),"anticoncepcion, prevencion de its y de cancer de cuello uterino",pildora: usuarias nuevas,2016-10-01,1,1,9,0,0,11
SAN JOAQUIN,"anticoncepcion, prevencion de its y de cancer de cuello uterino",pildora: usuarias nuevas,2016-10-01,0,1,1,0,0,2
SAN JOSE DE CHIQUITOS,"anticoncepcion, prevencion de its y de cancer de cuello uterino",pildora: usuarias nuevas,2016-10-01,0,1,1,1,0,3
SAN JUAN DE YAPACANI,"anticoncepcion, prevencion de its y de cancer de cuello uterino",pildora: usuarias nuevas,2016-10-01,0,1,5,0,0,6
SAN JULIAN,"anticoncepcion, prevencion de its y de cancer de cuello uterino",pildora: usuarias nuevas,2016-10-01,0,2,7,1,0,10
SAN LORENZO(PND),"anticoncepcion, prevencion de its y de cancer de cuello uterino",pildora: usuarias nuevas,2016-10-01,0,0,2,1,0,3
SAN LORENZO(TJA),"anticoncepcion, prevencion de its y de cancer de cuello uterino",pildora: usuarias nuevas,2016-10-01,0,0,0,12,0,12
SAN LUCAS,"anticoncepcion, prevencion de its y de cancer de cuello uterino",pildora: usuarias nuevas,2016-10-01,0,1,3,1,0,5
SAN MATIAS,"anticoncepcion, prevencion de its y de cancer de cuello uterino",pildora: usuarias nuevas,2016-10-01,0,1,12,1,0,14
SAN MIGUEL DE VELASCO,"anticoncepcion, prevencion de its y de cancer de cuello uterino",pildora: usuarias nuevas,2016-10-01,0,1,2,0,0,3
SAN PABLO DE LIPEZ,"anticoncepcion, prevencion de its y de cancer de cuello uterino",pildora: usuarias nuevas,2016-10-01,0,0,1,0,0,1
SAN PEDRO,"anticoncepcion, prevencion de its y de cancer de cuello uterino",pildora: usuarias nuevas,2016-10-01,0,1,2,2,0,5
SAN PEDRO DE BUENA VISTA,"anticoncepcion, prevencion de its y de cancer de cuello uterino",pildora: usuarias nuevas,2016-10-01,0,0,1,0,0,1
SAN PEDRO DE CURAHUARA,"anticoncepcion, prevencion de its y de cancer de cuello uterino",pildora: usuarias nuevas,2016-10-01,0,0,1,0,0,1
SAN PEDRO DE TIQUINA,"anticoncepcion, prevencion de its y de cancer de cuello uterino",pildora: usuarias nuevas,2016-10-01,0,0,0,1,0,1
SAN RAFAEL,"anticoncepcion, prevencion de its y de cancer de cuello uterino",pildora: usuarias nuevas,2016-10-01,0,1,8,3,0,12
SAN RAMON SCZ,"anticoncepcion, prevencion de its y de cancer de cuello uterino",pildora: usuarias nuevas,2016-10-01,0,2,3,0,0,5
SANTA ANA,"anticoncepcion, prevencion de its y de cancer de cuello uterino",pildora: usuarias nuevas,2016-10-01,1,0,4,5,0,10
SANTA CRUZ DE LA SIERRA,"anticoncepcion, prevencion de its y de cancer de cuello uterino",pildora: usuarias nuevas,2016-10-01,10,51,174,100,0,335
SANTA ROSA,"anticoncepcion, prevencion de its y de cancer de cuello uterino",pildora: usuarias nuevas,2016-10-01,0,1,0,0,0,1
SANTA ROSA DEL SARA,"anticoncepcion, prevencion de its y de cancer de cuello uterino",pildora: usuarias nuevas,2016-10-01,0,1,3,4,0,8
SANTIAGO DE HUATA,"anticoncepcion, prevencion de its y de cancer de cuello uterino",pildora: usuarias nuevas,2016-10-01,0,0,1,0,0,1
SANTIAGO DE MACHACA,"anticoncepcion, prevencion de its y de cancer de cuello uterino",pildora: usuarias nuevas,2016-10-01,0,0,1,0,0,1
SANTIVAÑES,"anticoncepcion, prevencion de its y de cancer de cuello uterino",pildora: usuarias nuevas,2016-10-01,0,1,0,0,0,1
SANTUARIO DE QUILLACAS,"anticoncepcion, prevencion de its y de cancer de cuello uterino",pildora: usuarias nuevas,2016-10-01,0,0,1,0,0,1
SAPAHAQUI,"anticoncepcion, prevencion de its y de cancer de cuello uterino",pildora: usuarias nuevas,2016-10-01,0,0,1,0,0,1
SENA,"anticoncepcion, prevencion de its y de cancer de cuello uterino",pildora: usuarias nuevas,2016-10-01,0,0,1,0,0,1
SHINAOTA,"anticoncepcion, prevencion de its y de cancer de cuello uterino",pildora: usuarias nuevas,2016-10-01,0,2,0,1,0,3
SICA SICA (VILLA AROMA),"anticoncepcion, prevencion de its y de cancer de cuello uterino",pildora: usuarias nuevas,2016-10-01,0,0,2,0,0,2
SIPE SIPE,"anticoncepcion, prevencion de its y de cancer de cuello uterino",pildora: usuarias nuevas,2016-10-01,0,3,6,2,1,12
SOPACHUY,"anticoncepcion, prevencion de its y de cancer de cuello uterino",pildora: usuarias nuevas,2016-10-01,0,1,2,3,0,6
SORACACHI,"anticoncepcion, prevencion de its y de cancer de cuello uterino",pildora: usuarias nuevas,2016-10-01,0,0,1,0,0,1
SORATA,"anticoncepcion, prevencion de its y de cancer de cuello uterino",pildora: usuarias nuevas,2016-10-01,0,1,0,0,0,1
SUCRE,"anticoncepcion, prevencion de its y de cancer de cuello uterino",pildora: usuarias nuevas,2016-10-01,0,16,58,15,0,89
TACACOMA,"anticoncepcion, prevencion de its y de cancer de cuello uterino",pildora: usuarias nuevas,2016-10-01,0,0,1,0,0,1
TACOPAYA,"anticoncepcion, prevencion de its y de cancer de cuello uterino",pildora: usuarias nuevas,2016-10-01,0,0,0,1,0,1
TAPACARI,"anticoncepcion, prevencion de its y de cancer de cuello uterino",pildora: usuarias nuevas,2016-10-01,0,0,2,3,0,5
TARABUCO,"anticoncepcion, prevencion de its y de cancer de cuello uterino",pildora: usuarias nuevas,2016-10-01,0,0,3,0,0,3
TARATA,"anticoncepcion, prevencion de its y de cancer de cuello uterino",pildora: usuarias nuevas,2016-10-01,0,1,0,0,0,1
TARIJA,"anticoncepcion, prevencion de its y de cancer de cuello uterino",pildora: usuarias nuevas,2016-10-01,0,7,42,21,0,70
TARVITA,"anticoncepcion, prevencion de its y de cancer de cuello uterino",pildora: usuarias nuevas,2016-10-01,0,1,1,2,0,4
TEOPONTE,"anticoncepcion, prevencion de its y de cancer de cuello uterino",pildora: usuarias nuevas,2016-10-01,0,2,1,0,0,3
TIAWANACU,"anticoncepcion, prevencion de its y de cancer de cuello uterino",pildora: usuarias nuevas,2016-10-01,0,1,0,1,0,2
TIPUANI,"anticoncepcion, prevencion de its y de cancer de cuello uterino",pildora: usuarias nuevas,2016-10-01,0,0,2,0,0,2
TIQUIPAYA,"anticoncepcion, prevencion de its y de cancer de cuello uterino",pildora: usuarias nuevas,2016-10-01,0,6,13,0,0,19
TIRAQUE (CBBA),"anticoncepcion, prevencion de its y de cancer de cuello uterino",pildora: usuarias nuevas,2016-10-01,0,0,1,1,0,2
TOCO,"anticoncepcion, prevencion de its y de cancer de cuello uterino",pildora: usuarias nuevas,2016-10-01,0,1,0,0,0,1
TOLATA,"anticoncepcion, prevencion de its y de cancer de cuello uterino",pildora: usuarias nuevas,2016-10-01,0,0,4,0,0,4
TOMINA,"anticoncepcion, prevencion de its y de cancer de cuello uterino",pildora: usuarias nuevas,2016-10-01,0,0,2,2,0,4
TORO TORO,"anticoncepcion, prevencion de its y de cancer de cuello uterino",pildora: usuarias nuevas,2016-10-01,0,0,1,0,0,1
TOTORA(CBBA),"anticoncepcion, prevencion de its y de cancer de cuello uterino",pildora: usuarias nuevas,2016-10-01,0,1,7,0,0,8
TOTORA(ORR),"anticoncepcion, prevencion de its y de cancer de cuello uterino",pildora: usuarias nuevas,2016-10-01,0,0,1,0,0,1
TRINIDAD,"anticoncepcion, prevencion de its y de cancer de cuello uterino",pildora: usuarias nuevas,2016-10-01,0,3,12,2,0,17
TUPIZA,"anticoncepcion, prevencion de its y de cancer de cuello uterino",pildora: usuarias nuevas,2016-10-01,0,4,6,4,0,14
UNCIA,"anticoncepcion, prevencion de its y de cancer de cuello uterino",pildora: usuarias nuevas,2016-10-01,0,3,6,1,0,10
URIONDO (A. CONCEPCION),"anticoncepcion, prevencion de its y de cancer de cuello uterino",pildora: usuarias nuevas,2016-10-01,0,0,3,0,0,3
URUBICHA,"anticoncepcion, prevencion de its y de cancer de cuello uterino",pildora: usuarias nuevas,2016-10-01,0,3,0,0,0,3
UYUNI,"anticoncepcion, prevencion de its y de cancer de cuello uterino",pildora: usuarias nuevas,2016-10-01,0,1,4,0,0,5
VACAS,"anticoncepcion, prevencion de its y de cancer de cuello uterino",pildora: usuarias nuevas,2016-10-01,0,0,1,0,0,1
VALLEGRANDE,"anticoncepcion, prevencion de its y de cancer de cuello uterino",pildora: usuarias nuevas,2016-10-01,0,0,3,1,0,4
VIACHA,"anticoncepcion, prevencion de its y de cancer de cuello uterino",pildora: usuarias nuevas,2016-10-01,0,1,4,0,0,5
VILA VILA,"anticoncepcion, prevencion de its y de cancer de cuello uterino",pildora: usuarias nuevas,2016-10-01,0,1,0,0,0,1
VILLA CHARCAS,"anticoncepcion, prevencion de its y de cancer de cuello uterino",pildora: usuarias nuevas,2016-10-01,0,1,1,2,0,4
VILLA MONTES,"anticoncepcion, prevencion de its y de cancer de cuello uterino",pildora: usuarias nuevas,2016-10-01,0,6,6,3,0,15
VILLA RIVERO,"anticoncepcion, prevencion de its y de cancer de cuello uterino",pildora: usuarias nuevas,2016-10-01,0,0,1,0,0,1
VILLA SERRANO,"anticoncepcion, prevencion de its y de cancer de cuello uterino",pildora: usuarias nuevas,2016-10-01,0,0,1,1,0,2
VILLA TUNARI,"anticoncepcion, prevencion de its y de cancer de cuello uterino",pildora: usuarias nuevas,2016-10-01,0,3,24,7,0,34
VILLA VACA GUZMAN (MUYUPAMPA),"anticoncepcion, prevencion de its y de cancer de cuello uterino",pildora: usuarias nuevas,2016-10-01,0,3,2,1,0,6
VILLAZON,"anticoncepcion, prevencion de its y de cancer de cuello uterino",pildora: usuarias nuevas,2016-10-01,0,2,6,1,0,9
VINTO,"anticoncepcion, prevencion de its y de cancer de cuello uterino",pildora: usuarias nuevas,2016-10-01,0,2,5,0,0,7
VITICHI,"anticoncepcion, prevencion de its y de cancer de cuello uterino",pildora: usuarias nuevas,2016-10-01,0,1,1,0,0,2
WALDO BALLIVIAN,"anticoncepcion, prevencion de its y de cancer de cuello uterino",pildora: usuarias nuevas,2016-10-01,0,0,0,1,0,1
WARNES,"anticoncepcion, prevencion de its y de cancer de cuello uterino",pildora: usuarias nuevas,2016-10-01,0,2,27,1,0,30
YACO,"anticoncepcion, prevencion de its y de cancer de cuello uterino",pildora: usuarias nuevas,2016-10-01,0,0,1,0,0,1
YACUIBA,"anticoncepcion, prevencion de its y de cancer de cuello uterino",pildora: usuarias nuevas,2016-10-01,0,2,9,2,0,13
YAMPARAEZ,"anticoncepcion, prevencion de its y de cancer de cuello uterino",pildora: usuarias nuevas,2016-10-01,0,0,0,1,0,1
YANACACHI,"anticoncepcion, prevencion de its y de cancer de cuello uterino",pildora: usuarias nuevas,2016-10-01,0,0,0,1,0,1
YAPACANI,"anticoncepcion, prevencion de its y de cancer de cuello uterino",pildora: usuarias nuevas,2016-10-01,0,5,10,4,0,19
YOTALA,"anticoncepcion, prevencion de its y de cancer de cuello uterino",pildora: usuarias nuevas,2016-10-01,0,0,2,1,0,3
ZUDAÑEZ,"anticoncepcion, prevencion de its y de cancer de cuello uterino",pildora: usuarias nuevas,2016-10-01,0,0,0,1,0,1
ACHACACHI,"anticoncepcion, prevencion de its y de cancer de cuello uterino",pildora: usuarias nuevas,2016-11-01,0,1,11,1,0,13
ACHOCALLA,"anticoncepcion, prevencion de its y de cancer de cuello uterino",pildora: usuarias nuevas,2016-11-01,0,0,3,0,0,3
AIQUILE,"anticoncepcion, prevencion de its y de cancer de cuello uterino",pildora: usuarias nuevas,2016-11-01,0,2,1,0,0,3
ANDAMARCA,"anticoncepcion, prevencion de its y de cancer de cuello uterino",pildora: usuarias nuevas,2016-11-01,0,1,0,0,0,1
ANTEQUERA,"anticoncepcion, prevencion de its y de cancer de cuello uterino",pildora: usuarias nuevas,2016-11-01,0,2,0,0,0,2
APOLO,"anticoncepcion, prevencion de its y de cancer de cuello uterino",pildora: usuarias nuevas,2016-11-01,0,0,5,2,0,7
ARANI,"anticoncepcion, prevencion de its y de cancer de cuello uterino",pildora: usuarias nuevas,2016-11-01,0,0,0,1,0,1
ARBIETO,"anticoncepcion, prevencion de its y de cancer de cuello uterino",pildora: usuarias nuevas,2016-11-01,0,0,5,1,0,6
ARQUE,"anticoncepcion, prevencion de its y de cancer de cuello uterino",pildora: usuarias nuevas,2016-11-01,0,0,1,2,0,3
ASCENCION DE GUARAYOS,"anticoncepcion, prevencion de its y de cancer de cuello uterino",pildora: usuarias nuevas,2016-11-01,0,2,8,6,0,16
ATOCHA,"anticoncepcion, prevencion de its y de cancer de cuello uterino",pildora: usuarias nuevas,2016-11-01,0,1,3,0,0,4
AYATA,"anticoncepcion, prevencion de its y de cancer de cuello uterino",pildora: usuarias nuevas,2016-11-01,0,1,2,1,0,4
AYO AYO,"anticoncepcion, prevencion de its y de cancer de cuello uterino",pildora: usuarias nuevas,2016-11-01,0,0,0,1,0,1
AYOPAYA (V. DE INDEPENDENCIA),"anticoncepcion, prevencion de its y de cancer de cuello uterino",pildora: usuarias nuevas,2016-11-01,0,2,5,1,0,8
AZURDUY,"anticoncepcion, prevencion de its y de cancer de cuello uterino",pildora: usuarias nuevas,2016-11-01,0,0,1,0,0,1
BATALLAS,"anticoncepcion, prevencion de its y de cancer de cuello uterino",pildora: usuarias nuevas,2016-11-01,0,1,1,0,0,2
BAURES,"anticoncepcion, prevencion de its y de cancer de cuello uterino",pildora: usuarias nuevas,2016-11-01,0,1,0,0,0,1
BELLA FLOR,"anticoncepcion, prevencion de its y de cancer de cuello uterino",pildora: usuarias nuevas,2016-11-01,0,1,0,0,0,1
BERMEJO,"anticoncepcion, prevencion de its y de cancer de cuello uterino",pildora: usuarias nuevas,2016-11-01,1,1,1,2,0,5
BETANZOS,"anticoncepcion, prevencion de its y de cancer de cuello uterino",pildora: usuarias nuevas,2016-11-01,0,0,2,0,0,2
BOYUIBE,"anticoncepcion, prevencion de its y de cancer de cuello uterino",pildora: usuarias nuevas,2016-11-01,0,0,3,0,0,3
BUENA VISTA,"anticoncepcion, prevencion de its y de cancer de cuello uterino",pildora: usuarias nuevas,2016-11-01,0,4,4,0,0,8
CABEZAS,"anticoncepcion, prevencion de its y de cancer de cuello uterino",pildora: usuarias nuevas,2016-11-01,0,3,7,2,0,12
"CAIZA ""D""","anticoncepcion, prevencion de its y de cancer de cuello uterino",pildora: usuarias nuevas,2016-11-01,0,1,2,0,0,3
CAJUATA,"anticoncepcion, prevencion de its y de cancer de cuello uterino",pildora: usuarias nuevas,2016-11-01,0,0,2,0,0,2
CALAMARCA,"anticoncepcion, prevencion de its y de cancer de cuello uterino",pildora: usuarias nuevas,2016-11-01,0,1,0,0,0,1
CAMARGO,"anticoncepcion, prevencion de its y de cancer de cuello uterino",pildora: usuarias nuevas,2016-11-01,0,1,3,2,0,6
CAMIRI,"anticoncepcion, prevencion de its y de cancer de cuello uterino",pildora: usuarias nuevas,2016-11-01,0,1,5,0,0,6
CAPINOTA,"anticoncepcion, prevencion de its y de cancer de cuello uterino",pildora: usuarias nuevas,2016-11-01,0,1,1,1,0,3
CARACOLLO,"anticoncepcion, prevencion de its y de cancer de cuello uterino",pildora: usuarias nuevas,2016-11-01,0,0,1,1,0,2
CARANAVI,"anticoncepcion, prevencion de its y de cancer de cuello uterino",pildora: usuarias nuevas,2016-11-01,0,0,4,0,0,4
CARAPARI,"anticoncepcion, prevencion de its y de cancer de cuello uterino",pildora: usuarias nuevas,2016-11-01,0,15,0,12,0,27
CHALLAPATA,"anticoncepcion, prevencion de its y de cancer de cuello uterino",pildora: usuarias nuevas,2016-11-01,0,0,2,0,0,2
CHARAGUA,"anticoncepcion, prevencion de its y de cancer de cuello uterino",pildora: usuarias nuevas,2016-11-01,0,0,10,7,0,17
CHAYANTA,"anticoncepcion, prevencion de its y de cancer de cuello uterino",pildora: usuarias nuevas,2016-11-01,0,0,1,0,0,1
CHIMORE,"anticoncepcion, prevencion de its y de cancer de cuello uterino",pildora: usuarias nuevas,2016-11-01,1,1,3,2,0,7
CHULUMANI (V. DE LA LIBERTAD),"anticoncepcion, prevencion de its y de cancer de cuello uterino",pildora: usuarias nuevas,2016-11-01,0,0,2,1,0,3
CHUQUIHUTA AYLLU JUCUMANI,"anticoncepcion, prevencion de its y de cancer de cuello uterino",pildora: usuarias nuevas,2016-11-01,0,1,1,0,0,2
CLIZA,"anticoncepcion, prevencion de its y de cancer de cuello uterino",pildora: usuarias nuevas,2016-11-01,0,0,0,1,0,1
COBIJA,"anticoncepcion, prevencion de its y de cancer de cuello uterino",pildora: usuarias nuevas,2016-11-01,0,0,1,0,0,1
COCAPATA,"anticoncepcion, prevencion de its y de cancer de cuello uterino",pildora: usuarias nuevas,2016-11-01,0,3,15,2,0,20
COCHABAMBA,"anticoncepcion, prevencion de its y de cancer de cuello uterino",pildora: usuarias nuevas,2016-11-01,15,29,131,38,0,213
COIPASA,"anticoncepcion, prevencion de its y de cancer de cuello uterino",pildora: usuarias nuevas,2016-11-01,0,0,0,1,0,1
COLCAPIRHUA,"anticoncepcion, prevencion de its y de cancer de cuello uterino",pildora: usuarias nuevas,2016-11-01,0,2,4,1,0,7
"COLCHA ""K""","anticoncepcion, prevencion de its y de cancer de cuello uterino",pildora: usuarias nuevas,2016-11-01,0,1,8,1,0,10
COLOMI,"anticoncepcion, prevencion de its y de cancer de cuello uterino",pildora: usuarias nuevas,2016-11-01,0,0,1,3,0,4
COLPA BELGICA,"anticoncepcion, prevencion de its y de cancer de cuello uterino",pildora: usuarias nuevas,2016-11-01,0,0,2,0,0,2
COLQUECHACA,"anticoncepcion, prevencion de its y de cancer de cuello uterino",pildora: usuarias nuevas,2016-11-01,0,1,2,2,0,5
COLQUENCHA,"anticoncepcion, prevencion de its y de cancer de cuello uterino",pildora: usuarias nuevas,2016-11-01,0,0,1,1,0,2
COLQUIRI,"anticoncepcion, prevencion de its y de cancer de cuello uterino",pildora: usuarias nuevas,2016-11-01,0,2,4,0,0,6
COMARAPA,"anticoncepcion, prevencion de its y de cancer de cuello uterino",pildora: usuarias nuevas,2016-11-01,0,0,1,0,0,1
CORIPATA,"anticoncepcion, prevencion de its y de cancer de cuello uterino",pildora: usuarias nuevas,2016-11-01,0,0,1,0,0,1
COROICO,"anticoncepcion, prevencion de its y de cancer de cuello uterino",pildora: usuarias nuevas,2016-11-01,0,0,2,0,0,2
CORQUE,"anticoncepcion, prevencion de its y de cancer de cuello uterino",pildora: usuarias nuevas,2016-11-01,0,2,3,1,0,6
COTAGAITA,"anticoncepcion, prevencion de its y de cancer de cuello uterino",pildora: usuarias nuevas,2016-11-01,0,1,0,0,0,1
COTOCA,"anticoncepcion, prevencion de its y de cancer de cuello uterino",pildora: usuarias nuevas,2016-11-01,0,3,14,2,0,19
CRUZ DE MACHACAMARCA,"anticoncepcion, prevencion de its y de cancer de cuello uterino",pildora: usuarias nuevas,2016-11-01,0,0,1,0,0,1
CUATRO CAÑADAS,"anticoncepcion, prevencion de its y de cancer de cuello uterino",pildora: usuarias nuevas,2016-11-01,0,2,3,1,0,6
CUCHUMUELA (V. G. VILLARROEL),"anticoncepcion, prevencion de its y de cancer de cuello uterino",pildora: usuarias nuevas,2016-11-01,0,0,1,0,0,1
CUEVO,"anticoncepcion, prevencion de its y de cancer de cuello uterino",pildora: usuarias nuevas,2016-11-01,0,1,0,0,0,1
CULPINA,"anticoncepcion, prevencion de its y de cancer de cuello uterino",pildora: usuarias nuevas,2016-11-01,0,1,4,1,0,6
DESAGUADERO,"anticoncepcion, prevencion de its y de cancer de cuello uterino",pildora: usuarias nuevas,2016-11-01,0,0,1,0,0,1
EL ALTO,"anticoncepcion, prevencion de its y de cancer de cuello uterino",pildora: usuarias nuevas,2016-11-01,0,12,86,36,0,134
EL CHORO,"anticoncepcion, prevencion de its y de cancer de cuello uterino",pildora: usuarias nuevas,2016-11-01,0,1,0,0,0,1
EL PUENTE(STC),"anticoncepcion, prevencion de its y de cancer de cuello uterino",pildora: usuarias nuevas,2016-11-01,0,2,3,0,0,5
EL PUENTE(TJA),"anticoncepcion, prevencion de its y de cancer de cuello uterino",pildora: usuarias nuevas,2016-11-01,0,0,1,0,0,1
EL TORNO,"anticoncepcion, prevencion de its y de cancer de cuello uterino",pildora: usuarias nuevas,2016-11-01,6,7,11,5,0,29
EL VILLAR,"anticoncepcion, prevencion de its y de cancer de cuello uterino",pildora: usuarias nuevas,2016-11-01,0,1,1,0,0,2
ENTRE RIOS TRJ,"anticoncepcion, prevencion de its y de cancer de cuello uterino",pildora: usuarias nuevas,2016-11-01,0,0,6,1,0,7
ENTRE RIOS CBBA,"anticoncepcion, prevencion de its y de cancer de cuello uterino",pildora: usuarias nuevas,2016-11-01,0,1,3,3,0,7
EUCALIPTUS,"anticoncepcion, prevencion de its y de cancer de cuello uterino",pildora: usuarias nuevas,2016-11-01,0,0,1,0,0,1
EUREKA (SANTOS MERCADO),"anticoncepcion, prevencion de its y de cancer de cuello uterino",pildora: usuarias nuevas,2016-11-01,0,0,2,1,0,3
EXALTACION,"anticoncepcion, prevencion de its y de cancer de cuello uterino",pildora: usuarias nuevas,2016-11-01,0,0,1,0,0,1
FERNANDEZ ALONSO,"anticoncepcion, prevencion de its y de cancer de cuello uterino",pildora: usuarias nuevas,2016-11-01,0,0,4,1,0,5
FILADELFIA,"anticoncepcion, prevencion de its y de cancer de cuello uterino",pildora: usuarias nuevas,2016-11-01,0,0,1,1,0,2
GENERAL SAAVEDRA,"anticoncepcion, prevencion de its y de cancer de cuello uterino",pildora: usuarias nuevas,2016-11-01,0,3,4,0,0,7
GRAL. J.J. PEREZ (CHARAZANI),"anticoncepcion, prevencion de its y de cancer de cuello uterino",pildora: usuarias nuevas,2016-11-01,0,0,1,0,1,2
GUANAY,"anticoncepcion, prevencion de its y de cancer de cuello uterino",pildora: usuarias nuevas,2016-11-01,0,0,1,0,0,1
GUAQUI,"anticoncepcion, prevencion de its y de cancer de cuello uterino",pildora: usuarias nuevas,2016-11-01,0,1,0,1,0,2
GUAYARAMERIN,"anticoncepcion, prevencion de its y de cancer de cuello uterino",pildora: usuarias nuevas,2016-11-01,0,4,10,2,0,16
GUTIERREZ,"anticoncepcion, prevencion de its y de cancer de cuello uterino",pildora: usuarias nuevas,2016-11-01,0,0,10,2,0,12
HUACARETA,"anticoncepcion, prevencion de its y de cancer de cuello uterino",pildora: usuarias nuevas,2016-11-01,0,0,2,0,0,2
HUACHACALLA,"anticoncepcion, prevencion de its y de cancer de cuello uterino",pildora: usuarias nuevas,2016-11-01,0,0,1,0,0,1
HUARACAJE,"anticoncepcion, prevencion de its y de cancer de cuello uterino",pildora: usuarias nuevas,2016-11-01,0,1,1,0,0,2
ICLA,"anticoncepcion, prevencion de its y de cancer de cuello uterino",pildora: usuarias nuevas,2016-11-01,0,1,0,0,0,1
INCAHUASI,"anticoncepcion, prevencion de its y de cancer de cuello uterino",pildora: usuarias nuevas,2016-11-01,0,1,1,1,0,3
IXIAMAS,"anticoncepcion, prevencion de its y de cancer de cuello uterino",pildora: usuarias nuevas,2016-11-01,0,0,3,0,0,3
JESUS DE MACHACA,"anticoncepcion, prevencion de its y de cancer de cuello uterino",pildora: usuarias nuevas,2016-11-01,0,0,1,0,0,1
LA ASUNTA,"anticoncepcion, prevencion de its y de cancer de cuello uterino",pildora: usuarias nuevas,2016-11-01,0,2,7,1,0,10
LA GUARDIA,"anticoncepcion, prevencion de its y de cancer de cuello uterino",pildora: usuarias nuevas,2016-11-01,0,7,26,10,0,43
LA PAZ,"anticoncepcion, prevencion de its y de cancer de cuello uterino",pildora: usuarias nuevas,2016-11-01,1,8,129,59,0,197
LAGUNILLAS,"anticoncepcion, prevencion de its y de cancer de cuello uterino",pildora: usuarias nuevas,2016-11-01,0,0,6,1,0,7
LAJA,"anticoncepcion, prevencion de its y de cancer de cuello uterino",pildora: usuarias nuevas,2016-11-01,0,0,1,0,0,1
LLALLAGUA,"anticoncepcion, prevencion de its y de cancer de cuello uterino",pildora: usuarias nuevas,2016-11-01,0,1,0,0,0,1
LORETO,"anticoncepcion, prevencion de its y de cancer de cuello uterino",pildora: usuarias nuevas,2016-11-01,0,5,0,0,0,5
LURIBAY,"anticoncepcion, prevencion de its y de cancer de cuello uterino",pildora: usuarias nuevas,2016-11-01,0,0,0,2,0,2
MACHARETI,"anticoncepcion, prevencion de its y de cancer de cuello uterino",pildora: usuarias nuevas,2016-11-01,0,0,2,1,0,3
MAGDALENA,"anticoncepcion, prevencion de its y de cancer de cuello uterino",pildora: usuarias nuevas,2016-11-01,0,2,1,1,0,4
MAIRANA,"anticoncepcion, prevencion de its y de cancer de cuello uterino",pildora: usuarias nuevas,2016-11-01,0,1,1,0,0,2
MAPIRI,"anticoncepcion, prevencion de its y de cancer de cuello uterino",pildora: usuarias nuevas,2016-11-01,0,0,4,2,0,6
MECAPACA,"anticoncepcion, prevencion de its y de cancer de cuello uterino",pildora: usuarias nuevas,2016-11-01,0,1,1,0,0,2
MINEROS,"anticoncepcion, prevencion de its y de cancer de cuello uterino",pildora: usuarias nuevas,2016-11-01,0,2,11,0,0,13
MIZQUE,"anticoncepcion, prevencion de its y de cancer de cuello uterino",pildora: usuarias nuevas,2016-11-01,0,1,3,3,0,7
MOCOMOCO,"anticoncepcion, prevencion de its y de cancer de cuello uterino",pildora: usuarias nuevas,2016-11-01,0,0,2,0,0,2
MOJOCOYA,"anticoncepcion, prevencion de its y de cancer de cuello uterino",pildora: usuarias nuevas,2016-11-01,0,0,1,1,0,2
MONTEAGUDO,"anticoncepcion, prevencion de its y de cancer de cuello uterino",pildora: usuarias nuevas,2016-11-01,0,1,8,1,0,10
MONTERO,"anticoncepcion, prevencion de its y de cancer de cuello uterino",pildora: usuarias nuevas,2016-11-01,0,7,18,7,0,32
MOROCHATA,"anticoncepcion, prevencion de its y de cancer de cuello uterino",pildora: usuarias nuevas,2016-11-01,0,0,6,0,0,6
NACEBE (SANTA ROSA DEL ABUNA),"anticoncepcion, prevencion de its y de cancer de cuello uterino",pildora: usuarias nuevas,2016-11-01,1,1,0,0,0,2
OCURI,"anticoncepcion, prevencion de its y de cancer de cuello uterino",pildora: usuarias nuevas,2016-11-01,0,0,1,0,0,1
OKINAWA,"anticoncepcion, prevencion de its y de cancer de cuello uterino",pildora: usuarias nuevas,2016-11-01,1,2,2,0,0,5
OMEREQUE,"anticoncepcion, prevencion de its y de cancer de cuello uterino",pildora: usuarias nuevas,2016-11-01,0,0,0,1,0,1
ORURO,"anticoncepcion, prevencion de its y de cancer de cuello uterino",pildora: usuarias nuevas,2016-11-01,0,7,52,18,0,77
PADCAYA,"anticoncepcion, prevencion de its y de cancer de cuello uterino",pildora: usuarias nuevas,2016-11-01,0,2,4,0,0,6
PADILLA,"anticoncepcion, prevencion de its y de cancer de cuello uterino",pildora: usuarias nuevas,2016-11-01,0,2,5,2,0,9
PAILON,"anticoncepcion, prevencion de its y de cancer de cuello uterino",pildora: usuarias nuevas,2016-11-01,0,6,4,2,0,12
PALCA,"anticoncepcion, prevencion de its y de cancer de cuello uterino",pildora: usuarias nuevas,2016-11-01,0,0,3,5,0,8
PALOS BLANCOS,"anticoncepcion, prevencion de its y de cancer de cuello uterino",pildora: usuarias nuevas,2016-11-01,0,1,8,1,0,10
PAMPA GRANDE,"anticoncepcion, prevencion de its y de cancer de cuello uterino",pildora: usuarias nuevas,2016-11-01,0,0,2,1,0,3
PATACAMAYA,"anticoncepcion, prevencion de its y de cancer de cuello uterino",pildora: usuarias nuevas,2016-11-01,0,0,0,1,0,1
PAZÑA,"anticoncepcion, prevencion de its y de cancer de cuello uterino",pildora: usuarias nuevas,2016-11-01,0,0,1,0,0,1
PELECHUCO,"anticoncepcion, prevencion de its y de cancer de cuello uterino",pildora: usuarias nuevas,2016-11-01,0,0,2,0,0,2
POCOATA,"anticoncepcion, prevencion de its y de cancer de cuello uterino",pildora: usuarias nuevas,2016-11-01,0,0,0,1,0,1
POCONA,"anticoncepcion, prevencion de its y de cancer de cuello uterino",pildora: usuarias nuevas,2016-11-01,0,0,4,1,0,5
POJO (CBBA),"anticoncepcion, prevencion de its y de cancer de cuello uterino",pildora: usuarias nuevas,2016-11-01,0,0,1,0,0,1
POROMA,"anticoncepcion, prevencion de its y de cancer de cuello uterino",pildora: usuarias nuevas,2016-11-01,0,0,2,0,0,2
PORONGO,"anticoncepcion, prevencion de its y de cancer de cuello uterino",pildora: usuarias nuevas,2016-11-01,0,1,9,3,0,13
PORTACHUELO,"anticoncepcion, prevencion de its y de cancer de cuello uterino",pildora: usuarias nuevas,2016-11-01,1,0,5,0,0,6
PORVENIR,"anticoncepcion, prevencion de its y de cancer de cuello uterino",pildora: usuarias nuevas,2016-11-01,0,2,0,0,0,2
POSTRER VALLE,"anticoncepcion, prevencion de its y de cancer de cuello uterino",pildora: usuarias nuevas,2016-11-01,0,0,1,0,0,1
POTOSI,"anticoncepcion, prevencion de its y de cancer de cuello uterino",pildora: usuarias nuevas,2016-11-01,0,4,38,4,0,46
PUCARANI,"anticoncepcion, prevencion de its y de cancer de cuello uterino",pildora: usuarias nuevas,2016-11-01,0,0,4,1,0,5
PUERTO ACOSTA,"anticoncepcion, prevencion de its y de cancer de cuello uterino",pildora: usuarias nuevas,2016-11-01,0,1,0,0,0,1
PUERTO CARABUCO,"anticoncepcion, prevencion de its y de cancer de cuello uterino",pildora: usuarias nuevas,2016-11-01,0,1,0,0,0,1
PUERTO GONZALO MORENO,"anticoncepcion, prevencion de its y de cancer de cuello uterino",pildora: usuarias nuevas,2016-11-01,1,2,1,0,0,4
PUERTO PEREZ,"anticoncepcion, prevencion de its y de cancer de cuello uterino",pildora: usuarias nuevas,2016-11-01,0,0,1,0,0,1
PUERTO QUIJARRO,"anticoncepcion, prevencion de its y de cancer de cuello uterino",pildora: usuarias nuevas,2016-11-01,0,2,0,0,0,2
PUERTO RICO,"anticoncepcion, prevencion de its y de cancer de cuello uterino",pildora: usuarias nuevas,2016-11-01,0,0,1,0,0,1
PUERTO SILES,"anticoncepcion, prevencion de its y de cancer de cuello uterino",pildora: usuarias nuevas,2016-11-01,0,0,2,0,0,2
PUERTO SUAREZ,"anticoncepcion, prevencion de its y de cancer de cuello uterino",pildora: usuarias nuevas,2016-11-01,0,1,8,2,0,11
PUERTO VILLARROEL,"anticoncepcion, prevencion de its y de cancer de cuello uterino",pildora: usuarias nuevas,2016-11-01,0,1,4,0,0,5
PUNA,"anticoncepcion, prevencion de its y de cancer de cuello uterino",pildora: usuarias nuevas,2016-11-01,0,2,2,2,0,6
PUNATA,"anticoncepcion, prevencion de its y de cancer de cuello uterino",pildora: usuarias nuevas,2016-11-01,0,0,4,3,0,7
QUIABAYA,"anticoncepcion, prevencion de its y de cancer de cuello uterino",pildora: usuarias nuevas,2016-11-01,0,0,1,0,0,1
QUILLACOLLO,"anticoncepcion, prevencion de its y de cancer de cuello uterino",pildora: usuarias nuevas,2016-11-01,0,7,20,2,0,29
QUIME,"anticoncepcion, prevencion de its y de cancer de cuello uterino",pildora: usuarias nuevas,2016-11-01,0,1,7,3,0,11
RAVELO,"anticoncepcion, prevencion de its y de cancer de cuello uterino",pildora: usuarias nuevas,2016-11-01,0,0,2,1,0,3
REYES,"anticoncepcion, prevencion de its y de cancer de cuello uterino",pildora: usuarias nuevas,2016-11-01,2,2,9,0,0,13
RIBERALTA,"anticoncepcion, prevencion de its y de cancer de cuello uterino",pildora: usuarias nuevas,2016-11-01,0,8,26,5,0,39
ROBORE,"anticoncepcion, prevencion de its y de cancer de cuello uterino",pildora: usuarias nuevas,2016-11-01,0,3,5,1,0,9
RURRENABAQUE,"anticoncepcion, prevencion de its y de cancer de cuello uterino",pildora: usuarias nuevas,2016-11-01,0,0,5,0,0,5
SABAYA,"anticoncepcion, prevencion de its y de cancer de cuello uterino",pildora: usuarias nuevas,2016-11-01,0,0,1,0,0,1
SACABA,"anticoncepcion, prevencion de its y de cancer de cuello uterino",pildora: usuarias nuevas,2016-11-01,0,1,16,5,0,22
SACABAMBA,"anticoncepcion, prevencion de its y de cancer de cuello uterino",pildora: usuarias nuevas,2016-11-01,0,1,0,0,0,1
SACACA,"anticoncepcion, prevencion de its y de cancer de cuello uterino",pildora: usuarias nuevas,2016-11-01,1,1,3,1,0,6
SAIPINA,"anticoncepcion, prevencion de its y de cancer de cuello uterino",pildora: usuarias nuevas,2016-11-01,0,0,3,0,0,3
SALINAS DE GARCI MENDOZA,"anticoncepcion, prevencion de its y de cancer de cuello uterino",pildora: usuarias nuevas,2016-11-01,0,1,1,0,0,2
SAMAIPATA,"anticoncepcion, prevencion de its y de cancer de cuello uterino",pildora: usuarias nuevas,2016-11-01,0,0,1,0,0,1
SAN AGUSTIN,"anticoncepcion, prevencion de its y de cancer de cuello uterino",pildora: usuarias nuevas,2016-11-01,0,0,1,0,0,1
SAN ANDRES,"anticoncepcion, prevencion de its y de cancer de cuello uterino",pildora: usuarias nuevas,2016-11-01,0,0,2,1,0,3
SAN ANDRES DE MACHACA,"anticoncepcion, prevencion de its y de cancer de cuello uterino",pildora: usuarias nuevas,2016-11-01,0,0,1,0,0,1
SAN ANTONIO DE LOMERIO,"anticoncepcion, prevencion de its y de cancer de cuello uterino",pildora: usuarias nuevas,2016-11-01,0,2,6,1,0,9
SAN BORJA,"anticoncepcion, prevencion de its y de cancer de cuello uterino",pildora: usuarias nuevas,2016-11-01,0,2,5,1,0,8
SAN BUENA VENTURA,"anticoncepcion, prevencion de its y de cancer de cuello uterino",pildora: usuarias nuevas,2016-11-01,0,0,9,0,0,9
SAN CARLOS,"anticoncepcion, prevencion de its y de cancer de cuello uterino",pildora: usuarias nuevas,2016-11-01,0,1,4,5,0,10
SAN IGNACIO,"anticoncepcion, prevencion de its y de cancer de cuello uterino",pildora: usuarias nuevas,2016-11-01,0,3,9,2,0,14
SAN IGNACIO DE VELASCO,"anticoncepcion, prevencion de its y de cancer de cuello uterino",pildora: usuarias nuevas,2016-11-01,0,5,14,6,0,25
SAN JAVIER(BNI),"anticoncepcion, prevencion de its y de cancer de cuello uterino",pildora: usuarias nuevas,2016-11-01,0,2,2,0,0,4
SAN JAVIER(STC),"anticoncepcion, prevencion de its y de cancer de cuello uterino",pildora: usuarias nuevas,2016-11-01,0,1,8,1,0,10
SAN JOAQUIN,"anticoncepcion, prevencion de its y de cancer de cuello uterino",pildora: usuarias nuevas,2016-11-01,0,0,2,1,0,3
SAN JOSE DE CHIQUITOS,"anticoncepcion, prevencion de its y de cancer de cuello uterino",pildora: usuarias nuevas,2016-11-01,0,0,4,0,0,4
SAN JUAN DE YAPACANI,"anticoncepcion, prevencion de its y de cancer de cuello uterino",pildora: usuarias nuevas,2016-11-01,0,0,1,0,0,1
SAN JULIAN,"anticoncepcion, prevencion de its y de cancer de cuello uterino",pildora: usuarias nuevas,2016-11-01,0,12,3,14,0,29
SAN LORENZO(PND),"anticoncepcion, prevencion de its y de cancer de cuello uterino",pildora: usuarias nuevas,2016-11-01,0,1,2,0,0,3
SAN LORENZO(TJA),"anticoncepcion, prevencion de its y de cancer de cuello uterino",pildora: usuarias nuevas,2016-11-01,0,2,2,2,0,6
SAN LUCAS,"anticoncepcion, prevencion de its y de cancer de cuello uterino",pildora: usuarias nuevas,2016-11-01,0,1,2,2,0,5
SAN MATIAS,"anticoncepcion, prevencion de its y de cancer de cuello uterino",pildora: usuarias nuevas,2016-11-01,0,0,2,1,0,3
SAN MIGUEL DE VELASCO,"anticoncepcion, prevencion de its y de cancer de cuello uterino",pildora: usuarias nuevas,2016-11-01,0,0,1,2,0,3
SAN PABLO DE LIPEZ,"anticoncepcion, prevencion de its y de cancer de cuello uterino",pildora: usuarias nuevas,2016-11-01,0,0,1,0,0,1
SAN PEDRO,"anticoncepcion, prevencion de its y de cancer de cuello uterino",pildora: usuarias nuevas,2016-11-01,0,1,4,2,0,7
SAN PEDRO DE BUENA VISTA,"anticoncepcion, prevencion de its y de cancer de cuello uterino",pildora: usuarias nuevas,2016-11-01,0,0,0,1,0,1
SAN PEDRO DE CURAHUARA,"anticoncepcion, prevencion de its y de cancer de cuello uterino",pildora: usuarias nuevas,2016-11-01,0,0,1,0,0,1
SAN RAFAEL,"anticoncepcion, prevencion de its y de cancer de cuello uterino",pildora: usuarias nuevas,2016-11-01,1,3,5,0,0,9
SAN RAMON BENI,"anticoncepcion, prevencion de its y de cancer de cuello uterino",pildora: usuarias nuevas,2016-11-01,1,0,0,0,0,1
SAN RAMON SCZ,"anticoncepcion, prevencion de its y de cancer de cuello uterino",pildora: usuarias nuevas,2016-11-01,0,1,1,0,0,2
SANTA ANA,"anticoncepcion, prevencion de its y de cancer de cuello uterino",pildora: usuarias nuevas,2016-11-01,0,2,6,0,0,8
SANTA CRUZ DE LA SIERRA,"anticoncepcion, prevencion de its y de cancer de cuello uterino",pildora: usuarias nuevas,2016-11-01,14,162,372,74,2,624
SANTA ROSA DEL SARA,"anticoncepcion, prevencion de its y de cancer de cuello uterino",pildora: usuarias nuevas,2016-11-01,0,4,8,4,1,17
SANTIAGO DE HUARI,"anticoncepcion, prevencion de its y de cancer de cuello uterino",pildora: usuarias nuevas,2016-11-01,0,0,0,1,0,1
SANTIVAÑES,"anticoncepcion, prevencion de its y de cancer de cuello uterino",pildora: usuarias nuevas,2016-11-01,0,0,2,0,0,2
SAPAHAQUI,"anticoncepcion, prevencion de its y de cancer de cuello uterino",pildora: usuarias nuevas,2016-11-01,0,0,1,1,0,2
SENA,"anticoncepcion, prevencion de its y de cancer de cuello uterino",pildora: usuarias nuevas,2016-11-01,0,1,1,0,0,2
SHINAOTA,"anticoncepcion, prevencion de its y de cancer de cuello uterino",pildora: usuarias nuevas,2016-11-01,0,1,3,1,0,5
SICA SICA (VILLA AROMA),"anticoncepcion, prevencion de its y de cancer de cuello uterino",pildora: usuarias nuevas,2016-11-01,0,1,1,1,0,3
SIPE SIPE,"anticoncepcion, prevencion de its y de cancer de cuello uterino",pildora: usuarias nuevas,2016-11-01,0,2,12,5,0,19
SOPACHUY,"anticoncepcion, prevencion de its y de cancer de cuello uterino",pildora: usuarias nuevas,2016-11-01,0,2,3,0,0,5
SORATA,"anticoncepcion, prevencion de its y de cancer de cuello uterino",pildora: usuarias nuevas,2016-11-01,0,0,2,1,0,3
SUCRE,"anticoncepcion, prevencion de its y de cancer de cuello uterino",pildora: usuarias nuevas,2016-11-01,0,10,55,10,0,75
TACACOMA,"anticoncepcion, prevencion de its y de cancer de cuello uterino",pildora: usuarias nuevas,2016-11-01,0,2,2,0,0,4
TACOBAMBA,"anticoncepcion, prevencion de its y de cancer de cuello uterino",pildora: usuarias nuevas,2016-11-01,0,0,1,0,0,1
TAHUA,"anticoncepcion, prevencion de its y de cancer de cuello uterino",pildora: usuarias nuevas,2016-11-01,0,0,1,0,0,1
TAPACARI,"anticoncepcion, prevencion de its y de cancer de cuello uterino",pildora: usuarias nuevas,2016-11-01,0,0,0,2,0,2
TARABUCO,"anticoncepcion, prevencion de its y de cancer de cuello uterino",pildora: usuarias nuevas,2016-11-01,0,1,1,0,0,2
TARACO,"anticoncepcion, prevencion de its y de cancer de cuello uterino",pildora: usuarias nuevas,2016-11-01,0,0,1,0,0,1
TARATA,"anticoncepcion, prevencion de its y de cancer de cuello uterino",pildora: usuarias nuevas,2016-11-01,0,0,2,0,0,2
TARIJA,"anticoncepcion, prevencion de its y de cancer de cuello uterino",pildora: usuarias nuevas,2016-11-01,0,2,40,7,0,49
TARVITA,"anticoncepcion, prevencion de its y de cancer de cuello uterino",pildora: usuarias nuevas,2016-11-01,1,0,0,2,0,3
TEOPONTE,"anticoncepcion, prevencion de its y de cancer de cuello uterino",pildora: usuarias nuevas,2016-11-01,0,0,6,1,0,7
TIAWANACU,"anticoncepcion, prevencion de its y de cancer de cuello uterino",pildora: usuarias nuevas,2016-11-01,0,0,1,0,0,1
TINGUIPAYA,"anticoncepcion, prevencion de its y de cancer de cuello uterino",pildora: usuarias nuevas,2016-11-01,0,0,1,0,0,1
TIQUIPAYA,"anticoncepcion, prevencion de its y de cancer de cuello uterino",pildora: usuarias nuevas,2016-11-01,0,4,13,2,0,19
TIRAQUE (CBBA),"anticoncepcion, prevencion de its y de cancer de cuello uterino",pildora: usuarias nuevas,2016-11-01,0,0,1,1,0,2
TOCO,"anticoncepcion, prevencion de its y de cancer de cuello uterino",pildora: usuarias nuevas,2016-11-01,0,0,1,0,0,1
TOLATA,"anticoncepcion, prevencion de its y de cancer de cuello uterino",pildora: usuarias nuevas,2016-11-01,0,0,1,1,0,2
TOLEDO,"anticoncepcion, prevencion de its y de cancer de cuello uterino",pildora: usuarias nuevas,2016-11-01,0,0,1,0,0,1
TOMAVE,"anticoncepcion, prevencion de its y de cancer de cuello uterino",pildora: usuarias nuevas,2016-11-01,0,0,3,0,0,3
TOMINA,"anticoncepcion, prevencion de its y de cancer de cuello uterino",pildora: usuarias nuevas,2016-11-01,0,0,2,0,0,2
TORO TORO,"anticoncepcion, prevencion de its y de cancer de cuello uterino",pildora: usuarias nuevas,2016-11-01,0,0,2,0,0,2
TOTORA(CBBA),"anticoncepcion, prevencion de its y de cancer de cuello uterino",pildora: usuarias nuevas,2016-11-01,0,1,6,0,0,7
TRINIDAD,"anticoncepcion, prevencion de its y de cancer de cuello uterino",pildora: usuarias nuevas,2016-11-01,0,0,17,5,0,22
TUPIZA,"anticoncepcion, prevencion de its y de cancer de cuello uterino",pildora: usuarias nuevas,2016-11-01,0,1,6,2,0,9
UMALA,"anticoncepcion, prevencion de its y de cancer de cuello uterino",pildora: usuarias nuevas,2016-11-01,0,0,1,0,0,1
UNCIA,"anticoncepcion, prevencion de its y de cancer de cuello uterino",pildora: usuarias nuevas,2016-11-01,0,4,2,1,0,7
URIONDO (A. CONCEPCION),"anticoncepcion, prevencion de its y de cancer de cuello uterino",pildora: usuarias nuevas,2016-11-01,0,0,2,0,0,2
URUBICHA,"anticoncepcion, prevencion de its y de cancer de cuello uterino",pildora: usuarias nuevas,2016-11-01,0,1,2,0,0,3
UYUNI,"anticoncepcion, prevencion de its y de cancer de cuello uterino",pildora: usuarias nuevas,2016-11-01,0,0,1,0,0,1
VACAS,"anticoncepcion, prevencion de its y de cancer de cuello uterino",pildora: usuarias nuevas,2016-11-01,0,0,2,1,0,3
VIACHA,"anticoncepcion, prevencion de its y de cancer de cuello uterino",pildora: usuarias nuevas,2016-11-01,0,0,4,3,0,7
VILLA CHARCAS,"anticoncepcion, prevencion de its y de cancer de cuello uterino",pildora: usuarias nuevas,2016-11-01,0,1,1,1,0,3
VILLA MONTES,"anticoncepcion, prevencion de its y de cancer de cuello uterino",pildora: usuarias nuevas,2016-11-01,1,0,6,1,0,8
VILLA NUEVA (LOMA ALTA),"anticoncepcion, prevencion de its y de cancer de cuello uterino",pildora: usuarias nuevas,2016-11-01,0,2,2,0,0,4
VILLA SERRANO,"anticoncepcion, prevencion de its y de cancer de cuello uterino",pildora: usuarias nuevas,2016-11-01,0,0,1,0,0,1
VILLA TUNARI,"anticoncepcion, prevencion de its y de cancer de cuello uterino",pildora: usuarias nuevas,2016-11-01,1,3,15,4,0,23
VILLA VACA GUZMAN (MUYUPAMPA),"anticoncepcion, prevencion de its y de cancer de cuello uterino",pildora: usuarias nuevas,2016-11-01,0,2,1,0,0,3
VILLAZON,"anticoncepcion, prevencion de its y de cancer de cuello uterino",pildora: usuarias nuevas,2016-11-01,0,3,5,0,0,8
VINTO,"anticoncepcion, prevencion de its y de cancer de cuello uterino",pildora: usuarias nuevas,2016-11-01,0,2,4,0,0,6
VITICHI,"anticoncepcion, prevencion de its y de cancer de cuello uterino",pildora: usuarias nuevas,2016-11-01,0,1,2,0,0,3
WARNES,"anticoncepcion, prevencion de its y de cancer de cuello uterino",pildora: usuarias nuevas,2016-11-01,0,8,13,0,0,21
YACO,"anticoncepcion, prevencion de its y de cancer de cuello uterino",pildora: usuarias nuevas,2016-11-01,1,0,6,0,0,7
YACUIBA,"anticoncepcion, prevencion de its y de cancer de cuello uterino",pildora: usuarias nuevas,2016-11-01,0,4,8,3,0,15
YAMPARAEZ,"anticoncepcion, prevencion de its y de cancer de cuello uterino",pildora: usuarias nuevas,2016-11-01,0,0,2,0,0,2
YANACACHI,"anticoncepcion, prevencion de its y de cancer de cuello uterino",pildora: usuarias nuevas,2016-11-01,0,0,0,1,0,1
YAPACANI,"anticoncepcion, prevencion de its y de cancer de cuello uterino",pildora: usuarias nuevas,2016-11-01,0,3,9,2,0,14
YOCALLA,"anticoncepcion, prevencion de its y de cancer de cuello uterino",pildora: usuarias nuevas,2016-11-01,0,0,1,0,0,1
YOTALA,"anticoncepcion, prevencion de its y de cancer de cuello uterino",pildora: usuarias nuevas,2016-11-01,0,3,0,0,0,3
YUNCHARA,"anticoncepcion, prevencion de its y de cancer de cuello uterino",pildora: usuarias nuevas,2016-11-01,0,1,4,0,0,5
ACACIO,"anticoncepcion, prevencion de its y de cancer de cuello uterino",pildora: usuarias nuevas,2016-12-01,0,0,1,0,0,1
ACHACACHI,"anticoncepcion, prevencion de its y de cancer de cuello uterino",pildora: usuarias nuevas,2016-12-01,0,0,3,0,0,3
ACHOCALLA,"anticoncepcion, prevencion de its y de cancer de cuello uterino",pildora: usuarias nuevas,2016-12-01,0,1,2,0,0,3
AIQUILE,"anticoncepcion, prevencion de its y de cancer de cuello uterino",pildora: usuarias nuevas,2016-12-01,0,1,7,2,0,10
ALCALA,"anticoncepcion, prevencion de its y de cancer de cuello uterino",pildora: usuarias nuevas,2016-12-01,0,0,1,0,0,1
ALTO BENI,"anticoncepcion, prevencion de its y de cancer de cuello uterino",pildora: usuarias nuevas,2016-12-01,0,0,0,1,0,1
ANDAMARCA,"anticoncepcion, prevencion de its y de cancer de cuello uterino",pildora: usuarias nuevas,2016-12-01,0,0,2,0,0,2
ANTEQUERA,"anticoncepcion, prevencion de its y de cancer de cuello uterino",pildora: usuarias nuevas,2016-12-01,0,0,1,0,0,1
ANZALDO,"anticoncepcion, prevencion de its y de cancer de cuello uterino",pildora: usuarias nuevas,2016-12-01,0,0,1,0,0,1
APOLO,"anticoncepcion, prevencion de its y de cancer de cuello uterino",pildora: usuarias nuevas,2016-12-01,0,0,2,1,0,3
ARBIETO,"anticoncepcion, prevencion de its y de cancer de cuello uterino",pildora: usuarias nuevas,2016-12-01,0,2,2,1,0,5
ASCENCION DE GUARAYOS,"anticoncepcion, prevencion de its y de cancer de cuello uterino",pildora: usuarias nuevas,2016-12-01,0,1,5,3,0,9
ATOCHA,"anticoncepcion, prevencion de its y de cancer de cuello uterino",pildora: usuarias nuevas,2016-12-01,0,1,11,4,0,16
AYATA,"anticoncepcion, prevencion de its y de cancer de cuello uterino",pildora: usuarias nuevas,2016-12-01,0,1,3,0,0,4
AYO AYO,"anticoncepcion, prevencion de its y de cancer de cuello uterino",pildora: usuarias nuevas,2016-12-01,0,0,1,1,0,2
AYOPAYA (V. DE INDEPENDENCIA),"anticoncepcion, prevencion de its y de cancer de cuello uterino",pildora: usuarias nuevas,2016-12-01,0,3,5,0,0,8
AZURDUY,"anticoncepcion, prevencion de its y de cancer de cuello uterino",pildora: usuarias nuevas,2016-12-01,0,0,3,0,0,3
BATALLAS,"anticoncepcion, prevencion de its y de cancer de cuello uterino",pildora: usuarias nuevas,2016-12-01,0,0,1,0,0,1
BAURES,"anticoncepcion, prevencion de its y de cancer de cuello uterino",pildora: usuarias nuevas,2016-12-01,0,0,1,1,0,2
BELEN DE URMIRI,"anticoncepcion, prevencion de its y de cancer de cuello uterino",pildora: usuarias nuevas,2016-12-01,0,0,1,0,0,1
BELLA FLOR,"anticoncepcion, prevencion de its y de cancer de cuello uterino",pildora: usuarias nuevas,2016-12-01,0,0,3,0,0,3
BERMEJO,"anticoncepcion, prevencion de its y de cancer de cuello uterino",pildora: usuarias nuevas,2016-12-01,0,1,5,2,0,8
BOYUIBE,"anticoncepcion, prevencion de its y de cancer de cuello uterino",pildora: usuarias nuevas,2016-12-01,0,0,1,0,0,1
BUENA VISTA,"anticoncepcion, prevencion de its y de cancer de cuello uterino",pildora: usuarias nuevas,2016-12-01,0,2,7,1,0,10
CABEZAS,"anticoncepcion, prevencion de its y de cancer de cuello uterino",pildora: usuarias nuevas,2016-12-01,0,2,9,1,0,12
CAIROMA,"anticoncepcion, prevencion de its y de cancer de cuello uterino",pildora: usuarias nuevas,2016-12-01,0,2,0,0,0,2
CAJUATA,"anticoncepcion, prevencion de its y de cancer de cuello uterino",pildora: usuarias nuevas,2016-12-01,0,0,2,0,0,2
CALACOTO,"anticoncepcion, prevencion de its y de cancer de cuello uterino",pildora: usuarias nuevas,2016-12-01,0,0,1,0,0,1
CALAMARCA,"anticoncepcion, prevencion de its y de cancer de cuello uterino",pildora: usuarias nuevas,2016-12-01,0,0,1,0,0,1
CAMARGO,"anticoncepcion, prevencion de its y de cancer de cuello uterino",pildora: usuarias nuevas,2016-12-01,0,0,1,1,0,2
CAMATAQUI (C. VILLA ABECIA),"anticoncepcion, prevencion de its y de cancer de cuello uterino",pildora: usuarias nuevas,2016-12-01,0,0,0,2,0,2
CAMIRI,"anticoncepcion, prevencion de its y de cancer de cuello uterino",pildora: usuarias nuevas,2016-12-01,0,1,2,1,0,4
CAPINOTA,"anticoncepcion, prevencion de its y de cancer de cuello uterino",pildora: usuarias nuevas,2016-12-01,0,1,1,1,0,3
CARACOLLO,"anticoncepcion, prevencion de its y de cancer de cuello uterino",pildora: usuarias nuevas,2016-12-01,0,1,2,0,0,3
CARANAVI,"anticoncepcion, prevencion de its y de cancer de cuello uterino",pildora: usuarias nuevas,2016-12-01,0,2,4,2,0,8
CARAPARI,"anticoncepcion, prevencion de its y de cancer de cuello uterino",pildora: usuarias nuevas,2016-12-01,0,0,0,2,0,2
CARMEN RIVERO TORREZ,"anticoncepcion, prevencion de its y de cancer de cuello uterino",pildora: usuarias nuevas,2016-12-01,0,0,2,1,0,3
CHAQUI,"anticoncepcion, prevencion de its y de cancer de cuello uterino",pildora: usuarias nuevas,2016-12-01,0,0,0,1,0,1
CHARAGUA,"anticoncepcion, prevencion de its y de cancer de cuello uterino",pildora: usuarias nuevas,2016-12-01,1,0,3,1,0,5
CHARAÑA,"anticoncepcion, prevencion de its y de cancer de cuello uterino",pildora: usuarias nuevas,2016-12-01,0,1,0,0,0,1
CHAYANTA,"anticoncepcion, prevencion de its y de cancer de cuello uterino",pildora: usuarias nuevas,2016-12-01,0,0,0,1,0,1
CHIMORE,"anticoncepcion, prevencion de its y de cancer de cuello uterino",pildora: usuarias nuevas,2016-12-01,0,1,6,1,0,8
CHUA COCANI,"anticoncepcion, prevencion de its y de cancer de cuello uterino",pildora: usuarias nuevas,2016-12-01,0,0,0,2,0,2
CHULUMANI (V. DE LA LIBERTAD),"anticoncepcion, prevencion de its y de cancer de cuello uterino",pildora: usuarias nuevas,2016-12-01,0,1,6,0,0,7
CHUMA,"anticoncepcion, prevencion de its y de cancer de cuello uterino",pildora: usuarias nuevas,2016-12-01,0,0,1,0,0,1
CHUQUIHUTA AYLLU JUCUMANI,"anticoncepcion, prevencion de its y de cancer de cuello uterino",pildora: usuarias nuevas,2016-12-01,0,0,3,2,1,6
CLIZA,"anticoncepcion, prevencion de its y de cancer de cuello uterino",pildora: usuarias nuevas,2016-12-01,0,1,1,0,0,2
COBIJA,"anticoncepcion, prevencion de its y de cancer de cuello uterino",pildora: usuarias nuevas,2016-12-01,0,1,7,0,0,8
COCAPATA,"anticoncepcion, prevencion de its y de cancer de cuello uterino",pildora: usuarias nuevas,2016-12-01,0,1,14,4,0,19
COCHABAMBA,"anticoncepcion, prevencion de its y de cancer de cuello uterino",pildora: usuarias nuevas,2016-12-01,0,29,187,61,1,278
COLCAPIRHUA,"anticoncepcion, prevencion de its y de cancer de cuello uterino",pildora: usuarias nuevas,2016-12-01,0,1,9,0,0,10
"COLCHA ""K""","anticoncepcion, prevencion de its y de cancer de cuello uterino",pildora: usuarias nuevas,2016-12-01,0,1,4,0,0,5
COLOMI,"anticoncepcion, prevencion de its y de cancer de cuello uterino",pildora: usuarias nuevas,2016-12-01,0,0,10,3,0,13
COLPA BELGICA,"anticoncepcion, prevencion de its y de cancer de cuello uterino",pildora: usuarias nuevas,2016-12-01,0,1,4,1,0,6
COLQUECHACA,"anticoncepcion, prevencion de its y de cancer de cuello uterino",pildora: usuarias nuevas,2016-12-01,0,1,1,2,0,4
COLQUIRI,"anticoncepcion, prevencion de its y de cancer de cuello uterino",pildora: usuarias nuevas,2016-12-01,0,1,1,1,0,3
COMARAPA,"anticoncepcion, prevencion de its y de cancer de cuello uterino",pildora: usuarias nuevas,2016-12-01,0,1,1,0,0,2
CONCEPCION,"anticoncepcion, prevencion de its y de cancer de cuello uterino",pildora: usuarias nuevas,2016-12-01,0,0,4,0,0,4
CORIPATA,"anticoncepcion, prevencion de its y de cancer de cuello uterino",pildora: usuarias nuevas,2016-12-01,0,0,1,0,0,1
COROICO,"anticoncepcion, prevencion de its y de cancer de cuello uterino",pildora: usuarias nuevas,2016-12-01,0,1,1,1,1,4
CORQUE,"anticoncepcion, prevencion de its y de cancer de cuello uterino",pildora: usuarias nuevas,2016-12-01,0,0,1,0,0,1
COTAGAITA,"anticoncepcion, prevencion de its y de cancer de cuello uterino",pildora: usuarias nuevas,2016-12-01,0,1,2,1,0,4
COTOCA,"anticoncepcion, prevencion de its y de cancer de cuello uterino",pildora: usuarias nuevas,2016-12-01,0,6,19,6,0,31
CUATRO CAÑADAS,"anticoncepcion, prevencion de its y de cancer de cuello uterino",pildora: usuarias nuevas,2016-12-01,0,0,3,1,0,4
CUEVO,"anticoncepcion, prevencion de its y de cancer de cuello uterino",pildora: usuarias nuevas,2016-12-01,0,0,3,0,0,3
CULPINA,"anticoncepcion, prevencion de its y de cancer de cuello uterino",pildora: usuarias nuevas,2016-12-01,0,2,2,4,0,8
DESAGUADERO,"anticoncepcion, prevencion de its y de cancer de cuello uterino",pildora: usuarias nuevas,2016-12-01,0,0,3,0,0,3
EL ALTO,"anticoncepcion, prevencion de its y de cancer de cuello uterino",pildora: usuarias nuevas,2016-12-01,0,9,92,19,0,120
EL PUENTE(STC),"anticoncepcion, prevencion de its y de cancer de cuello uterino",pildora: usuarias nuevas,2016-12-01,0,1,1,2,0,4
EL PUENTE(TJA),"anticoncepcion, prevencion de its y de cancer de cuello uterino",pildora: usuarias nuevas,2016-12-01,1,2,4,0,0,7
EL TORNO,"anticoncepcion, prevencion de its y de cancer de cuello uterino",pildora: usuarias nuevas,2016-12-01,0,2,9,2,0,13
EL VILLAR,"anticoncepcion, prevencion de its y de cancer de cuello uterino",pildora: usuarias nuevas,2016-12-01,0,0,1,0,0,1
ENTRE RIOS TRJ,"anticoncepcion, prevencion de its y de cancer de cuello uterino",pildora: usuarias nuevas,2016-12-01,0,2,7,5,1,15
ENTRE RIOS CBBA,"anticoncepcion, prevencion de its y de cancer de cuello uterino",pildora: usuarias nuevas,2016-12-01,0,0,5,3,0,8
EUCALIPTUS,"anticoncepcion, prevencion de its y de cancer de cuello uterino",pildora: usuarias nuevas,2016-12-01,0,0,1,0,0,1
EUREKA (SANTOS MERCADO),"anticoncepcion, prevencion de its y de cancer de cuello uterino",pildora: usuarias nuevas,2016-12-01,0,1,2,0,0,3
EXALTACION,"anticoncepcion, prevencion de its y de cancer de cuello uterino",pildora: usuarias nuevas,2016-12-01,0,1,1,1,0,3
FERNANDEZ ALONSO,"anticoncepcion, prevencion de its y de cancer de cuello uterino",pildora: usuarias nuevas,2016-12-01,0,0,5,0,0,5
GENERAL SAAVEDRA,"anticoncepcion, prevencion de its y de cancer de cuello uterino",pildora: usuarias nuevas,2016-12-01,0,2,3,0,0,5
GRAL. J.J. PEREZ (CHARAZANI),"anticoncepcion, prevencion de its y de cancer de cuello uterino",pildora: usuarias nuevas,2016-12-01,0,1,2,0,0,3
GUANAY,"anticoncepcion, prevencion de its y de cancer de cuello uterino",pildora: usuarias nuevas,2016-12-01,0,0,2,1,0,3
GUAQUI,"anticoncepcion, prevencion de its y de cancer de cuello uterino",pildora: usuarias nuevas,2016-12-01,0,2,0,0,0,2
GUAYARAMERIN,"anticoncepcion, prevencion de its y de cancer de cuello uterino",pildora: usuarias nuevas,2016-12-01,0,5,11,1,0,17
GUTIERREZ,"anticoncepcion, prevencion de its y de cancer de cuello uterino",pildora: usuarias nuevas,2016-12-01,0,1,2,1,0,4
HUACARETA,"anticoncepcion, prevencion de its y de cancer de cuello uterino",pildora: usuarias nuevas,2016-12-01,0,0,3,1,0,4
HUACAYA (VILLA DE HUACAYA),"anticoncepcion, prevencion de its y de cancer de cuello uterino",pildora: usuarias nuevas,2016-12-01,0,1,2,1,0,4
HUANUNI,"anticoncepcion, prevencion de its y de cancer de cuello uterino",pildora: usuarias nuevas,2016-12-01,0,0,2,0,0,2
HUARACAJE,"anticoncepcion, prevencion de its y de cancer de cuello uterino",pildora: usuarias nuevas,2016-12-01,0,0,1,0,0,1
HUATAJATA,"anticoncepcion, prevencion de its y de cancer de cuello uterino",pildora: usuarias nuevas,2016-12-01,0,0,0,1,0,1
ICLA,"anticoncepcion, prevencion de its y de cancer de cuello uterino",pildora: usuarias nuevas,2016-12-01,0,0,1,0,0,1
INQUISIVI,"anticoncepcion, prevencion de its y de cancer de cuello uterino",pildora: usuarias nuevas,2016-12-01,0,1,1,0,0,2
IRUPANA (VILLA DE LANZA),"anticoncepcion, prevencion de its y de cancer de cuello uterino",pildora: usuarias nuevas,2016-12-01,0,1,2,0,0,3
IXIAMAS,"anticoncepcion, prevencion de its y de cancer de cuello uterino",pildora: usuarias nuevas,2016-12-01,0,0,1,0,0,1
LA ASUNTA,"anticoncepcion, prevencion de its y de cancer de cuello uterino",pildora: usuarias nuevas,2016-12-01,0,1,4,0,0,5
LA GUARDIA,"anticoncepcion, prevencion de its y de cancer de cuello uterino",pildora: usuarias nuevas,2016-12-01,0,13,24,0,0,37
LA PAZ,"anticoncepcion, prevencion de its y de cancer de cuello uterino",pildora: usuarias nuevas,2016-12-01,0,6,131,62,0,199
LAGUNILLAS,"anticoncepcion, prevencion de its y de cancer de cuello uterino",pildora: usuarias nuevas,2016-12-01,0,2,2,0,0,4
LAJA,"anticoncepcion, prevencion de its y de cancer de cuello uterino",pildora: usuarias nuevas,2016-12-01,0,0,1,1,0,2
LAS CARRERAS,"anticoncepcion, prevencion de its y de cancer de cuello uterino",pildora: usuarias nuevas,2016-12-01,0,0,1,0,0,1
LLALLAGUA,"anticoncepcion, prevencion de its y de cancer de cuello uterino",pildora: usuarias nuevas,2016-12-01,0,0,8,2,0,10
LLICA,"anticoncepcion, prevencion de its y de cancer de cuello uterino",pildora: usuarias nuevas,2016-12-01,0,0,1,0,0,1
LORETO,"anticoncepcion, prevencion de its y de cancer de cuello uterino",pildora: usuarias nuevas,2016-12-01,0,0,1,0,0,1
LURIBAY,"anticoncepcion, prevencion de its y de cancer de cuello uterino",pildora: usuarias nuevas,2016-12-01,0,0,1,1,0,2
MACHACAMARCA,"anticoncepcion, prevencion de its y de cancer de cuello uterino",pildora: usuarias nuevas,2016-12-01,0,0,3,1,0,4
MACHARETI,"anticoncepcion, prevencion de its y de cancer de cuello uterino",pildora: usuarias nuevas,2016-12-01,0,1,7,2,0,10
MAGDALENA,"anticoncepcion, prevencion de its y de cancer de cuello uterino",pildora: usuarias nuevas,2016-12-01,0,0,1,2,0,3
MAPIRI,"anticoncepcion, prevencion de its y de cancer de cuello uterino",pildora: usuarias nuevas,2016-12-01,0,0,1,0,0,1
MECAPACA,"anticoncepcion, prevencion de its y de cancer de cuello uterino",pildora: usuarias nuevas,2016-12-01,0,1,1,1,0,3
MINEROS,"anticoncepcion, prevencion de its y de cancer de cuello uterino",pildora: usuarias nuevas,2016-12-01,1,1,1,2,0,5
MIZQUE,"anticoncepcion, prevencion de its y de cancer de cuello uterino",pildora: usuarias nuevas,2016-12-01,0,2,5,2,0,9
MOJOCOYA,"anticoncepcion, prevencion de its y de cancer de cuello uterino",pildora: usuarias nuevas,2016-12-01,0,0,1,0,0,1
MONTEAGUDO,"anticoncepcion, prevencion de its y de cancer de cuello uterino",pildora: usuarias nuevas,2016-12-01,1,1,5,4,0,11
MONTERO,"anticoncepcion, prevencion de its y de cancer de cuello uterino",pildora: usuarias nuevas,2016-12-01,3,5,22,10,0,40
MORO MORO,"anticoncepcion, prevencion de its y de cancer de cuello uterino",pildora: usuarias nuevas,2016-12-01,0,1,0,0,0,1
MOROCHATA,"anticoncepcion, prevencion de its y de cancer de cuello uterino",pildora: usuarias nuevas,2016-12-01,0,0,5,0,0,5
NACEBE (SANTA ROSA DEL ABUNA),"anticoncepcion, prevencion de its y de cancer de cuello uterino",pildora: usuarias nuevas,2016-12-01,0,0,1,4,0,5
NUEVO MANOA (NUEVA ESPERANZA),"anticoncepcion, prevencion de its y de cancer de cuello uterino",pildora: usuarias nuevas,2016-12-01,0,0,2,0,0,2
OCURI,"anticoncepcion, prevencion de its y de cancer de cuello uterino",pildora: usuarias nuevas,2016-12-01,0,0,5,0,0,5
OKINAWA,"anticoncepcion, prevencion de its y de cancer de cuello uterino",pildora: usuarias nuevas,2016-12-01,0,1,1,0,0,2
ORURO,"anticoncepcion, prevencion de its y de cancer de cuello uterino",pildora: usuarias nuevas,2016-12-01,0,3,35,13,0,51
PADCAYA,"anticoncepcion, prevencion de its y de cancer de cuello uterino",pildora: usuarias nuevas,2016-12-01,0,2,3,0,0,5
PADILLA,"anticoncepcion, prevencion de its y de cancer de cuello uterino",pildora: usuarias nuevas,2016-12-01,0,1,14,1,0,16
PAILON,"anticoncepcion, prevencion de its y de cancer de cuello uterino",pildora: usuarias nuevas,2016-12-01,0,0,1,0,0,1
PALCA,"anticoncepcion, prevencion de its y de cancer de cuello uterino",pildora: usuarias nuevas,2016-12-01,0,0,3,0,0,3
PALOS BLANCOS,"anticoncepcion, prevencion de its y de cancer de cuello uterino",pildora: usuarias nuevas,2016-12-01,1,1,13,2,0,17
PAMPA GRANDE,"anticoncepcion, prevencion de its y de cancer de cuello uterino",pildora: usuarias nuevas,2016-12-01,0,2,0,0,0,2
PASORAPA,"anticoncepcion, prevencion de its y de cancer de cuello uterino",pildora: usuarias nuevas,2016-12-01,0,0,1,0,0,1
PAZÑA,"anticoncepcion, prevencion de its y de cancer de cuello uterino",pildora: usuarias nuevas,2016-12-01,0,0,4,2,0,6
PELECHUCO,"anticoncepcion, prevencion de its y de cancer de cuello uterino",pildora: usuarias nuevas,2016-12-01,0,0,2,0,0,2
POCOATA,"anticoncepcion, prevencion de its y de cancer de cuello uterino",pildora: usuarias nuevas,2016-12-01,0,0,1,0,0,1
POCONA,"anticoncepcion, prevencion de its y de cancer de cuello uterino",pildora: usuarias nuevas,2016-12-01,0,1,6,0,0,7
POJO (CBBA),"anticoncepcion, prevencion de its y de cancer de cuello uterino",pildora: usuarias nuevas,2016-12-01,0,1,3,0,0,4
PORCO,"anticoncepcion, prevencion de its y de cancer de cuello uterino",pildora: usuarias nuevas,2016-12-01,0,0,1,0,0,1
POROMA,"anticoncepcion, prevencion de its y de cancer de cuello uterino",pildora: usuarias nuevas,2016-12-01,0,4,2,0,0,6
PORONGO,"anticoncepcion, prevencion de its y de cancer de cuello uterino",pildora: usuarias nuevas,2016-12-01,1,1,7,2,0,11
PORTACHUELO,"anticoncepcion, prevencion de its y de cancer de cuello uterino",pildora: usuarias nuevas,2016-12-01,0,0,1,0,0,1
PORVENIR,"anticoncepcion, prevencion de its y de cancer de cuello uterino",pildora: usuarias nuevas,2016-12-01,0,0,2,0,0,2
POTOSI,"anticoncepcion, prevencion de its y de cancer de cuello uterino",pildora: usuarias nuevas,2016-12-01,0,5,22,2,0,29
PRESTO,"anticoncepcion, prevencion de its y de cancer de cuello uterino",pildora: usuarias nuevas,2016-12-01,0,0,1,1,0,2
PUERTO CARABUCO,"anticoncepcion, prevencion de its y de cancer de cuello uterino",pildora: usuarias nuevas,2016-12-01,0,0,1,0,0,1
PUERTO GONZALO MORENO,"anticoncepcion, prevencion de its y de cancer de cuello uterino",pildora: usuarias nuevas,2016-12-01,2,1,1,0,0,4
PUERTO PEREZ,"anticoncepcion, prevencion de its y de cancer de cuello uterino",pildora: usuarias nuevas,2016-12-01,0,0,1,0,0,1
PUERTO QUIJARRO,"anticoncepcion, prevencion de its y de cancer de cuello uterino",pildora: usuarias nuevas,2016-12-01,0,0,3,0,0,3
PUERTO RICO,"anticoncepcion, prevencion de its y de cancer de cuello uterino",pildora: usuarias nuevas,2016-12-01,0,0,2,0,0,2
PUERTO SILES,"anticoncepcion, prevencion de its y de cancer de cuello uterino",pildora: usuarias nuevas,2016-12-01,0,0,3,3,0,6
PUERTO SUAREZ,"anticoncepcion, prevencion de its y de cancer de cuello uterino",pildora: usuarias nuevas,2016-12-01,0,2,0,2,0,4
PUERTO VILLARROEL,"anticoncepcion, prevencion de its y de cancer de cuello uterino",pildora: usuarias nuevas,2016-12-01,0,2,10,2,0,14
PUNATA,"anticoncepcion, prevencion de its y de cancer de cuello uterino",pildora: usuarias nuevas,2016-12-01,0,0,4,0,0,4
QUILLACOLLO,"anticoncepcion, prevencion de its y de cancer de cuello uterino",pildora: usuarias nuevas,2016-12-01,1,2,8,5,0,16
QUIME,"anticoncepcion, prevencion de its y de cancer de cuello uterino",pildora: usuarias nuevas,2016-12-01,0,1,1,0,0,2
RAVELO,"anticoncepcion, prevencion de its y de cancer de cuello uterino",pildora: usuarias nuevas,2016-12-01,0,2,4,0,0,6
REYES,"anticoncepcion, prevencion de its y de cancer de cuello uterino",pildora: usuarias nuevas,2016-12-01,0,0,5,0,0,5
RIBERALTA,"anticoncepcion, prevencion de its y de cancer de cuello uterino",pildora: usuarias nuevas,2016-12-01,1,3,21,3,0,28
ROBORE,"anticoncepcion, prevencion de its y de cancer de cuello uterino",pildora: usuarias nuevas,2016-12-01,0,1,1,0,0,2
RURRENABAQUE,"anticoncepcion, prevencion de its y de cancer de cuello uterino",pildora: usuarias nuevas,2016-12-01,0,1,5,0,0,6
SABAYA,"anticoncepcion, prevencion de its y de cancer de cuello uterino",pildora: usuarias nuevas,2016-12-01,0,2,0,0,0,2
SACABA,"anticoncepcion, prevencion de its y de cancer de cuello uterino",pildora: usuarias nuevas,2016-12-01,0,3,13,5,0,21
SACABAMBA,"anticoncepcion, prevencion de its y de cancer de cuello uterino",pildora: usuarias nuevas,2016-12-01,0,0,0,1,0,1
SACACA,"anticoncepcion, prevencion de its y de cancer de cuello uterino",pildora: usuarias nuevas,2016-12-01,0,1,1,1,0,3
SAIPINA,"anticoncepcion, prevencion de its y de cancer de cuello uterino",pildora: usuarias nuevas,2016-12-01,0,0,1,0,0,1
SALINAS DE GARCI MENDOZA,"anticoncepcion, prevencion de its y de cancer de cuello uterino",pildora: usuarias nuevas,2016-12-01,0,1,1,0,0,2
SAMAIPATA,"anticoncepcion, prevencion de its y de cancer de cuello uterino",pildora: usuarias nuevas,2016-12-01,0,0,1,0,0,1
SAN AGUSTIN,"anticoncepcion, prevencion de its y de cancer de cuello uterino",pildora: usuarias nuevas,2016-12-01,0,0,1,0,0,1
SAN ANDRES,"anticoncepcion, prevencion de its y de cancer de cuello uterino",pildora: usuarias nuevas,2016-12-01,1,1,5,1,0,8
SAN ANDRES DE MACHACA,"anticoncepcion, prevencion de its y de cancer de cuello uterino",pildora: usuarias nuevas,2016-12-01,0,1,0,0,0,1
SAN ANTONIO DE ESMORUCO,"anticoncepcion, prevencion de its y de cancer de cuello uterino",pildora: usuarias nuevas,2016-12-01,0,0,1,0,0,1
SAN ANTONIO DE LOMERIO,"anticoncepcion, prevencion de its y de cancer de cuello uterino",pildora: usuarias nuevas,2016-12-01,0,1,1,0,0,2
SAN BORJA,"anticoncepcion, prevencion de its y de cancer de cuello uterino",pildora: usuarias nuevas,2016-12-01,0,2,10,2,0,14
SAN BUENA VENTURA,"anticoncepcion, prevencion de its y de cancer de cuello uterino",pildora: usuarias nuevas,2016-12-01,0,0,1,1,0,2
SAN CARLOS,"anticoncepcion, prevencion de its y de cancer de cuello uterino",pildora: usuarias nuevas,2016-12-01,0,3,3,1,0,7
SAN IGNACIO,"anticoncepcion, prevencion de its y de cancer de cuello uterino",pildora: usuarias nuevas,2016-12-01,0,4,8,4,0,16
SAN IGNACIO DE VELASCO,"anticoncepcion, prevencion de its y de cancer de cuello uterino",pildora: usuarias nuevas,2016-12-01,0,5,7,3,0,15
SAN JAVIER(BNI),"anticoncepcion, prevencion de its y de cancer de cuello uterino",pildora: usuarias nuevas,2016-12-01,0,0,3,0,0,3
SAN JAVIER(STC),"anticoncepcion, prevencion de its y de cancer de cuello uterino",pildora: usuarias nuevas,2016-12-01,0,7,0,0,0,7
SAN JOAQUIN,"anticoncepcion, prevencion de its y de cancer de cuello uterino",pildora: usuarias nuevas,2016-12-01,0,1,1,0,0,2
SAN JOSE DE CHIQUITOS,"anticoncepcion, prevencion de its y de cancer de cuello uterino",pildora: usuarias nuevas,2016-12-01,0,1,1,0,0,2
SAN JUAN DE YAPACANI,"anticoncepcion, prevencion de its y de cancer de cuello uterino",pildora: usuarias nuevas,2016-12-01,0,1,2,1,0,4
SAN JULIAN,"anticoncepcion, prevencion de its y de cancer de cuello uterino",pildora: usuarias nuevas,2016-12-01,0,1,13,5,0,19
SAN LORENZO(PND),"anticoncepcion, prevencion de its y de cancer de cuello uterino",pildora: usuarias nuevas,2016-12-01,0,0,1,0,0,1
SAN LORENZO(TJA),"anticoncepcion, prevencion de its y de cancer de cuello uterino",pildora: usuarias nuevas,2016-12-01,0,2,4,1,0,7
SAN LUCAS,"anticoncepcion, prevencion de its y de cancer de cuello uterino",pildora: usuarias nuevas,2016-12-01,0,1,2,0,0,3
SAN MATIAS,"anticoncepcion, prevencion de its y de cancer de cuello uterino",pildora: usuarias nuevas,2016-12-01,0,0,4,0,0,4
SAN MIGUEL DE VELASCO,"anticoncepcion, prevencion de its y de cancer de cuello uterino",pildora: usuarias nuevas,2016-12-01,0,1,3,0,0,4
SAN PEDRO,"anticoncepcion, prevencion de its y de cancer de cuello uterino",pildora: usuarias nuevas,2016-12-01,0,2,3,0,0,5
SAN PEDRO DE BUENA VISTA,"anticoncepcion, prevencion de its y de cancer de cuello uterino",pildora: usuarias nuevas,2016-12-01,0,0,4,0,0,4
SAN PEDRO DE CURAHUARA,"anticoncepcion, prevencion de its y de cancer de cuello uterino",pildora: usuarias nuevas,2016-12-01,0,0,1,1,0,2
SAN PEDRO DE QUEMES,"anticoncepcion, prevencion de its y de cancer de cuello uterino",pildora: usuarias nuevas,2016-12-01,0,0,2,0,0,2
SAN RAFAEL,"anticoncepcion, prevencion de its y de cancer de cuello uterino",pildora: usuarias nuevas,2016-12-01,0,2,6,0,0,8
SAN RAMON SCZ,"anticoncepcion, prevencion de its y de cancer de cuello uterino",pildora: usuarias nuevas,2016-12-01,0,0,6,3,0,9
SANTA ANA,"anticoncepcion, prevencion de its y de cancer de cuello uterino",pildora: usuarias nuevas,2016-12-01,0,0,7,0,0,7
SANTA CRUZ DE LA SIERRA,"anticoncepcion, prevencion de its y de cancer de cuello uterino",pildora: usuarias nuevas,2016-12-01,0,50,145,38,0,233
SANTA ROSA,"anticoncepcion, prevencion de its y de cancer de cuello uterino",pildora: usuarias nuevas,2016-12-01,0,1,2,0,0,3
SANTA ROSA DEL SARA,"anticoncepcion, prevencion de its y de cancer de cuello uterino",pildora: usuarias nuevas,2016-12-01,0,1,11,2,0,14
SANTIAGO DE HUATA,"anticoncepcion, prevencion de its y de cancer de cuello uterino",pildora: usuarias nuevas,2016-12-01,0,0,2,0,0,2
SANTIVAÑES,"anticoncepcion, prevencion de its y de cancer de cuello uterino",pildora: usuarias nuevas,2016-12-01,0,1,2,0,0,3
SANTUARIO DE QUILLACAS,"anticoncepcion, prevencion de its y de cancer de cuello uterino",pildora: usuarias nuevas,2016-12-01,0,1,0,0,0,1
SAPAHAQUI,"anticoncepcion, prevencion de its y de cancer de cuello uterino",pildora: usuarias nuevas,2016-12-01,0,0,2,0,0,2
SENA,"anticoncepcion, prevencion de its y de cancer de cuello uterino",pildora: usuarias nuevas,2016-12-01,0,1,1,0,0,2
SHINAOTA,"anticoncepcion, prevencion de its y de cancer de cuello uterino",pildora: usuarias nuevas,2016-12-01,0,0,8,0,0,8
SICA SICA (VILLA AROMA),"anticoncepcion, prevencion de its y de cancer de cuello uterino",pildora: usuarias nuevas,2016-12-01,0,0,1,2,0,3
SICAYA,"anticoncepcion, prevencion de its y de cancer de cuello uterino",pildora: usuarias nuevas,2016-12-01,0,0,1,0,0,1
SIPE SIPE,"anticoncepcion, prevencion de its y de cancer de cuello uterino",pildora: usuarias nuevas,2016-12-01,0,0,14,7,0,21
SOPACHUY,"anticoncepcion, prevencion de its y de cancer de cuello uterino",pildora: usuarias nuevas,2016-12-01,0,2,4,1,0,7
SORACACHI,"anticoncepcion, prevencion de its y de cancer de cuello uterino",pildora: usuarias nuevas,2016-12-01,0,0,3,0,0,3
SORATA,"anticoncepcion, prevencion de its y de cancer de cuello uterino",pildora: usuarias nuevas,2016-12-01,0,0,2,3,0,5
SUCRE,"anticoncepcion, prevencion de its y de cancer de cuello uterino",pildora: usuarias nuevas,2016-12-01,0,10,42,11,0,63
TACACOMA,"anticoncepcion, prevencion de its y de cancer de cuello uterino",pildora: usuarias nuevas,2016-12-01,0,1,3,2,0,6
TACOPAYA,"anticoncepcion, prevencion de its y de cancer de cuello uterino",pildora: usuarias nuevas,2016-12-01,0,0,1,0,0,1
TAHUA,"anticoncepcion, prevencion de its y de cancer de cuello uterino",pildora: usuarias nuevas,2016-12-01,0,0,1,0,0,1
TAPACARI,"anticoncepcion, prevencion de its y de cancer de cuello uterino",pildora: usuarias nuevas,2016-12-01,0,0,1,1,0,2
TARABUCO,"anticoncepcion, prevencion de its y de cancer de cuello uterino",pildora: usuarias nuevas,2016-12-01,0,1,2,1,0,4
TARATA,"anticoncepcion, prevencion de its y de cancer de cuello uterino",pildora: usuarias nuevas,2016-12-01,0,0,1,0,0,1
TARIJA,"anticoncepcion, prevencion de its y de cancer de cuello uterino",pildora: usuarias nuevas,2016-12-01,0,8,31,17,0,56
TARVITA,"anticoncepcion, prevencion de its y de cancer de cuello uterino",pildora: usuarias nuevas,2016-12-01,1,1,2,0,0,4
TEOPONTE,"anticoncepcion, prevencion de its y de cancer de cuello uterino",pildora: usuarias nuevas,2016-12-01,0,1,2,0,0,3
TIAWANACU,"anticoncepcion, prevencion de its y de cancer de cuello uterino",pildora: usuarias nuevas,2016-12-01,0,0,0,1,0,1
TINGUIPAYA,"anticoncepcion, prevencion de its y de cancer de cuello uterino",pildora: usuarias nuevas,2016-12-01,0,0,2,0,0,2
TIPUANI,"anticoncepcion, prevencion de its y de cancer de cuello uterino",pildora: usuarias nuevas,2016-12-01,0,0,3,0,0,3
TIQUIPAYA,"anticoncepcion, prevencion de its y de cancer de cuello uterino",pildora: usuarias nuevas,2016-12-01,0,2,11,2,0,15
TIRAQUE (CBBA),"anticoncepcion, prevencion de its y de cancer de cuello uterino",pildora: usuarias nuevas,2016-12-01,0,0,3,1,0,4
TOLATA,"anticoncepcion, prevencion de its y de cancer de cuello uterino",pildora: usuarias nuevas,2016-12-01,0,0,1,1,0,2
TOMAVE,"anticoncepcion, prevencion de its y de cancer de cuello uterino",pildora: usuarias nuevas,2016-12-01,0,1,0,1,0,2
TOMINA,"anticoncepcion, prevencion de its y de cancer de cuello uterino",pildora: usuarias nuevas,2016-12-01,0,0,1,1,0,2
TORO TORO,"anticoncepcion, prevencion de its y de cancer de cuello uterino",pildora: usuarias nuevas,2016-12-01,0,2,0,1,0,3
TOTORA(CBBA),"anticoncepcion, prevencion de its y de cancer de cuello uterino",pildora: usuarias nuevas,2016-12-01,0,1,1,1,0,3
TRINIDAD,"anticoncepcion, prevencion de its y de cancer de cuello uterino",pildora: usuarias nuevas,2016-12-01,1,3,13,8,0,25
TUPIZA,"anticoncepcion, prevencion de its y de cancer de cuello uterino",pildora: usuarias nuevas,2016-12-01,0,3,5,2,0,10
UNCIA,"anticoncepcion, prevencion de its y de cancer de cuello uterino",pildora: usuarias nuevas,2016-12-01,0,0,3,1,0,4
URIONDO (A. CONCEPCION),"anticoncepcion, prevencion de its y de cancer de cuello uterino",pildora: usuarias nuevas,2016-12-01,0,3,3,1,0,7
UYUNI,"anticoncepcion, prevencion de its y de cancer de cuello uterino",pildora: usuarias nuevas,2016-12-01,0,0,4,1,0,5
VALLEGRANDE,"anticoncepcion, prevencion de its y de cancer de cuello uterino",pildora: usuarias nuevas,2016-12-01,0,1,1,1,0,3
VIACHA,"anticoncepcion, prevencion de its y de cancer de cuello uterino",pildora: usuarias nuevas,2016-12-01,0,1,5,0,0,6
VILLA CHARCAS,"anticoncepcion, prevencion de its y de cancer de cuello uterino",pildora: usuarias nuevas,2016-12-01,0,0,2,0,0,2
VILLA MONTES,"anticoncepcion, prevencion de its y de cancer de cuello uterino",pildora: usuarias nuevas,2016-12-01,0,1,8,1,0,10
VILLA NUEVA (LOMA ALTA),"anticoncepcion, prevencion de its y de cancer de cuello uterino",pildora: usuarias nuevas,2016-12-01,0,0,1,0,0,1
VILLA RIVERO,"anticoncepcion, prevencion de its y de cancer de cuello uterino",pildora: usuarias nuevas,2016-12-01,0,0,1,0,0,1
VILLA SERRANO,"anticoncepcion, prevencion de its y de cancer de cuello uterino",pildora: usuarias nuevas,2016-12-01,0,0,0,1,0,1
VILLA TUNARI,"anticoncepcion, prevencion de its y de cancer de cuello uterino",pildora: usuarias nuevas,2016-12-01,0,3,16,5,0,24
VILLA VACA GUZMAN (MUYUPAMPA),"anticoncepcion, prevencion de its y de cancer de cuello uterino",pildora: usuarias nuevas,2016-12-01,1,2,0,0,0,3
VILLAZON,"anticoncepcion, prevencion de its y de cancer de cuello uterino",pildora: usuarias nuevas,2016-12-01,0,1,4,1,0,6
VINTO,"anticoncepcion, prevencion de its y de cancer de cuello uterino",pildora: usuarias nuevas,2016-12-01,0,1,3,0,0,4
VITICHI,"anticoncepcion, prevencion de its y de cancer de cuello uterino",pildora: usuarias nuevas,2016-12-01,0,1,0,0,0,1
WARNES,"anticoncepcion, prevencion de its y de cancer de cuello uterino",pildora: usuarias nuevas,2016-12-01,0,13,15,9,0,37
YACO,"anticoncepcion, prevencion de its y de cancer de cuello uterino",pildora: usuarias nuevas,2016-12-01,0,1,0,1,0,2
YACUIBA,"anticoncepcion, prevencion de its y de cancer de cuello uterino",pildora: usuarias nuevas,2016-12-01,0,4,7,1,0,12
YAPACANI,"anticoncepcion, prevencion de its y de cancer de cuello uterino",pildora: usuarias nuevas,2016-12-01,0,2,15,1,0,18
YOCALLA,"anticoncepcion, prevencion de its y de cancer de cuello uterino",pildora: usuarias nuevas,2016-12-01,0,0,1,0,0,1
YOTALA,"anticoncepcion, prevencion de its y de cancer de cuello uterino",pildora: usuarias nuevas,2016-12-01,0,0,2,0,0,2
YUNCHARA,"anticoncepcion, prevencion de its y de cancer de cuello uterino",pildora: usuarias nuevas,2016-12-01,0,0,1,1,0,2
