municipality,group,variable,month,úmero de DIU Insertados,úmero de DIU Insertados1,úmero de DIU Insertados2,úmero de DIU Insertados3,úmero de DIU Insertados4,TOTAL
ACHACACHI,"anticoncepcion, prevencion de its y de cancer de cuello uterino",umero de diu insertados,2016-01-01,0,0,1,2,0,3
AIQUILE,"anticoncepcion, prevencion de its y de cancer de cuello uterino",umero de diu insertados,2016-01-01,0,1,0,0,0,1
ASCENCION DE GUARAYOS,"anticoncepcion, prevencion de its y de cancer de cuello uterino",umero de diu insertados,2016-01-01,0,0,1,0,0,1
BAURES,"anticoncepcion, prevencion de its y de cancer de cuello uterino",umero de diu insertados,2016-01-01,0,1,2,0,0,3
BERMEJO,"anticoncepcion, prevencion de its y de cancer de cuello uterino",umero de diu insertados,2016-01-01,0,0,3,2,0,5
BETANZOS,"anticoncepcion, prevencion de its y de cancer de cuello uterino",umero de diu insertados,2016-01-01,0,1,0,0,0,1
BUENA VISTA,"anticoncepcion, prevencion de its y de cancer de cuello uterino",umero de diu insertados,2016-01-01,0,1,0,0,0,1
CAMARGO,"anticoncepcion, prevencion de its y de cancer de cuello uterino",umero de diu insertados,2016-01-01,0,0,2,0,0,2
CAMIRI,"anticoncepcion, prevencion de its y de cancer de cuello uterino",umero de diu insertados,2016-01-01,0,0,0,4,0,4
CAPINOTA,"anticoncepcion, prevencion de its y de cancer de cuello uterino",umero de diu insertados,2016-01-01,0,1,0,0,0,1
CARAPARI,"anticoncepcion, prevencion de its y de cancer de cuello uterino",umero de diu insertados,2016-01-01,0,0,1,0,0,1
CHULUMANI (V. DE LA LIBERTAD),"anticoncepcion, prevencion de its y de cancer de cuello uterino",umero de diu insertados,2016-01-01,0,0,0,1,0,1
CHUQUIHUTA AYLLU JUCUMANI,"anticoncepcion, prevencion de its y de cancer de cuello uterino",umero de diu insertados,2016-01-01,0,1,0,1,0,2
CLIZA,"anticoncepcion, prevencion de its y de cancer de cuello uterino",umero de diu insertados,2016-01-01,0,0,2,0,0,2
COBIJA,"anticoncepcion, prevencion de its y de cancer de cuello uterino",umero de diu insertados,2016-01-01,0,1,1,1,0,3
COCHABAMBA,"anticoncepcion, prevencion de its y de cancer de cuello uterino",umero de diu insertados,2016-01-01,0,36,125,66,0,227
COLCAPIRHUA,"anticoncepcion, prevencion de its y de cancer de cuello uterino",umero de diu insertados,2016-01-01,0,0,3,0,0,3
COMARAPA,"anticoncepcion, prevencion de its y de cancer de cuello uterino",umero de diu insertados,2016-01-01,0,0,1,0,0,1
COTOCA,"anticoncepcion, prevencion de its y de cancer de cuello uterino",umero de diu insertados,2016-01-01,0,0,0,1,0,1
EL ALTO,"anticoncepcion, prevencion de its y de cancer de cuello uterino",umero de diu insertados,2016-01-01,0,2,27,14,0,43
EL TORNO,"anticoncepcion, prevencion de its y de cancer de cuello uterino",umero de diu insertados,2016-01-01,0,1,3,1,0,5
ENTRE RIOS TRJ,"anticoncepcion, prevencion de its y de cancer de cuello uterino",umero de diu insertados,2016-01-01,1,1,1,0,0,3
ENTRE RIOS CBBA,"anticoncepcion, prevencion de its y de cancer de cuello uterino",umero de diu insertados,2016-01-01,0,1,0,0,0,1
GENERAL SAAVEDRA,"anticoncepcion, prevencion de its y de cancer de cuello uterino",umero de diu insertados,2016-01-01,0,0,3,0,0,3
GUANAY,"anticoncepcion, prevencion de its y de cancer de cuello uterino",umero de diu insertados,2016-01-01,0,2,0,0,0,2
GUAQUI,"anticoncepcion, prevencion de its y de cancer de cuello uterino",umero de diu insertados,2016-01-01,0,0,1,0,0,1
GUAYARAMERIN,"anticoncepcion, prevencion de its y de cancer de cuello uterino",umero de diu insertados,2016-01-01,0,1,0,0,0,1
LA GUARDIA,"anticoncepcion, prevencion de its y de cancer de cuello uterino",umero de diu insertados,2016-01-01,0,5,7,3,0,15
LA PAZ,"anticoncepcion, prevencion de its y de cancer de cuello uterino",umero de diu insertados,2016-01-01,1,10,164,39,1,215
LAS CARRERAS,"anticoncepcion, prevencion de its y de cancer de cuello uterino",umero de diu insertados,2016-01-01,0,0,0,1,0,1
MAGDALENA,"anticoncepcion, prevencion de its y de cancer de cuello uterino",umero de diu insertados,2016-01-01,0,0,2,0,0,2
MAIRANA,"anticoncepcion, prevencion de its y de cancer de cuello uterino",umero de diu insertados,2016-01-01,1,0,2,0,0,3
MINEROS,"anticoncepcion, prevencion de its y de cancer de cuello uterino",umero de diu insertados,2016-01-01,0,0,0,1,0,1
MIZQUE,"anticoncepcion, prevencion de its y de cancer de cuello uterino",umero de diu insertados,2016-01-01,0,0,2,0,0,2
MONTEAGUDO,"anticoncepcion, prevencion de its y de cancer de cuello uterino",umero de diu insertados,2016-01-01,0,1,6,1,0,8
MONTERO,"anticoncepcion, prevencion de its y de cancer de cuello uterino",umero de diu insertados,2016-01-01,0,1,17,2,0,20
OKINAWA,"anticoncepcion, prevencion de its y de cancer de cuello uterino",umero de diu insertados,2016-01-01,0,0,1,0,0,1
ORURO,"anticoncepcion, prevencion de its y de cancer de cuello uterino",umero de diu insertados,2016-01-01,1,4,12,2,1,20
PADCAYA,"anticoncepcion, prevencion de its y de cancer de cuello uterino",umero de diu insertados,2016-01-01,0,0,1,3,0,4
PADILLA,"anticoncepcion, prevencion de its y de cancer de cuello uterino",umero de diu insertados,2016-01-01,0,0,0,3,0,3
PAILON,"anticoncepcion, prevencion de its y de cancer de cuello uterino",umero de diu insertados,2016-01-01,0,0,1,0,0,1
PALOS BLANCOS,"anticoncepcion, prevencion de its y de cancer de cuello uterino",umero de diu insertados,2016-01-01,0,0,0,1,0,1
PAMPA GRANDE,"anticoncepcion, prevencion de its y de cancer de cuello uterino",umero de diu insertados,2016-01-01,0,0,1,0,0,1
PASORAPA,"anticoncepcion, prevencion de its y de cancer de cuello uterino",umero de diu insertados,2016-01-01,0,1,1,0,0,2
POCOATA,"anticoncepcion, prevencion de its y de cancer de cuello uterino",umero de diu insertados,2016-01-01,0,1,1,0,0,2
PORONGO,"anticoncepcion, prevencion de its y de cancer de cuello uterino",umero de diu insertados,2016-01-01,0,0,0,1,0,1
PORTACHUELO,"anticoncepcion, prevencion de its y de cancer de cuello uterino",umero de diu insertados,2016-01-01,0,0,5,1,0,6
POTOSI,"anticoncepcion, prevencion de its y de cancer de cuello uterino",umero de diu insertados,2016-01-01,0,0,13,4,0,17
PUERTO SUAREZ,"anticoncepcion, prevencion de its y de cancer de cuello uterino",umero de diu insertados,2016-01-01,0,0,4,1,0,5
QUILLACOLLO,"anticoncepcion, prevencion de its y de cancer de cuello uterino",umero de diu insertados,2016-01-01,0,3,5,4,0,12
RIBERALTA,"anticoncepcion, prevencion de its y de cancer de cuello uterino",umero de diu insertados,2016-01-01,0,0,2,0,0,2
SACABA,"anticoncepcion, prevencion de its y de cancer de cuello uterino",umero de diu insertados,2016-01-01,0,1,10,3,0,14
SAIPINA,"anticoncepcion, prevencion de its y de cancer de cuello uterino",umero de diu insertados,2016-01-01,0,1,1,0,0,2
SAN BORJA,"anticoncepcion, prevencion de its y de cancer de cuello uterino",umero de diu insertados,2016-01-01,0,0,2,0,0,2
SAN BUENA VENTURA,"anticoncepcion, prevencion de its y de cancer de cuello uterino",umero de diu insertados,2016-01-01,0,1,0,0,0,1
SAN CARLOS,"anticoncepcion, prevencion de its y de cancer de cuello uterino",umero de diu insertados,2016-01-01,0,1,0,0,0,1
SAN IGNACIO,"anticoncepcion, prevencion de its y de cancer de cuello uterino",umero de diu insertados,2016-01-01,0,0,3,0,0,3
SAN IGNACIO DE VELASCO,"anticoncepcion, prevencion de its y de cancer de cuello uterino",umero de diu insertados,2016-01-01,0,0,2,0,0,2
SAN LORENZO(TJA),"anticoncepcion, prevencion de its y de cancer de cuello uterino",umero de diu insertados,2016-01-01,0,1,2,0,0,3
SAN RAMON SCZ,"anticoncepcion, prevencion de its y de cancer de cuello uterino",umero de diu insertados,2016-01-01,0,0,3,0,0,3
SANTA ANA,"anticoncepcion, prevencion de its y de cancer de cuello uterino",umero de diu insertados,2016-01-01,0,0,2,0,0,2
SANTA CRUZ DE LA SIERRA,"anticoncepcion, prevencion de its y de cancer de cuello uterino",umero de diu insertados,2016-01-01,0,8,189,72,1,270
SANTA ROSA,"anticoncepcion, prevencion de its y de cancer de cuello uterino",umero de diu insertados,2016-01-01,0,0,2,0,0,2
SANTA ROSA DEL SARA,"anticoncepcion, prevencion de its y de cancer de cuello uterino",umero de diu insertados,2016-01-01,0,0,2,0,0,2
SANTIVAÑES,"anticoncepcion, prevencion de its y de cancer de cuello uterino",umero de diu insertados,2016-01-01,0,0,1,0,0,1
SHINAOTA,"anticoncepcion, prevencion de its y de cancer de cuello uterino",umero de diu insertados,2016-01-01,0,1,0,2,0,3
SIPE SIPE,"anticoncepcion, prevencion de its y de cancer de cuello uterino",umero de diu insertados,2016-01-01,0,1,2,0,0,3
SUCRE,"anticoncepcion, prevencion de its y de cancer de cuello uterino",umero de diu insertados,2016-01-01,0,6,92,28,0,126
TAPACARI,"anticoncepcion, prevencion de its y de cancer de cuello uterino",umero de diu insertados,2016-01-01,0,0,1,1,0,2
TARATA,"anticoncepcion, prevencion de its y de cancer de cuello uterino",umero de diu insertados,2016-01-01,0,0,1,0,0,1
TARIJA,"anticoncepcion, prevencion de its y de cancer de cuello uterino",umero de diu insertados,2016-01-01,0,4,28,4,0,36
TIQUIPAYA,"anticoncepcion, prevencion de its y de cancer de cuello uterino",umero de diu insertados,2016-01-01,0,0,7,3,0,10
TORO TORO,"anticoncepcion, prevencion de its y de cancer de cuello uterino",umero de diu insertados,2016-01-01,0,0,2,0,0,2
TOTORA(CBBA),"anticoncepcion, prevencion de its y de cancer de cuello uterino",umero de diu insertados,2016-01-01,0,1,1,0,0,2
TRINIDAD,"anticoncepcion, prevencion de its y de cancer de cuello uterino",umero de diu insertados,2016-01-01,0,2,9,2,0,13
TUPIZA,"anticoncepcion, prevencion de its y de cancer de cuello uterino",umero de diu insertados,2016-01-01,0,0,3,1,0,4
VALLEGRANDE,"anticoncepcion, prevencion de its y de cancer de cuello uterino",umero de diu insertados,2016-01-01,0,0,2,0,0,2
VIACHA,"anticoncepcion, prevencion de its y de cancer de cuello uterino",umero de diu insertados,2016-01-01,0,2,11,6,0,19
VILLA CHARCAS,"anticoncepcion, prevencion de its y de cancer de cuello uterino",umero de diu insertados,2016-01-01,0,0,1,0,0,1
VILLA RIVERO,"anticoncepcion, prevencion de its y de cancer de cuello uterino",umero de diu insertados,2016-01-01,0,0,0,1,0,1
VILLAZON,"anticoncepcion, prevencion de its y de cancer de cuello uterino",umero de diu insertados,2016-01-01,0,0,3,0,0,3
VINTO,"anticoncepcion, prevencion de its y de cancer de cuello uterino",umero de diu insertados,2016-01-01,0,0,10,1,0,11
WARNES,"anticoncepcion, prevencion de its y de cancer de cuello uterino",umero de diu insertados,2016-01-01,0,1,6,0,0,7
YACUIBA,"anticoncepcion, prevencion de its y de cancer de cuello uterino",umero de diu insertados,2016-01-01,0,0,7,0,0,7
YOTALA,"anticoncepcion, prevencion de its y de cancer de cuello uterino",umero de diu insertados,2016-01-01,0,0,1,0,0,1
ANZALDO,"anticoncepcion, prevencion de its y de cancer de cuello uterino",umero de diu insertados,2016-02-01,0,0,2,1,0,3
ASCENCION DE GUARAYOS,"anticoncepcion, prevencion de its y de cancer de cuello uterino",umero de diu insertados,2016-02-01,1,0,1,0,0,2
AYOPAYA (V. DE INDEPENDENCIA),"anticoncepcion, prevencion de its y de cancer de cuello uterino",umero de diu insertados,2016-02-01,0,0,1,0,0,1
AZURDUY,"anticoncepcion, prevencion de its y de cancer de cuello uterino",umero de diu insertados,2016-02-01,0,0,1,0,0,1
BAURES,"anticoncepcion, prevencion de its y de cancer de cuello uterino",umero de diu insertados,2016-02-01,0,1,0,0,0,1
BERMEJO,"anticoncepcion, prevencion de its y de cancer de cuello uterino",umero de diu insertados,2016-02-01,0,1,0,2,0,3
BUENA VISTA,"anticoncepcion, prevencion de its y de cancer de cuello uterino",umero de diu insertados,2016-02-01,0,0,1,0,0,1
CABEZAS,"anticoncepcion, prevencion de its y de cancer de cuello uterino",umero de diu insertados,2016-02-01,0,0,1,0,0,1
CAMARGO,"anticoncepcion, prevencion de its y de cancer de cuello uterino",umero de diu insertados,2016-02-01,0,0,1,1,0,2
CAMIRI,"anticoncepcion, prevencion de its y de cancer de cuello uterino",umero de diu insertados,2016-02-01,0,0,4,0,0,4
CAPINOTA,"anticoncepcion, prevencion de its y de cancer de cuello uterino",umero de diu insertados,2016-02-01,0,0,1,1,0,2
CARAPARI,"anticoncepcion, prevencion de its y de cancer de cuello uterino",umero de diu insertados,2016-02-01,0,0,0,2,0,2
CHALLAPATA,"anticoncepcion, prevencion de its y de cancer de cuello uterino",umero de diu insertados,2016-02-01,0,0,1,0,0,1
CHARAGUA,"anticoncepcion, prevencion de its y de cancer de cuello uterino",umero de diu insertados,2016-02-01,0,0,1,0,0,1
CHIMORE,"anticoncepcion, prevencion de its y de cancer de cuello uterino",umero de diu insertados,2016-02-01,0,0,1,0,0,1
CHUQUIHUTA AYLLU JUCUMANI,"anticoncepcion, prevencion de its y de cancer de cuello uterino",umero de diu insertados,2016-02-01,0,0,1,1,0,2
CKOCHAS,"anticoncepcion, prevencion de its y de cancer de cuello uterino",umero de diu insertados,2016-02-01,0,0,0,1,0,1
CLIZA,"anticoncepcion, prevencion de its y de cancer de cuello uterino",umero de diu insertados,2016-02-01,0,0,1,0,0,1
COBIJA,"anticoncepcion, prevencion de its y de cancer de cuello uterino",umero de diu insertados,2016-02-01,0,0,4,0,0,4
COCHABAMBA,"anticoncepcion, prevencion de its y de cancer de cuello uterino",umero de diu insertados,2016-02-01,0,2,109,93,0,204
COLCAPIRHUA,"anticoncepcion, prevencion de its y de cancer de cuello uterino",umero de diu insertados,2016-02-01,0,0,6,0,0,6
COLPA BELGICA,"anticoncepcion, prevencion de its y de cancer de cuello uterino",umero de diu insertados,2016-02-01,0,0,1,0,0,1
COTOCA,"anticoncepcion, prevencion de its y de cancer de cuello uterino",umero de diu insertados,2016-02-01,0,1,0,1,0,2
CULPINA,"anticoncepcion, prevencion de its y de cancer de cuello uterino",umero de diu insertados,2016-02-01,0,0,1,0,0,1
EL ALTO,"anticoncepcion, prevencion de its y de cancer de cuello uterino",umero de diu insertados,2016-02-01,0,2,34,31,0,67
EL TORNO,"anticoncepcion, prevencion de its y de cancer de cuello uterino",umero de diu insertados,2016-02-01,0,0,3,4,0,7
ENTRE RIOS TRJ,"anticoncepcion, prevencion de its y de cancer de cuello uterino",umero de diu insertados,2016-02-01,0,0,1,1,0,2
GENERAL SAAVEDRA,"anticoncepcion, prevencion de its y de cancer de cuello uterino",umero de diu insertados,2016-02-01,0,0,0,0,1,1
GUAYARAMERIN,"anticoncepcion, prevencion de its y de cancer de cuello uterino",umero de diu insertados,2016-02-01,0,0,4,1,0,5
HUANUNI,"anticoncepcion, prevencion de its y de cancer de cuello uterino",umero de diu insertados,2016-02-01,0,0,1,0,0,1
IRUPANA (VILLA DE LANZA),"anticoncepcion, prevencion de its y de cancer de cuello uterino",umero de diu insertados,2016-02-01,0,1,0,0,0,1
LA GUARDIA,"anticoncepcion, prevencion de its y de cancer de cuello uterino",umero de diu insertados,2016-02-01,0,0,1,0,0,1
LA PAZ,"anticoncepcion, prevencion de its y de cancer de cuello uterino",umero de diu insertados,2016-02-01,0,8,205,37,0,250
LAGUNILLAS,"anticoncepcion, prevencion de its y de cancer de cuello uterino",umero de diu insertados,2016-02-01,0,0,1,0,0,1
LLALLAGUA,"anticoncepcion, prevencion de its y de cancer de cuello uterino",umero de diu insertados,2016-02-01,0,2,2,0,0,4
MACHACAMARCA,"anticoncepcion, prevencion de its y de cancer de cuello uterino",umero de diu insertados,2016-02-01,0,0,1,0,0,1
MAIRANA,"anticoncepcion, prevencion de its y de cancer de cuello uterino",umero de diu insertados,2016-02-01,0,0,5,1,0,6
MECAPACA,"anticoncepcion, prevencion de its y de cancer de cuello uterino",umero de diu insertados,2016-02-01,0,0,1,0,0,1
MIZQUE,"anticoncepcion, prevencion de its y de cancer de cuello uterino",umero de diu insertados,2016-02-01,0,1,1,4,0,6
MONTEAGUDO,"anticoncepcion, prevencion de its y de cancer de cuello uterino",umero de diu insertados,2016-02-01,0,1,3,1,0,5
MONTERO,"anticoncepcion, prevencion de its y de cancer de cuello uterino",umero de diu insertados,2016-02-01,2,4,7,1,0,14
MOROCHATA,"anticoncepcion, prevencion de its y de cancer de cuello uterino",umero de diu insertados,2016-02-01,0,0,1,0,0,1
ORURO,"anticoncepcion, prevencion de its y de cancer de cuello uterino",umero de diu insertados,2016-02-01,0,2,11,0,0,13
PADCAYA,"anticoncepcion, prevencion de its y de cancer de cuello uterino",umero de diu insertados,2016-02-01,0,2,3,3,0,8
PADILLA,"anticoncepcion, prevencion de its y de cancer de cuello uterino",umero de diu insertados,2016-02-01,0,0,1,0,0,1
PAILON,"anticoncepcion, prevencion de its y de cancer de cuello uterino",umero de diu insertados,2016-02-01,0,1,7,2,0,10
PALCA,"anticoncepcion, prevencion de its y de cancer de cuello uterino",umero de diu insertados,2016-02-01,0,0,1,0,0,1
PORONGO,"anticoncepcion, prevencion de its y de cancer de cuello uterino",umero de diu insertados,2016-02-01,0,0,2,0,0,2
POTOSI,"anticoncepcion, prevencion de its y de cancer de cuello uterino",umero de diu insertados,2016-02-01,0,1,5,3,0,9
PUERTO SUAREZ,"anticoncepcion, prevencion de its y de cancer de cuello uterino",umero de diu insertados,2016-02-01,0,0,4,0,0,4
PUERTO VILLARROEL,"anticoncepcion, prevencion de its y de cancer de cuello uterino",umero de diu insertados,2016-02-01,0,2,0,0,0,2
PUNA,"anticoncepcion, prevencion de its y de cancer de cuello uterino",umero de diu insertados,2016-02-01,0,0,2,0,0,2
QUILLACOLLO,"anticoncepcion, prevencion de its y de cancer de cuello uterino",umero de diu insertados,2016-02-01,0,1,7,1,0,9
RIBERALTA,"anticoncepcion, prevencion de its y de cancer de cuello uterino",umero de diu insertados,2016-02-01,0,1,1,0,0,2
RURRENABAQUE,"anticoncepcion, prevencion de its y de cancer de cuello uterino",umero de diu insertados,2016-02-01,0,0,2,1,0,3
SACABA,"anticoncepcion, prevencion de its y de cancer de cuello uterino",umero de diu insertados,2016-02-01,0,1,8,5,1,15
SAIPINA,"anticoncepcion, prevencion de its y de cancer de cuello uterino",umero de diu insertados,2016-02-01,0,0,1,0,0,1
SAN BORJA,"anticoncepcion, prevencion de its y de cancer de cuello uterino",umero de diu insertados,2016-02-01,0,0,1,0,0,1
SAN CARLOS,"anticoncepcion, prevencion de its y de cancer de cuello uterino",umero de diu insertados,2016-02-01,0,2,4,0,0,6
SAN JAVIER(STC),"anticoncepcion, prevencion de its y de cancer de cuello uterino",umero de diu insertados,2016-02-01,0,0,1,0,0,1
SAN LORENZO(TJA),"anticoncepcion, prevencion de its y de cancer de cuello uterino",umero de diu insertados,2016-02-01,0,0,2,0,0,2
SAN LUCAS,"anticoncepcion, prevencion de its y de cancer de cuello uterino",umero de diu insertados,2016-02-01,0,0,1,0,0,1
SAN RAMON SCZ,"anticoncepcion, prevencion de its y de cancer de cuello uterino",umero de diu insertados,2016-02-01,0,0,1,0,0,1
SANTA ANA,"anticoncepcion, prevencion de its y de cancer de cuello uterino",umero de diu insertados,2016-02-01,0,1,2,0,0,3
SANTA CRUZ DE LA SIERRA,"anticoncepcion, prevencion de its y de cancer de cuello uterino",umero de diu insertados,2016-02-01,0,14,97,60,0,171
SANTA ROSA DEL SARA,"anticoncepcion, prevencion de its y de cancer de cuello uterino",umero de diu insertados,2016-02-01,0,0,2,0,0,2
SENA,"anticoncepcion, prevencion de its y de cancer de cuello uterino",umero de diu insertados,2016-02-01,0,1,0,0,0,1
SHINAOTA,"anticoncepcion, prevencion de its y de cancer de cuello uterino",umero de diu insertados,2016-02-01,0,0,0,3,0,3
SIPE SIPE,"anticoncepcion, prevencion de its y de cancer de cuello uterino",umero de diu insertados,2016-02-01,0,0,3,2,0,5
SOPACHUY,"anticoncepcion, prevencion de its y de cancer de cuello uterino",umero de diu insertados,2016-02-01,0,0,1,0,0,1
SUCRE,"anticoncepcion, prevencion de its y de cancer de cuello uterino",umero de diu insertados,2016-02-01,0,3,53,14,0,70
TARIJA,"anticoncepcion, prevencion de its y de cancer de cuello uterino",umero de diu insertados,2016-02-01,3,7,48,23,0,81
TIQUIPAYA,"anticoncepcion, prevencion de its y de cancer de cuello uterino",umero de diu insertados,2016-02-01,0,0,0,1,0,1
TORO TORO,"anticoncepcion, prevencion de its y de cancer de cuello uterino",umero de diu insertados,2016-02-01,0,0,2,0,0,2
TRINIDAD,"anticoncepcion, prevencion de its y de cancer de cuello uterino",umero de diu insertados,2016-02-01,0,5,9,7,0,21
TUPIZA,"anticoncepcion, prevencion de its y de cancer de cuello uterino",umero de diu insertados,2016-02-01,0,0,3,1,0,4
URIONDO (A. CONCEPCION),"anticoncepcion, prevencion de its y de cancer de cuello uterino",umero de diu insertados,2016-02-01,0,0,1,0,0,1
UYUNI,"anticoncepcion, prevencion de its y de cancer de cuello uterino",umero de diu insertados,2016-02-01,0,0,2,0,0,2
VALLEGRANDE,"anticoncepcion, prevencion de its y de cancer de cuello uterino",umero de diu insertados,2016-02-01,0,1,5,0,0,6
VIACHA,"anticoncepcion, prevencion de its y de cancer de cuello uterino",umero de diu insertados,2016-02-01,0,0,0,3,0,3
VILLA MONTES,"anticoncepcion, prevencion de its y de cancer de cuello uterino",umero de diu insertados,2016-02-01,0,1,0,0,0,1
VILLA TUNARI,"anticoncepcion, prevencion de its y de cancer de cuello uterino",umero de diu insertados,2016-02-01,0,2,7,2,1,12
VILLAZON,"anticoncepcion, prevencion de its y de cancer de cuello uterino",umero de diu insertados,2016-02-01,0,0,6,1,0,7
VINTO,"anticoncepcion, prevencion de its y de cancer de cuello uterino",umero de diu insertados,2016-02-01,0,0,9,0,0,9
WARNES,"anticoncepcion, prevencion de its y de cancer de cuello uterino",umero de diu insertados,2016-02-01,1,1,2,1,0,5
YACUIBA,"anticoncepcion, prevencion de its y de cancer de cuello uterino",umero de diu insertados,2016-02-01,0,1,21,2,0,24
YOTALA,"anticoncepcion, prevencion de its y de cancer de cuello uterino",umero de diu insertados,2016-02-01,0,1,0,0,0,1
ZUDAÑEZ,"anticoncepcion, prevencion de its y de cancer de cuello uterino",umero de diu insertados,2016-02-01,0,0,1,0,0,1
AIQUILE,"anticoncepcion, prevencion de its y de cancer de cuello uterino",umero de diu insertados,2016-03-01,0,0,4,1,0,5
ARANI,"anticoncepcion, prevencion de its y de cancer de cuello uterino",umero de diu insertados,2016-03-01,0,0,2,0,0,2
ARBIETO,"anticoncepcion, prevencion de its y de cancer de cuello uterino",umero de diu insertados,2016-03-01,0,1,1,0,0,2
ATOCHA,"anticoncepcion, prevencion de its y de cancer de cuello uterino",umero de diu insertados,2016-03-01,0,0,1,0,0,1
AYOPAYA (V. DE INDEPENDENCIA),"anticoncepcion, prevencion de its y de cancer de cuello uterino",umero de diu insertados,2016-03-01,0,0,7,1,0,8
BERMEJO,"anticoncepcion, prevencion de its y de cancer de cuello uterino",umero de diu insertados,2016-03-01,0,1,4,0,0,5
BETANZOS,"anticoncepcion, prevencion de its y de cancer de cuello uterino",umero de diu insertados,2016-03-01,0,1,1,2,0,4
"CAIZA ""D""","anticoncepcion, prevencion de its y de cancer de cuello uterino",umero de diu insertados,2016-03-01,0,0,6,1,0,7
CAMARGO,"anticoncepcion, prevencion de its y de cancer de cuello uterino",umero de diu insertados,2016-03-01,0,0,8,3,0,11
CAMIRI,"anticoncepcion, prevencion de its y de cancer de cuello uterino",umero de diu insertados,2016-03-01,0,0,3,0,0,3
CAPINOTA,"anticoncepcion, prevencion de its y de cancer de cuello uterino",umero de diu insertados,2016-03-01,0,1,2,2,0,5
CARANAVI,"anticoncepcion, prevencion de its y de cancer de cuello uterino",umero de diu insertados,2016-03-01,0,0,2,1,0,3
CHIMORE,"anticoncepcion, prevencion de its y de cancer de cuello uterino",umero de diu insertados,2016-03-01,0,0,1,0,0,1
CHIPAYA,"anticoncepcion, prevencion de its y de cancer de cuello uterino",umero de diu insertados,2016-03-01,0,0,0,1,0,1
CHUQUIHUTA AYLLU JUCUMANI,"anticoncepcion, prevencion de its y de cancer de cuello uterino",umero de diu insertados,2016-03-01,0,0,2,0,0,2
CLIZA,"anticoncepcion, prevencion de its y de cancer de cuello uterino",umero de diu insertados,2016-03-01,0,0,1,1,0,2
COBIJA,"anticoncepcion, prevencion de its y de cancer de cuello uterino",umero de diu insertados,2016-03-01,0,1,2,0,0,3
COCHABAMBA,"anticoncepcion, prevencion de its y de cancer de cuello uterino",umero de diu insertados,2016-03-01,0,5,120,223,0,348
COLCAPIRHUA,"anticoncepcion, prevencion de its y de cancer de cuello uterino",umero de diu insertados,2016-03-01,0,1,7,1,0,9
COMARAPA,"anticoncepcion, prevencion de its y de cancer de cuello uterino",umero de diu insertados,2016-03-01,0,0,1,0,0,1
COPACABANA,"anticoncepcion, prevencion de its y de cancer de cuello uterino",umero de diu insertados,2016-03-01,0,0,1,0,0,1
COTOCA,"anticoncepcion, prevencion de its y de cancer de cuello uterino",umero de diu insertados,2016-03-01,0,0,1,0,0,1
CUATRO CAÑADAS,"anticoncepcion, prevencion de its y de cancer de cuello uterino",umero de diu insertados,2016-03-01,0,1,4,1,0,6
CULPINA,"anticoncepcion, prevencion de its y de cancer de cuello uterino",umero de diu insertados,2016-03-01,0,0,1,0,0,1
EL ALTO,"anticoncepcion, prevencion de its y de cancer de cuello uterino",umero de diu insertados,2016-03-01,0,2,27,19,0,48
EL TORNO,"anticoncepcion, prevencion de its y de cancer de cuello uterino",umero de diu insertados,2016-03-01,0,0,8,3,0,11
ENTRE RIOS TRJ,"anticoncepcion, prevencion de its y de cancer de cuello uterino",umero de diu insertados,2016-03-01,0,1,1,0,1,3
FERNANDEZ ALONSO,"anticoncepcion, prevencion de its y de cancer de cuello uterino",umero de diu insertados,2016-03-01,0,0,1,1,0,2
GENERAL SAAVEDRA,"anticoncepcion, prevencion de its y de cancer de cuello uterino",umero de diu insertados,2016-03-01,0,0,1,0,0,1
GUAYARAMERIN,"anticoncepcion, prevencion de its y de cancer de cuello uterino",umero de diu insertados,2016-03-01,0,0,2,0,0,2
HUANUNI,"anticoncepcion, prevencion de its y de cancer de cuello uterino",umero de diu insertados,2016-03-01,0,0,0,1,0,1
IRUPANA (VILLA DE LANZA),"anticoncepcion, prevencion de its y de cancer de cuello uterino",umero de diu insertados,2016-03-01,0,0,2,0,0,2
LA GUARDIA,"anticoncepcion, prevencion de its y de cancer de cuello uterino",umero de diu insertados,2016-03-01,0,0,10,0,0,10
LA PAZ,"anticoncepcion, prevencion de its y de cancer de cuello uterino",umero de diu insertados,2016-03-01,0,11,192,75,0,278
LAS CARRERAS,"anticoncepcion, prevencion de its y de cancer de cuello uterino",umero de diu insertados,2016-03-01,0,0,1,1,0,2
LLALLAGUA,"anticoncepcion, prevencion de its y de cancer de cuello uterino",umero de diu insertados,2016-03-01,0,2,2,0,0,4
MACHARETI,"anticoncepcion, prevencion de its y de cancer de cuello uterino",umero de diu insertados,2016-03-01,0,0,1,0,0,1
MAIRANA,"anticoncepcion, prevencion de its y de cancer de cuello uterino",umero de diu insertados,2016-03-01,0,0,2,1,1,4
MINEROS,"anticoncepcion, prevencion de its y de cancer de cuello uterino",umero de diu insertados,2016-03-01,0,0,1,1,0,2
MIZQUE,"anticoncepcion, prevencion de its y de cancer de cuello uterino",umero de diu insertados,2016-03-01,0,0,1,1,0,2
MONTEAGUDO,"anticoncepcion, prevencion de its y de cancer de cuello uterino",umero de diu insertados,2016-03-01,0,3,6,1,0,10
MONTERO,"anticoncepcion, prevencion de its y de cancer de cuello uterino",umero de diu insertados,2016-03-01,0,6,8,1,0,15
ORURO,"anticoncepcion, prevencion de its y de cancer de cuello uterino",umero de diu insertados,2016-03-01,0,3,28,67,0,98
PADCAYA,"anticoncepcion, prevencion de its y de cancer de cuello uterino",umero de diu insertados,2016-03-01,0,0,5,0,0,5
PADILLA,"anticoncepcion, prevencion de its y de cancer de cuello uterino",umero de diu insertados,2016-03-01,0,0,0,1,0,1
PAILON,"anticoncepcion, prevencion de its y de cancer de cuello uterino",umero de diu insertados,2016-03-01,0,0,9,0,0,9
POCOATA,"anticoncepcion, prevencion de its y de cancer de cuello uterino",umero de diu insertados,2016-03-01,0,0,1,0,0,1
PORTACHUELO,"anticoncepcion, prevencion de its y de cancer de cuello uterino",umero de diu insertados,2016-03-01,0,1,1,0,0,2
POSTRER VALLE,"anticoncepcion, prevencion de its y de cancer de cuello uterino",umero de diu insertados,2016-03-01,0,1,1,0,0,2
POTOSI,"anticoncepcion, prevencion de its y de cancer de cuello uterino",umero de diu insertados,2016-03-01,0,0,7,5,0,12
PUERTO QUIJARRO,"anticoncepcion, prevencion de its y de cancer de cuello uterino",umero de diu insertados,2016-03-01,0,2,1,0,0,3
PUERTO RICO,"anticoncepcion, prevencion de its y de cancer de cuello uterino",umero de diu insertados,2016-03-01,0,0,1,1,0,2
PUERTO SUAREZ,"anticoncepcion, prevencion de its y de cancer de cuello uterino",umero de diu insertados,2016-03-01,0,0,3,0,0,3
PUERTO VILLARROEL,"anticoncepcion, prevencion de its y de cancer de cuello uterino",umero de diu insertados,2016-03-01,0,0,1,0,0,1
PUNA,"anticoncepcion, prevencion de its y de cancer de cuello uterino",umero de diu insertados,2016-03-01,0,0,1,0,0,1
PUNATA,"anticoncepcion, prevencion de its y de cancer de cuello uterino",umero de diu insertados,2016-03-01,0,0,2,0,0,2
QUILLACOLLO,"anticoncepcion, prevencion de its y de cancer de cuello uterino",umero de diu insertados,2016-03-01,0,1,13,1,0,15
REYES,"anticoncepcion, prevencion de its y de cancer de cuello uterino",umero de diu insertados,2016-03-01,0,1,0,0,0,1
RIBERALTA,"anticoncepcion, prevencion de its y de cancer de cuello uterino",umero de diu insertados,2016-03-01,0,0,1,0,0,1
ROBORE,"anticoncepcion, prevencion de its y de cancer de cuello uterino",umero de diu insertados,2016-03-01,0,0,2,0,0,2
RURRENABAQUE,"anticoncepcion, prevencion de its y de cancer de cuello uterino",umero de diu insertados,2016-03-01,0,0,3,0,0,3
SACABA,"anticoncepcion, prevencion de its y de cancer de cuello uterino",umero de diu insertados,2016-03-01,0,4,10,6,0,20
SAN BORJA,"anticoncepcion, prevencion de its y de cancer de cuello uterino",umero de diu insertados,2016-03-01,0,0,2,0,0,2
SAN CARLOS,"anticoncepcion, prevencion de its y de cancer de cuello uterino",umero de diu insertados,2016-03-01,0,1,1,0,0,2
SAN IGNACIO,"anticoncepcion, prevencion de its y de cancer de cuello uterino",umero de diu insertados,2016-03-01,0,0,0,1,0,1
SAN IGNACIO DE VELASCO,"anticoncepcion, prevencion de its y de cancer de cuello uterino",umero de diu insertados,2016-03-01,0,0,1,0,0,1
SAN JAVIER(STC),"anticoncepcion, prevencion de its y de cancer de cuello uterino",umero de diu insertados,2016-03-01,0,0,2,1,0,3
SAN LUCAS,"anticoncepcion, prevencion de its y de cancer de cuello uterino",umero de diu insertados,2016-03-01,0,0,1,0,0,1
SAN PEDRO,"anticoncepcion, prevencion de its y de cancer de cuello uterino",umero de diu insertados,2016-03-01,0,0,1,0,0,1
SAN RAMON SCZ,"anticoncepcion, prevencion de its y de cancer de cuello uterino",umero de diu insertados,2016-03-01,0,0,1,0,0,1
SANTA ANA,"anticoncepcion, prevencion de its y de cancer de cuello uterino",umero de diu insertados,2016-03-01,0,1,3,0,0,4
SANTA CRUZ DE LA SIERRA,"anticoncepcion, prevencion de its y de cancer de cuello uterino",umero de diu insertados,2016-03-01,0,25,124,40,0,189
SANTA ROSA DEL SARA,"anticoncepcion, prevencion de its y de cancer de cuello uterino",umero de diu insertados,2016-03-01,0,1,5,0,0,6
SIPE SIPE,"anticoncepcion, prevencion de its y de cancer de cuello uterino",umero de diu insertados,2016-03-01,0,0,3,4,0,7
SUCRE,"anticoncepcion, prevencion de its y de cancer de cuello uterino",umero de diu insertados,2016-03-01,0,7,54,12,0,73
TARIJA,"anticoncepcion, prevencion de its y de cancer de cuello uterino",umero de diu insertados,2016-03-01,0,1,48,15,0,64
TIAWANACU,"anticoncepcion, prevencion de its y de cancer de cuello uterino",umero de diu insertados,2016-03-01,0,0,0,1,0,1
TIQUIPAYA,"anticoncepcion, prevencion de its y de cancer de cuello uterino",umero de diu insertados,2016-03-01,0,1,4,1,0,6
TOLATA,"anticoncepcion, prevencion de its y de cancer de cuello uterino",umero de diu insertados,2016-03-01,0,0,1,0,0,1
TOMINA,"anticoncepcion, prevencion de its y de cancer de cuello uterino",umero de diu insertados,2016-03-01,0,1,0,0,0,1
TORO TORO,"anticoncepcion, prevencion de its y de cancer de cuello uterino",umero de diu insertados,2016-03-01,0,0,2,0,0,2
TOTORA(CBBA),"anticoncepcion, prevencion de its y de cancer de cuello uterino",umero de diu insertados,2016-03-01,0,0,1,0,0,1
TRINIDAD,"anticoncepcion, prevencion de its y de cancer de cuello uterino",umero de diu insertados,2016-03-01,0,3,15,1,0,19
TUPIZA,"anticoncepcion, prevencion de its y de cancer de cuello uterino",umero de diu insertados,2016-03-01,0,2,5,1,0,8
URIONDO (A. CONCEPCION),"anticoncepcion, prevencion de its y de cancer de cuello uterino",umero de diu insertados,2016-03-01,0,2,0,0,0,2
UYUNI,"anticoncepcion, prevencion de its y de cancer de cuello uterino",umero de diu insertados,2016-03-01,0,1,1,0,0,2
VIACHA,"anticoncepcion, prevencion de its y de cancer de cuello uterino",umero de diu insertados,2016-03-01,0,0,9,0,0,9
VILA VILA,"anticoncepcion, prevencion de its y de cancer de cuello uterino",umero de diu insertados,2016-03-01,0,0,0,1,0,1
VILLA TUNARI,"anticoncepcion, prevencion de its y de cancer de cuello uterino",umero de diu insertados,2016-03-01,0,1,5,1,0,7
VILLA VACA GUZMAN (MUYUPAMPA),"anticoncepcion, prevencion de its y de cancer de cuello uterino",umero de diu insertados,2016-03-01,0,0,17,3,1,21
VILLAZON,"anticoncepcion, prevencion de its y de cancer de cuello uterino",umero de diu insertados,2016-03-01,0,0,3,0,0,3
VINTO,"anticoncepcion, prevencion de its y de cancer de cuello uterino",umero de diu insertados,2016-03-01,0,0,1,1,0,2
VITICHI,"anticoncepcion, prevencion de its y de cancer de cuello uterino",umero de diu insertados,2016-03-01,0,0,2,0,0,2
WARNES,"anticoncepcion, prevencion de its y de cancer de cuello uterino",umero de diu insertados,2016-03-01,0,1,1,1,0,3
YACUIBA,"anticoncepcion, prevencion de its y de cancer de cuello uterino",umero de diu insertados,2016-03-01,0,1,7,0,0,8
ARBIETO,"anticoncepcion, prevencion de its y de cancer de cuello uterino",umero de diu insertados,2016-04-01,0,1,1,0,0,2
ASCENCION DE GUARAYOS,"anticoncepcion, prevencion de its y de cancer de cuello uterino",umero de diu insertados,2016-04-01,0,0,0,1,0,1
AZURDUY,"anticoncepcion, prevencion de its y de cancer de cuello uterino",umero de diu insertados,2016-04-01,0,0,0,2,0,2
BERMEJO,"anticoncepcion, prevencion de its y de cancer de cuello uterino",umero de diu insertados,2016-04-01,0,1,2,0,0,3
CAJUATA,"anticoncepcion, prevencion de its y de cancer de cuello uterino",umero de diu insertados,2016-04-01,0,1,0,0,0,1
CAMARGO,"anticoncepcion, prevencion de its y de cancer de cuello uterino",umero de diu insertados,2016-04-01,0,1,1,0,0,2
CAMIRI,"anticoncepcion, prevencion de its y de cancer de cuello uterino",umero de diu insertados,2016-04-01,0,0,1,0,0,1
CAPINOTA,"anticoncepcion, prevencion de its y de cancer de cuello uterino",umero de diu insertados,2016-04-01,0,0,4,1,0,5
CARACOLLO,"anticoncepcion, prevencion de its y de cancer de cuello uterino",umero de diu insertados,2016-04-01,0,0,1,0,0,1
CHUQUIHUTA AYLLU JUCUMANI,"anticoncepcion, prevencion de its y de cancer de cuello uterino",umero de diu insertados,2016-04-01,0,0,0,1,0,1
CKOCHAS,"anticoncepcion, prevencion de its y de cancer de cuello uterino",umero de diu insertados,2016-04-01,0,0,6,1,0,7
CLIZA,"anticoncepcion, prevencion de its y de cancer de cuello uterino",umero de diu insertados,2016-04-01,0,1,2,0,0,3
COBIJA,"anticoncepcion, prevencion de its y de cancer de cuello uterino",umero de diu insertados,2016-04-01,0,1,5,0,0,6
COCHABAMBA,"anticoncepcion, prevencion de its y de cancer de cuello uterino",umero de diu insertados,2016-04-01,0,19,101,126,0,246
COLCAPIRHUA,"anticoncepcion, prevencion de its y de cancer de cuello uterino",umero de diu insertados,2016-04-01,0,0,3,2,0,5
CONCEPCION,"anticoncepcion, prevencion de its y de cancer de cuello uterino",umero de diu insertados,2016-04-01,0,0,1,0,0,1
COTOCA,"anticoncepcion, prevencion de its y de cancer de cuello uterino",umero de diu insertados,2016-04-01,0,0,2,0,0,2
CUATRO CAÑADAS,"anticoncepcion, prevencion de its y de cancer de cuello uterino",umero de diu insertados,2016-04-01,0,0,3,0,0,3
CULPINA,"anticoncepcion, prevencion de its y de cancer de cuello uterino",umero de diu insertados,2016-04-01,0,0,1,0,0,1
EL ALTO,"anticoncepcion, prevencion de its y de cancer de cuello uterino",umero de diu insertados,2016-04-01,0,1,31,14,1,47
EL TORNO,"anticoncepcion, prevencion de its y de cancer de cuello uterino",umero de diu insertados,2016-04-01,0,0,3,0,0,3
ENTRE RIOS TRJ,"anticoncepcion, prevencion de its y de cancer de cuello uterino",umero de diu insertados,2016-04-01,0,5,3,0,1,9
ENTRE RIOS CBBA,"anticoncepcion, prevencion de its y de cancer de cuello uterino",umero de diu insertados,2016-04-01,0,0,2,1,0,3
GENERAL SAAVEDRA,"anticoncepcion, prevencion de its y de cancer de cuello uterino",umero de diu insertados,2016-04-01,0,2,3,0,0,5
GUANAY,"anticoncepcion, prevencion de its y de cancer de cuello uterino",umero de diu insertados,2016-04-01,0,0,2,0,0,2
GUAYARAMERIN,"anticoncepcion, prevencion de its y de cancer de cuello uterino",umero de diu insertados,2016-04-01,0,0,2,0,0,2
HUANUNI,"anticoncepcion, prevencion de its y de cancer de cuello uterino",umero de diu insertados,2016-04-01,0,0,1,0,0,1
LA GUARDIA,"anticoncepcion, prevencion de its y de cancer de cuello uterino",umero de diu insertados,2016-04-01,0,0,10,1,0,11
LA PAZ,"anticoncepcion, prevencion de its y de cancer de cuello uterino",umero de diu insertados,2016-04-01,0,8,205,66,0,279
LLALLAGUA,"anticoncepcion, prevencion de its y de cancer de cuello uterino",umero de diu insertados,2016-04-01,0,0,3,0,0,3
MAIRANA,"anticoncepcion, prevencion de its y de cancer de cuello uterino",umero de diu insertados,2016-04-01,0,0,0,3,0,3
MAPIRI,"anticoncepcion, prevencion de its y de cancer de cuello uterino",umero de diu insertados,2016-04-01,0,0,0,1,0,1
MINEROS,"anticoncepcion, prevencion de its y de cancer de cuello uterino",umero de diu insertados,2016-04-01,0,0,2,0,0,2
MIZQUE,"anticoncepcion, prevencion de its y de cancer de cuello uterino",umero de diu insertados,2016-04-01,0,1,1,1,0,3
MONTEAGUDO,"anticoncepcion, prevencion de its y de cancer de cuello uterino",umero de diu insertados,2016-04-01,0,3,3,0,0,6
MONTERO,"anticoncepcion, prevencion de its y de cancer de cuello uterino",umero de diu insertados,2016-04-01,0,0,7,4,0,11
ORURO,"anticoncepcion, prevencion de its y de cancer de cuello uterino",umero de diu insertados,2016-04-01,0,0,28,5,0,33
PADCAYA,"anticoncepcion, prevencion de its y de cancer de cuello uterino",umero de diu insertados,2016-04-01,0,1,1,0,0,2
PAILON,"anticoncepcion, prevencion de its y de cancer de cuello uterino",umero de diu insertados,2016-04-01,1,1,3,1,0,6
POCONA,"anticoncepcion, prevencion de its y de cancer de cuello uterino",umero de diu insertados,2016-04-01,0,0,0,1,0,1
PORTACHUELO,"anticoncepcion, prevencion de its y de cancer de cuello uterino",umero de diu insertados,2016-04-01,0,0,2,0,0,2
POTOSI,"anticoncepcion, prevencion de its y de cancer de cuello uterino",umero de diu insertados,2016-04-01,0,0,13,4,0,17
PUERTO QUIJARRO,"anticoncepcion, prevencion de its y de cancer de cuello uterino",umero de diu insertados,2016-04-01,0,0,1,0,0,1
PUERTO SUAREZ,"anticoncepcion, prevencion de its y de cancer de cuello uterino",umero de diu insertados,2016-04-01,0,0,0,1,0,1
PUERTO VILLARROEL,"anticoncepcion, prevencion de its y de cancer de cuello uterino",umero de diu insertados,2016-04-01,0,0,1,1,0,2
PUNA,"anticoncepcion, prevencion de its y de cancer de cuello uterino",umero de diu insertados,2016-04-01,0,0,8,1,0,9
PUNATA,"anticoncepcion, prevencion de its y de cancer de cuello uterino",umero de diu insertados,2016-04-01,0,1,4,2,0,7
QUILLACOLLO,"anticoncepcion, prevencion de its y de cancer de cuello uterino",umero de diu insertados,2016-04-01,0,1,8,2,0,11
REYES,"anticoncepcion, prevencion de its y de cancer de cuello uterino",umero de diu insertados,2016-04-01,0,0,0,1,0,1
RIBERALTA,"anticoncepcion, prevencion de its y de cancer de cuello uterino",umero de diu insertados,2016-04-01,0,0,3,0,0,3
ROBORE,"anticoncepcion, prevencion de its y de cancer de cuello uterino",umero de diu insertados,2016-04-01,0,0,1,0,0,1
RURRENABAQUE,"anticoncepcion, prevencion de its y de cancer de cuello uterino",umero de diu insertados,2016-04-01,0,0,1,0,0,1
SACABA,"anticoncepcion, prevencion de its y de cancer de cuello uterino",umero de diu insertados,2016-04-01,0,3,12,11,1,27
SAIPINA,"anticoncepcion, prevencion de its y de cancer de cuello uterino",umero de diu insertados,2016-04-01,0,0,1,0,0,1
SAN BORJA,"anticoncepcion, prevencion de its y de cancer de cuello uterino",umero de diu insertados,2016-04-01,0,0,0,1,0,1
SAN BUENA VENTURA,"anticoncepcion, prevencion de its y de cancer de cuello uterino",umero de diu insertados,2016-04-01,0,0,1,0,0,1
SAN CARLOS,"anticoncepcion, prevencion de its y de cancer de cuello uterino",umero de diu insertados,2016-04-01,0,2,0,1,0,3
SAN IGNACIO,"anticoncepcion, prevencion de its y de cancer de cuello uterino",umero de diu insertados,2016-04-01,0,1,3,3,0,7
SAN IGNACIO DE VELASCO,"anticoncepcion, prevencion de its y de cancer de cuello uterino",umero de diu insertados,2016-04-01,0,0,1,0,0,1
SAN JAVIER(STC),"anticoncepcion, prevencion de its y de cancer de cuello uterino",umero de diu insertados,2016-04-01,0,1,3,1,0,5
SAN JOSE DE CHIQUITOS,"anticoncepcion, prevencion de its y de cancer de cuello uterino",umero de diu insertados,2016-04-01,0,0,1,0,0,1
SAN LORENZO(TJA),"anticoncepcion, prevencion de its y de cancer de cuello uterino",umero de diu insertados,2016-04-01,0,0,2,0,0,2
SAN LUCAS,"anticoncepcion, prevencion de its y de cancer de cuello uterino",umero de diu insertados,2016-04-01,0,0,0,1,0,1
SANTA ANA,"anticoncepcion, prevencion de its y de cancer de cuello uterino",umero de diu insertados,2016-04-01,0,0,4,0,0,4
SANTA CRUZ DE LA SIERRA,"anticoncepcion, prevencion de its y de cancer de cuello uterino",umero de diu insertados,2016-04-01,0,25,219,104,0,348
SANTA ROSA DEL SARA,"anticoncepcion, prevencion de its y de cancer de cuello uterino",umero de diu insertados,2016-04-01,0,1,5,0,0,6
SANTIAGO DE HUARI,"anticoncepcion, prevencion de its y de cancer de cuello uterino",umero de diu insertados,2016-04-01,0,0,1,0,0,1
SANTIVAÑES,"anticoncepcion, prevencion de its y de cancer de cuello uterino",umero de diu insertados,2016-04-01,0,0,0,1,0,1
SIPE SIPE,"anticoncepcion, prevencion de its y de cancer de cuello uterino",umero de diu insertados,2016-04-01,0,3,3,0,0,6
SUCRE,"anticoncepcion, prevencion de its y de cancer de cuello uterino",umero de diu insertados,2016-04-01,0,1,67,22,0,90
TARIJA,"anticoncepcion, prevencion de its y de cancer de cuello uterino",umero de diu insertados,2016-04-01,0,8,39,66,0,113
TINGUIPAYA,"anticoncepcion, prevencion de its y de cancer de cuello uterino",umero de diu insertados,2016-04-01,0,0,1,0,0,1
TIQUIPAYA,"anticoncepcion, prevencion de its y de cancer de cuello uterino",umero de diu insertados,2016-04-01,0,0,3,0,0,3
TOLATA,"anticoncepcion, prevencion de its y de cancer de cuello uterino",umero de diu insertados,2016-04-01,0,0,0,1,0,1
TORO TORO,"anticoncepcion, prevencion de its y de cancer de cuello uterino",umero de diu insertados,2016-04-01,0,0,2,0,0,2
TOTORA(CBBA),"anticoncepcion, prevencion de its y de cancer de cuello uterino",umero de diu insertados,2016-04-01,0,0,1,0,0,1
TRINIDAD,"anticoncepcion, prevencion de its y de cancer de cuello uterino",umero de diu insertados,2016-04-01,0,0,11,1,0,12
TUPIZA,"anticoncepcion, prevencion de its y de cancer de cuello uterino",umero de diu insertados,2016-04-01,0,0,3,1,0,4
URIONDO (A. CONCEPCION),"anticoncepcion, prevencion de its y de cancer de cuello uterino",umero de diu insertados,2016-04-01,0,0,3,0,0,3
UYUNI,"anticoncepcion, prevencion de its y de cancer de cuello uterino",umero de diu insertados,2016-04-01,0,0,1,0,0,1
VALLEGRANDE,"anticoncepcion, prevencion de its y de cancer de cuello uterino",umero de diu insertados,2016-04-01,0,1,4,1,0,6
VILLA MONTES,"anticoncepcion, prevencion de its y de cancer de cuello uterino",umero de diu insertados,2016-04-01,0,0,1,0,0,1
VILLA SERRANO,"anticoncepcion, prevencion de its y de cancer de cuello uterino",umero de diu insertados,2016-04-01,0,0,0,1,0,1
VILLA TUNARI,"anticoncepcion, prevencion de its y de cancer de cuello uterino",umero de diu insertados,2016-04-01,0,1,2,3,0,6
VILLA VACA GUZMAN (MUYUPAMPA),"anticoncepcion, prevencion de its y de cancer de cuello uterino",umero de diu insertados,2016-04-01,0,0,0,1,0,1
VILLAZON,"anticoncepcion, prevencion de its y de cancer de cuello uterino",umero de diu insertados,2016-04-01,0,0,2,3,0,5
WARNES,"anticoncepcion, prevencion de its y de cancer de cuello uterino",umero de diu insertados,2016-04-01,0,2,11,2,0,15
YACUIBA,"anticoncepcion, prevencion de its y de cancer de cuello uterino",umero de diu insertados,2016-04-01,0,0,4,0,0,4
AIQUILE,"anticoncepcion, prevencion de its y de cancer de cuello uterino",umero de diu insertados,2016-05-01,0,0,1,0,0,1
ARANI,"anticoncepcion, prevencion de its y de cancer de cuello uterino",umero de diu insertados,2016-05-01,0,0,1,0,0,1
AYOPAYA (V. DE INDEPENDENCIA),"anticoncepcion, prevencion de its y de cancer de cuello uterino",umero de diu insertados,2016-05-01,0,0,1,0,0,1
BAURES,"anticoncepcion, prevencion de its y de cancer de cuello uterino",umero de diu insertados,2016-05-01,0,1,0,0,0,1
BERMEJO,"anticoncepcion, prevencion de its y de cancer de cuello uterino",umero de diu insertados,2016-05-01,0,0,1,2,0,3
BETANZOS,"anticoncepcion, prevencion de its y de cancer de cuello uterino",umero de diu insertados,2016-05-01,0,1,3,3,0,7
CABEZAS,"anticoncepcion, prevencion de its y de cancer de cuello uterino",umero de diu insertados,2016-05-01,0,1,0,1,0,2
"CAIZA ""D""","anticoncepcion, prevencion de its y de cancer de cuello uterino",umero de diu insertados,2016-05-01,0,1,2,0,0,3
CAMARGO,"anticoncepcion, prevencion de its y de cancer de cuello uterino",umero de diu insertados,2016-05-01,0,1,1,0,0,2
CAMIRI,"anticoncepcion, prevencion de its y de cancer de cuello uterino",umero de diu insertados,2016-05-01,0,0,2,0,0,2
CHIMORE,"anticoncepcion, prevencion de its y de cancer de cuello uterino",umero de diu insertados,2016-05-01,0,1,0,0,0,1
CKOCHAS,"anticoncepcion, prevencion de its y de cancer de cuello uterino",umero de diu insertados,2016-05-01,0,0,1,0,0,1
CLIZA,"anticoncepcion, prevencion de its y de cancer de cuello uterino",umero de diu insertados,2016-05-01,0,0,2,1,0,3
COBIJA,"anticoncepcion, prevencion de its y de cancer de cuello uterino",umero de diu insertados,2016-05-01,0,0,4,0,0,4
COCHABAMBA,"anticoncepcion, prevencion de its y de cancer de cuello uterino",umero de diu insertados,2016-05-01,0,7,71,96,0,174
COLCAPIRHUA,"anticoncepcion, prevencion de its y de cancer de cuello uterino",umero de diu insertados,2016-05-01,0,2,3,0,0,5
COLOMI,"anticoncepcion, prevencion de its y de cancer de cuello uterino",umero de diu insertados,2016-05-01,0,0,1,0,0,1
COLQUIRI,"anticoncepcion, prevencion de its y de cancer de cuello uterino",umero de diu insertados,2016-05-01,0,1,0,0,0,1
COMARAPA,"anticoncepcion, prevencion de its y de cancer de cuello uterino",umero de diu insertados,2016-05-01,0,0,1,0,0,1
CONCEPCION,"anticoncepcion, prevencion de its y de cancer de cuello uterino",umero de diu insertados,2016-05-01,0,0,2,0,0,2
COPACABANA,"anticoncepcion, prevencion de its y de cancer de cuello uterino",umero de diu insertados,2016-05-01,0,0,1,0,0,1
COTAGAITA,"anticoncepcion, prevencion de its y de cancer de cuello uterino",umero de diu insertados,2016-05-01,0,0,0,1,0,1
COTOCA,"anticoncepcion, prevencion de its y de cancer de cuello uterino",umero de diu insertados,2016-05-01,0,0,1,0,0,1
CULPINA,"anticoncepcion, prevencion de its y de cancer de cuello uterino",umero de diu insertados,2016-05-01,0,0,1,0,0,1
EL ALTO,"anticoncepcion, prevencion de its y de cancer de cuello uterino",umero de diu insertados,2016-05-01,0,5,18,35,0,58
EL TORNO,"anticoncepcion, prevencion de its y de cancer de cuello uterino",umero de diu insertados,2016-05-01,1,4,3,0,0,8
ENTRE RIOS TRJ,"anticoncepcion, prevencion de its y de cancer de cuello uterino",umero de diu insertados,2016-05-01,0,0,1,0,0,1
ENTRE RIOS CBBA,"anticoncepcion, prevencion de its y de cancer de cuello uterino",umero de diu insertados,2016-05-01,0,0,0,1,0,1
FERNANDEZ ALONSO,"anticoncepcion, prevencion de its y de cancer de cuello uterino",umero de diu insertados,2016-05-01,0,0,2,0,0,2
GENERAL SAAVEDRA,"anticoncepcion, prevencion de its y de cancer de cuello uterino",umero de diu insertados,2016-05-01,0,1,2,0,0,3
GUAYARAMERIN,"anticoncepcion, prevencion de its y de cancer de cuello uterino",umero de diu insertados,2016-05-01,0,1,0,1,0,2
HUACARETA,"anticoncepcion, prevencion de its y de cancer de cuello uterino",umero de diu insertados,2016-05-01,0,0,3,0,0,3
HUANUNI,"anticoncepcion, prevencion de its y de cancer de cuello uterino",umero de diu insertados,2016-05-01,0,0,1,0,0,1
LA GUARDIA,"anticoncepcion, prevencion de its y de cancer de cuello uterino",umero de diu insertados,2016-05-01,0,1,4,1,0,6
LA PAZ,"anticoncepcion, prevencion de its y de cancer de cuello uterino",umero de diu insertados,2016-05-01,0,9,177,107,0,293
LAS CARRERAS,"anticoncepcion, prevencion de its y de cancer de cuello uterino",umero de diu insertados,2016-05-01,0,0,0,1,0,1
LLALLAGUA,"anticoncepcion, prevencion de its y de cancer de cuello uterino",umero de diu insertados,2016-05-01,0,0,2,0,0,2
MAIRANA,"anticoncepcion, prevencion de its y de cancer de cuello uterino",umero de diu insertados,2016-05-01,0,0,1,0,0,1
MINEROS,"anticoncepcion, prevencion de its y de cancer de cuello uterino",umero de diu insertados,2016-05-01,0,0,1,0,0,1
MIZQUE,"anticoncepcion, prevencion de its y de cancer de cuello uterino",umero de diu insertados,2016-05-01,0,0,0,2,0,2
MONTEAGUDO,"anticoncepcion, prevencion de its y de cancer de cuello uterino",umero de diu insertados,2016-05-01,0,3,2,0,0,5
MONTERO,"anticoncepcion, prevencion de its y de cancer de cuello uterino",umero de diu insertados,2016-05-01,0,2,10,5,0,17
OKINAWA,"anticoncepcion, prevencion de its y de cancer de cuello uterino",umero de diu insertados,2016-05-01,0,0,2,0,0,2
ORURO,"anticoncepcion, prevencion de its y de cancer de cuello uterino",umero de diu insertados,2016-05-01,0,1,17,4,0,22
PADCAYA,"anticoncepcion, prevencion de its y de cancer de cuello uterino",umero de diu insertados,2016-05-01,0,1,0,0,0,1
PAILON,"anticoncepcion, prevencion de its y de cancer de cuello uterino",umero de diu insertados,2016-05-01,0,0,1,0,0,1
PALOS BLANCOS,"anticoncepcion, prevencion de its y de cancer de cuello uterino",umero de diu insertados,2016-05-01,0,0,1,0,0,1
PORCO,"anticoncepcion, prevencion de its y de cancer de cuello uterino",umero de diu insertados,2016-05-01,0,0,3,0,0,3
POTOSI,"anticoncepcion, prevencion de its y de cancer de cuello uterino",umero de diu insertados,2016-05-01,0,0,6,15,0,21
PUERTO SUAREZ,"anticoncepcion, prevencion de its y de cancer de cuello uterino",umero de diu insertados,2016-05-01,0,0,1,0,0,1
PUERTO VILLARROEL,"anticoncepcion, prevencion de its y de cancer de cuello uterino",umero de diu insertados,2016-05-01,0,0,1,0,0,1
PUNA,"anticoncepcion, prevencion de its y de cancer de cuello uterino",umero de diu insertados,2016-05-01,0,0,1,0,0,1
QUILLACOLLO,"anticoncepcion, prevencion de its y de cancer de cuello uterino",umero de diu insertados,2016-05-01,0,0,11,2,0,13
REYES,"anticoncepcion, prevencion de its y de cancer de cuello uterino",umero de diu insertados,2016-05-01,0,0,1,1,0,2
RIBERALTA,"anticoncepcion, prevencion de its y de cancer de cuello uterino",umero de diu insertados,2016-05-01,0,0,1,0,0,1
SACABA,"anticoncepcion, prevencion de its y de cancer de cuello uterino",umero de diu insertados,2016-05-01,0,5,13,3,0,21
SAIPINA,"anticoncepcion, prevencion de its y de cancer de cuello uterino",umero de diu insertados,2016-05-01,0,0,2,0,0,2
SAMAIPATA,"anticoncepcion, prevencion de its y de cancer de cuello uterino",umero de diu insertados,2016-05-01,0,0,1,0,0,1
SAN ANDRES,"anticoncepcion, prevencion de its y de cancer de cuello uterino",umero de diu insertados,2016-05-01,0,0,0,1,0,1
SAN BORJA,"anticoncepcion, prevencion de its y de cancer de cuello uterino",umero de diu insertados,2016-05-01,0,1,1,1,0,3
SAN CARLOS,"anticoncepcion, prevencion de its y de cancer de cuello uterino",umero de diu insertados,2016-05-01,0,0,2,1,0,3
SAN IGNACIO,"anticoncepcion, prevencion de its y de cancer de cuello uterino",umero de diu insertados,2016-05-01,0,0,3,0,0,3
SAN IGNACIO DE VELASCO,"anticoncepcion, prevencion de its y de cancer de cuello uterino",umero de diu insertados,2016-05-01,0,0,2,0,0,2
SAN JAVIER(STC),"anticoncepcion, prevencion de its y de cancer de cuello uterino",umero de diu insertados,2016-05-01,0,2,2,0,0,4
SAN LORENZO(TJA),"anticoncepcion, prevencion de its y de cancer de cuello uterino",umero de diu insertados,2016-05-01,0,0,2,0,0,2
SAN LUCAS,"anticoncepcion, prevencion de its y de cancer de cuello uterino",umero de diu insertados,2016-05-01,0,0,0,1,0,1
SANTA ANA,"anticoncepcion, prevencion de its y de cancer de cuello uterino",umero de diu insertados,2016-05-01,0,0,2,0,0,2
SANTA CRUZ DE LA SIERRA,"anticoncepcion, prevencion de its y de cancer de cuello uterino",umero de diu insertados,2016-05-01,0,24,164,91,0,279
SANTA ROSA DEL SARA,"anticoncepcion, prevencion de its y de cancer de cuello uterino",umero de diu insertados,2016-05-01,0,0,4,0,0,4
SANTIVAÑES,"anticoncepcion, prevencion de its y de cancer de cuello uterino",umero de diu insertados,2016-05-01,0,0,0,1,0,1
SIPE SIPE,"anticoncepcion, prevencion de its y de cancer de cuello uterino",umero de diu insertados,2016-05-01,0,0,1,0,0,1
SUCRE,"anticoncepcion, prevencion de its y de cancer de cuello uterino",umero de diu insertados,2016-05-01,0,2,59,12,0,73
TARATA,"anticoncepcion, prevencion de its y de cancer de cuello uterino",umero de diu insertados,2016-05-01,0,0,1,1,0,2
TARIJA,"anticoncepcion, prevencion de its y de cancer de cuello uterino",umero de diu insertados,2016-05-01,0,3,55,19,0,77
TIPUANI,"anticoncepcion, prevencion de its y de cancer de cuello uterino",umero de diu insertados,2016-05-01,0,0,0,1,0,1
TIQUIPAYA,"anticoncepcion, prevencion de its y de cancer de cuello uterino",umero de diu insertados,2016-05-01,0,0,8,2,0,10
TOTORA(CBBA),"anticoncepcion, prevencion de its y de cancer de cuello uterino",umero de diu insertados,2016-05-01,0,1,1,0,0,2
TRINIDAD,"anticoncepcion, prevencion de its y de cancer de cuello uterino",umero de diu insertados,2016-05-01,0,3,11,1,0,15
TUPIZA,"anticoncepcion, prevencion de its y de cancer de cuello uterino",umero de diu insertados,2016-05-01,0,0,3,0,0,3
UNCIA,"anticoncepcion, prevencion de its y de cancer de cuello uterino",umero de diu insertados,2016-05-01,0,0,1,0,0,1
URIONDO (A. CONCEPCION),"anticoncepcion, prevencion de its y de cancer de cuello uterino",umero de diu insertados,2016-05-01,0,1,2,0,0,3
UYUNI,"anticoncepcion, prevencion de its y de cancer de cuello uterino",umero de diu insertados,2016-05-01,0,0,1,0,0,1
VALLEGRANDE,"anticoncepcion, prevencion de its y de cancer de cuello uterino",umero de diu insertados,2016-05-01,0,1,1,0,0,2
VIACHA,"anticoncepcion, prevencion de its y de cancer de cuello uterino",umero de diu insertados,2016-05-01,0,0,2,3,0,5
VILLA CHARCAS,"anticoncepcion, prevencion de its y de cancer de cuello uterino",umero de diu insertados,2016-05-01,0,1,0,0,0,1
VILLA MONTES,"anticoncepcion, prevencion de its y de cancer de cuello uterino",umero de diu insertados,2016-05-01,0,1,3,0,0,4
VILLA RIVERO,"anticoncepcion, prevencion de its y de cancer de cuello uterino",umero de diu insertados,2016-05-01,0,0,1,0,0,1
VILLA TUNARI,"anticoncepcion, prevencion de its y de cancer de cuello uterino",umero de diu insertados,2016-05-01,0,7,0,0,0,7
VILLA VACA GUZMAN (MUYUPAMPA),"anticoncepcion, prevencion de its y de cancer de cuello uterino",umero de diu insertados,2016-05-01,0,1,0,0,0,1
VILLAZON,"anticoncepcion, prevencion de its y de cancer de cuello uterino",umero de diu insertados,2016-05-01,0,0,2,3,0,5
VINTO,"anticoncepcion, prevencion de its y de cancer de cuello uterino",umero de diu insertados,2016-05-01,0,3,10,5,0,18
WARNES,"anticoncepcion, prevencion de its y de cancer de cuello uterino",umero de diu insertados,2016-05-01,0,2,9,0,0,11
YACUIBA,"anticoncepcion, prevencion de its y de cancer de cuello uterino",umero de diu insertados,2016-05-01,0,0,9,2,0,11
ZUDAÑEZ,"anticoncepcion, prevencion de its y de cancer de cuello uterino",umero de diu insertados,2016-05-01,0,0,2,0,0,2
AIQUILE,"anticoncepcion, prevencion de its y de cancer de cuello uterino",umero de diu insertados,2016-06-01,0,2,1,0,0,3
ARANI,"anticoncepcion, prevencion de its y de cancer de cuello uterino",umero de diu insertados,2016-06-01,0,0,0,1,0,1
ASCENCION DE GUARAYOS,"anticoncepcion, prevencion de its y de cancer de cuello uterino",umero de diu insertados,2016-06-01,0,0,2,0,0,2
AYOPAYA (V. DE INDEPENDENCIA),"anticoncepcion, prevencion de its y de cancer de cuello uterino",umero de diu insertados,2016-06-01,0,0,1,1,0,2
AZURDUY,"anticoncepcion, prevencion de its y de cancer de cuello uterino",umero de diu insertados,2016-06-01,0,0,1,0,0,1
BERMEJO,"anticoncepcion, prevencion de its y de cancer de cuello uterino",umero de diu insertados,2016-06-01,0,0,3,0,0,3
BETANZOS,"anticoncepcion, prevencion de its y de cancer de cuello uterino",umero de diu insertados,2016-06-01,0,0,3,0,0,3
BUENA VISTA,"anticoncepcion, prevencion de its y de cancer de cuello uterino",umero de diu insertados,2016-06-01,0,0,3,0,0,3
CABEZAS,"anticoncepcion, prevencion de its y de cancer de cuello uterino",umero de diu insertados,2016-06-01,0,0,2,0,0,2
CAMARGO,"anticoncepcion, prevencion de its y de cancer de cuello uterino",umero de diu insertados,2016-06-01,0,0,1,1,0,2
CAMIRI,"anticoncepcion, prevencion de its y de cancer de cuello uterino",umero de diu insertados,2016-06-01,0,1,7,1,0,9
CAPINOTA,"anticoncepcion, prevencion de its y de cancer de cuello uterino",umero de diu insertados,2016-06-01,0,0,7,3,0,10
CARANAVI,"anticoncepcion, prevencion de its y de cancer de cuello uterino",umero de diu insertados,2016-06-01,0,0,2,0,0,2
CARAPARI,"anticoncepcion, prevencion de its y de cancer de cuello uterino",umero de diu insertados,2016-06-01,0,0,0,1,0,1
CKOCHAS,"anticoncepcion, prevencion de its y de cancer de cuello uterino",umero de diu insertados,2016-06-01,0,0,2,2,0,4
CLIZA,"anticoncepcion, prevencion de its y de cancer de cuello uterino",umero de diu insertados,2016-06-01,0,0,2,0,0,2
COBIJA,"anticoncepcion, prevencion de its y de cancer de cuello uterino",umero de diu insertados,2016-06-01,0,0,3,0,0,3
COCHABAMBA,"anticoncepcion, prevencion de its y de cancer de cuello uterino",umero de diu insertados,2016-06-01,0,18,156,35,4,213
COLCAPIRHUA,"anticoncepcion, prevencion de its y de cancer de cuello uterino",umero de diu insertados,2016-06-01,0,4,8,1,0,13
COPACABANA,"anticoncepcion, prevencion de its y de cancer de cuello uterino",umero de diu insertados,2016-06-01,0,0,2,1,1,4
COROICO,"anticoncepcion, prevencion de its y de cancer de cuello uterino",umero de diu insertados,2016-06-01,0,0,1,0,0,1
COTAGAITA,"anticoncepcion, prevencion de its y de cancer de cuello uterino",umero de diu insertados,2016-06-01,0,0,0,1,0,1
CUATRO CAÑADAS,"anticoncepcion, prevencion de its y de cancer de cuello uterino",umero de diu insertados,2016-06-01,0,0,1,0,0,1
CULPINA,"anticoncepcion, prevencion de its y de cancer de cuello uterino",umero de diu insertados,2016-06-01,0,0,0,1,0,1
EL ALTO,"anticoncepcion, prevencion de its y de cancer de cuello uterino",umero de diu insertados,2016-06-01,0,1,25,31,0,57
EL PUENTE(STC),"anticoncepcion, prevencion de its y de cancer de cuello uterino",umero de diu insertados,2016-06-01,0,0,1,0,0,1
EL TORNO,"anticoncepcion, prevencion de its y de cancer de cuello uterino",umero de diu insertados,2016-06-01,0,4,5,0,0,9
ENTRE RIOS TRJ,"anticoncepcion, prevencion de its y de cancer de cuello uterino",umero de diu insertados,2016-06-01,0,0,1,0,0,1
ENTRE RIOS CBBA,"anticoncepcion, prevencion de its y de cancer de cuello uterino",umero de diu insertados,2016-06-01,0,0,1,0,0,1
FERNANDEZ ALONSO,"anticoncepcion, prevencion de its y de cancer de cuello uterino",umero de diu insertados,2016-06-01,0,0,1,0,0,1
GENERAL SAAVEDRA,"anticoncepcion, prevencion de its y de cancer de cuello uterino",umero de diu insertados,2016-06-01,0,0,1,0,0,1
GUANAY,"anticoncepcion, prevencion de its y de cancer de cuello uterino",umero de diu insertados,2016-06-01,0,0,1,0,0,1
GUAYARAMERIN,"anticoncepcion, prevencion de its y de cancer de cuello uterino",umero de diu insertados,2016-06-01,0,0,1,1,0,2
HUACARETA,"anticoncepcion, prevencion de its y de cancer de cuello uterino",umero de diu insertados,2016-06-01,0,0,1,0,0,1
INCAHUASI,"anticoncepcion, prevencion de its y de cancer de cuello uterino",umero de diu insertados,2016-06-01,0,0,1,0,0,1
IRUPANA (VILLA DE LANZA),"anticoncepcion, prevencion de its y de cancer de cuello uterino",umero de diu insertados,2016-06-01,0,0,0,1,0,1
LA GUARDIA,"anticoncepcion, prevencion de its y de cancer de cuello uterino",umero de diu insertados,2016-06-01,0,1,10,0,0,11
LA PAZ,"anticoncepcion, prevencion de its y de cancer de cuello uterino",umero de diu insertados,2016-06-01,0,6,179,164,2,351
LAS CARRERAS,"anticoncepcion, prevencion de its y de cancer de cuello uterino",umero de diu insertados,2016-06-01,0,0,0,1,0,1
LLALLAGUA,"anticoncepcion, prevencion de its y de cancer de cuello uterino",umero de diu insertados,2016-06-01,0,5,4,2,0,11
MAIRANA,"anticoncepcion, prevencion de its y de cancer de cuello uterino",umero de diu insertados,2016-06-01,0,1,0,0,0,1
MAPIRI,"anticoncepcion, prevencion de its y de cancer de cuello uterino",umero de diu insertados,2016-06-01,0,0,1,0,0,1
MIZQUE,"anticoncepcion, prevencion de its y de cancer de cuello uterino",umero de diu insertados,2016-06-01,0,0,2,0,0,2
MONTEAGUDO,"anticoncepcion, prevencion de its y de cancer de cuello uterino",umero de diu insertados,2016-06-01,0,0,6,2,0,8
MONTERO,"anticoncepcion, prevencion de its y de cancer de cuello uterino",umero de diu insertados,2016-06-01,0,0,13,3,0,16
MORO MORO,"anticoncepcion, prevencion de its y de cancer de cuello uterino",umero de diu insertados,2016-06-01,0,0,1,0,0,1
ORURO,"anticoncepcion, prevencion de its y de cancer de cuello uterino",umero de diu insertados,2016-06-01,0,0,16,21,0,37
PADCAYA,"anticoncepcion, prevencion de its y de cancer de cuello uterino",umero de diu insertados,2016-06-01,0,0,1,0,0,1
PADILLA,"anticoncepcion, prevencion de its y de cancer de cuello uterino",umero de diu insertados,2016-06-01,0,0,1,0,0,1
PAILON,"anticoncepcion, prevencion de its y de cancer de cuello uterino",umero de diu insertados,2016-06-01,0,0,3,0,0,3
PASORAPA,"anticoncepcion, prevencion de its y de cancer de cuello uterino",umero de diu insertados,2016-06-01,0,0,1,0,0,1
PATACAMAYA,"anticoncepcion, prevencion de its y de cancer de cuello uterino",umero de diu insertados,2016-06-01,0,0,1,2,0,3
POCOATA,"anticoncepcion, prevencion de its y de cancer de cuello uterino",umero de diu insertados,2016-06-01,0,0,0,2,0,2
POJO (CBBA),"anticoncepcion, prevencion de its y de cancer de cuello uterino",umero de diu insertados,2016-06-01,0,0,1,1,0,2
PORONGO,"anticoncepcion, prevencion de its y de cancer de cuello uterino",umero de diu insertados,2016-06-01,0,0,2,0,0,2
POTOSI,"anticoncepcion, prevencion de its y de cancer de cuello uterino",umero de diu insertados,2016-06-01,0,1,3,16,0,20
PUERTO SUAREZ,"anticoncepcion, prevencion de its y de cancer de cuello uterino",umero de diu insertados,2016-06-01,0,0,1,0,0,1
PUERTO VILLARROEL,"anticoncepcion, prevencion de its y de cancer de cuello uterino",umero de diu insertados,2016-06-01,0,0,2,1,0,3
PUNA,"anticoncepcion, prevencion de its y de cancer de cuello uterino",umero de diu insertados,2016-06-01,0,0,0,2,0,2
PUNATA,"anticoncepcion, prevencion de its y de cancer de cuello uterino",umero de diu insertados,2016-06-01,0,0,1,0,0,1
QUILLACOLLO,"anticoncepcion, prevencion de its y de cancer de cuello uterino",umero de diu insertados,2016-06-01,0,0,6,1,0,7
REYES,"anticoncepcion, prevencion de its y de cancer de cuello uterino",umero de diu insertados,2016-06-01,0,0,0,1,0,1
RIBERALTA,"anticoncepcion, prevencion de its y de cancer de cuello uterino",umero de diu insertados,2016-06-01,0,2,1,1,0,4
ROBORE,"anticoncepcion, prevencion de its y de cancer de cuello uterino",umero de diu insertados,2016-06-01,0,1,1,0,0,2
SACABA,"anticoncepcion, prevencion de its y de cancer de cuello uterino",umero de diu insertados,2016-06-01,0,2,10,7,0,19
SAMAIPATA,"anticoncepcion, prevencion de its y de cancer de cuello uterino",umero de diu insertados,2016-06-01,0,1,1,0,0,2
SAN BORJA,"anticoncepcion, prevencion de its y de cancer de cuello uterino",umero de diu insertados,2016-06-01,0,0,4,0,0,4
SAN BUENA VENTURA,"anticoncepcion, prevencion de its y de cancer de cuello uterino",umero de diu insertados,2016-06-01,0,0,1,1,0,2
SAN IGNACIO,"anticoncepcion, prevencion de its y de cancer de cuello uterino",umero de diu insertados,2016-06-01,0,0,8,0,0,8
SAN IGNACIO DE VELASCO,"anticoncepcion, prevencion de its y de cancer de cuello uterino",umero de diu insertados,2016-06-01,0,1,3,2,0,6
SAN JAVIER(STC),"anticoncepcion, prevencion de its y de cancer de cuello uterino",umero de diu insertados,2016-06-01,0,0,3,0,0,3
SAN JOSE DE CHIQUITOS,"anticoncepcion, prevencion de its y de cancer de cuello uterino",umero de diu insertados,2016-06-01,0,1,0,0,0,1
SAN JULIAN,"anticoncepcion, prevencion de its y de cancer de cuello uterino",umero de diu insertados,2016-06-01,0,0,0,1,0,1
SAN LORENZO(TJA),"anticoncepcion, prevencion de its y de cancer de cuello uterino",umero de diu insertados,2016-06-01,0,0,2,0,0,2
SAN MIGUEL DE VELASCO,"anticoncepcion, prevencion de its y de cancer de cuello uterino",umero de diu insertados,2016-06-01,0,0,4,0,0,4
SANTA ANA,"anticoncepcion, prevencion de its y de cancer de cuello uterino",umero de diu insertados,2016-06-01,0,0,1,0,0,1
SANTA CRUZ DE LA SIERRA,"anticoncepcion, prevencion de its y de cancer de cuello uterino",umero de diu insertados,2016-06-01,0,39,179,136,2,356
SANTA ROSA DEL SARA,"anticoncepcion, prevencion de its y de cancer de cuello uterino",umero de diu insertados,2016-06-01,0,0,1,0,0,1
SANTIVAÑES,"anticoncepcion, prevencion de its y de cancer de cuello uterino",umero de diu insertados,2016-06-01,0,0,1,0,0,1
SIPE SIPE,"anticoncepcion, prevencion de its y de cancer de cuello uterino",umero de diu insertados,2016-06-01,0,0,3,3,0,6
SUCRE,"anticoncepcion, prevencion de its y de cancer de cuello uterino",umero de diu insertados,2016-06-01,0,2,56,28,0,86
TARIJA,"anticoncepcion, prevencion de its y de cancer de cuello uterino",umero de diu insertados,2016-06-01,0,6,43,18,0,67
TIPUANI,"anticoncepcion, prevencion de its y de cancer de cuello uterino",umero de diu insertados,2016-06-01,0,0,0,1,0,1
TIQUIPAYA,"anticoncepcion, prevencion de its y de cancer de cuello uterino",umero de diu insertados,2016-06-01,0,0,5,2,0,7
TIRAQUE (CBBA),"anticoncepcion, prevencion de its y de cancer de cuello uterino",umero de diu insertados,2016-06-01,0,0,0,1,0,1
TORO TORO,"anticoncepcion, prevencion de its y de cancer de cuello uterino",umero de diu insertados,2016-06-01,0,1,1,0,0,2
TRINIDAD,"anticoncepcion, prevencion de its y de cancer de cuello uterino",umero de diu insertados,2016-06-01,0,6,18,2,0,26
TUPIZA,"anticoncepcion, prevencion de its y de cancer de cuello uterino",umero de diu insertados,2016-06-01,0,0,4,1,0,5
URIONDO (A. CONCEPCION),"anticoncepcion, prevencion de its y de cancer de cuello uterino",umero de diu insertados,2016-06-01,0,0,1,0,0,1
VALLEGRANDE,"anticoncepcion, prevencion de its y de cancer de cuello uterino",umero de diu insertados,2016-06-01,0,1,2,1,0,4
VIACHA,"anticoncepcion, prevencion de its y de cancer de cuello uterino",umero de diu insertados,2016-06-01,0,0,3,1,0,4
VILA VILA,"anticoncepcion, prevencion de its y de cancer de cuello uterino",umero de diu insertados,2016-06-01,0,0,2,0,0,2
VILLA MONTES,"anticoncepcion, prevencion de its y de cancer de cuello uterino",umero de diu insertados,2016-06-01,0,0,1,0,0,1
VILLA VACA GUZMAN (MUYUPAMPA),"anticoncepcion, prevencion de its y de cancer de cuello uterino",umero de diu insertados,2016-06-01,0,0,3,0,0,3
VILLAZON,"anticoncepcion, prevencion de its y de cancer de cuello uterino",umero de diu insertados,2016-06-01,0,1,0,1,0,2
VINTO,"anticoncepcion, prevencion de its y de cancer de cuello uterino",umero de diu insertados,2016-06-01,0,2,7,4,0,13
WARNES,"anticoncepcion, prevencion de its y de cancer de cuello uterino",umero de diu insertados,2016-06-01,0,12,19,4,0,35
YACUIBA,"anticoncepcion, prevencion de its y de cancer de cuello uterino",umero de diu insertados,2016-06-01,0,13,6,4,0,23
ZUDAÑEZ,"anticoncepcion, prevencion de its y de cancer de cuello uterino",umero de diu insertados,2016-06-01,0,0,0,1,0,1
AIQUILE,"anticoncepcion, prevencion de its y de cancer de cuello uterino",umero de diu insertados,2016-07-01,0,1,3,1,0,5
ANZALDO,"anticoncepcion, prevencion de its y de cancer de cuello uterino",umero de diu insertados,2016-07-01,0,0,1,0,0,1
ARBIETO,"anticoncepcion, prevencion de its y de cancer de cuello uterino",umero de diu insertados,2016-07-01,0,1,0,0,0,1
BERMEJO,"anticoncepcion, prevencion de its y de cancer de cuello uterino",umero de diu insertados,2016-07-01,0,0,3,1,0,4
BETANZOS,"anticoncepcion, prevencion de its y de cancer de cuello uterino",umero de diu insertados,2016-07-01,0,0,2,0,0,2
BOYUIBE,"anticoncepcion, prevencion de its y de cancer de cuello uterino",umero de diu insertados,2016-07-01,0,0,0,1,0,1
CAMARGO,"anticoncepcion, prevencion de its y de cancer de cuello uterino",umero de diu insertados,2016-07-01,0,1,1,1,0,3
CAMIRI,"anticoncepcion, prevencion de its y de cancer de cuello uterino",umero de diu insertados,2016-07-01,0,0,4,4,0,8
CAPINOTA,"anticoncepcion, prevencion de its y de cancer de cuello uterino",umero de diu insertados,2016-07-01,0,0,1,0,0,1
CARIPUYO,"anticoncepcion, prevencion de its y de cancer de cuello uterino",umero de diu insertados,2016-07-01,0,0,1,0,0,1
CHUQUIHUTA AYLLU JUCUMANI,"anticoncepcion, prevencion de its y de cancer de cuello uterino",umero de diu insertados,2016-07-01,0,0,2,0,0,2
CKOCHAS,"anticoncepcion, prevencion de its y de cancer de cuello uterino",umero de diu insertados,2016-07-01,0,1,0,2,0,3
COBIJA,"anticoncepcion, prevencion de its y de cancer de cuello uterino",umero de diu insertados,2016-07-01,0,3,2,0,0,5
COCHABAMBA,"anticoncepcion, prevencion de its y de cancer de cuello uterino",umero de diu insertados,2016-07-01,1,24,171,30,0,226
COLCAPIRHUA,"anticoncepcion, prevencion de its y de cancer de cuello uterino",umero de diu insertados,2016-07-01,0,0,1,0,0,1
COMARAPA,"anticoncepcion, prevencion de its y de cancer de cuello uterino",umero de diu insertados,2016-07-01,0,0,1,0,0,1
CONCEPCION,"anticoncepcion, prevencion de its y de cancer de cuello uterino",umero de diu insertados,2016-07-01,0,0,1,0,0,1
CORQUE,"anticoncepcion, prevencion de its y de cancer de cuello uterino",umero de diu insertados,2016-07-01,0,0,0,1,0,1
COTAGAITA,"anticoncepcion, prevencion de its y de cancer de cuello uterino",umero de diu insertados,2016-07-01,0,1,11,6,0,18
COTOCA,"anticoncepcion, prevencion de its y de cancer de cuello uterino",umero de diu insertados,2016-07-01,0,0,1,0,0,1
EL ALTO,"anticoncepcion, prevencion de its y de cancer de cuello uterino",umero de diu insertados,2016-07-01,0,5,43,20,0,68
EL TORNO,"anticoncepcion, prevencion de its y de cancer de cuello uterino",umero de diu insertados,2016-07-01,0,4,6,4,0,14
ENTRE RIOS TRJ,"anticoncepcion, prevencion de its y de cancer de cuello uterino",umero de diu insertados,2016-07-01,0,0,4,1,0,5
ENTRE RIOS CBBA,"anticoncepcion, prevencion de its y de cancer de cuello uterino",umero de diu insertados,2016-07-01,0,0,1,1,0,2
GENERAL SAAVEDRA,"anticoncepcion, prevencion de its y de cancer de cuello uterino",umero de diu insertados,2016-07-01,0,1,2,0,0,3
GUAYARAMERIN,"anticoncepcion, prevencion de its y de cancer de cuello uterino",umero de diu insertados,2016-07-01,0,0,0,1,0,1
HUACARETA,"anticoncepcion, prevencion de its y de cancer de cuello uterino",umero de diu insertados,2016-07-01,0,0,2,0,0,2
HUANUNI,"anticoncepcion, prevencion de its y de cancer de cuello uterino",umero de diu insertados,2016-07-01,0,0,1,1,0,2
IRUPANA (VILLA DE LANZA),"anticoncepcion, prevencion de its y de cancer de cuello uterino",umero de diu insertados,2016-07-01,0,0,0,1,0,1
LA GUARDIA,"anticoncepcion, prevencion de its y de cancer de cuello uterino",umero de diu insertados,2016-07-01,0,1,9,1,0,11
LA PAZ,"anticoncepcion, prevencion de its y de cancer de cuello uterino",umero de diu insertados,2016-07-01,0,7,158,75,11,251
LAS CARRERAS,"anticoncepcion, prevencion de its y de cancer de cuello uterino",umero de diu insertados,2016-07-01,0,0,0,1,0,1
LLALLAGUA,"anticoncepcion, prevencion de its y de cancer de cuello uterino",umero de diu insertados,2016-07-01,0,1,2,1,0,4
MACHARETI,"anticoncepcion, prevencion de its y de cancer de cuello uterino",umero de diu insertados,2016-07-01,0,0,1,0,0,1
MAIRANA,"anticoncepcion, prevencion de its y de cancer de cuello uterino",umero de diu insertados,2016-07-01,0,2,5,2,0,9
MIZQUE,"anticoncepcion, prevencion de its y de cancer de cuello uterino",umero de diu insertados,2016-07-01,0,0,1,2,0,3
MONTEAGUDO,"anticoncepcion, prevencion de its y de cancer de cuello uterino",umero de diu insertados,2016-07-01,0,2,3,0,0,5
MONTERO,"anticoncepcion, prevencion de its y de cancer de cuello uterino",umero de diu insertados,2016-07-01,0,0,9,2,0,11
OMEREQUE,"anticoncepcion, prevencion de its y de cancer de cuello uterino",umero de diu insertados,2016-07-01,0,0,1,0,0,1
ORURO,"anticoncepcion, prevencion de its y de cancer de cuello uterino",umero de diu insertados,2016-07-01,0,13,33,7,0,53
PADCAYA,"anticoncepcion, prevencion de its y de cancer de cuello uterino",umero de diu insertados,2016-07-01,0,0,1,0,0,1
PADILLA,"anticoncepcion, prevencion de its y de cancer de cuello uterino",umero de diu insertados,2016-07-01,0,0,3,0,0,3
POCONA,"anticoncepcion, prevencion de its y de cancer de cuello uterino",umero de diu insertados,2016-07-01,0,0,1,1,0,2
POJO (CBBA),"anticoncepcion, prevencion de its y de cancer de cuello uterino",umero de diu insertados,2016-07-01,0,0,1,1,0,2
PORCO,"anticoncepcion, prevencion de its y de cancer de cuello uterino",umero de diu insertados,2016-07-01,0,0,1,1,0,2
POTOSI,"anticoncepcion, prevencion de its y de cancer de cuello uterino",umero de diu insertados,2016-07-01,0,0,15,5,0,20
PUERTO SUAREZ,"anticoncepcion, prevencion de its y de cancer de cuello uterino",umero de diu insertados,2016-07-01,0,1,0,0,0,1
PUERTO VILLARROEL,"anticoncepcion, prevencion de its y de cancer de cuello uterino",umero de diu insertados,2016-07-01,0,0,1,1,0,2
PUNATA,"anticoncepcion, prevencion de its y de cancer de cuello uterino",umero de diu insertados,2016-07-01,0,1,1,0,0,2
QUILLACOLLO,"anticoncepcion, prevencion de its y de cancer de cuello uterino",umero de diu insertados,2016-07-01,0,0,12,1,0,13
RIBERALTA,"anticoncepcion, prevencion de its y de cancer de cuello uterino",umero de diu insertados,2016-07-01,1,0,6,1,0,8
ROBORE,"anticoncepcion, prevencion de its y de cancer de cuello uterino",umero de diu insertados,2016-07-01,0,2,0,0,0,2
RURRENABAQUE,"anticoncepcion, prevencion de its y de cancer de cuello uterino",umero de diu insertados,2016-07-01,0,0,1,1,0,2
SACABA,"anticoncepcion, prevencion de its y de cancer de cuello uterino",umero de diu insertados,2016-07-01,0,3,14,3,0,20
SAIPINA,"anticoncepcion, prevencion de its y de cancer de cuello uterino",umero de diu insertados,2016-07-01,0,0,1,0,0,1
SAN BORJA,"anticoncepcion, prevencion de its y de cancer de cuello uterino",umero de diu insertados,2016-07-01,1,1,4,0,0,6
SAN CARLOS,"anticoncepcion, prevencion de its y de cancer de cuello uterino",umero de diu insertados,2016-07-01,0,1,2,0,0,3
SAN IGNACIO,"anticoncepcion, prevencion de its y de cancer de cuello uterino",umero de diu insertados,2016-07-01,0,0,7,2,0,9
SAN IGNACIO DE VELASCO,"anticoncepcion, prevencion de its y de cancer de cuello uterino",umero de diu insertados,2016-07-01,0,1,1,0,0,2
SAN JAVIER(STC),"anticoncepcion, prevencion de its y de cancer de cuello uterino",umero de diu insertados,2016-07-01,0,0,2,0,0,2
SAN JOSE DE CHIQUITOS,"anticoncepcion, prevencion de its y de cancer de cuello uterino",umero de diu insertados,2016-07-01,0,1,7,2,0,10
SAN JULIAN,"anticoncepcion, prevencion de its y de cancer de cuello uterino",umero de diu insertados,2016-07-01,0,0,2,0,0,2
SAN LORENZO(TJA),"anticoncepcion, prevencion de its y de cancer de cuello uterino",umero de diu insertados,2016-07-01,0,1,1,1,0,3
SAN PEDRO,"anticoncepcion, prevencion de its y de cancer de cuello uterino",umero de diu insertados,2016-07-01,0,0,1,0,0,1
SAN RAMON SCZ,"anticoncepcion, prevencion de its y de cancer de cuello uterino",umero de diu insertados,2016-07-01,0,0,1,1,0,2
SANTA ANA,"anticoncepcion, prevencion de its y de cancer de cuello uterino",umero de diu insertados,2016-07-01,0,0,0,1,0,1
SANTA CRUZ DE LA SIERRA,"anticoncepcion, prevencion de its y de cancer de cuello uterino",umero de diu insertados,2016-07-01,0,32,254,131,3,420
SANTA ROSA DEL SARA,"anticoncepcion, prevencion de its y de cancer de cuello uterino",umero de diu insertados,2016-07-01,0,0,2,0,0,2
SANTIVAÑES,"anticoncepcion, prevencion de its y de cancer de cuello uterino",umero de diu insertados,2016-07-01,0,0,0,1,0,1
SHINAOTA,"anticoncepcion, prevencion de its y de cancer de cuello uterino",umero de diu insertados,2016-07-01,0,0,1,0,0,1
SIPE SIPE,"anticoncepcion, prevencion de its y de cancer de cuello uterino",umero de diu insertados,2016-07-01,0,1,6,0,0,7
SUCRE,"anticoncepcion, prevencion de its y de cancer de cuello uterino",umero de diu insertados,2016-07-01,0,13,64,31,0,108
TARIJA,"anticoncepcion, prevencion de its y de cancer de cuello uterino",umero de diu insertados,2016-07-01,0,8,43,21,1,73
TARVITA,"anticoncepcion, prevencion de its y de cancer de cuello uterino",umero de diu insertados,2016-07-01,0,0,1,0,0,1
TIQUIPAYA,"anticoncepcion, prevencion de its y de cancer de cuello uterino",umero de diu insertados,2016-07-01,0,0,5,0,0,5
TIRAQUE (CBBA),"anticoncepcion, prevencion de its y de cancer de cuello uterino",umero de diu insertados,2016-07-01,0,0,0,1,0,1
TOLATA,"anticoncepcion, prevencion de its y de cancer de cuello uterino",umero de diu insertados,2016-07-01,0,0,0,1,0,1
TORO TORO,"anticoncepcion, prevencion de its y de cancer de cuello uterino",umero de diu insertados,2016-07-01,0,0,1,0,0,1
TRINIDAD,"anticoncepcion, prevencion de its y de cancer de cuello uterino",umero de diu insertados,2016-07-01,0,2,12,1,0,15
TUPIZA,"anticoncepcion, prevencion de its y de cancer de cuello uterino",umero de diu insertados,2016-07-01,0,1,0,0,0,1
URIONDO (A. CONCEPCION),"anticoncepcion, prevencion de its y de cancer de cuello uterino",umero de diu insertados,2016-07-01,0,0,0,1,0,1
VALLEGRANDE,"anticoncepcion, prevencion de its y de cancer de cuello uterino",umero de diu insertados,2016-07-01,0,2,2,0,0,4
VIACHA,"anticoncepcion, prevencion de its y de cancer de cuello uterino",umero de diu insertados,2016-07-01,0,1,3,0,0,4
VILLA MONTES,"anticoncepcion, prevencion de its y de cancer de cuello uterino",umero de diu insertados,2016-07-01,0,0,1,2,0,3
VILLA SERRANO,"anticoncepcion, prevencion de its y de cancer de cuello uterino",umero de diu insertados,2016-07-01,0,0,1,0,0,1
VILLA TUNARI,"anticoncepcion, prevencion de its y de cancer de cuello uterino",umero de diu insertados,2016-07-01,0,0,0,1,0,1
VILLA VACA GUZMAN (MUYUPAMPA),"anticoncepcion, prevencion de its y de cancer de cuello uterino",umero de diu insertados,2016-07-01,0,0,4,1,1,6
VILLAZON,"anticoncepcion, prevencion de its y de cancer de cuello uterino",umero de diu insertados,2016-07-01,0,1,3,0,0,4
VINTO,"anticoncepcion, prevencion de its y de cancer de cuello uterino",umero de diu insertados,2016-07-01,0,0,10,4,0,14
VITICHI,"anticoncepcion, prevencion de its y de cancer de cuello uterino",umero de diu insertados,2016-07-01,0,0,1,2,0,3
WARNES,"anticoncepcion, prevencion de its y de cancer de cuello uterino",umero de diu insertados,2016-07-01,0,1,4,0,0,5
YACUIBA,"anticoncepcion, prevencion de its y de cancer de cuello uterino",umero de diu insertados,2016-07-01,0,1,3,4,0,8
YAPACANI,"anticoncepcion, prevencion de its y de cancer de cuello uterino",umero de diu insertados,2016-07-01,0,0,1,0,0,1
YOTALA,"anticoncepcion, prevencion de its y de cancer de cuello uterino",umero de diu insertados,2016-07-01,0,0,1,0,0,1
AIQUILE,"anticoncepcion, prevencion de its y de cancer de cuello uterino",umero de diu insertados,2016-08-01,0,0,4,1,0,5
ARBIETO,"anticoncepcion, prevencion de its y de cancer de cuello uterino",umero de diu insertados,2016-08-01,0,0,2,0,0,2
BERMEJO,"anticoncepcion, prevencion de its y de cancer de cuello uterino",umero de diu insertados,2016-08-01,0,0,2,1,0,3
BUENA VISTA,"anticoncepcion, prevencion de its y de cancer de cuello uterino",umero de diu insertados,2016-08-01,0,0,2,0,0,2
CABEZAS,"anticoncepcion, prevencion de its y de cancer de cuello uterino",umero de diu insertados,2016-08-01,0,0,1,0,0,1
"CAIZA ""D""","anticoncepcion, prevencion de its y de cancer de cuello uterino",umero de diu insertados,2016-08-01,0,0,1,2,0,3
CAMARGO,"anticoncepcion, prevencion de its y de cancer de cuello uterino",umero de diu insertados,2016-08-01,0,0,3,1,0,4
CAMATAQUI (C. VILLA ABECIA),"anticoncepcion, prevencion de its y de cancer de cuello uterino",umero de diu insertados,2016-08-01,0,0,1,0,0,1
CAMIRI,"anticoncepcion, prevencion de its y de cancer de cuello uterino",umero de diu insertados,2016-08-01,0,1,6,2,0,9
CAPINOTA,"anticoncepcion, prevencion de its y de cancer de cuello uterino",umero de diu insertados,2016-08-01,0,0,1,0,0,1
CARANAVI,"anticoncepcion, prevencion de its y de cancer de cuello uterino",umero de diu insertados,2016-08-01,0,0,1,0,0,1
CHALLAPATA,"anticoncepcion, prevencion de its y de cancer de cuello uterino",umero de diu insertados,2016-08-01,0,0,1,0,0,1
CHARAGUA,"anticoncepcion, prevencion de its y de cancer de cuello uterino",umero de diu insertados,2016-08-01,0,0,1,1,0,2
CHIMORE,"anticoncepcion, prevencion de its y de cancer de cuello uterino",umero de diu insertados,2016-08-01,0,0,2,0,0,2
CHUQUIHUTA AYLLU JUCUMANI,"anticoncepcion, prevencion de its y de cancer de cuello uterino",umero de diu insertados,2016-08-01,0,0,1,0,0,1
COBIJA,"anticoncepcion, prevencion de its y de cancer de cuello uterino",umero de diu insertados,2016-08-01,0,1,3,1,0,5
COCHABAMBA,"anticoncepcion, prevencion de its y de cancer de cuello uterino",umero de diu insertados,2016-08-01,0,31,113,81,0,225
COLCAPIRHUA,"anticoncepcion, prevencion de its y de cancer de cuello uterino",umero de diu insertados,2016-08-01,0,0,0,1,0,1
COLOMI,"anticoncepcion, prevencion de its y de cancer de cuello uterino",umero de diu insertados,2016-08-01,0,0,1,0,0,1
COLPA BELGICA,"anticoncepcion, prevencion de its y de cancer de cuello uterino",umero de diu insertados,2016-08-01,0,0,0,2,0,2
CONCEPCION,"anticoncepcion, prevencion de its y de cancer de cuello uterino",umero de diu insertados,2016-08-01,0,0,1,0,0,1
COTOCA,"anticoncepcion, prevencion de its y de cancer de cuello uterino",umero de diu insertados,2016-08-01,0,1,0,1,0,2
CULPINA,"anticoncepcion, prevencion de its y de cancer de cuello uterino",umero de diu insertados,2016-08-01,0,0,8,1,0,9
EL ALTO,"anticoncepcion, prevencion de its y de cancer de cuello uterino",umero de diu insertados,2016-08-01,0,10,26,10,0,46
EL CHORO,"anticoncepcion, prevencion de its y de cancer de cuello uterino",umero de diu insertados,2016-08-01,0,0,2,0,0,2
EL PUENTE(TJA),"anticoncepcion, prevencion de its y de cancer de cuello uterino",umero de diu insertados,2016-08-01,0,0,1,0,0,1
EL TORNO,"anticoncepcion, prevencion de its y de cancer de cuello uterino",umero de diu insertados,2016-08-01,0,3,8,1,0,12
ENTRE RIOS TRJ,"anticoncepcion, prevencion de its y de cancer de cuello uterino",umero de diu insertados,2016-08-01,0,0,2,1,0,3
ENTRE RIOS CBBA,"anticoncepcion, prevencion de its y de cancer de cuello uterino",umero de diu insertados,2016-08-01,0,0,1,0,0,1
GENERAL SAAVEDRA,"anticoncepcion, prevencion de its y de cancer de cuello uterino",umero de diu insertados,2016-08-01,0,0,2,1,0,3
GUAYARAMERIN,"anticoncepcion, prevencion de its y de cancer de cuello uterino",umero de diu insertados,2016-08-01,0,2,6,6,0,14
HUACARETA,"anticoncepcion, prevencion de its y de cancer de cuello uterino",umero de diu insertados,2016-08-01,0,0,3,0,0,3
HUANUNI,"anticoncepcion, prevencion de its y de cancer de cuello uterino",umero de diu insertados,2016-08-01,0,0,2,0,0,2
ICLA,"anticoncepcion, prevencion de its y de cancer de cuello uterino",umero de diu insertados,2016-08-01,0,1,0,0,0,1
IRUPANA (VILLA DE LANZA),"anticoncepcion, prevencion de its y de cancer de cuello uterino",umero de diu insertados,2016-08-01,0,0,1,0,0,1
LA GUARDIA,"anticoncepcion, prevencion de its y de cancer de cuello uterino",umero de diu insertados,2016-08-01,0,2,17,1,0,20
LA PAZ,"anticoncepcion, prevencion de its y de cancer de cuello uterino",umero de diu insertados,2016-08-01,1,10,179,86,28,304
LLALLAGUA,"anticoncepcion, prevencion de its y de cancer de cuello uterino",umero de diu insertados,2016-08-01,0,1,0,1,0,2
LURIBAY,"anticoncepcion, prevencion de its y de cancer de cuello uterino",umero de diu insertados,2016-08-01,0,0,1,0,0,1
MAIRANA,"anticoncepcion, prevencion de its y de cancer de cuello uterino",umero de diu insertados,2016-08-01,0,2,1,0,0,3
MAPIRI,"anticoncepcion, prevencion de its y de cancer de cuello uterino",umero de diu insertados,2016-08-01,0,1,0,0,0,1
MECAPACA,"anticoncepcion, prevencion de its y de cancer de cuello uterino",umero de diu insertados,2016-08-01,0,0,0,1,0,1
MONTEAGUDO,"anticoncepcion, prevencion de its y de cancer de cuello uterino",umero de diu insertados,2016-08-01,0,1,5,0,0,6
MONTERO,"anticoncepcion, prevencion de its y de cancer de cuello uterino",umero de diu insertados,2016-08-01,0,4,3,6,0,13
OKINAWA,"anticoncepcion, prevencion de its y de cancer de cuello uterino",umero de diu insertados,2016-08-01,0,0,0,1,0,1
ORURO,"anticoncepcion, prevencion de its y de cancer de cuello uterino",umero de diu insertados,2016-08-01,0,4,32,11,0,47
PADCAYA,"anticoncepcion, prevencion de its y de cancer de cuello uterino",umero de diu insertados,2016-08-01,0,0,1,0,0,1
PASORAPA,"anticoncepcion, prevencion de its y de cancer de cuello uterino",umero de diu insertados,2016-08-01,0,0,1,0,0,1
POCONA,"anticoncepcion, prevencion de its y de cancer de cuello uterino",umero de diu insertados,2016-08-01,0,0,1,0,0,1
PORTACHUELO,"anticoncepcion, prevencion de its y de cancer de cuello uterino",umero de diu insertados,2016-08-01,0,0,0,1,0,1
POTOSI,"anticoncepcion, prevencion de its y de cancer de cuello uterino",umero de diu insertados,2016-08-01,0,0,14,5,0,19
PUERTO QUIJARRO,"anticoncepcion, prevencion de its y de cancer de cuello uterino",umero de diu insertados,2016-08-01,0,0,1,0,0,1
PUERTO SUAREZ,"anticoncepcion, prevencion de its y de cancer de cuello uterino",umero de diu insertados,2016-08-01,0,1,0,1,0,2
PUERTO VILLARROEL,"anticoncepcion, prevencion de its y de cancer de cuello uterino",umero de diu insertados,2016-08-01,0,1,3,0,0,4
PUNATA,"anticoncepcion, prevencion de its y de cancer de cuello uterino",umero de diu insertados,2016-08-01,0,0,3,0,0,3
QUILLACOLLO,"anticoncepcion, prevencion de its y de cancer de cuello uterino",umero de diu insertados,2016-08-01,0,2,13,1,0,16
QUIRUSILLAS,"anticoncepcion, prevencion de its y de cancer de cuello uterino",umero de diu insertados,2016-08-01,0,0,1,0,0,1
REYES,"anticoncepcion, prevencion de its y de cancer de cuello uterino",umero de diu insertados,2016-08-01,0,0,1,0,0,1
RIBERALTA,"anticoncepcion, prevencion de its y de cancer de cuello uterino",umero de diu insertados,2016-08-01,9,0,15,4,0,28
ROBORE,"anticoncepcion, prevencion de its y de cancer de cuello uterino",umero de diu insertados,2016-08-01,0,1,1,1,0,3
SACABA,"anticoncepcion, prevencion de its y de cancer de cuello uterino",umero de diu insertados,2016-08-01,0,2,10,5,0,17
SAIPINA,"anticoncepcion, prevencion de its y de cancer de cuello uterino",umero de diu insertados,2016-08-01,0,0,2,0,0,2
SAMAIPATA,"anticoncepcion, prevencion de its y de cancer de cuello uterino",umero de diu insertados,2016-08-01,0,0,2,0,0,2
SAN ANDRES,"anticoncepcion, prevencion de its y de cancer de cuello uterino",umero de diu insertados,2016-08-01,0,0,0,1,0,1
SAN BORJA,"anticoncepcion, prevencion de its y de cancer de cuello uterino",umero de diu insertados,2016-08-01,0,0,1,1,0,2
SAN CARLOS,"anticoncepcion, prevencion de its y de cancer de cuello uterino",umero de diu insertados,2016-08-01,0,0,0,1,0,1
SAN IGNACIO,"anticoncepcion, prevencion de its y de cancer de cuello uterino",umero de diu insertados,2016-08-01,0,0,7,1,0,8
SAN IGNACIO DE VELASCO,"anticoncepcion, prevencion de its y de cancer de cuello uterino",umero de diu insertados,2016-08-01,0,0,1,0,0,1
SAN JAVIER(STC),"anticoncepcion, prevencion de its y de cancer de cuello uterino",umero de diu insertados,2016-08-01,0,0,1,0,0,1
SAN JOSE DE CHIQUITOS,"anticoncepcion, prevencion de its y de cancer de cuello uterino",umero de diu insertados,2016-08-01,0,1,2,0,0,3
SAN JULIAN,"anticoncepcion, prevencion de its y de cancer de cuello uterino",umero de diu insertados,2016-08-01,0,0,1,0,0,1
SAN LORENZO(TJA),"anticoncepcion, prevencion de its y de cancer de cuello uterino",umero de diu insertados,2016-08-01,0,2,1,2,0,5
SAN LUCAS,"anticoncepcion, prevencion de its y de cancer de cuello uterino",umero de diu insertados,2016-08-01,0,0,1,0,0,1
SAN RAMON SCZ,"anticoncepcion, prevencion de its y de cancer de cuello uterino",umero de diu insertados,2016-08-01,0,1,0,0,0,1
SANTA ANA,"anticoncepcion, prevencion de its y de cancer de cuello uterino",umero de diu insertados,2016-08-01,0,1,0,0,0,1
SANTA CRUZ DE LA SIERRA,"anticoncepcion, prevencion de its y de cancer de cuello uterino",umero de diu insertados,2016-08-01,0,30,154,89,3,276
SANTA ROSA DEL SARA,"anticoncepcion, prevencion de its y de cancer de cuello uterino",umero de diu insertados,2016-08-01,0,0,1,0,0,1
SANTIVAÑES,"anticoncepcion, prevencion de its y de cancer de cuello uterino",umero de diu insertados,2016-08-01,0,0,1,0,0,1
SIPE SIPE,"anticoncepcion, prevencion de its y de cancer de cuello uterino",umero de diu insertados,2016-08-01,0,1,7,1,0,9
SUCRE,"anticoncepcion, prevencion de its y de cancer de cuello uterino",umero de diu insertados,2016-08-01,0,6,47,23,0,76
TACOPAYA,"anticoncepcion, prevencion de its y de cancer de cuello uterino",umero de diu insertados,2016-08-01,0,0,1,0,0,1
TARIJA,"anticoncepcion, prevencion de its y de cancer de cuello uterino",umero de diu insertados,2016-08-01,0,10,61,31,0,102
TIQUIPAYA,"anticoncepcion, prevencion de its y de cancer de cuello uterino",umero de diu insertados,2016-08-01,0,1,4,3,1,9
TOCO,"anticoncepcion, prevencion de its y de cancer de cuello uterino",umero de diu insertados,2016-08-01,0,0,1,0,0,1
TOMAVE,"anticoncepcion, prevencion de its y de cancer de cuello uterino",umero de diu insertados,2016-08-01,0,0,1,0,0,1
TORO TORO,"anticoncepcion, prevencion de its y de cancer de cuello uterino",umero de diu insertados,2016-08-01,0,0,2,1,0,3
TRINIDAD,"anticoncepcion, prevencion de its y de cancer de cuello uterino",umero de diu insertados,2016-08-01,0,0,9,7,0,16
TUPIZA,"anticoncepcion, prevencion de its y de cancer de cuello uterino",umero de diu insertados,2016-08-01,0,0,3,0,0,3
URIONDO (A. CONCEPCION),"anticoncepcion, prevencion de its y de cancer de cuello uterino",umero de diu insertados,2016-08-01,0,0,1,0,0,1
UYUNI,"anticoncepcion, prevencion de its y de cancer de cuello uterino",umero de diu insertados,2016-08-01,0,0,3,0,0,3
VALLEGRANDE,"anticoncepcion, prevencion de its y de cancer de cuello uterino",umero de diu insertados,2016-08-01,0,0,4,0,0,4
VIACHA,"anticoncepcion, prevencion de its y de cancer de cuello uterino",umero de diu insertados,2016-08-01,0,0,3,1,0,4
VILLA CHARCAS,"anticoncepcion, prevencion de its y de cancer de cuello uterino",umero de diu insertados,2016-08-01,0,0,1,0,0,1
VILLA MONTES,"anticoncepcion, prevencion de its y de cancer de cuello uterino",umero de diu insertados,2016-08-01,0,1,2,3,0,6
VILLA RIVERO,"anticoncepcion, prevencion de its y de cancer de cuello uterino",umero de diu insertados,2016-08-01,0,0,2,0,0,2
VILLA SERRANO,"anticoncepcion, prevencion de its y de cancer de cuello uterino",umero de diu insertados,2016-08-01,0,1,0,0,0,1
VILLA TUNARI,"anticoncepcion, prevencion de its y de cancer de cuello uterino",umero de diu insertados,2016-08-01,0,0,3,3,0,6
VILLA VACA GUZMAN (MUYUPAMPA),"anticoncepcion, prevencion de its y de cancer de cuello uterino",umero de diu insertados,2016-08-01,0,1,2,1,0,4
VILLAZON,"anticoncepcion, prevencion de its y de cancer de cuello uterino",umero de diu insertados,2016-08-01,0,0,0,2,0,2
VINTO,"anticoncepcion, prevencion de its y de cancer de cuello uterino",umero de diu insertados,2016-08-01,0,2,2,0,0,4
WARNES,"anticoncepcion, prevencion de its y de cancer de cuello uterino",umero de diu insertados,2016-08-01,0,1,2,1,0,4
YACUIBA,"anticoncepcion, prevencion de its y de cancer de cuello uterino",umero de diu insertados,2016-08-01,0,1,7,1,0,9
AIQUILE,"anticoncepcion, prevencion de its y de cancer de cuello uterino",umero de diu insertados,2016-09-01,0,1,5,0,0,6
ANZALDO,"anticoncepcion, prevencion de its y de cancer de cuello uterino",umero de diu insertados,2016-09-01,0,0,0,1,0,1
ARBIETO,"anticoncepcion, prevencion de its y de cancer de cuello uterino",umero de diu insertados,2016-09-01,0,1,0,0,0,1
ASCENCION DE GUARAYOS,"anticoncepcion, prevencion de its y de cancer de cuello uterino",umero de diu insertados,2016-09-01,0,0,0,1,0,1
AYOPAYA (V. DE INDEPENDENCIA),"anticoncepcion, prevencion de its y de cancer de cuello uterino",umero de diu insertados,2016-09-01,0,0,1,0,0,1
BERMEJO,"anticoncepcion, prevencion de its y de cancer de cuello uterino",umero de diu insertados,2016-09-01,0,0,9,0,0,9
BETANZOS,"anticoncepcion, prevencion de its y de cancer de cuello uterino",umero de diu insertados,2016-09-01,0,0,1,1,0,2
CAMARGO,"anticoncepcion, prevencion de its y de cancer de cuello uterino",umero de diu insertados,2016-09-01,0,0,1,0,0,1
CAMIRI,"anticoncepcion, prevencion de its y de cancer de cuello uterino",umero de diu insertados,2016-09-01,0,0,5,2,0,7
CARACOLLO,"anticoncepcion, prevencion de its y de cancer de cuello uterino",umero de diu insertados,2016-09-01,0,0,1,0,0,1
CARANAVI,"anticoncepcion, prevencion de its y de cancer de cuello uterino",umero de diu insertados,2016-09-01,0,0,1,0,0,1
CHALLAPATA,"anticoncepcion, prevencion de its y de cancer de cuello uterino",umero de diu insertados,2016-09-01,0,0,1,1,0,2
CHARAGUA,"anticoncepcion, prevencion de its y de cancer de cuello uterino",umero de diu insertados,2016-09-01,0,0,1,1,0,2
CKOCHAS,"anticoncepcion, prevencion de its y de cancer de cuello uterino",umero de diu insertados,2016-09-01,0,0,3,1,0,4
CLIZA,"anticoncepcion, prevencion de its y de cancer de cuello uterino",umero de diu insertados,2016-09-01,0,0,1,0,0,1
COBIJA,"anticoncepcion, prevencion de its y de cancer de cuello uterino",umero de diu insertados,2016-09-01,0,0,5,1,0,6
COCHABAMBA,"anticoncepcion, prevencion de its y de cancer de cuello uterino",umero de diu insertados,2016-09-01,0,20,126,60,0,206
COLCAPIRHUA,"anticoncepcion, prevencion de its y de cancer de cuello uterino",umero de diu insertados,2016-09-01,0,0,2,0,0,2
COLOMI,"anticoncepcion, prevencion de its y de cancer de cuello uterino",umero de diu insertados,2016-09-01,0,0,1,0,0,1
COMARAPA,"anticoncepcion, prevencion de its y de cancer de cuello uterino",umero de diu insertados,2016-09-01,0,0,0,1,0,1
CONCEPCION,"anticoncepcion, prevencion de its y de cancer de cuello uterino",umero de diu insertados,2016-09-01,0,0,0,1,0,1
COPACABANA,"anticoncepcion, prevencion de its y de cancer de cuello uterino",umero de diu insertados,2016-09-01,0,1,0,0,0,1
COTAGAITA,"anticoncepcion, prevencion de its y de cancer de cuello uterino",umero de diu insertados,2016-09-01,0,0,1,2,0,3
COTOCA,"anticoncepcion, prevencion de its y de cancer de cuello uterino",umero de diu insertados,2016-09-01,0,0,2,1,0,3
EL ALTO,"anticoncepcion, prevencion de its y de cancer de cuello uterino",umero de diu insertados,2016-09-01,1,4,23,26,0,54
EL TORNO,"anticoncepcion, prevencion de its y de cancer de cuello uterino",umero de diu insertados,2016-09-01,2,4,7,2,0,15
ENTRE RIOS CBBA,"anticoncepcion, prevencion de its y de cancer de cuello uterino",umero de diu insertados,2016-09-01,0,0,1,0,0,1
FERNANDEZ ALONSO,"anticoncepcion, prevencion de its y de cancer de cuello uterino",umero de diu insertados,2016-09-01,0,0,1,0,0,1
GENERAL SAAVEDRA,"anticoncepcion, prevencion de its y de cancer de cuello uterino",umero de diu insertados,2016-09-01,0,0,3,0,0,3
GUAYARAMERIN,"anticoncepcion, prevencion de its y de cancer de cuello uterino",umero de diu insertados,2016-09-01,0,1,2,1,0,4
HUACARETA,"anticoncepcion, prevencion de its y de cancer de cuello uterino",umero de diu insertados,2016-09-01,0,2,0,0,0,2
LA GUARDIA,"anticoncepcion, prevencion de its y de cancer de cuello uterino",umero de diu insertados,2016-09-01,0,3,11,2,0,16
LA PAZ,"anticoncepcion, prevencion de its y de cancer de cuello uterino",umero de diu insertados,2016-09-01,0,7,133,270,20,430
LAGUNILLAS,"anticoncepcion, prevencion de its y de cancer de cuello uterino",umero de diu insertados,2016-09-01,0,0,2,0,0,2
LAS CARRERAS,"anticoncepcion, prevencion de its y de cancer de cuello uterino",umero de diu insertados,2016-09-01,0,0,1,0,0,1
LLALLAGUA,"anticoncepcion, prevencion de its y de cancer de cuello uterino",umero de diu insertados,2016-09-01,0,3,0,0,0,3
LURIBAY,"anticoncepcion, prevencion de its y de cancer de cuello uterino",umero de diu insertados,2016-09-01,0,0,1,0,0,1
MACHARETI,"anticoncepcion, prevencion de its y de cancer de cuello uterino",umero de diu insertados,2016-09-01,0,0,1,0,0,1
MAPIRI,"anticoncepcion, prevencion de its y de cancer de cuello uterino",umero de diu insertados,2016-09-01,0,0,1,0,0,1
MIZQUE,"anticoncepcion, prevencion de its y de cancer de cuello uterino",umero de diu insertados,2016-09-01,0,0,1,0,0,1
MOJOCOYA,"anticoncepcion, prevencion de its y de cancer de cuello uterino",umero de diu insertados,2016-09-01,0,0,1,0,0,1
MONTEAGUDO,"anticoncepcion, prevencion de its y de cancer de cuello uterino",umero de diu insertados,2016-09-01,0,1,2,0,0,3
MONTERO,"anticoncepcion, prevencion de its y de cancer de cuello uterino",umero de diu insertados,2016-09-01,0,7,16,3,0,26
OKINAWA,"anticoncepcion, prevencion de its y de cancer de cuello uterino",umero de diu insertados,2016-09-01,0,0,1,0,0,1
ORURO,"anticoncepcion, prevencion de its y de cancer de cuello uterino",umero de diu insertados,2016-09-01,0,1,20,6,0,27
PADCAYA,"anticoncepcion, prevencion de its y de cancer de cuello uterino",umero de diu insertados,2016-09-01,0,0,1,0,0,1
PADILLA,"anticoncepcion, prevencion de its y de cancer de cuello uterino",umero de diu insertados,2016-09-01,0,0,0,1,0,1
PAILON,"anticoncepcion, prevencion de its y de cancer de cuello uterino",umero de diu insertados,2016-09-01,0,0,4,1,0,5
PAMPA GRANDE,"anticoncepcion, prevencion de its y de cancer de cuello uterino",umero de diu insertados,2016-09-01,0,0,2,0,0,2
POCOATA,"anticoncepcion, prevencion de its y de cancer de cuello uterino",umero de diu insertados,2016-09-01,0,0,1,0,0,1
POCONA,"anticoncepcion, prevencion de its y de cancer de cuello uterino",umero de diu insertados,2016-09-01,0,0,1,0,0,1
PORONGO,"anticoncepcion, prevencion de its y de cancer de cuello uterino",umero de diu insertados,2016-09-01,0,1,1,0,0,2
PORTACHUELO,"anticoncepcion, prevencion de its y de cancer de cuello uterino",umero de diu insertados,2016-09-01,0,0,2,0,0,2
POTOSI,"anticoncepcion, prevencion de its y de cancer de cuello uterino",umero de diu insertados,2016-09-01,0,0,6,3,0,9
PUERTO QUIJARRO,"anticoncepcion, prevencion de its y de cancer de cuello uterino",umero de diu insertados,2016-09-01,0,0,1,0,0,1
PUERTO SUAREZ,"anticoncepcion, prevencion de its y de cancer de cuello uterino",umero de diu insertados,2016-09-01,0,1,1,1,0,3
PUERTO VILLARROEL,"anticoncepcion, prevencion de its y de cancer de cuello uterino",umero de diu insertados,2016-09-01,0,0,0,1,0,1
PUNATA,"anticoncepcion, prevencion de its y de cancer de cuello uterino",umero de diu insertados,2016-09-01,0,0,2,1,0,3
QUILLACOLLO,"anticoncepcion, prevencion de its y de cancer de cuello uterino",umero de diu insertados,2016-09-01,0,0,4,0,0,4
REYES,"anticoncepcion, prevencion de its y de cancer de cuello uterino",umero de diu insertados,2016-09-01,0,0,1,0,0,1
RIBERALTA,"anticoncepcion, prevencion de its y de cancer de cuello uterino",umero de diu insertados,2016-09-01,0,0,3,0,0,3
RURRENABAQUE,"anticoncepcion, prevencion de its y de cancer de cuello uterino",umero de diu insertados,2016-09-01,0,0,1,0,0,1
SACABA,"anticoncepcion, prevencion de its y de cancer de cuello uterino",umero de diu insertados,2016-09-01,0,1,16,3,0,20
SAIPINA,"anticoncepcion, prevencion de its y de cancer de cuello uterino",umero de diu insertados,2016-09-01,0,1,1,1,0,3
SAN BORJA,"anticoncepcion, prevencion de its y de cancer de cuello uterino",umero de diu insertados,2016-09-01,0,2,1,0,0,3
SAN CARLOS,"anticoncepcion, prevencion de its y de cancer de cuello uterino",umero de diu insertados,2016-09-01,0,1,2,0,0,3
SAN IGNACIO,"anticoncepcion, prevencion de its y de cancer de cuello uterino",umero de diu insertados,2016-09-01,0,1,9,1,0,11
SAN IGNACIO DE VELASCO,"anticoncepcion, prevencion de its y de cancer de cuello uterino",umero de diu insertados,2016-09-01,0,3,3,0,0,6
SAN JAVIER(STC),"anticoncepcion, prevencion de its y de cancer de cuello uterino",umero de diu insertados,2016-09-01,0,3,0,1,0,4
SAN JOSE DE CHIQUITOS,"anticoncepcion, prevencion de its y de cancer de cuello uterino",umero de diu insertados,2016-09-01,0,1,2,0,0,3
SAN LORENZO(TJA),"anticoncepcion, prevencion de its y de cancer de cuello uterino",umero de diu insertados,2016-09-01,0,0,2,1,0,3
SAN MATIAS,"anticoncepcion, prevencion de its y de cancer de cuello uterino",umero de diu insertados,2016-09-01,0,0,1,0,0,1
SAN RAMON SCZ,"anticoncepcion, prevencion de its y de cancer de cuello uterino",umero de diu insertados,2016-09-01,0,5,3,1,0,9
SANTA CRUZ DE LA SIERRA,"anticoncepcion, prevencion de its y de cancer de cuello uterino",umero de diu insertados,2016-09-01,1,24,94,68,0,187
SANTA ROSA DEL SARA,"anticoncepcion, prevencion de its y de cancer de cuello uterino",umero de diu insertados,2016-09-01,0,1,2,0,0,3
SHINAOTA,"anticoncepcion, prevencion de its y de cancer de cuello uterino",umero de diu insertados,2016-09-01,0,1,0,0,0,1
SIPE SIPE,"anticoncepcion, prevencion de its y de cancer de cuello uterino",umero de diu insertados,2016-09-01,0,2,6,1,0,9
SUCRE,"anticoncepcion, prevencion de its y de cancer de cuello uterino",umero de diu insertados,2016-09-01,0,1,39,10,0,50
TARIJA,"anticoncepcion, prevencion de its y de cancer de cuello uterino",umero de diu insertados,2016-09-01,0,2,59,16,0,77
TEOPONTE,"anticoncepcion, prevencion de its y de cancer de cuello uterino",umero de diu insertados,2016-09-01,0,0,1,1,0,2
TIQUIPAYA,"anticoncepcion, prevencion de its y de cancer de cuello uterino",umero de diu insertados,2016-09-01,0,0,6,1,0,7
TOLATA,"anticoncepcion, prevencion de its y de cancer de cuello uterino",umero de diu insertados,2016-09-01,0,2,7,2,0,11
TORO TORO,"anticoncepcion, prevencion de its y de cancer de cuello uterino",umero de diu insertados,2016-09-01,0,0,1,1,0,2
TOTORA(CBBA),"anticoncepcion, prevencion de its y de cancer de cuello uterino",umero de diu insertados,2016-09-01,0,0,1,0,0,1
TRINIDAD,"anticoncepcion, prevencion de its y de cancer de cuello uterino",umero de diu insertados,2016-09-01,1,4,27,0,0,32
TUPIZA,"anticoncepcion, prevencion de its y de cancer de cuello uterino",umero de diu insertados,2016-09-01,0,1,1,1,0,3
URIONDO (A. CONCEPCION),"anticoncepcion, prevencion de its y de cancer de cuello uterino",umero de diu insertados,2016-09-01,0,1,1,0,0,2
UYUNI,"anticoncepcion, prevencion de its y de cancer de cuello uterino",umero de diu insertados,2016-09-01,0,1,0,0,0,1
VALLEGRANDE,"anticoncepcion, prevencion de its y de cancer de cuello uterino",umero de diu insertados,2016-09-01,0,0,1,0,0,1
VIACHA,"anticoncepcion, prevencion de its y de cancer de cuello uterino",umero de diu insertados,2016-09-01,0,2,2,0,0,4
VILLA MONTES,"anticoncepcion, prevencion de its y de cancer de cuello uterino",umero de diu insertados,2016-09-01,0,0,5,0,0,5
VILLA TUNARI,"anticoncepcion, prevencion de its y de cancer de cuello uterino",umero de diu insertados,2016-09-01,0,0,1,3,3,7
VILLA VACA GUZMAN (MUYUPAMPA),"anticoncepcion, prevencion de its y de cancer de cuello uterino",umero de diu insertados,2016-09-01,2,0,4,2,0,8
VILLAZON,"anticoncepcion, prevencion de its y de cancer de cuello uterino",umero de diu insertados,2016-09-01,0,0,2,0,0,2
VINTO,"anticoncepcion, prevencion de its y de cancer de cuello uterino",umero de diu insertados,2016-09-01,0,0,3,0,0,3
WARNES,"anticoncepcion, prevencion de its y de cancer de cuello uterino",umero de diu insertados,2016-09-01,0,1,5,0,0,6
YACUIBA,"anticoncepcion, prevencion de its y de cancer de cuello uterino",umero de diu insertados,2016-09-01,0,5,8,6,0,19
ZUDAÑEZ,"anticoncepcion, prevencion de its y de cancer de cuello uterino",umero de diu insertados,2016-09-01,0,1,2,0,0,3
AIQUILE,"anticoncepcion, prevencion de its y de cancer de cuello uterino",umero de diu insertados,2016-10-01,0,1,2,1,0,4
ARANI,"anticoncepcion, prevencion de its y de cancer de cuello uterino",umero de diu insertados,2016-10-01,0,0,0,2,0,2
ASCENCION DE GUARAYOS,"anticoncepcion, prevencion de its y de cancer de cuello uterino",umero de diu insertados,2016-10-01,0,0,0,1,0,1
ATOCHA,"anticoncepcion, prevencion de its y de cancer de cuello uterino",umero de diu insertados,2016-10-01,0,0,1,0,0,1
BATALLAS,"anticoncepcion, prevencion de its y de cancer de cuello uterino",umero de diu insertados,2016-10-01,0,0,1,0,0,1
BERMEJO,"anticoncepcion, prevencion de its y de cancer de cuello uterino",umero de diu insertados,2016-10-01,0,1,2,1,0,4
BETANZOS,"anticoncepcion, prevencion de its y de cancer de cuello uterino",umero de diu insertados,2016-10-01,0,1,2,3,0,6
CAMARGO,"anticoncepcion, prevencion de its y de cancer de cuello uterino",umero de diu insertados,2016-10-01,0,0,2,1,0,3
CAMIRI,"anticoncepcion, prevencion de its y de cancer de cuello uterino",umero de diu insertados,2016-10-01,0,1,7,1,0,9
CAPINOTA,"anticoncepcion, prevencion de its y de cancer de cuello uterino",umero de diu insertados,2016-10-01,0,0,1,0,0,1
CARACOLLO,"anticoncepcion, prevencion de its y de cancer de cuello uterino",umero de diu insertados,2016-10-01,0,0,1,0,0,1
CARANAVI,"anticoncepcion, prevencion de its y de cancer de cuello uterino",umero de diu insertados,2016-10-01,0,0,4,0,0,4
CHALLAPATA,"anticoncepcion, prevencion de its y de cancer de cuello uterino",umero de diu insertados,2016-10-01,0,0,1,0,0,1
CHULUMANI (V. DE LA LIBERTAD),"anticoncepcion, prevencion de its y de cancer de cuello uterino",umero de diu insertados,2016-10-01,0,0,1,0,0,1
CKOCHAS,"anticoncepcion, prevencion de its y de cancer de cuello uterino",umero de diu insertados,2016-10-01,0,1,1,1,0,3
CLIZA,"anticoncepcion, prevencion de its y de cancer de cuello uterino",umero de diu insertados,2016-10-01,0,0,4,0,0,4
COBIJA,"anticoncepcion, prevencion de its y de cancer de cuello uterino",umero de diu insertados,2016-10-01,0,0,5,1,0,6
COCHABAMBA,"anticoncepcion, prevencion de its y de cancer de cuello uterino",umero de diu insertados,2016-10-01,0,6,62,119,0,187
COLCAPIRHUA,"anticoncepcion, prevencion de its y de cancer de cuello uterino",umero de diu insertados,2016-10-01,0,1,3,1,0,5
CORO CORO,"anticoncepcion, prevencion de its y de cancer de cuello uterino",umero de diu insertados,2016-10-01,0,0,1,0,0,1
COTAGAITA,"anticoncepcion, prevencion de its y de cancer de cuello uterino",umero de diu insertados,2016-10-01,0,0,9,1,0,10
COTOCA,"anticoncepcion, prevencion de its y de cancer de cuello uterino",umero de diu insertados,2016-10-01,0,0,2,0,0,2
CULPINA,"anticoncepcion, prevencion de its y de cancer de cuello uterino",umero de diu insertados,2016-10-01,0,1,0,0,0,1
EL ALTO,"anticoncepcion, prevencion de its y de cancer de cuello uterino",umero de diu insertados,2016-10-01,0,6,30,66,0,102
EL TORNO,"anticoncepcion, prevencion de its y de cancer de cuello uterino",umero de diu insertados,2016-10-01,0,3,4,1,0,8
ENTRE RIOS TRJ,"anticoncepcion, prevencion de its y de cancer de cuello uterino",umero de diu insertados,2016-10-01,0,0,1,0,0,1
ENTRE RIOS CBBA,"anticoncepcion, prevencion de its y de cancer de cuello uterino",umero de diu insertados,2016-10-01,0,0,1,0,0,1
GENERAL SAAVEDRA,"anticoncepcion, prevencion de its y de cancer de cuello uterino",umero de diu insertados,2016-10-01,0,1,0,1,0,2
GUAQUI,"anticoncepcion, prevencion de its y de cancer de cuello uterino",umero de diu insertados,2016-10-01,0,0,1,0,0,1
GUAYARAMERIN,"anticoncepcion, prevencion de its y de cancer de cuello uterino",umero de diu insertados,2016-10-01,0,1,2,0,0,3
HUACARETA,"anticoncepcion, prevencion de its y de cancer de cuello uterino",umero de diu insertados,2016-10-01,0,1,3,1,0,5
LA GUARDIA,"anticoncepcion, prevencion de its y de cancer de cuello uterino",umero de diu insertados,2016-10-01,0,2,7,1,0,10
LA PAZ,"anticoncepcion, prevencion de its y de cancer de cuello uterino",umero de diu insertados,2016-10-01,1,13,144,108,7,273
LAGUNILLAS,"anticoncepcion, prevencion de its y de cancer de cuello uterino",umero de diu insertados,2016-10-01,0,3,0,0,0,3
LLALLAGUA,"anticoncepcion, prevencion de its y de cancer de cuello uterino",umero de diu insertados,2016-10-01,0,0,2,0,0,2
MAIRANA,"anticoncepcion, prevencion de its y de cancer de cuello uterino",umero de diu insertados,2016-10-01,0,0,0,1,0,1
MIZQUE,"anticoncepcion, prevencion de its y de cancer de cuello uterino",umero de diu insertados,2016-10-01,0,0,0,1,0,1
MONTEAGUDO,"anticoncepcion, prevencion de its y de cancer de cuello uterino",umero de diu insertados,2016-10-01,0,1,18,4,0,23
MONTERO,"anticoncepcion, prevencion de its y de cancer de cuello uterino",umero de diu insertados,2016-10-01,0,1,9,3,0,13
OKINAWA,"anticoncepcion, prevencion de its y de cancer de cuello uterino",umero de diu insertados,2016-10-01,0,0,1,0,0,1
ORURO,"anticoncepcion, prevencion de its y de cancer de cuello uterino",umero de diu insertados,2016-10-01,0,4,20,4,0,28
PADCAYA,"anticoncepcion, prevencion de its y de cancer de cuello uterino",umero de diu insertados,2016-10-01,0,0,4,1,0,5
PADILLA,"anticoncepcion, prevencion de its y de cancer de cuello uterino",umero de diu insertados,2016-10-01,0,0,0,1,0,1
PAMPA GRANDE,"anticoncepcion, prevencion de its y de cancer de cuello uterino",umero de diu insertados,2016-10-01,0,3,0,0,0,3
PORTACHUELO,"anticoncepcion, prevencion de its y de cancer de cuello uterino",umero de diu insertados,2016-10-01,0,0,5,0,0,5
PORVENIR,"anticoncepcion, prevencion de its y de cancer de cuello uterino",umero de diu insertados,2016-10-01,0,2,1,0,0,3
POSTRER VALLE,"anticoncepcion, prevencion de its y de cancer de cuello uterino",umero de diu insertados,2016-10-01,0,0,1,0,0,1
POTOSI,"anticoncepcion, prevencion de its y de cancer de cuello uterino",umero de diu insertados,2016-10-01,0,1,7,23,0,31
PUERTO QUIJARRO,"anticoncepcion, prevencion de its y de cancer de cuello uterino",umero de diu insertados,2016-10-01,0,0,1,0,0,1
PUERTO RICO,"anticoncepcion, prevencion de its y de cancer de cuello uterino",umero de diu insertados,2016-10-01,0,0,0,1,0,1
PUERTO SUAREZ,"anticoncepcion, prevencion de its y de cancer de cuello uterino",umero de diu insertados,2016-10-01,0,0,1,0,0,1
PUERTO VILLARROEL,"anticoncepcion, prevencion de its y de cancer de cuello uterino",umero de diu insertados,2016-10-01,0,2,2,0,0,4
PUNA,"anticoncepcion, prevencion de its y de cancer de cuello uterino",umero de diu insertados,2016-10-01,0,1,0,2,0,3
PUNATA,"anticoncepcion, prevencion de its y de cancer de cuello uterino",umero de diu insertados,2016-10-01,0,1,3,0,0,4
QUILLACOLLO,"anticoncepcion, prevencion de its y de cancer de cuello uterino",umero de diu insertados,2016-10-01,0,2,15,1,0,18
QUIME,"anticoncepcion, prevencion de its y de cancer de cuello uterino",umero de diu insertados,2016-10-01,0,0,1,0,0,1
RIBERALTA,"anticoncepcion, prevencion de its y de cancer de cuello uterino",umero de diu insertados,2016-10-01,0,0,1,0,0,1
ROBORE,"anticoncepcion, prevencion de its y de cancer de cuello uterino",umero de diu insertados,2016-10-01,0,0,2,0,0,2
SACABA,"anticoncepcion, prevencion de its y de cancer de cuello uterino",umero de diu insertados,2016-10-01,0,3,12,7,0,22
SAIPINA,"anticoncepcion, prevencion de its y de cancer de cuello uterino",umero de diu insertados,2016-10-01,0,0,1,1,0,2
SAMAIPATA,"anticoncepcion, prevencion de its y de cancer de cuello uterino",umero de diu insertados,2016-10-01,0,0,2,0,0,2
SAN BORJA,"anticoncepcion, prevencion de its y de cancer de cuello uterino",umero de diu insertados,2016-10-01,0,1,0,0,0,1
SAN CARLOS,"anticoncepcion, prevencion de its y de cancer de cuello uterino",umero de diu insertados,2016-10-01,0,1,7,1,0,9
SAN IGNACIO,"anticoncepcion, prevencion de its y de cancer de cuello uterino",umero de diu insertados,2016-10-01,0,0,9,0,0,9
SAN IGNACIO DE VELASCO,"anticoncepcion, prevencion de its y de cancer de cuello uterino",umero de diu insertados,2016-10-01,0,2,4,1,0,7
SAN JAVIER(STC),"anticoncepcion, prevencion de its y de cancer de cuello uterino",umero de diu insertados,2016-10-01,0,0,1,0,0,1
SAN JOAQUIN,"anticoncepcion, prevencion de its y de cancer de cuello uterino",umero de diu insertados,2016-10-01,0,0,1,0,0,1
SAN JOSE DE CHIQUITOS,"anticoncepcion, prevencion de its y de cancer de cuello uterino",umero de diu insertados,2016-10-01,0,1,2,0,0,3
SAN LORENZO(TJA),"anticoncepcion, prevencion de its y de cancer de cuello uterino",umero de diu insertados,2016-10-01,0,1,2,1,0,4
SANTA CRUZ DE LA SIERRA,"anticoncepcion, prevencion de its y de cancer de cuello uterino",umero de diu insertados,2016-10-01,0,30,133,154,6,323
SANTA ROSA DEL SARA,"anticoncepcion, prevencion de its y de cancer de cuello uterino",umero de diu insertados,2016-10-01,0,0,1,0,1,2
SIPE SIPE,"anticoncepcion, prevencion de its y de cancer de cuello uterino",umero de diu insertados,2016-10-01,0,1,11,0,0,12
SUCRE,"anticoncepcion, prevencion de its y de cancer de cuello uterino",umero de diu insertados,2016-10-01,0,4,52,20,0,76
TARIJA,"anticoncepcion, prevencion de its y de cancer de cuello uterino",umero de diu insertados,2016-10-01,2,2,59,31,1,95
TIQUIPAYA,"anticoncepcion, prevencion de its y de cancer de cuello uterino",umero de diu insertados,2016-10-01,0,0,4,0,0,4
TOLATA,"anticoncepcion, prevencion de its y de cancer de cuello uterino",umero de diu insertados,2016-10-01,0,0,1,0,0,1
TORO TORO,"anticoncepcion, prevencion de its y de cancer de cuello uterino",umero de diu insertados,2016-10-01,0,0,2,1,0,3
TRINIDAD,"anticoncepcion, prevencion de its y de cancer de cuello uterino",umero de diu insertados,2016-10-01,0,0,10,4,0,14
TUPIZA,"anticoncepcion, prevencion de its y de cancer de cuello uterino",umero de diu insertados,2016-10-01,0,0,3,0,0,3
UYUNI,"anticoncepcion, prevencion de its y de cancer de cuello uterino",umero de diu insertados,2016-10-01,0,0,3,1,0,4
VALLEGRANDE,"anticoncepcion, prevencion de its y de cancer de cuello uterino",umero de diu insertados,2016-10-01,0,3,0,1,0,4
VILLA MONTES,"anticoncepcion, prevencion de its y de cancer de cuello uterino",umero de diu insertados,2016-10-01,0,0,5,2,0,7
VILLA TUNARI,"anticoncepcion, prevencion de its y de cancer de cuello uterino",umero de diu insertados,2016-10-01,0,0,1,3,0,4
VILLA VACA GUZMAN (MUYUPAMPA),"anticoncepcion, prevencion de its y de cancer de cuello uterino",umero de diu insertados,2016-10-01,0,1,0,0,0,1
VILLAZON,"anticoncepcion, prevencion de its y de cancer de cuello uterino",umero de diu insertados,2016-10-01,0,1,0,0,0,1
VINTO,"anticoncepcion, prevencion de its y de cancer de cuello uterino",umero de diu insertados,2016-10-01,0,0,7,1,0,8
WARNES,"anticoncepcion, prevencion de its y de cancer de cuello uterino",umero de diu insertados,2016-10-01,0,0,2,1,0,3
YACUIBA,"anticoncepcion, prevencion de its y de cancer de cuello uterino",umero de diu insertados,2016-10-01,0,0,16,3,0,19
YOCALLA,"anticoncepcion, prevencion de its y de cancer de cuello uterino",umero de diu insertados,2016-10-01,0,0,1,0,0,1
AIQUILE,"anticoncepcion, prevencion de its y de cancer de cuello uterino",umero de diu insertados,2016-11-01,0,1,3,1,0,5
ASCENCION DE GUARAYOS,"anticoncepcion, prevencion de its y de cancer de cuello uterino",umero de diu insertados,2016-11-01,0,1,2,1,0,4
ATOCHA,"anticoncepcion, prevencion de its y de cancer de cuello uterino",umero de diu insertados,2016-11-01,0,1,0,0,0,1
AZURDUY,"anticoncepcion, prevencion de its y de cancer de cuello uterino",umero de diu insertados,2016-11-01,0,0,1,0,0,1
BAURES,"anticoncepcion, prevencion de its y de cancer de cuello uterino",umero de diu insertados,2016-11-01,0,0,0,1,0,1
BERMEJO,"anticoncepcion, prevencion de its y de cancer de cuello uterino",umero de diu insertados,2016-11-01,0,0,3,1,0,4
BOYUIBE,"anticoncepcion, prevencion de its y de cancer de cuello uterino",umero de diu insertados,2016-11-01,0,0,1,0,0,1
BUENA VISTA,"anticoncepcion, prevencion de its y de cancer de cuello uterino",umero de diu insertados,2016-11-01,0,0,2,0,0,2
CAMARGO,"anticoncepcion, prevencion de its y de cancer de cuello uterino",umero de diu insertados,2016-11-01,0,1,3,2,0,6
CAMIRI,"anticoncepcion, prevencion de its y de cancer de cuello uterino",umero de diu insertados,2016-11-01,0,1,6,2,0,9
CARANAVI,"anticoncepcion, prevencion de its y de cancer de cuello uterino",umero de diu insertados,2016-11-01,0,0,4,2,0,6
CHALLAPATA,"anticoncepcion, prevencion de its y de cancer de cuello uterino",umero de diu insertados,2016-11-01,0,0,1,0,0,1
CHARAGUA,"anticoncepcion, prevencion de its y de cancer de cuello uterino",umero de diu insertados,2016-11-01,0,0,2,0,0,2
COBIJA,"anticoncepcion, prevencion de its y de cancer de cuello uterino",umero de diu insertados,2016-11-01,0,2,2,0,0,4
COCHABAMBA,"anticoncepcion, prevencion de its y de cancer de cuello uterino",umero de diu insertados,2016-11-01,0,20,99,31,1,151
COLCAPIRHUA,"anticoncepcion, prevencion de its y de cancer de cuello uterino",umero de diu insertados,2016-11-01,0,0,1,1,0,2
COTOCA,"anticoncepcion, prevencion de its y de cancer de cuello uterino",umero de diu insertados,2016-11-01,0,0,1,2,0,3
EL ALTO,"anticoncepcion, prevencion de its y de cancer de cuello uterino",umero de diu insertados,2016-11-01,0,7,36,5,0,48
EL PUENTE(STC),"anticoncepcion, prevencion de its y de cancer de cuello uterino",umero de diu insertados,2016-11-01,0,0,1,0,0,1
EL PUENTE(TJA),"anticoncepcion, prevencion de its y de cancer de cuello uterino",umero de diu insertados,2016-11-01,0,0,0,1,0,1
EL TORNO,"anticoncepcion, prevencion de its y de cancer de cuello uterino",umero de diu insertados,2016-11-01,2,3,5,2,0,12
ENTRE RIOS TRJ,"anticoncepcion, prevencion de its y de cancer de cuello uterino",umero de diu insertados,2016-11-01,0,0,5,0,0,5
ENTRE RIOS CBBA,"anticoncepcion, prevencion de its y de cancer de cuello uterino",umero de diu insertados,2016-11-01,0,0,1,0,0,1
GENERAL SAAVEDRA,"anticoncepcion, prevencion de its y de cancer de cuello uterino",umero de diu insertados,2016-11-01,0,0,2,1,0,3
GUANAY,"anticoncepcion, prevencion de its y de cancer de cuello uterino",umero de diu insertados,2016-11-01,0,0,1,0,0,1
GUAYARAMERIN,"anticoncepcion, prevencion de its y de cancer de cuello uterino",umero de diu insertados,2016-11-01,0,0,3,0,0,3
HUACARETA,"anticoncepcion, prevencion de its y de cancer de cuello uterino",umero de diu insertados,2016-11-01,0,0,3,0,0,3
LA GUARDIA,"anticoncepcion, prevencion de its y de cancer de cuello uterino",umero de diu insertados,2016-11-01,0,1,7,0,0,8
LA PAZ,"anticoncepcion, prevencion de its y de cancer de cuello uterino",umero de diu insertados,2016-11-01,0,6,168,60,0,234
LAJA,"anticoncepcion, prevencion de its y de cancer de cuello uterino",umero de diu insertados,2016-11-01,0,0,1,0,0,1
LLALLAGUA,"anticoncepcion, prevencion de its y de cancer de cuello uterino",umero de diu insertados,2016-11-01,0,1,1,1,0,3
LURIBAY,"anticoncepcion, prevencion de its y de cancer de cuello uterino",umero de diu insertados,2016-11-01,0,0,1,0,0,1
MAGDALENA,"anticoncepcion, prevencion de its y de cancer de cuello uterino",umero de diu insertados,2016-11-01,0,0,1,0,0,1
MAIRANA,"anticoncepcion, prevencion de its y de cancer de cuello uterino",umero de diu insertados,2016-11-01,0,0,1,1,0,2
MINEROS,"anticoncepcion, prevencion de its y de cancer de cuello uterino",umero de diu insertados,2016-11-01,0,0,1,0,0,1
MONTEAGUDO,"anticoncepcion, prevencion de its y de cancer de cuello uterino",umero de diu insertados,2016-11-01,0,0,4,0,0,4
MONTERO,"anticoncepcion, prevencion de its y de cancer de cuello uterino",umero de diu insertados,2016-11-01,0,2,7,1,0,10
MOROCHATA,"anticoncepcion, prevencion de its y de cancer de cuello uterino",umero de diu insertados,2016-11-01,0,1,0,0,0,1
OKINAWA,"anticoncepcion, prevencion de its y de cancer de cuello uterino",umero de diu insertados,2016-11-01,0,3,2,0,0,5
ORURO,"anticoncepcion, prevencion de its y de cancer de cuello uterino",umero de diu insertados,2016-11-01,0,2,24,9,0,35
PADCAYA,"anticoncepcion, prevencion de its y de cancer de cuello uterino",umero de diu insertados,2016-11-01,0,0,2,1,0,3
PADILLA,"anticoncepcion, prevencion de its y de cancer de cuello uterino",umero de diu insertados,2016-11-01,0,0,1,1,0,2
PAILON,"anticoncepcion, prevencion de its y de cancer de cuello uterino",umero de diu insertados,2016-11-01,0,1,3,0,0,4
POCONA,"anticoncepcion, prevencion de its y de cancer de cuello uterino",umero de diu insertados,2016-11-01,0,0,1,0,0,1
PORTACHUELO,"anticoncepcion, prevencion de its y de cancer de cuello uterino",umero de diu insertados,2016-11-01,0,0,1,0,0,1
PORVENIR,"anticoncepcion, prevencion de its y de cancer de cuello uterino",umero de diu insertados,2016-11-01,0,1,0,0,0,1
POTOSI,"anticoncepcion, prevencion de its y de cancer de cuello uterino",umero de diu insertados,2016-11-01,0,0,9,22,0,31
PUERTO QUIJARRO,"anticoncepcion, prevencion de its y de cancer de cuello uterino",umero de diu insertados,2016-11-01,0,0,2,0,0,2
PUERTO RICO,"anticoncepcion, prevencion de its y de cancer de cuello uterino",umero de diu insertados,2016-11-01,0,0,0,1,0,1
PUERTO SUAREZ,"anticoncepcion, prevencion de its y de cancer de cuello uterino",umero de diu insertados,2016-11-01,0,0,4,0,0,4
PUERTO VILLARROEL,"anticoncepcion, prevencion de its y de cancer de cuello uterino",umero de diu insertados,2016-11-01,0,0,3,0,0,3
PUNA,"anticoncepcion, prevencion de its y de cancer de cuello uterino",umero de diu insertados,2016-11-01,0,0,0,2,0,2
PUNATA,"anticoncepcion, prevencion de its y de cancer de cuello uterino",umero de diu insertados,2016-11-01,0,0,1,0,0,1
QUILLACOLLO,"anticoncepcion, prevencion de its y de cancer de cuello uterino",umero de diu insertados,2016-11-01,0,0,11,2,0,13
QUIRUSILLAS,"anticoncepcion, prevencion de its y de cancer de cuello uterino",umero de diu insertados,2016-11-01,0,0,2,0,0,2
RIBERALTA,"anticoncepcion, prevencion de its y de cancer de cuello uterino",umero de diu insertados,2016-11-01,0,1,2,1,0,4
ROBORE,"anticoncepcion, prevencion de its y de cancer de cuello uterino",umero de diu insertados,2016-11-01,0,0,1,0,0,1
SACABA,"anticoncepcion, prevencion de its y de cancer de cuello uterino",umero de diu insertados,2016-11-01,0,1,11,4,0,16
SAIPINA,"anticoncepcion, prevencion de its y de cancer de cuello uterino",umero de diu insertados,2016-11-01,0,1,2,1,0,4
SAN BORJA,"anticoncepcion, prevencion de its y de cancer de cuello uterino",umero de diu insertados,2016-11-01,0,0,3,1,0,4
SAN CARLOS,"anticoncepcion, prevencion de its y de cancer de cuello uterino",umero de diu insertados,2016-11-01,0,0,6,1,0,7
SAN IGNACIO,"anticoncepcion, prevencion de its y de cancer de cuello uterino",umero de diu insertados,2016-11-01,0,0,6,1,0,7
SAN IGNACIO DE VELASCO,"anticoncepcion, prevencion de its y de cancer de cuello uterino",umero de diu insertados,2016-11-01,0,2,7,1,0,10
SAN JAVIER(STC),"anticoncepcion, prevencion de its y de cancer de cuello uterino",umero de diu insertados,2016-11-01,0,1,1,0,0,2
SAN JOSE DE CHIQUITOS,"anticoncepcion, prevencion de its y de cancer de cuello uterino",umero de diu insertados,2016-11-01,0,1,2,1,0,4
SAN LORENZO(TJA),"anticoncepcion, prevencion de its y de cancer de cuello uterino",umero de diu insertados,2016-11-01,0,1,2,1,0,4
SAN PEDRO DE TIQUINA,"anticoncepcion, prevencion de its y de cancer de cuello uterino",umero de diu insertados,2016-11-01,0,0,1,0,0,1
SAN RAMON BENI,"anticoncepcion, prevencion de its y de cancer de cuello uterino",umero de diu insertados,2016-11-01,0,0,1,0,0,1
SAN RAMON SCZ,"anticoncepcion, prevencion de its y de cancer de cuello uterino",umero de diu insertados,2016-11-01,0,0,1,0,0,1
SANTA ANA,"anticoncepcion, prevencion de its y de cancer de cuello uterino",umero de diu insertados,2016-11-01,0,0,2,1,0,3
SANTA CRUZ DE LA SIERRA,"anticoncepcion, prevencion de its y de cancer de cuello uterino",umero de diu insertados,2016-11-01,7,11,94,36,0,148
SANTA ROSA DEL SARA,"anticoncepcion, prevencion de its y de cancer de cuello uterino",umero de diu insertados,2016-11-01,0,0,1,0,0,1
SIPE SIPE,"anticoncepcion, prevencion de its y de cancer de cuello uterino",umero de diu insertados,2016-11-01,0,0,7,0,0,7
SUCRE,"anticoncepcion, prevencion de its y de cancer de cuello uterino",umero de diu insertados,2016-11-01,0,3,45,15,0,63
TARIJA,"anticoncepcion, prevencion de its y de cancer de cuello uterino",umero de diu insertados,2016-11-01,0,4,50,25,0,79
TIPUANI,"anticoncepcion, prevencion de its y de cancer de cuello uterino",umero de diu insertados,2016-11-01,0,0,1,0,0,1
TIQUIPAYA,"anticoncepcion, prevencion de its y de cancer de cuello uterino",umero de diu insertados,2016-11-01,0,0,4,2,0,6
TOTORA(CBBA),"anticoncepcion, prevencion de its y de cancer de cuello uterino",umero de diu insertados,2016-11-01,0,0,1,1,0,2
TRINIDAD,"anticoncepcion, prevencion de its y de cancer de cuello uterino",umero de diu insertados,2016-11-01,0,0,10,1,0,11
UYUNI,"anticoncepcion, prevencion de its y de cancer de cuello uterino",umero de diu insertados,2016-11-01,0,1,1,0,0,2
VALLEGRANDE,"anticoncepcion, prevencion de its y de cancer de cuello uterino",umero de diu insertados,2016-11-01,0,1,3,0,0,4
VILLA TUNARI,"anticoncepcion, prevencion de its y de cancer de cuello uterino",umero de diu insertados,2016-11-01,0,0,2,4,0,6
VILLA VACA GUZMAN (MUYUPAMPA),"anticoncepcion, prevencion de its y de cancer de cuello uterino",umero de diu insertados,2016-11-01,0,0,1,0,0,1
VILLAZON,"anticoncepcion, prevencion de its y de cancer de cuello uterino",umero de diu insertados,2016-11-01,0,0,3,0,0,3
VINTO,"anticoncepcion, prevencion de its y de cancer de cuello uterino",umero de diu insertados,2016-11-01,0,2,4,0,0,6
WARNES,"anticoncepcion, prevencion de its y de cancer de cuello uterino",umero de diu insertados,2016-11-01,0,0,2,0,0,2
YACUIBA,"anticoncepcion, prevencion de its y de cancer de cuello uterino",umero de diu insertados,2016-11-01,0,1,17,1,1,20
AIQUILE,"anticoncepcion, prevencion de its y de cancer de cuello uterino",umero de diu insertados,2016-12-01,0,0,1,0,0,1
ATOCHA,"anticoncepcion, prevencion de its y de cancer de cuello uterino",umero de diu insertados,2016-12-01,0,0,1,1,0,2
AYOPAYA (V. DE INDEPENDENCIA),"anticoncepcion, prevencion de its y de cancer de cuello uterino",umero de diu insertados,2016-12-01,0,0,1,1,0,2
BERMEJO,"anticoncepcion, prevencion de its y de cancer de cuello uterino",umero de diu insertados,2016-12-01,0,1,2,0,0,3
BOYUIBE,"anticoncepcion, prevencion de its y de cancer de cuello uterino",umero de diu insertados,2016-12-01,0,0,1,0,0,1
BUENA VISTA,"anticoncepcion, prevencion de its y de cancer de cuello uterino",umero de diu insertados,2016-12-01,1,0,1,0,0,2
CAMARGO,"anticoncepcion, prevencion de its y de cancer de cuello uterino",umero de diu insertados,2016-12-01,0,0,2,0,0,2
CAMIRI,"anticoncepcion, prevencion de its y de cancer de cuello uterino",umero de diu insertados,2016-12-01,0,1,4,0,0,5
CARANAVI,"anticoncepcion, prevencion de its y de cancer de cuello uterino",umero de diu insertados,2016-12-01,0,0,0,1,0,1
CLIZA,"anticoncepcion, prevencion de its y de cancer de cuello uterino",umero de diu insertados,2016-12-01,0,0,4,0,0,4
COBIJA,"anticoncepcion, prevencion de its y de cancer de cuello uterino",umero de diu insertados,2016-12-01,0,0,1,0,0,1
COCHABAMBA,"anticoncepcion, prevencion de its y de cancer de cuello uterino",umero de diu insertados,2016-12-01,0,5,119,29,0,153
COLOMI,"anticoncepcion, prevencion de its y de cancer de cuello uterino",umero de diu insertados,2016-12-01,0,0,2,1,0,3
CONCEPCION,"anticoncepcion, prevencion de its y de cancer de cuello uterino",umero de diu insertados,2016-12-01,0,0,1,0,0,1
COTOCA,"anticoncepcion, prevencion de its y de cancer de cuello uterino",umero de diu insertados,2016-12-01,0,1,2,0,0,3
EL ALTO,"anticoncepcion, prevencion de its y de cancer de cuello uterino",umero de diu insertados,2016-12-01,0,1,37,4,0,42
EL TORNO,"anticoncepcion, prevencion de its y de cancer de cuello uterino",umero de diu insertados,2016-12-01,0,1,0,0,0,1
ENTRE RIOS TRJ,"anticoncepcion, prevencion de its y de cancer de cuello uterino",umero de diu insertados,2016-12-01,0,0,1,0,0,1
ESCARA,"anticoncepcion, prevencion de its y de cancer de cuello uterino",umero de diu insertados,2016-12-01,0,0,2,0,0,2
GENERAL SAAVEDRA,"anticoncepcion, prevencion de its y de cancer de cuello uterino",umero de diu insertados,2016-12-01,0,0,1,1,0,2
GUTIERREZ,"anticoncepcion, prevencion de its y de cancer de cuello uterino",umero de diu insertados,2016-12-01,0,0,1,0,0,1
HUACARETA,"anticoncepcion, prevencion de its y de cancer de cuello uterino",umero de diu insertados,2016-12-01,0,2,0,0,0,2
LA GUARDIA,"anticoncepcion, prevencion de its y de cancer de cuello uterino",umero de diu insertados,2016-12-01,0,1,4,2,0,7
LA PAZ,"anticoncepcion, prevencion de its y de cancer de cuello uterino",umero de diu insertados,2016-12-01,0,5,113,38,0,156
LAS CARRERAS,"anticoncepcion, prevencion de its y de cancer de cuello uterino",umero de diu insertados,2016-12-01,0,0,0,1,0,1
LLALLAGUA,"anticoncepcion, prevencion de its y de cancer de cuello uterino",umero de diu insertados,2016-12-01,0,0,2,1,0,3
MAPIRI,"anticoncepcion, prevencion de its y de cancer de cuello uterino",umero de diu insertados,2016-12-01,0,0,1,0,0,1
MINEROS,"anticoncepcion, prevencion de its y de cancer de cuello uterino",umero de diu insertados,2016-12-01,0,0,1,0,0,1
MIZQUE,"anticoncepcion, prevencion de its y de cancer de cuello uterino",umero de diu insertados,2016-12-01,0,0,2,0,0,2
MONTEAGUDO,"anticoncepcion, prevencion de its y de cancer de cuello uterino",umero de diu insertados,2016-12-01,2,1,1,1,0,5
MONTERO,"anticoncepcion, prevencion de its y de cancer de cuello uterino",umero de diu insertados,2016-12-01,0,1,7,1,0,9
MOROCHATA,"anticoncepcion, prevencion de its y de cancer de cuello uterino",umero de diu insertados,2016-12-01,0,1,0,0,0,1
ORURO,"anticoncepcion, prevencion de its y de cancer de cuello uterino",umero de diu insertados,2016-12-01,0,1,17,3,0,21
PADCAYA,"anticoncepcion, prevencion de its y de cancer de cuello uterino",umero de diu insertados,2016-12-01,0,0,1,0,0,1
PADILLA,"anticoncepcion, prevencion de its y de cancer de cuello uterino",umero de diu insertados,2016-12-01,0,0,2,0,0,2
PAILON,"anticoncepcion, prevencion de its y de cancer de cuello uterino",umero de diu insertados,2016-12-01,0,1,1,0,0,2
PAMPA GRANDE,"anticoncepcion, prevencion de its y de cancer de cuello uterino",umero de diu insertados,2016-12-01,0,0,1,0,0,1
PORCO,"anticoncepcion, prevencion de its y de cancer de cuello uterino",umero de diu insertados,2016-12-01,0,0,1,0,0,1
PORTACHUELO,"anticoncepcion, prevencion de its y de cancer de cuello uterino",umero de diu insertados,2016-12-01,0,1,1,0,0,2
POTOSI,"anticoncepcion, prevencion de its y de cancer de cuello uterino",umero de diu insertados,2016-12-01,0,1,2,14,0,17
PUERTO QUIJARRO,"anticoncepcion, prevencion de its y de cancer de cuello uterino",umero de diu insertados,2016-12-01,0,0,5,0,0,5
PUERTO SUAREZ,"anticoncepcion, prevencion de its y de cancer de cuello uterino",umero de diu insertados,2016-12-01,0,0,1,0,0,1
PUERTO VILLARROEL,"anticoncepcion, prevencion de its y de cancer de cuello uterino",umero de diu insertados,2016-12-01,0,0,1,0,0,1
PUNATA,"anticoncepcion, prevencion de its y de cancer de cuello uterino",umero de diu insertados,2016-12-01,0,2,1,1,0,4
QUILLACOLLO,"anticoncepcion, prevencion de its y de cancer de cuello uterino",umero de diu insertados,2016-12-01,0,0,11,4,0,15
QUIRUSILLAS,"anticoncepcion, prevencion de its y de cancer de cuello uterino",umero de diu insertados,2016-12-01,0,0,1,0,0,1
RIBERALTA,"anticoncepcion, prevencion de its y de cancer de cuello uterino",umero de diu insertados,2016-12-01,0,0,1,0,0,1
ROBORE,"anticoncepcion, prevencion de its y de cancer de cuello uterino",umero de diu insertados,2016-12-01,0,0,3,0,0,3
RURRENABAQUE,"anticoncepcion, prevencion de its y de cancer de cuello uterino",umero de diu insertados,2016-12-01,0,0,1,0,0,1
SACABA,"anticoncepcion, prevencion de its y de cancer de cuello uterino",umero de diu insertados,2016-12-01,0,2,12,6,0,20
SAN BORJA,"anticoncepcion, prevencion de its y de cancer de cuello uterino",umero de diu insertados,2016-12-01,0,3,1,0,0,4
SAN BUENA VENTURA,"anticoncepcion, prevencion de its y de cancer de cuello uterino",umero de diu insertados,2016-12-01,0,1,1,0,0,2
SAN CARLOS,"anticoncepcion, prevencion de its y de cancer de cuello uterino",umero de diu insertados,2016-12-01,0,0,1,0,0,1
SAN IGNACIO,"anticoncepcion, prevencion de its y de cancer de cuello uterino",umero de diu insertados,2016-12-01,0,1,5,0,1,7
SAN IGNACIO DE VELASCO,"anticoncepcion, prevencion de its y de cancer de cuello uterino",umero de diu insertados,2016-12-01,0,2,6,2,0,10
SAN JAVIER(STC),"anticoncepcion, prevencion de its y de cancer de cuello uterino",umero de diu insertados,2016-12-01,0,0,2,0,0,2
SAN JOSE DE CHIQUITOS,"anticoncepcion, prevencion de its y de cancer de cuello uterino",umero de diu insertados,2016-12-01,0,0,4,1,0,5
SAN JULIAN,"anticoncepcion, prevencion de its y de cancer de cuello uterino",umero de diu insertados,2016-12-01,0,0,2,0,0,2
SAN LORENZO(TJA),"anticoncepcion, prevencion de its y de cancer de cuello uterino",umero de diu insertados,2016-12-01,0,0,0,1,0,1
SAN RAMON BENI,"anticoncepcion, prevencion de its y de cancer de cuello uterino",umero de diu insertados,2016-12-01,0,0,0,1,0,1
SAN RAMON SCZ,"anticoncepcion, prevencion de its y de cancer de cuello uterino",umero de diu insertados,2016-12-01,0,0,2,0,0,2
SANTA ANA,"anticoncepcion, prevencion de its y de cancer de cuello uterino",umero de diu insertados,2016-12-01,0,1,0,0,0,1
SANTA CRUZ DE LA SIERRA,"anticoncepcion, prevencion de its y de cancer de cuello uterino",umero de diu insertados,2016-12-01,0,32,123,83,1,239
SANTA ROSA DEL SARA,"anticoncepcion, prevencion de its y de cancer de cuello uterino",umero de diu insertados,2016-12-01,0,0,2,0,0,2
SANTIAGO DE HUARI,"anticoncepcion, prevencion de its y de cancer de cuello uterino",umero de diu insertados,2016-12-01,0,0,1,0,0,1
SIPE SIPE,"anticoncepcion, prevencion de its y de cancer de cuello uterino",umero de diu insertados,2016-12-01,0,0,3,2,0,5
SUCRE,"anticoncepcion, prevencion de its y de cancer de cuello uterino",umero de diu insertados,2016-12-01,0,3,47,15,1,66
TACOPAYA,"anticoncepcion, prevencion de its y de cancer de cuello uterino",umero de diu insertados,2016-12-01,0,0,1,0,0,1
TAPACARI,"anticoncepcion, prevencion de its y de cancer de cuello uterino",umero de diu insertados,2016-12-01,0,0,0,1,0,1
TARATA,"anticoncepcion, prevencion de its y de cancer de cuello uterino",umero de diu insertados,2016-12-01,0,0,1,0,0,1
TARIJA,"anticoncepcion, prevencion de its y de cancer de cuello uterino",umero de diu insertados,2016-12-01,0,8,79,34,0,121
TIQUIPAYA,"anticoncepcion, prevencion de its y de cancer de cuello uterino",umero de diu insertados,2016-12-01,0,1,3,0,0,4
TOMAVE,"anticoncepcion, prevencion de its y de cancer de cuello uterino",umero de diu insertados,2016-12-01,0,0,1,0,0,1
TORO TORO,"anticoncepcion, prevencion de its y de cancer de cuello uterino",umero de diu insertados,2016-12-01,0,0,1,1,0,2
TRINIDAD,"anticoncepcion, prevencion de its y de cancer de cuello uterino",umero de diu insertados,2016-12-01,0,0,9,4,0,13
TUPIZA,"anticoncepcion, prevencion de its y de cancer de cuello uterino",umero de diu insertados,2016-12-01,0,0,2,1,0,3
VALLEGRANDE,"anticoncepcion, prevencion de its y de cancer de cuello uterino",umero de diu insertados,2016-12-01,0,0,1,0,0,1
VIACHA,"anticoncepcion, prevencion de its y de cancer de cuello uterino",umero de diu insertados,2016-12-01,0,0,8,3,0,11
VILLA CHARCAS,"anticoncepcion, prevencion de its y de cancer de cuello uterino",umero de diu insertados,2016-12-01,0,0,1,0,0,1
VILLA MONTES,"anticoncepcion, prevencion de its y de cancer de cuello uterino",umero de diu insertados,2016-12-01,0,0,1,0,0,1
VILLA TUNARI,"anticoncepcion, prevencion de its y de cancer de cuello uterino",umero de diu insertados,2016-12-01,0,0,0,3,0,3
VILLA VACA GUZMAN (MUYUPAMPA),"anticoncepcion, prevencion de its y de cancer de cuello uterino",umero de diu insertados,2016-12-01,0,0,2,2,0,4
VILLAZON,"anticoncepcion, prevencion de its y de cancer de cuello uterino",umero de diu insertados,2016-12-01,0,0,2,1,0,3
VINTO,"anticoncepcion, prevencion de its y de cancer de cuello uterino",umero de diu insertados,2016-12-01,0,3,12,0,0,15
WARNES,"anticoncepcion, prevencion de its y de cancer de cuello uterino",umero de diu insertados,2016-12-01,0,0,5,0,0,5
YACUIBA,"anticoncepcion, prevencion de its y de cancer de cuello uterino",umero de diu insertados,2016-12-01,0,3,8,0,0,11
YOCALLA,"anticoncepcion, prevencion de its y de cancer de cuello uterino",umero de diu insertados,2016-12-01,0,0,1,0,0,1
